habathu,	হাবাথু,	হাবাথু,	
sangaskritipreme,	সংস্কৃতৃতেপ্রেপে,	সংস্কৃতিপ্রেমে,	
ghotolen,	ঘটলেন,	ঘটলেন,	
bibecchyo,	বিবেচ্ছ,	বিবেচ্য,	
dweepgoolotey,	দ্বীপগুলিতে,	দ্বীপগুলোতে,	
ved,	ভেদ,	বেদ,	
kaleo,	কালেও,	কালেও,	
chaudhurider,	চৌধুরীদের,	চৌধুরীদের,	
meloonborrone,	মেলোকনগররে,	মেলবোর্নে,	
sommotite,	সম্মতিতে,	সম্মতিতে,	
baasaate,	বাসাতে,	বাসাতে,	
mahasava,	মহাসভা,	মহাসভা,	
reshmirekha,	রেশমেরেখা,	রেশমীরেখা,	
si,	সি,	এসআই,	
sip,	সিপ,	শিপ,	
raiialati,	রাইফালিট,	রয়্যালটি,	
asif,	আসিফ,	আসিফ,	
shilpikuler,	শিল্পীকুলের,	শিল্পীকুলের,	
thyachar,	থ্যাচার,	থ্যাচার,	
ghumachche,	ঘুমাচ্ছে,	ঘুমাচ্ছে,	
probeshan,	প্রবেশান,	প্রবেশন,	
krus,	ক্রুস,	ক্রুশ,	
chahidapotrer,	চাহিদাপত্রের,	চাহিদাপত্রের,	
aairees,	আইরিস,	আইরিস,	
anandamahale,	আনন্দমহলে,	আনন্দমহলে,	
markeetim,	মার্কিটিম,	মার্কেটিং,	
assaciates,	অ্যাসাসিয়েটস,	এসোসিয়েটস,	
byabaharkareer,	ব্যবহারকারীর,	ব্যবহারকারীর,	
granthatyke,	গ্রান্থাটকে,	গ্রন্থটিকে,	
churger,	চার্গের,	চার্জের,	
dhonni,	ধন্ী,	ধন্যি,	
jansa,	জানসা,	জন্স,	
charban,	চরবান,	চর্বন,	
sinakey,	সিনাকে,	সিনাকে,	
arekdol,	আরেকদোল,	আরেকদল,	
milea,	মিলি,	মাইলে,	
gandogol,	গণ্ডগোল,	গন্ডগোল,	
bedantodhormo,	বেদান্তধর্ম,	বেদান্তধর্ম,	
jontrangshogulor,	যন্ত্রাংশগুলোর,	যন্ত্রাংশগুলোর,	
yaq,	যাক,	ইয়াক,	
silabhara,	সিলাভারা,	সিলভার,	
mozlis,	মজলিস,	মজলিশ,	
bhromonkaale,	ভ্রমণকালে,	ভ্রমণকালে,	
nodimatrik,	নদীমাত্রিক,	নদীমাতৃক,	
biplabee,	বিপ্লববে,	বিপ্লবী,	
rashider,	রাশীদের,	রশিদের,	
teenej,	তেইনজ,	টিনেজ,	
byaboharkarie,	ব্যবহারকারী,	ব্যবহারকারীই,	
addabaj,	আদ্ডাবাজ,	আড্ডাবাজ,	
chatrorai,	ছাত্ররাই,	ছাত্ররাই,	
choudry,	চাউড্রি,	চৌধুরী,	
kantojir,	কান্তজীর,	কান্তজির,	
liaodong,	লিয়াডওং,	লিয়াওদং,	
sealvi,	সিলভি,	সিলভি,	
jandrel,	জান্দ্রেল,	জাঁদরেল,	
deputi,	দেপুটি,	ডেপুটি,	
sazanor,	সাজানোর,	সাজানোর,	
croak,	ক্রোয়াক,	ক্রোক,	
ekok,	একোক,	একক,	
forma,	ফোরমা,	ফর্মা,	
bikretaara,	বিক্রিতারা,	বিক্রেতারা,	
oikhan,	ঐখখান,	ঐখান,	
amittrakkhor,	অমিত্রাক্ষর,	অমিত্রাক্ষর,	
cheess,	চিস,	চেস,	
gabinius,	গাবিনিয়াস,	গাবিনিআস,	
chikkingsasoho,	চিক্কিংসাসহ,	চিকিংসাসহ,	
kanasharabheshhana,	কনারার্ভেষণা,	কনসারভেশন,	
dayitta,	দায়িত্ব,	দায়িত্ব,	
uponeeshod,	উপনিষদ,	উপনিষদ,	
bahubar,	বাহুবার,	বহুবার,	
seconder,	সেকন্ডের,	সেকেন্ডের,	
turkii,	তুরকি,	তুর্কি,	
soteciety,	সোটেসিওটি,	সোসাইটিতে,	
hank,	হ্যাঙ্ক,	হাঙ্ক,	
timoothi,	তিমুথী,	টিমোথি,	
bolbo,	বলবো,	বলবো,	
grambasheeo,	গ্রামবাসেও,	গ্রামবাসীও,	
chamski,	চামস্কি,	চমস্কি,	
weenis,	ওয়েনিস,	ভেনিস,	
gaziipur,	গজিিপুর,	গাজীপুর,	
juboke,	যুবকে,	যুবকে,	
phakay,	একায়া,	ফাকে,	
chemjong,	চেমঝং,	চেমজং,	
pinglateo,	পিংলাতেও,	পিংলাতেও,	
paste,	পাস্তে,	পেষ্ট,	
aprasangikbhabei,	অপ্রাানসিভক্বেই,	অপ্রাসঙ্গিকভাবেই,	
gandhiir,	গানধীর,	গান্ধীর,	
mathews,	ম্যাভেস,	ম্যাথিউস,	
hepatitis,	হেপাটাটিস,	হেপাটাইটিস,	
fatkabazare,	ফতকবাজারে,	ফাটকাবাজারে,	
harbare,	হরবারে,	হারবারে,	
ovinetar,	অভিনেতার,	অভিনেতার,	
qraima,	ক্রেইম,	ক্রাইম,	
konoroop,	কনরূপ,	কোনরূপ,	
dhaleshorii,	ধলেশরি,	ধলেশ্বরী,	
vangley,	ভাংলে,	ভাঙলে,	
koota,	কোটা,	কোটা,	
rahimed,	রহিমেদ,	রহিমেদ,	
vromonkaley,	ভ্রমণকালে,	ভ্রমণকালে,	
akatwa,	আকা্তবা,	একাত্ব,	
basermick,	বেসারম্যাক,	বেসারমিক,	
orthonitir,	অর্থনীতির,	অর্থনীতির,	
bethikata,	বেথিকাটা,	বেঠিকতা,	
aasirbaad,	এসীরবাদ,	আশির্বাদ,	
vetrillocuism,	ভেট্রিলো্লিকম,	ভেট্রিলোকুইজম,	
asovyo,	অসভ্য,	অসভ্য,	
sharif,	শরিিফ,	শরিফ,	
toufik,	তাফিক,	তৌফিক,	
khitkar,	খিটকার,	ক্ষিতকর,	
disposes,	ডিসপোজেস,	ডিসপোজেস,	
mentither,	মেন্থিথের,	মেনটিথের,	
ostheesandhi,	অস্থিসন্ধি,	অস্থিসন্ধি,	
vorkendra,	ভররকেন্দ্র,	ভরকেন্দ্র,	
seo,	সেও,	সেও,	
ranangane,	রানাঙ্গনে,	রণাঙ্গনে,	
oncolsoho,	অনকলসহ,	অঞ্চলসহ,	
orthanitir,	অর্থানিতির,	অর্থনীতির,	
bodhukeo,	বোধুকেও,	বধুকেও,	
dalip,	ডালিপ,	দালিপ,	
charpanch,	চারপাঞ্চ,	চারপাঁচ,	
parisankhanbid,	পরিসংখ্যানবিদ,	পরিসংখ্যানবিদ,	
romantik,	রোমান্টিক,	রোমান্টিক,	
pichte,	পিচতে,	পিছতে,	
dighol,	দিঘোল,	দীঘল,	
idyi,	আইডিআইআই,	আইডিই,	
kogake,	কোগাকে,	কোগাকে,	
deeares,	ডিয়ার্স,	ডিআরএস,	
thyachara,	থ্যাচারা,	থ্যাচার,	
orgho,	অর্ঘ,	অর্ঘ্য,	
nothibhukto,	নথিভুক্ত,	নথিভুক্ত,	
harris,	হ্যারিস,	হ্যারিস,	
prity,	প্রিইটি,	প্রিটি,	
batom,	বাতম,	বাটম,	
poripakey,	পরিপাকে,	পরিপাকে,	
debdebyr,	দেবদেবীর,	দেবদেবীর,	
atarkitey,	আতারকিতে,	অতর্কিতে,	
hijri,	হিজরি,	হিজরী,	
associatis,	অ্যাসোসিয়েটিস,	এসোসিয়েটস,	
hisabagyan,	হিসাবাগ্যন,	হিসাবজ্ঞান,	
pouchute,	পৌছুতে,	পৌঁছুতে,	
shurugulo,	শুরুগুলো,	শুরুগুলো,	
hojurer,	হজুরের,	হজুরের,	
bishnu,	বিষ্ণু,	বিষ্ণু,	
nothivookta,	নথভিভক্তা,	নথিভুক্ত,	
haitasha,	হাইতাশা,	হাইটস,	
adhunikkaley,	আধুনিক্যালে,	আধুনিককালে,	
totokhon,	ততৈখন,	ততক্ষন,	
satarkokari,	সতর্ককারী,	সতর্ককারী,	
phiksa,	ফিকসা,	ফিক্স,	
dishani,	ধিশানি,	দিশানি,	
dajjha,	দাজহা,	দাহ্য,	
sahajlabhbhotar,	সহজলভ্যভাতার,	সহজলভ্যতার,	
mase,	মাসে,	মাসে,	
ajeem,	আজিম,	আজিম,	
dinar,	দিনার,	ডিনার,	
lyandim,	ল্যান্ডিং,	ল্যান্ডিং,	
laat,	লাত,	লাট,	
standards,	স্ট্যান্ডার্ডস,	স্টান্ডার্ডস,	
biprodas,	বিপ্রদাস,	বিপ্রদাস,	
kanshat,	কানশট,	কানসাট,	
deputee,	ডিপিউট,	ডেপুটি,	
madhukori,	মধুকোরি,	মাধুকরী,	
khelechen,	খেলেছেন,	খেলেছেন,	
samashtike,	সামস্তিকে,	সমষ্টিকে,	
simantarkkhibahinir,	সীমান্তরখাক্ষিবাণীর,	সীমান্তরক্ষীবাহিনীর,	
danab,	দানাব,	দানব,	
themeke,	থেমেকে,	থিমকে,	
konorup,	কোনরূপ,	কোনরূপ,	
jyaqasana,	জ্যাকাসানা,	জ্যাকসন,	
horipur,	হরিপুর,	হরিপুর,	
aniyantrita,	অনিয়ন্ত্রিত,	অনিয়ন্ত্রিত,	
kani,	কানি,	কানি,	
bishashke,	বিষাশকে,	বিশ্বাসকে,	
hooq,	হুক,	হুক,	
ganonanatto,	গণনানাত্ত,	গণনাট্য,	
biplobi,	বিপ্লবী,	বিপ্লবী,	
ongshogrohoner,	অংশগ্রহণের,	অংশগ্রহনের,	
bojhe,	বঝে,	বোঝে,	
garora,	গারোরা,	গারোরা,	
tahalo,	তাহালো,	তাহলো,	
podarthobidder,	পদার্থবিদের,	পদার্থবিদদের,	
armeeniyana,	আর্মেনীয়ন,	আর্মেনিয়ান,	
dormetori,	ডরমেটরি,	ডরমিটরি,	
nomo,	নোমো,	নমো,	
probhuder,	প্রভুদের,	প্রভুদের,	
bagdad,	বাগদাদ,	বাগদাদে,	
seqtara,	সেক্তারা,	সেক্টর,	
superheiroo,	সুপারহিনেরও,	সুপারহিরো,	
ruptan,	রূপ্তান,	রূপটান,	
ponchasjon,	পঞ্চাসন,	পঞ্চাশজন,	
songkulan,	সংকুলান,	সংকুলান,	
snehban,	স্নেহবান,	স্নেহবান,	
abhidhaaner,	অভিধানের,	অভিধানের,	
tasminer,	তাসমিনের,	তাসমিনের,	
bodhirta,	বোধিরতা,	বধিরতা,	
footbalarra,	ফুটবালাররা,	ফুটবলাররা,	
grauth,	গ্রুউথ,	গ্রোথ,	
chaalkee,	চালক,	চালকে,	
brixfield,	ব্রিক্সফিল্ড,	ব্রিক্সফিল্ড,	
kurdira,	কুর্দিরা,	কুর্দিরা,	
quata,	কোয়াতা,	কোটা,	
unchuporjayer,	উঁচুপরাযায়ের,	উঁচুপর্যায়ের,	
hoil,	হইল,	হইল,	
manohputa,	মনোপপুতা,	মনঃপুত,	
murali,	মুরালি,	মুরলী,	
vushi,	ভুশী,	ভুষি,	
drissogoolote,	দৃশসগুলোতে,	দৃশ্যগুলোতে,	
plusey,	প্লুসে,	প্লাসে,	
dojo,	ডজো,	ডোজো,	
ganjana,	গঞ্জনা,	গঞ্জনা,	
bhagno,	ভাগনো,	ভগ্ন,	
oncoleo,	অঙ্কলেও,	অঞ্চলেও,	
khorsed,	খোর্সড,	খোরশেদ,	
nathivookteer,	ন্যাটিভুক্তির,	নথিভুক্তির,	
primoo,	প্রীমু,	প্রিমো,	
harasta,	হারস্তা,	হারাস্তা,	
poste,	পোস্টে,	পোষ্টে,	
chokhwala,	চোখবালা,	চোখওয়ালা,	
songbadmadhyomer,	সংবাদমাধ্যমের,	সংবাদমাধ্যমের,	
janghu,	জঙ্ঘু,	জঙ্ঘু,	
kanshater,	কানশতের,	কানসাটের,	
bojhey,	বোঝে,	বোঝে,	
uporitale,	উপরিতালে,	উপরিতলে,	
niropekkho,	নিরোপেক্ষ,	নিরপেক্ষ,	
societytey,	সোস্ইটিতে,	সোসাইটিতে,	
cloring,	ক্লরিং,	ক্লোরিং,	
sommoteer,	সম্মতির,	সম্মতির,	
teksuser,	টেকসুসের,	টেক্সাসের,	
ukeliptash,	উকেলিপ্তস,	ইউক্যালিপ্টাস,	
koordider,	কর্দীদের,	কুর্দিদের,	
ashiatic,	আশ্য়াটিক,	এশিয়াটিক,	
phiqsa,	ফিকসা,	ফিক্স,	
borkhastokritora,	বরখাস্তকতারারা,	বরখাস্তকৃতরা,	
mangoleek,	ম্যাঙ্গোলিক,	মাঙ্গলিক,	
pharn,	ফার্ন,	ফার্ন,	
gabhaskaar,	গভাসকার,	গাভাস্কার,	
matthews,	ম্যাথহেযা,	ম্যাথিউস,	
cheerokoomari,	চেরকুমারি,	চিরকুমারী,	
abarte,	আবার্তে,	আবর্তে,	
shingping,	শিংপিং,	শিংপিং,	
phartha,	ফার্থা,	ফার্থ,	
hillse,	হিলসে,	হিলসে,	
ameettrakkhor,	আমিত্ররক্ষর,	অমিত্রাক্ষর,	
tokee,	টকক,	তকি,	
mujuru,	মুজুরু,	মুজুরু,	
ansareer,	আনসারীর,	আনসারীর,	
longhan,	লঙ্ঘান,	লংঘন,	
dokaanei,	ডোকানেই,	দোকানেই,	
dheke,	ধেকে,	ঢেকে,	
bharpur,	ভারপুর,	ভরপুর,	
amburi,	আমবুরি,	আম্বুরি,	
mosharroph,	মোশারস,	মশাররফ,	
bibechyo,	বিবেচ্য,	বিবেচ্য,	
spredshiit,	স্প্রাডশেট,	স্প্রেডশীট,	
arthurer,	অর্থুরের,	আর্থারের,	
shilbar,	শিলবার,	সিলভার,	
jolrang,	জোরলাং,	জলরঙ,	
mukhomandal,	মুখমন্ডল,	মুখমণ্ডল,	
zeebonto,	জীবন্ত,	জীবন্ত,	
aswasteekor,	অস্বাস্তিকর,	অস্বস্তিকর,	
sahinsatar,	সহিনসতার,	সহিংসতার,	
elakatite,	এলাকাটিতে,	এলাকাটিকে,	
chaanoo,	চানু,	চানু,	
arshie,	আরশি,	আরসিএ,	
shotodha,	শতধা,	শতধা,	
satarkatar,	সতর্কাটার,	সতর্কতার,	
sahozlabhbhatar,	সহজ্যভল্লারার,	সহজলভ্যতার,	
akkhunno,	অক্ষুন্ন,	অক্ষুণ্ণ,	
shector,	সেক্টর,	সেক্টর,	
parijaner,	পরিজানের,	পরিজনের,	
bangobandhu,	বঙ্গবন্ধু,	বঙ্গবন্ধু,	
naitikatavodh,	নৈতিকতাবোধ,	নৈতিকতাবোধ,	
guha,	গুহা,	গোহ,	
jeshtha,	যেষ্ঠ,	জ্যেষ্ঠা,	
sarbhare,	সারভারে,	সার্ভারে,	
chargar,	চরগর,	চার্জার,	
vushito,	ভুষিত,	ভূষিত,	
kathmandu,	কাঠমান্ডু,	কাঠমান্ডু,	
tukrote,	টুকরোতে,	টুকরোতে,	
teliha,	তেলিহা,	তেলিহা,	
pariyech,	পরিয়েছ,	পরিয়েছ,	
upobasee,	উপবাসী,	উপবাসী,	
dushtogone,	দুষ্টগণে,	দুষ্টগণে,	
lobbytey,	লবিটে,	লবিতে,	
laiseensim,	লেইস্নিমিম,	লাইসেন্সিং,	
shourshe,	শৌর্ষে,	সোর্স,	
kekru,	কেকরু,	কেকরু,	
damodar,	দামোদার,	দামদর,	
veemsen,	ভীমসেন,	ভীমসেন,	
black,	ব্ল্যাক,	ব্ল্যাক,	
bisshasi,	বিশবাসী,	বিশ্বাসী,	
khoakshir,	খোয়াক্ষির,	খোয়াক্ষীর,	
naazee,	নাজি,	নাত্সি,	
rijoor,	রিজুর,	রিজুর,	
govindarajan,	গোবিন্দরাজন,	গোবিন্দরাজন,	
plator,	প্ল্যাটর,	প্লেটোর,	
bhikkharthe,	ভিক্ষার্থে,	ভিক্ষার্থে,	
langhaner,	লঙ্ঘনের,	লংঘনের,	
boudher,	বৌধের,	বৌদ্ধের,	
khali,	খালি,	খালি,	
prapokkey,	প্রাপক্ষে,	প্রাপককে,	
chakundite,	চাকুন্ডিতে,	চাকুন্দিতে,	
batsmanei,	ব্যাটসম্নেই,	ব্যাটসম্যানই,	
asbab,	আসবাব,	আসবাব,	
atwobishvashi,	অত্বভিষ্বাসী,	আত্মবিশ্বাসী,	
chowdhuryke,	চৌধুরকে,	চৌধুরীকে,	
fastara,	ফাস্তারা,	ফস্টার,	
emarjenshi,	এমারজেশ্চি,	এমার্জেন্সি,	
shrabosty,	শ্রাবস্টি,	শ্রাবস্তী,	
porirshoder,	পরীর্ষদের,	পরির্ষদের,	
vobanipur,	ভবানিপুর,	ভবানীপুর,	
streegon,	স্ত্রীগণ,	স্ত্রীগণ,	
hoteltee,	হোটেলটি,	হোটেলটি,	
byaboharkariyi,	ব্যবহারকারিণী,	ব্যবহারকারীই,	
oitijhyotike,	ঐতিহ্যটিকে,	ঐতিহ্যটিকে,	
japanostho,	জাপানস্থ,	জাপানস্থ,	
jhimochchilo,	ঝিমোচ্ছিল,	ঝিমোচ্ছিলো,	
janosamaj,	জনসমাজ,	জনসমাজ,	
onkush,	অঙ্কুষ,	অংকুশ,	
buddhitii,	বুদ্ধিটি,	বুদ্ধিটিই,	
leaders,	লিডারস,	লিডার্স,	
joki,	জোকি,	জকি,	
tooku,	টুকু,	টুকু,	
ghamtaa,	ঘামটা,	ঘোমটা,	
pleeta,	প্লিটা,	প্লেট,	
tottorat,	তত্ততাত,	তওরাত,	
swarther,	স্বার্থের,	স্বার্থের,	
baman,	বামান,	বামন,	
nodiitei,	নদীতেই,	নদীতেই,	
prasadhoner,	প্রাসাধনের,	প্রসাধনের,	
pyor,	পোয়র,	পিওর,	
sakshatkarer,	সাকষাটকারের,	সাক্ষাৎকারের,	
groundta,	গ্রাউন্ডটা,	গ্রাউন্ডটা,	
jaunotar,	যৌনতার,	যৌনতার,	
dufresne,	ডুফ্রেন্সে,	ডুফরেস্ন,	
jetam,	জেতাম,	যেতাম,	
purborekorde,	পূর্বরেকর্ডে,	পূর্বরেকর্ডে,	
shahanara,	শাহানারা,	শাহানারা,	
ghetu,	ঘেটু,	ঘেটু,	
byabosthar,	ব্যবস্থার,	ব্যবস্থার,	
ghurechen,	ঘুরেছেন,	ঘুরেছেন,	
katbe,	কাটবে,	কাটবে,	
jor,	জর,	জ্বর,	
khargosher,	খরর্োশের,	খরগোসের,	
siqhar,	সিখার,	শিকার,	
kuthibarike,	কুটিবারিকে,	কুঠিবাড়ীকে,	
heelser,	হেলসার,	হিলসের,	
pratisthasaho,	প্রতিস্থাসহ,	প্রতিষ্ঠাসহ,	
moushum,	মৌশুম,	মৌসুম,	
dwijenbabuder,	দ্বিজেন্বাবুদের,	দ্বিজেনবাবুদের,	
batikromee,	বাতিক্রমে,	ব্যতিক্রমী,	
nirbaho,	নির্বাহ,	নির্বাহ,	
pujit,	পুজিত,	পুজিত,	
madrasi,	মাদ্রাসি,	মাদ্রাজি,	
uqeliptas,	উকেলিপ্তস,	ইউক্যালিপ্টাস,	
freelancerra,	ফ্রিল্যান্সাররা,	ফ্রিল্যান্সাররা,	
saazano,	সাজানো,	সাজানো,	
phund,	ফান্ড,	ফান্ড,	
jatinke,	জাতিনকে,	যতীনকে,	
ajij,	অজিজ,	আজিজ,	
sangkulaan,	সংকুলান,	সংকুলান,	
temanti,	তেমন্তি,	তেমনটি,	
jaanar,	যানার,	জানার,	
khelaphate,	খেলাফাতে,	খেলাফতে,	
akhandota,	অখণ্ডটা,	অখণ্ডতা,	
soinyo,	সৈন্য,	সৈন্য,	
dakshinangsho,	দক্ষিণাংশ,	দক্ষিণাংশ,	
onshogrohoner,	অংশগ্রহণের,	অংশগ্রহনের,	
rajtontro,	রাজতন্ত্র,	রাজতন্ত্র,	
sikkhakbrinda,	শিক্ষাকবৃন্দ,	শিক্ষকবৃন্দ,	
dhos,	ধোস,	ধস,	
taalaal,	তালাল,	তালাল,	
tikto,	টিক্ত,	তিক্ত,	
magrey,	ম্যাগ্রে,	ম্যাগ্রে,	
masjidsaho,	মসজিদসহ,	মসজিদসহ,	
neshnos,	নেশনোস,	নেশনস,	
kokeyin,	কোকেইন,	কোকেইন,	
balokarak,	বালকারাক,	বলকারক,	
uttor,	উত্তর,	উওর,	
nathibhuktir,	নাটিভুক্তির,	নথিভুক্তির,	
benojir,	বেনজীর,	বেনজীর,	
maudelder,	মাউডলদের,	মডেলদের,	
umedpoor,	উমেদপুর,	উমেদপুর,	
mane,	মানে,	মানে,	
deil,	দেল,	ডেইল,	
jothon,	যথন,	যথন,	
kruser,	ক্রুসের,	ক্রুশের,	
aabarte,	আবার্তে,	আবর্তে,	
shikshakbrindo,	শিক্ষাকৃত্ন্,	শিক্ষকবৃন্দ,	
farhetin,	ফ্যারেটিন,	ফারহেতিন,	
shipley,	শিপলে,	শিপলে,	
ghenshei,	ঘেনশেই,	ঘেঁষেই,	
akkheperi,	আক্ষেপেরই,	আক্ষেপেরই,	
lirikti,	লিরিকটি,	লিরিকটি,	
gasthi,	গাস্থি,	গোষ্ঠী,	
kachhakaachhi,	কচাচক্ছি,	কাছাকাছি,	
iling,	ইলিং,	ইলিং,	
bhumija,	ভূমিজা,	ভূমিজ,	
saranor,	সারানোর,	সরানোর,	
cholochchitrer,	চলচ্চিত্রের,	চলচ্চিত্রের,	
sambatsarkal,	সম্বতস্করাল,	সম্বৎসরকাল,	
goonoman,	গুণমান,	গুণমান,	
protijogii,	প্রতিযোগী,	প্রতিযোগী,	
jaruri,	জারুরি,	জরূরী,	
diibug,	দিইবুগ,	ডিবাগ,	
damakalkarmirao,	দমকলকর্মীরাও,	দমকলকর্মীরাও,	
naraphoka,	নারাফোকা,	নরফোক,	
bangladesh,	বাংলাদেশ,	বঙ্গালাদেস,	
firth,	ফির্থ,	ফার্থ,	
cholochchitrai,	চলচ্চিত্রায়,	চলচ্চিত্রই,	
stander,	স্ট্যান্ডার,	স্ট্যাণ্ডের,	
mukhomondoler,	মুখমন্ডলের,	মুখমণ্ডলের,	
taitela,	টাইটেলা,	টাইটেল,	
orbi,	অরবি,	ওরবি,	
bee,	বী,	বি,	
scholastic,	স্কোল্সটিক,	স্কলাস্টিক,	
tecnokret,	টেকনকোরেট,	টেকনোক্র্যাট,	
uporoshtho,	উপরস্থ,	উপরস্থ,	
balatkar,	বালাটকর,	বলাৎকার,	
rilayensa,	রিলায়েনস,	রিলায়েন্স,	
balatarin,	ব্যালাটারিন,	বালাতারিয়ান,	
rajdhani,	রাজধানী,	রাজধানি,	
obhaarbhiu,	অভারভু,	ওভারভিউ,	
nuhas,	নুহাস,	নুহাশ,	
sedikei,	সেদিকেই,	সেদিকেই,	
bhugol,	ভুগল,	ভূগোল,	
dhormoprobortokder,	ধর্মপ্রবর্তকদের,	ধর্মপ্রবর্তকদের,	
bbiswashke,	বিবসবাসকে,	বিশ্বাসকে,	
mukhbondho,	মুখবন্ধ,	মুখবন্ধ,	
obdi,	অব্দি,	অব্দি,	
aamor,	আমার,	আমর,	
bapokotor,	বাপকতোর,	ব্যাপকতর,	
daaoon,	ডাউন,	ডাউন,	
narsaari,	নার্সারি,	নার্সারি,	
pray,	প্রায়,	প্রায়,	
corymb,	কররিম্ব,	করিম,	
gujab,	গুজব,	গুজব,	
dimbacriti,	ডিম্বাবকৃতি,	ডিম্বাকৃতি,	
oncholtee,	অঞ্চলটি,	অঞ্চলটি,	
seekkhokbrindo,	সিক্ষকবৃন্দ,	শিক্ষকবৃন্দ,	
monur,	মনুর,	মনুর,	
caroline,	ক্যারোলিন,	ক্যরোলিন,	
karadandey,	কারাদণ্ডে,	কারাদণ্ডে,	
ddheela,	ঢিলা,	ঢিলা,	
cooda,	কুডা,	কোডা,	
kramp,	ক্রাম্প,	ক্র্যাম্প,	
eucalyptus,	ইউক্যাক্্প্লাস,	ইউক্যালিপ্টাস,	
dhaleshwari,	ধলেশ্বরী,	ধলেশ্বরী,	
teemothi,	তেমথি,	টিমোথি,	
kalenga,	কালেঙ্গা,	কালেঙ্গা,	
commissionvogider,	কমিশভিঙ্গদের,	কমিশনভোগীদের,	
haridware,	হরিদ্বারে,	হরিদ্বারে,	
sthapanatir,	স্থাপানাটির,	স্থাপনাটির,	
dibi,	দিবি,	দিবি,	
aakkas,	আক্কাস,	আককাস,	
olpo,	ওল্প,	অল্প,	
oncholsomuho,	অঞ্চলসমূহ,	অঞ্চলসমূহ,	
songasthatike,	সংস্থাটাতিকে,	সংস্থাটিকে,	
ghatiti,	ঘাটিটি,	ঘাঁটিটি,	
veenis,	ভেনিস,	ভেনিস,	
ghoomachhe,	ঘুমাছে,	ঘুমাচ্ছে,	
feroza,	ফেরোজা,	ফিরোজা,	
maadla,	মাদলা,	মাদলা,	
pyatarne,	প্যাটার্ন,	প্যাটার্নে,	
guzon,	গুজন,	গুজব,	
alpo,	আল্প,	অল্প,	
sithilota,	সিথিলতা,	শিথিলতা,	
cheento,	চেন্টো,	চিনতো,	
debdebie,	দেবদেবী,	দেবদেবী,	
oncoltike,	অঙ্কটলিকে,	অঞ্চলটিকে,	
simons,	সিমন্স,	সিমন্স,	
chakrapani,	চক্রপানি,	চক্রপানী,	
societyke,	সোস্ইটিকে,	সোসাইটিকে,	
kushumba,	কুশুম্বা,	কুশুম্বা,	
jaatti,	যাত্তি,	জাতটি,	
jibonnogor,	জীবনযোগর,	জীবননগর,	
uddhrita,	উদ্ধৃত,	উদ্ধৃত,	
trutimatra,	ত্রুটিমাত্র,	ত্রুটিমাত্র,	
nirgoon,	নির্গুণ,	নির্গুণ,	
fakhrul,	ফখরুল,	ফাখরুল,	
jolaatonko,	জলাতানকো,	জলাতঙ্ক,	
thaanobhi,	থানোভি,	থানভী,	
protyokkhovabey,	প্রত্যক্ষকভাবে,	প্রত্যক্ষভাবে,	
pratijogitamulak,	প্রতিযোগিতামূলক,	প্রতিযোগীতামূলক,	
moomtaj,	মুমতাজ,	মুমতাজ,	
niurolaji,	নিউরোজাী,	নিউরোলজি,	
ekirokom,	একিকোরম,	একইরকম,	
transapharma,	ট্রান্সফর্মা,	ট্রান্সফর্ম,	
nirgomon,	নির্গমন,	নির্গমন,	
bisshonath,	বিশ্বনাথ,	বিশ্বনাথ,	
teentir,	টেনটির,	তিনটির,	
shibraj,	শিবরাজ,	শিবরাজ,	
kommandar,	কোম্মানদার,	কমাণ্ডার,	
asovarno,	অশোভরর্ণ,	অসবর্ণ,	
shanno,	শান্ন,	সান্নো,	
kyatagorir,	ক্যাটাগরীর,	ক্যাটাগরির,	
chikitsanirbhar,	চিকিৎসানির্ভর,	চিকিৎসানির্ভর,	
bachai,	বাচাই,	বাছাই,	
sqirt,	স্কির্ট,	স্কার্ট,	
jhijhi,	ঝিঝি,	ঝিঝি,	
jaadrel,	জাদ্রেল,	জাঁদরেল,	
shangsthatikey,	সংস্থাটিকে,	সংস্থাটিকে,	
aarik,	আরিক,	আরিক,	
jhalkanite,	ঝালকানিতে,	ঝলকানীতে,	
baffer,	ব্যাফার,	বাফার,	
bouddha,	বৌদ্ধ,	বৌদ্ধ,	
danata,	দানাটা,	ডোনাট,	
heavy,	হেভি,	হেভি,	
holding,	হোল্ডিং,	হোল্ডিং,	
marmaraa,	মারমারা,	মারমারা,	
madhabike,	মাধবীকে,	মাধবীকে,	
qonflict,	কনফ্লিক্ট,	কনফ্লিক্ট,	
beila,	বেইলা,	বেইলা,	
kumbhalnar,	কুম্ভলনার,	কুম্ভালনার,	
alraji,	আলরাজি,	আলরাজী,	
somabeshti,	সোমাবেশটি,	সমাবেশটি,	
talgach,	টালগাছ,	তালগাছ,	
puroheetder,	পুরোহিতদের,	পুরোহিতদের,	
nakkal,	নাক্কাল,	নক্কল,	
ghoor,	ঘুর,	ঘুর,	
ashonkai,	আশঙ্কাই,	আশঙ্কাই,	
wilderske,	উইলদার্সকে,	উইল্ডার্সকে,	
jonoshongjog,	জনশংযোগ,	জনসংযোগ,	
bhangle,	ভাংলে,	ভাঙলে,	
kortona,	কর্তনা,	করতনা,	
hoonayin,	হুনাইন,	হুনাইন,	
bite,	বিইইট,	বাইট,	
utsahi,	উৎসাহী,	উৎসাহী,	
hukar,	হুকার,	হুকার,	
waal,	ওয়াল,	উল,	
gloria,	গ্লোরিয়া,	গ্লোরিয়া,	
taler,	তালের,	তালের,	
huka,	হুকা,	হুক,	
bolechile,	বলেছিলে,	বলেছিলে,	
shattoki,	সাত্তকী,	সাত্যকি,	
venkates,	ভেঙ্কটেটস,	ভেঙ্কটেশ,	
sangitanusthane,	সংগীতানুষ্ঠানে,	সঙ্গীতানুষ্ঠানে,	
machsoho,	মাছসহ,	মাছসহ,	
jamseder,	জামসেদের,	জামসেদের,	
shikshagata,	শিক্ষাগত,	শিক্ষাগত,	
kanasarabheeshana,	কনসররভীশন,	কনসারভেশন,	
madhuri,	মধুরি,	মাধুরী,	
laps,	ল্যাপস,	ল্যাপস,	
daebug,	দাবুগ,	ডিবাগ,	
ponera,	পোনেরা,	পনের,	
hosne,	হোস্ন,	হোসনে,	
dhyanastha,	ধ্যানস্থ,	ধ্যানস্থ,	
maudelgulo,	মাওদেলগুলো,	মডেলগুলো,	
torkareer,	তর্কারীর,	তরকারীর,	
shektore,	শেক্টরে,	সেক্টরে,	
rahee,	রাহী,	রাহি,	
grambaasi,	গ্রামবাসি,	গ্রামবাসী,	
starker,	স্টার্কের,	স্টার্কের,	
nagarikera,	নাগারিকেরা,	নাগরিকেরা,	
pulivendla,	পুলিভেন্ডলা,	পুলিভেন্ডলা,	
narishwar,	নারীশ্বর,	নারীশ্বরের,	
beauby,	বিউবি,	বিউবি,	
bikromei,	বিক্রমেই,	বিক্রমেই,	
sthapanar,	স্থপানার,	স্থাপনার,	
barbadoj,	বার্বাদজ,	বার্বাডোজ,	
daap,	দাপ,	ড্যাপ,	
bulichev,	বুলিছেব,	বুলিচেভ,	
neelfamarir,	নীলফামারীর,	নীলফামারীর,	
recondishon,	রেকন্ডিশন,	রিকন্ডিশন,	
pisach,	পিসাচ,	পিশাচ,	
pakhtunistan,	পাখতুসন্তান,	পাখতুনিস্তান,	
dharavassokar,	ধারাভাসকর,	ধারাভাষ্যকার,	
maaktoome,	মাক্তুমে,	মাকতুম,	
dharabahikotitey,	ধারাবাহিকতিতেই,	ধারাবাহিকটিতে,	
bhenicer,	ভেনিসের,	ভেনিসের,	
vagini,	ভাগিনী,	ভগিনী,	
aaps,	এএপএস,	এএপিএস,	
pettern,	পেটার্ন,	প্যাটার্ন,	
salafeta,	সালাফেতা,	সালফেট,	
nabotom,	নাবোমম,	নবতম,	
oncholeo,	অঞ্চলেও,	অঞ্চলেও,	
langhoner,	লঙ্ঘনের,	লংঘনের,	
soori,	সূরী,	সুরি,	
mausumer,	মৌসুমের,	মৌসুমের,	
shangkulaan,	শংকুলান,	সংকুলান,	
daaradaa,	দারাদা,	দারদা,	
shilpojaat,	শিল্পজাত,	শিল্পজাত,	
taxikeo,	ট্যাক্সিকেও,	ট্যাক্সিকেও,	
elakaasoho,	এলাকাসহ,	এলাকাসহ,	
scholastik,	স্কলাস্তিক,	স্কলাস্টিক,	
addata,	আড্ডটা,	আড্ডাটা,	
panchashjon,	পঞ্চাশযোন,	পঞ্চাশজন,	
jalarong,	জ্যালারং,	জলরঙ,	
khaschandpur,	খসসচন্দুর,	খাসচাঁদপুর,	
kareer,	কারির,	কারীর,	
mankisundar,	মানকিসুন্দর,	মানকিসুন্দর,	
reflex,	রিফলেক্স,	রিফ্লেক্স,	
jaubankal,	যৌবনকাল,	যৌবনকাল,	
dhadhiye,	ধধিয়ে,	ধাধিয়ে,	
messengerer,	মেসেঙ্গেরের,	মেসেঞ্জারের,	
vabnakey,	ভবন্কে,	ভাবনাকে,	
baarnish,	বার্নিশ,	বার্নিশ,	
ingreziteo,	ইংরেজিতেও,	ইংরেজিতেও,	
rajbondir,	রাজবন্দির,	রাজবন্দীর,	
ghumachchila,	ঘুমাচ্ছিলা,	ঘুমাচ্ছিল,	
akhandata,	অখণ্ডাতা,	অখণ্ডতা,	
deelibhara,	ডেলিভারা,	ডেলিভার,	
osoborno,	অসবর্ণ,	অসবর্ণ,	
bibhinno,	বিভিন্ন,	বিভন্ন,	
notti,	নট্টি,	নোটটি,	
catholicbad,	ক্যাথলিকবাদ,	ক্যাথলিকবাদ,	
rajtantra,	রাজতন্ত্র,	রাজতন্ত্র,	
myari,	ম্যারি,	ম্যারি,	
favorite,	ফাভারিতে,	ফেভারিট,	
baipass,	বাইপাস,	বাইপাস,	
fasi,	ফাসি,	ফাঁসী,	
semai,	সেমাই,	সেমাই,	
bhalobasar,	ভালোবাসার,	ভালোবাসার,	
mastarsa,	মাস্তারসা,	মাস্টার্স,	
jhamala,	ঝামালা,	ঝামালা,	
uter,	উউটার,	উটের,	
shrabasti,	শ্রাবস্তি,	শ্রাবস্তী,	
chetanagoto,	চেতনাগত,	চেতনাগত,	
majdur,	মাজদুর,	মজদুর,	
tukroti,	টুকরোটি,	টুকরোটি,	
bhogiroth,	ভগিরথ,	ভগীরথ,	
nibobondhonkrito,	নিববন্ধনকৃত,	নিববন্ধনকৃত,	
bandhubhaabaapanna,	বন্ধুভাবপন্ন,	বন্ধুভাবাপন্ন,	
madrasake,	মাদারসাকে,	মাদ্রাসাকে,	
mosjidtir,	মসজিদটির,	মসজিদটির,	
lyaandeeng,	ল্যান্ডারিং,	ল্যান্ডিং,	
vishnuu,	বিষ্ণু,	বিষ্ণু,	
heena,	হেইনা,	হেনা,	
torunosomriddho,	তরুণসমৃদ্ধ,	তরুণসমৃদ্ধ,	
pnouchute,	পৌঁছুতে,	পৌঁছুতে,	
jesh,	জেশ,	জেস,	
nobotomo,	নবতম,	নবতম,	
musalmani,	মুসলমানি,	মুসলমানই,	
manjushree,	মঞ্জুষ্রী,	মঞ্জুশ্রী,	
soheensotar,	সহিনস্তার,	সহিংসতার,	
chikitsar,	চিকিৎসার,	চিকিত্সার,	
hosney,	হোসনে,	হোসনে,	
ponero,	পনেরও,	পনের,	
hetimganje,	হিটিমগঞ্জে,	হেতিমগঞ্জে,	
ashankai,	আশঙ্কাই,	আশঙ্কাই,	
kottar,	কোটার,	কট্টর,	
sectore,	সেক্টর,	সেক্টরে,	
jeebonnogor,	জীবনযোগর,	জীবননগর,	
dipti,	দীপ্তি,	ডেপুটি,	
torikher,	তরিখের,	তরিখের,	
moshahidur,	মোশাহিদুর,	মোশাহিদুর,	
vortuki,	ভোরতুকি,	ভর্তুকি,	
shangsthaner,	সংস্থানের,	সংস্থানের,	
harza,	হার্জা,	হার্জ,	
toptoshele,	তপ্তশেলে,	তপ্তশেলে,	
nirobota,	নিরবতা,	নিরবতা,	
ishtone,	ইশ্টনে,	স্টোন,	
engrejra,	এংরেজরা,	ইংরেজরা,	
kompeeto,	কম্পিত,	কম্পিত,	
bii,	বিআইআই,	বি,	
annanere,	আন্নানেরে,	অন্যানেরে,	
trabuco,	ট্র্যাবুকো,	ট্র্যাবুকো,	
panthar,	পান্থার,	পন্থার,	
suisharke,	সুইশারকে,	সুইশারকে,	
byabosthar,	ব্যবস্থার,	ব্যাবস্থার,	
anyorup,	অন্যরূপ,	অন্যরূপ,	
shoodhooi,	শুধুই,	শুধুই,	
antorbhuktimulak,	আন্তর্ভক্তিমূলক,	অন্তর্ভুক্তিমূলক,	
kale,	কালে,	কালে,	
mmadhuri,	ম্মাধুরি,	মাধুরী,	
karmake,	কারমাকে,	কর্মকে,	
elakatike,	এলাকাটিকে,	এলাকাটিকে,	
dakteekiter,	ডাক্তিকেটের,	ডাকটিকিটের,	
bohudeen,	বহুদিন,	বহুদিন,	
manbe,	মানবে,	মানবে,	
ramzaner,	রামজানের,	রমযানের,	
graambasider,	গ্রামবাসীদের,	গ্রামবাসীদের,	
prarthonakokkher,	প্রার্থনাক্ষকের,	প্রার্থনাকক্ষের,	
poste,	পোস্টে,	পোস্টে,	
jeshh,	যেশ,	জেস,	
rejidens,	রিজেডেন্স,	রেসিডেন্স,	
jarmaniteo,	জারমানীতেও,	জার্মানিতেও,	
tatey,	তাতে,	তাতে,	
slatgulor,	স্ল্যাটগুলোর,	স্ল্যাটগুলোর,	
capshule,	ক্যাপশুলে,	ক্যাপসুল,	
devolapar,	দেবলাপার,	ডেভলপার,	
zeland,	জেলাযান্ড,	জিল্যান্ড,	
bbiseshyer,	ব্বিবেশ্যের,	বিশেষ্যের,	
bibader,	বিবাদের,	বিবাদের,	
lambaate,	লাম্বাতে,	লম্বাটে,	
adhyatmik,	আধ্যাত্মিক,	আধ্যাত্মিক,	
rokkhonabekkhoner,	রক্ষণাকেশনের,	রক্ষণাবেক্ষণের,	
sosoa,	সোয়া,	শশা,	
kalki,	কালকি,	কালকি,	
panchbar,	পাঁচবার,	পাঁচবার,	
porobortii,	পরবর্তী,	পরর্বতী,	
ramolino,	রামোলিনো,	রামোলিনো,	
elakatikay,	এলাকাটিকায়,	এলাকাটিকে,	
masjidtir,	মসজিদটির,	মসজিদটির,	
colgirl,	কলগির,	কলগার্ল,	
manushera,	মননুষেরা,	মানুষেরা,	
bisheshshyo,	বিশেষ্ঠ্য,	বিশেষ্য,	
prokalpagulo,	প্রকালপগুলো,	প্রকল্পগুলো,	
dipon,	ডিপন,	দীপন,	
humner,	হামনার,	হামনার,	
probhur,	প্রভুর,	প্রভুর,	
ronodeep,	রণদীপ,	রণদীপ,	
jounotar,	যৌনতার,	যৌনতার,	
myat,	ম্যাট,	ম্যাট,	
avinetar,	আভিনেতার,	অভিনেতার,	
bhoutikeshu,	ভৌতিকেষু,	ভৌতিকেষু,	
jolbe,	জলবে,	জ্বলবে,	
sossar,	সোসার,	সকার,	
bbiswasho,	বিশবিশাশো,	বিশ্বাসও,	
notey,	নোটে,	নোটে,	
dhanak,	ধনক,	ধানক,	
literacy,	লাটারেসি,	লিটারেসি,	
shoreefer,	শরীফার,	শরিফের,	
reetesh,	রিটেশ,	রিতেশ,	
stoonahenja,	স্টুনেনুহ্জা,	স্টোনহেঞ্জ,	
byaboharkari,	ব্যবহারকারী,	ব্যবহারকারী,	
debate,	দেবাতে,	ডিবেট,	
debeting,	ডিবাইটিং,	ডিবেটিং,	
laiseensee,	লেইস্নিজ,	লাইসেন্স,	
cxt,	সিকিএসটি,	সিএক্সটি,	
olympicer,	অলিম্পিসের,	অলিম্পিকের,	
lokhindorer,	লোখিন্দরের,	লখিন্দরের,	
sohojlovyotar,	সহজ্যভল্যার,	সহজলভ্যতার,	
landey,	ল্যান্ডে,	ল্যান্ডে,	
philo,	ফিলো,	ফিলো,	
jacksoner,	জ্যাকসনের,	জ্যাকসনের,	
borlen,	বোরলেন,	বরলেন,	
hingsar,	হিংসার,	হিংসার,	
madraser,	মাদ্রাসের,	মাদ্রাজের,	
ruble,	রাবল,	রুবল,	
fastag,	ফাস্টাগ,	ফ্যাসট্যাগ,	
directarate,	ডিরেক্টরেট,	ডিরেক্টরেট,	
prakare,	প্রকারে,	প্রকারে,	
armshtronj,	আর্মোর্ট্রুজ,	আর্মস্ট্রং,	
purohitra,	পুরোহিত্রা,	পুরোহিতরা,	
ohalyar,	ওহল্যার,	অহল্যার,	
orthisoho,	অর্থিসহ,	অর্থিসহ,	
navaratri,	নবরত্রী,	নবরাত্রি,	
footballerra,	ফুটবলাররা,	ফুটবলাররা,	
punosthaner,	পুনস্থানের,	পুনঃস্থানের,	
goolen,	গুলেন,	গুলেন,	
bhyatikaner,	ভ্যাটিকানের,	ভ্যাটিকানের,	
bangalore,	বাঙ্গালোর,	ব্যাঙ্গালুরে,	
parka,	পারকা,	পার্ক,	
hijritey,	হিজরিতে,	হিজরীতে,	
elahabade,	এলাহাবাদে,	এলাহাবাদে,	
sampadon,	সম্পাদন,	সম্পাদন,	
anusvara,	আনুসভারা,	অনুস্বার,	
juktarashtrasaha,	যুক্তরাষ্ট্রসহ,	যুক্তরাষ্ট্রসহ,	
chaka,	চাকা,	চাকা,	
militarir,	মিলিটারির,	মিলিটারির,	
brookoleen,	ব্রুকলিন,	ব্রুকলিন,	
bhageri,	ভাগেরি,	ভাগেরই,	
sten,	স্টেন,	স্টেন,	
istoone,	ইস্তুনে,	স্টোন,	
tigre,	তিগ্রে,	টাইগার,	
sooya,	সুয়া,	সোয়া,	
vabook,	ভ্বাক,	ভাবুক,	
pyetarna,	পিতাত্রা,	প্যাটার্ন,	
phuda,	ফুড়া,	ফুড,	
songkolonti,	সংকলন্তি,	সংকলনটি,	
nikela,	নিকেলা,	নিকেল,	
beshirbhaagei,	বেশীরভাগেই,	বেশিরভাগেই,	
ceramiker,	সেরামিকের,	সিরামিকের,	
deejeejer,	দিজিজের,	ডিজিজের,	
vittiteo,	ভিত্তিতেও,	ভিত্তিতেও,	
plaiin,	প্লেইন,	প্লেন,	
ekatto,	একাত্ত,	একাত্ব,	
chalochchitraeei,	চলচ্চিত্রীয়ই,	চলচ্চিত্রেই,	
siit,	সিয়,	শীত,	
debete,	দেবীতে,	ডিবেট,	
shpredshiit,	স্প্রেডশিটি,	স্প্রেডশীট,	
graambaaseeo,	গ্রামবাসিও,	গ্রামবাসীও,	
azin,	আজিন,	আজিন,	
norpholk,	নরফোল্ক,	নরফোক,	
inphormeshon,	ইনফোর্মেশন,	ইনফরমেশন,	
nick,	নিক,	নিক্,	
cholochchitratike,	চলচ্চিত্রাটিকে,	চলচ্চিত্রটিকে,	
gronther,	গ্রন্থের,	গ্রন্থের,	
naobihar,	নওয়িবাহার,	নৌবিহার,	
nagorikra,	নাগরিকরা,	নাগরিকেরা,	
vagni,	ভাগ্নি,	ভগ্নী,	
hastamathun,	হস্তামাথুন,	হস্তমথুন,	
shift,	শিফ্ট,	শিফট,	
basaake,	বাসাকে,	বাসাকে,	
tiger,	টিগের,	টাইগার,	
chanoo,	চানু,	চানু,	
toxoid,	টক্সোড,	টক্সয়েড,	
onchalgulir,	অঞ্চলগুলির,	অঞ্চলগুলির,	
alumni,	আলুমনি,	অ্যালমনি,	
kaalki,	কালকি,	কালকি,	
horidbar,	হরিদবার,	হরিদ্বার,	
pretti,	প্রেত্তি,	প্রিটি,	
yukeliptash,	যুকেলিপ্পস,	ইউক্যালিপ্টাস,	
qarlosa,	কররোলসা,	কার্লোস,	
geejeeteeda,	গীজিতেদা,	গেজেটেড,	
laishensh,	লেইশেং,	লাইসেন্স,	
peengna,	পিংনা,	পিংনা,	
mukhmondole,	মুখমন্ডলে,	মুখমণ্ডলে,	
fooloo,	ফুলু,	পোলো,	
mulyabriddhikale,	মূল্যবৃদ্ধিকালে,	মূল্যবৃদ্ধিকালে,	
puding,	পুডিং,	পুডিং,	
drishi,	দৃশি,	দৃশ্যই,	
carlos,	কারলোস,	কার্লোস,	
capsule,	ক্যাপসুলে,	ক্যাপ্সুল,	
niroja,	নিরোজা,	নিরোজা,	
timathi,	তিমথি,	টিমোথি,	
shithilata,	শিথিলতা,	শিথিলতা,	
elakatir,	এলাকাটির,	এলাকাটির,	
basakey,	বাসাকে,	বাসাকে,	
kathmandute,	কাঠমণ্ডুতে,	কাঠমান্ডুতে,	
rajbandi,	রাজবন্দি,	রাজবন্দী,	
krisenta,	ক্রিসেন্টা,	ক্রিসেন্ট,	
kod,	কোড,	কোড,	
nariderke,	নারীদেরকে,	নারিদেরকে,	
rezidence,	রিজিডেন্সে,	রেসিডেন্স,	
ayantarqatiqa,	আয়ন্তরাকৃতা,	অ্যান্টার্কটিকা,	
thare,	থারে,	থরে,	
prakalpoguli,	প্রকলোপগুলি,	প্রকল্পগুলি,	
vittio,	ভিত্তিও,	ভিত্তিও,	
soinyora,	সৈন্যরা,	সৈন্যরা,	
rajyabhogi,	রাজ্যভোগী,	রাজ্যভোগী,	
hydrological,	হাইড্রোলজিক্যাল,	হাইড্রোলজিক্যাল,	
terlarang,	টেরলারাং,	তেরলারং,	
shunani,	শুনানি,	শুনানী,	
gyandas,	জ্ঞানদাস,	জ্ঞানদাস,	
photanor,	ফোটানোর,	ফোটানোর,	
padee,	পাডি,	পাড়ে,	
tiuning,	টিউনিং,	টিউনিং,	
asantosh,	অসন্তথ,	অসন্তোষ,	
hossne,	হোসনে,	হোসনে,	
daakticketer,	ডাক্টিকটের,	ডাকটিকিটের,	
nabatarange,	নবতরঙ্গে,	নবতরঙ্গে,	
rekhapat,	রিখাপাত,	রেখাপাত,	
rahi,	রাহি,	রাহী,	
srabosty,	স্রাবস্টি,	শ্রাবস্তী,	
nodnodeer,	নদ্দনের,	নদনদীর,	
valobase,	ভালোবাসে,	ভালোবাসে,	
inafarameshana,	ইনাফারশেমানা,	ইনফরমেশন,	
protijogiider,	প্রতিযোগীদের,	প্রতিযোগীদের,	
jatotaa,	জাতোটা,	যতোটা,	
agamane,	আগামানে,	আগমনে,	
boshoborty,	বশবর্তি,	বশবর্তী,	
fibergulote,	ফাইবারগুলোতে,	ফাইবারগুলোতে,	
bishshasho,	বিশ্বসস,	বিশ্বাসও,	
orhan,	ওরহান,	ওরহান,	
dhalur,	ধালুর,	ঢালুর,	
smarak,	স্মরক,	স্মারক,	
hafej,	হাফেজ,	হাফেয,	
mekapgulo,	মেকাপগুলো,	মেকআপগুলো,	
laatimer,	লাটিমের,	লাটিমের,	
tapdei,	তাপদেই,	তাপড়েই,	
nogore,	নগরে,	নগরে,	
rushad,	রুশাদ,	রুশদ,	
rata,	রা,	রত,	
niphelheim,	নাইফলিহেম,	নিফেলহেইম,	
kuldip,	কুলদীপ,	কুলদীপ,	
bagicha,	বাগিচা,	বাগিচা,	
ekghore,	একঘরে,	একঘরে,	
shommoteer,	সম্মতির,	সম্মতির,	
cholechi,	চলেছি,	চলেছি,	
jonosomaj,	জনসমাজ,	জনসমাজ,	
aizulke,	আইজুলকে,	আইজুলকে,	
pothon,	পথন,	পঠন,	
nadike,	নাদিকে,	নদীকে,	
chomski,	চমস্কি,	চমস্কি,	
patigoniter,	পাটিগণিতের,	পাটিগণিতের,	
fanse,	ফ্যান্সে,	ফাঁসে,	
gurmukh,	গুরমুখ,	গুরমুখ,	
cheerontan,	চেরোন্টান,	চিরন্তন,	
prosadhoni,	প্রসাধনী,	প্রসাধনী,	
chhooti,	ছুটি,	ছুটি,	
aanaan,	আনান,	আনান,	
laesens,	লেসেন্স,	লাইসেন্স,	
aakabar,	আকাবার,	আকাবার,	
emiratas,	এমিরাতাস,	এমিরেটাস,	
kkomandar,	ক্রমন্্দর,	কমাণ্ডার,	
dharabahikbhabe,	ধারাবাহিকভাবে,	ধারাবাহিকভাবে,	
yura,	যুরা,	ইউরো,	
nirbahey,	নির্বাহে,	নির্বাহে,	
baet,	বাইট,	বাইট,	
noditei,	নদীতেই,	নদীতেই,	
hindutirtha,	হিন্দুতীর্থ,	হিন্দুতীর্থ,	
binakar,	বিনাকার,	বিনাকার,	
serup,	সেরুপ,	সেরূপ,	
zoubankal,	যৌবনকাল,	যৌবনকাল,	
chotogolper,	চটোগল্পের,	ছোটগল্পের,	
railliner,	রেললিনের,	রেললাইনের,	
bikretara,	বিক্রেতারা,	বিক্রেতারা,	
konisttha,	কোনিস্থ,	কনিষ্ঠ,	
agomoney,	অগমমেনে,	আগমনে,	
sadadyarao,	সদদ্যারাও,	সদদ্যরাও,	
nothivukto,	নথিভুক্ত,	নথিভুক্ত,	
itastata,	ইটস্তাতা,	ইতস্তত,	
upbrazillian,	আউব্রাজ্লিবিয়ান,	আপব্রাজিলিয়ান,	
jocqey,	জকক,	জকি,	
korley,	করলে,	করলে,	
meridiane,	মেরিডিয়ানে,	মেরিডিয়ানে,	
atmiyasulabh,	আত্মীয়সূলভ,	আত্মীয়সুলভ,	
breakthrough,	ব্রেক্টরথিগ,	ব্রেকথ্রু,	
utpotti,	উৎপত্তি,	উতপত্তি,	
soommita,	সুমিতা,	সুমিতা,	
durarohini,	দুরারোহিনী,	দুরারোহিণী,	
rakkhanbhag,	রক্ষণভাগ,	রক্ষণভাগ,	
sikkhagata,	শিক্ষাগত,	শিক্ষাগত,	
sahittopritite,	সাহিত্যপ্রীতিতে,	সাহিত্যপ্রীতিতে,	
conflict,	কনফ্লিক্ট,	কনফ্লিক্ট,	
siddhantei,	সিদ্ধান্তেই,	সিদ্ধান্তেই,	
protul,	প্রতুল,	প্রতুল,	
hosto,	হস্ত,	হস্ত,	
bohorompurer,	বহরমম্পুরের,	বহরমপুরের,	
bhutbhut,	ভূতভূত,	ভুটভুট,	
foks,	ফকস,	ফক্স,	
moushumei,	মৌশুমেই,	মৌসুমেই,	
panda,	পান্ডা,	পান্ডে,	
uparjoner,	উপার্নের,	উপার্জনের,	
shasonamoleri,	শাসনামলেরই,	শাসনামলেরই,	
bhadaka,	ভাদাকা,	ভদকা,	
dhhaloor,	ঢালুর,	ঢালুর,	
fokskon,	ফকস্কন,	ফক্সকন,	
bane,	বানে,	বনে,	
khamotagulor,	ক্ষমতাগুলোর,	ক্ষমতাগুলোর,	
chhutochhuti,	ছুটোছুটি,	ছুটোছুটি,	
brahmanera,	ব্রাহ্মণেরা,	ব্রাহ্মণেরা,	
drishyogulote,	দৃশ্যগুলোতে,	দৃশ্যগুলোতে,	
victor,	ভিক্টর,	ভিক্টর,	
dara,	দারা,	দারা,	
boiragirhat,	বৈরাগীরহাট,	বৈরাগিরহাট,	
rahee,	রাহী,	রাহী,	
sausage,	সৌগসে,	সসেজ,	
dipgulote,	ডিপগুলোতে,	দ্বীপগুলোতে,	
mmehonoti,	ম্মেহোোটি,	মেহনতি,	
mohajote,	মহাজতে,	মহাজোট,	
sikkharrtheerao,	শিক্ষার্থীরাও,	শিক্ষার্থীরাও,	
hool,	হুল,	হুল,	
byabaharkariderke,	ব্যবহারকারীদেরকে,	ব্যবহারকারীদেরকে,	
sangbadmadhyomgulote,	সংবাদমাধ্যমগুলোতে,	সংবাদমাধ্যমগুলোতে,	
gamdan,	গামদান,	গামদান,	
canflikt,	ক্যানফ্লিক্ট,	কনফ্লিক্ট,	
bahjya,	বাহ্য্যা,	বাহ্য,	
pleto,	প্লেটো,	প্লেটো,	
kanasarabhesana,	কনসররভেসন,	কনসারভেশন,	
abhiyojan,	অভিযোজন,	অভিযোজন,	
kuresher,	কুরেশের,	কুরেশের,	
porbotmala,	পর্বতমালা,	পর্বতমালা,	
uparzoner,	উপার্নের,	উপার্জনের,	
parikha,	পরিখা,	পরিখার,	
sarboshokteeman,	সর্বশক্তিমান,	সর্বশক্তিমান,	
remacri,	রিম্য্কি,	রেমাক্রী,	
oitijjha,	ঐতিহ্যা,	ঐতিহ্য,	
mette,	মেট্তে,	ম্যাট,	
nirbahi,	নির্বাহী,	নির্বাহি,	
geja,	গেজ,	গেজ,	
adhyatmikata,	আধ্যাত্মিকতা,	আধ্যাত্মিকতা,	
subader,	সুবাদের,	সুবাদে,	
birmuktijoddhagan,	বীরমুক্তিনিদ্যাগ,	বীরমুক্তিযোদ্ধাগণ,	
shite,	সিতে,	শীতে,	
weelcomee,	ওয়েলকমি,	ওয়েলকাম,	
sahojlovyotar,	সহজ্বল্যাার,	সহজলভ্যতার,	
koyekbare,	কয়েকবারে,	কয়েকবারে,	
kiibord,	কিইবডর্,	কীবোর্ড,	
sbaajan,	স্বজন,	স্বজন,	
shiqara,	শিকারা,	শিকার,	
ekekrokom,	একেক্করোম,	একেকরকম,	
phutbolarder,	ফুটবোলারদের,	ফুটবলারদের,	
sharoker,	শাকোরের,	স্মারকের,	
prangulo,	প্রাণগুলো,	প্রানগুলো,	
engrejer,	এংরেজের,	ইংরেজের,	
ekoirokom,	একৈরকম,	একইরকম,	
rachonakal,	রচনাকাল,	রচনাকাল,	
hoondayi,	হুনদাই,	হুন্দাই,	
duple,	ডুপল,	ডুপ্লে,	
tennis,	টেনিস,	টেনিস,	
saamaanya,	সামানয়া,	সামান্য,	
eshtonia,	এষ্টনীয়া,	এস্তোনিয়া,	
proshtotto,	প্রস্তত্ত্ব,	প্রস্ত্তত,	
senior,	সেনিওর,	সিনিয়র,	
harishankar,	হরিশংকর,	হরিশংকর,	
browser,	ব্রাউসের,	ব্রাউজার,	
transhapharma,	ট্রান্সফা্রাম,	ট্রান্সফর্ম,	
plack,	প্ল্যাক,	প্ল্যাক,	
kaalengaa,	কালেঙ্গা,	কালেঙ্গা,	
somraatder,	সম্রাটদের,	সম্রাটদের,	
mandondo,	ম্যান্ডন্ডো,	মানদণ্ড,	
byaboharkarike,	ব্যবহারকারীকে,	ব্যবহারকারীকে,	
jotsna,	জোটসনা,	জ্যোৎস্না,	
protishta,	প্রতিষ্টা,	প্রতিষ্টা,	
daqten,	ডেকতেন,	ডাকতেন,	
crashlands,	ক্রাশল্যান্ডস,	ক্র্যাশল্যান্ডস,	
porinoti,	পরিণতি,	পরিণতি,	
sures,	সুরেস,	সুরেশ,	
hajeerhatt,	হাজেরহাট,	হাজিরহাট,	
durgatsabe,	দুর্গতসবে,	দুর্গোৎসবে,	
dakter,	ডাক্টার,	ডাকতের,	
oboshore,	অবশরে,	অবসরে,	
groth,	গ্রথ,	গ্রোথ,	
salsa,	সালসা,	সালসা,	
highcomissione,	হাইকোমিশনে,	হাইকমিশনে,	
abhidhaanic,	অভিধানিক,	অভিধানিক,	
karmosansthan,	কর্মসংস্থান,	কর্মসংস্থান,	
jamaanor,	জামানোর,	জমানোর,	
perri,	পেররি,	পেরি,	
shahoshikatar,	শাহশিকতার,	সাহসিকতার,	
prottokkhovabe,	প্রত্যক্ষভাবে,	প্রত্যক্ষভাবে,	
irana,	ইরানা,	ইরান,	
ipl,	আইপিএল,	আইপিএল,	
neemeetto,	নেমিত্ব,	নিমিত্ত,	
borendroke,	বরেন্দ্রকে,	বরেন্দ্রকে,	
juakhelar,	জুয়াখেলার,	জুয়াখেলার,	
musabbirul,	মুসাব্বিরুল,	মুসাব্বিরুল,	
societykey,	সোস্ইটিকে,	সোসাইটিকে,	
nutunotto,	নুতুনত্ব,	নতুনত্ব,	
perry,	পেরি,	পেরি,	
conflikt,	কনফ্লিক্ট,	কনফ্লিক্ট,	
sangharshik,	সংঘর্ষ্িক,	সাংঘর্ষিক,	
eenameela,	ইনামেলিয়া,	এনামেল,	
dong,	ডং,	ডং,	
drissogulo,	দৃশসগলো,	দৃশ্যগুলো,	
mukhya,	মুখ্যা,	মুখ্য,	
ghomtaa,	ঘোমটা,	ঘোমটা,	
gabhaaskar,	গভাষকর,	গাভাস্কার,	
pacbar,	পাকবার,	পাঁচবার,	
teenisa,	তেনিসা,	টেনিস,	
shikshakbrinda,	শিক্ষাকৃন্দ,	শিক্ষকবৃন্দ,	
antarbhutto,	অন্তর্ভূত্ত,	অন্তর্ভুক্ত,	
chowdhurir,	চৌধিরুর,	চৌধুরীর,	
diznee,	দিজনি,	ডিজনী,	
shekarone,	শেকারোনে,	সেকারণে,	
bharatey,	ভারতে,	ভারতে,	
shasyadi,	শস্যদি,	শস্যাদি,	
awatar,	আওয়াটার,	অবতার,	
falasrutite,	ফালস্ুরিতে,	ফলশ্রুতিতে,	
gajetted,	গ্যাজেটেড,	গেজেটেড,	
saifullahil,	সাইফুল্লাহিল,	সাইফুল্লাহিল,	
vaisoho,	ভাইসহ,	ভাইসহ,	
digreeke,	ডিগ্রিকে,	ডিগ্রিকে,	
janmat,	জন্মত,	জন্মাত,	
bhabatarini,	ভবতারিণী,	ভবতারিণী,	
siddhantoo,	সিদ্ধান্তই,	সিদ্ধান্তও,	
pluck,	প্লাক,	প্ল্যাক,	
spashtotai,	স্পষ্টতাই,	স্পষ্টতই,	
madaspushto,	মাদস্পুষ্ট,	মদদপুষ্ট,	
gandhiio,	গানধিই,	গান্ধীও,	
shajano,	শাজানো,	সাজানো,	
suparichiti,	সুপারিচিতি,	সুপরিচিতি,	
seekkhaou,	শীক্ষাও,	শিক্ষাও,	
manob,	মানব,	মানব,	
alpa,	আলপা,	অল্প,	
neemeette,	নেমিত্বে,	নিমিত্তে,	
laaishenshh,	লেইশেংশ,	লাইসেন্স,	
ganaparibahan,	গণপরিবাহন,	গণপরিবহন,	
huk,	হ্যাক,	হুক,	
apolokbhabe,	অপোকলভাবে,	অপলকভাবে,	
siddhante,	সিদ্ধান্তে,	সিদ্ধান্তে,	
akreetokarjo,	আকৃতিকরোজ্য,	অকৃতকার্য,	
bhabanir,	ভবানীর,	ভবানীর,	
muradke,	মুরাডকে,	মুরাদকে,	
gatibege,	গেটিবেগে,	গতিবেগে,	
madhobi,	মাধবী,	মাধবী,	
aholyar,	আহল্যার,	অহল্যার,	
xpose,	ক্কোসওস,	এক্সপোজ,	
supparak,	সুপ্রাক,	সুপ্পারক,	
kharavel,	খরাভেল,	খারবেল,	
eoki,	এইকি,	এওকি,	
pratijogider,	প্রতিযোগীদের,	প্রতিযোগীদের,	
eshiyetika,	এশিয়েটাকি,	এশিয়াটিক,	
kormopontha,	কর্মপন্থা,	কর্মপন্থা,	
nirbachakder,	নির্বাচকদের,	নির্বাচকদের,	
awrbit,	অর্বিত,	অরবিট,	
poorohitder,	পুরহিতদের,	পুরোহিতদের,	
riazuddin,	রাইজুদ্দিন,	রিয়াজউদ্দীন,	
aarke,	এ্যাকারে,	আরকে,	
konar,	কোনার,	কণার,	
akkelpure,	আক্কেলপুরে,	আক্কেলপুরে,	
dola,	দোলা,	দলা,	
homeser,	হোমেসের,	হোমসের,	
konroop,	কোনরূপ,	কোনরূপ,	
elakayi,	এলাকায়ী,	এলাকাই,	
gudamjat,	গুড়াজমাত,	গুদামজাত,	
maley,	ম্যালে,	মালে,	
zozyota,	যোজ্যতা,	যোজ্যতা,	
saqara,	সাকারা,	সকার,	
pabo,	পাবো,	পাব,	
onucheeder,	অনুচেদের,	অনুচ্ছেদের,	
shishu,	শিশু,	শিশু,	
brekthrough,	ব্রেকথারুঘ,	ব্রেকথ্রু,	
akhando,	অখাণ্ড,	অখন্ড,	
sobrakamer,	সব্রাকামের,	সবরকমের,	
dhwajbhango,	ধ্বাভাঙ্গ্য,	ধ্বজভঙ্গ,	
angibhutovabe,	অঙ্গিভূভভাবে,	অঙ্গীভূতভাবে,	
eshtoniya,	এষ্টনীয়,	এস্তোনিয়া,	
shahjapur,	শাহজাপুর,	শাহজাপুর,	
sobaiderke,	সোবাইদেরকে,	সবাইদেরকে,	
srichoitonnodeb,	শ্রীচৈতন্যবের,	শ্রীচৈতন্যদেব,	
mozdoor,	মোদদুর,	মজদুর,	
orbit,	অরবিট,	অরবিট,	
bonnypran,	বো্যিনরাণ,	বন্যপ্রাণ,	
townshhip,	টৌনশিপ,	টাউনশিপ,	
akmato,	আকমাতো,	একমত,	
kalkarkhana,	কালকর্খনা,	কলকারখানা,	
asthishondhi,	অস্থিশন্ধী,	অস্থিসন্ধি,	
planey,	প্লেন,	প্লেনে,	
aviyojan,	অভিযোজন,	অভিযোজন,	
himsrot,	হিমস্রোট,	হিমস্রোত,	
tanshree,	তাশ্রী,	তানশ্রী,	
sportstar,	স্পোর্টস্টার,	স্পোর্টসস্টার,	
furio,	ফুরিও,	ফুরিও,	
kodorer,	কদরের,	কদরের,	
taufiq,	তাফিক,	তৌফিক,	
munsi,	মুন্সি,	মুন্সী,	
kraanti,	ক্রান্টি,	ক্রান্তি,	
kaathhaamaandu,	কথথামান্ডু,	কাঠমান্ডু,	
qanasarabheshana,	কনারারভূষণ,	কনসারভেশন,	
charukala,	চারুকালা,	চারুকলা,	
desiseyer,	ড্যাসিয়েকের,	ডিজিজের,	
taatey,	তাতে,	তাতে,	
byke,	বিইইকে,	বাইক,	
khanabale,	খানাবলে,	খানাবলে,	
rananganey,	রণাঙ্গনে,	রণাঙ্গনে,	
epiela,	এপিয়েলা,	আইপিএল,	
chalachchitroi,	চালাচ্ছিত্রই,	চলচ্চিত্রই,	
deebug,	দেবুগ,	ডিবাগ,	
said,	সাইদ,	সাইদ,	
protijogitamulok,	প্রতিযোগিতামূলক,	প্রতিযোগীতামূলক,	
chaudhurio,	চৌধুরিও,	চৌধুরীও,	
chokrantosoho,	চক্রান্তসহ,	চক্রান্তসহ,	
manabmaner,	মানবমানের,	মানবমনের,	
chhooteete,	ছুটিতে,	ছুটিতে,	
annorup,	আন্নরূপ,	অন্যরূপ,	
nothiboddho,	নথিবদ্ধ,	নথিবদ্ধ,	
alsaar,	আলসার,	আলসার,	
atak,	আতাক,	আটক,	
siramikasa,	সিরামিকাসা,	সিরামিকস,	
ekbai,	একবাই,	একবাই,	
sonaktokaran,	সোনাক্তকরণ,	সনাক্তকরণ,	
bhupal,	ভুপাল,	ভূপাল,	
khaaneker,	খানেকের,	খানেকের,	
temonbhabe,	তেমনভাবে,	তেমনভাবে,	
shatodha,	শতোধ,	শতধা,	
babare,	বাবারে,	বাবারে,	
tuni,	তুনি,	টুনি,	
hadisti,	হাদিস্তি,	হাদিসটি,	
sanghatakder,	সংঘাটকদের,	সংঘটকদের,	
hilser,	হিলসের,	হিলসের,	
shuchonakal,	শূচনাকাল,	সূচনাকাল,	
monchosthol,	মন্চস্থল,	মঞ্চস্থল,	
bondi,	বন্ডী,	বন্দী,	
mulvitti,	মুলভিত্তি,	মূলভিত্তি,	
casper,	ক্যাসপার,	ক্যাসপার,	
yatharthabhabe,	যথোর্থভাবে,	যথার্থভাবে,	
kourabe,	কৌরাবে,	কৌরবে,	
dala,	ডালা,	দলা,	
raia,	রাইয়া,	রায়,	
collaborators,	কলাবরেটারস,	কলাবরেটরস,	
shamijir,	শামিজীর,	স্বামীজীর,	
boikolyo,	বৈকল্য,	বৈকল্য,	
bujhtepari,	বুঝতেপারি,	বুঝতেপারি,	
ayumi,	আয়ুমী,	আয়ুমি,	
rudroke,	রুদ্রোকে,	রুদ্রকে,	
hariken,	হরিকেন,	হ্যারিকেন,	
meloonborroner,	মেলুকন্রনের,	মেলবোর্নের,	
bhramapraban,	ভ্রমপব্বন,	ভ্রমপ্রবণ,	
baptics,	ব্যাপটিক্স,	ব্যাপটিকস,	
subade,	সুবাদে,	সুবাদে,	
nirikhe,	নিরিখে,	নিরিখ,	
saarbhaarti,	সররভার্তি,	সার্ভারটি,	
horiddare,	হরিদ্দারে,	হরিদ্বারে,	
uthhaane,	উঠানে,	উঠানে,	
udbodhaney,	উদ্বোধনে,	উদ্বোধনে,	
zoojyota,	যোজ্যতা,	যোজ্যতা,	
chhutochhooti,	ছুটোছুটি,	ছুটোছুটি,	
abheedhaneek,	অভিদানিক,	অভিধানিক,	
kantajir,	কান্তাজীর,	কান্তজির,	
bhittiti,	ভিত্তিটি,	ভিত্তিটি,	
durlabhatwang,	দুর্লাভবত্বং,	দুর্লভত্বং,	
difinishian,	ডিফিনশিয়ান,	ডেফিনেশন,	
lagche,	লাগছে,	লাগছে,	
sadeena,	সাদিনা,	সাডেন,	
palashir,	পলাশির,	পলাশীর,	
oncholshomuher,	অঞ্চলসমূহের,	অঞ্চলসমূহের,	
carbus,	কারবাস,	কারবাস,	
capsul,	ক্যাপসুল,	ক্যাপসুল,	
dip,	ডিপ,	দীপ,	
digree,	ডিগ্রি,	ডিগ্রি,	
akpaase,	আকপাসে,	একপাশে,	
prrajanankaal,	প্রেজননণকাল,	প্রজননকাল,	
dhhaabi,	ঢাবি,	ঢাবি,	
kormyi,	কর্মিই,	কর্মই,	
manab,	মানাব,	মানব,	
tiunara,	টিউনারা,	টিউনার,	
shrabostee,	শ্রাবস্তি,	শ্রাবস্তী,	
bhebechili,	ভেবেছিলি,	ভেবেছিলি,	
dumaa,	ডামা,	দুমা,	
gaddaphii,	গাদ্ডাফি,	গাদ্দাফী,	
upobasher,	উপবাশের,	উপবাসের,	
aansaareer,	আনসারীর,	আনসারীর,	
poscater,	পোস্কাটের,	পশ্চাতের,	
alimpiqa,	আলিম্পিকা,	অলিম্পিক,	
gagee,	গাগী,	গেজ,	
dhojovongo,	ধ্বজঙ্গ,	ধ্বজভঙ্গ,	
proteemake,	প্রতিমেক,	প্রতিমাকে,	
prothar,	প্রথার,	প্রথার,	
swairacharibirodhi,	স্বৈরাচারিদিরি,	স্বৈরাচারীবিরোধী,	
byomkesh,	ব্যামকেষ,	ব্যোমকেশ,	
shuri,	শুরী,	সুরি,	
mosjidsoho,	মসজিদসহ,	মসজিদসহ,	
stona,	স্তোনা,	স্টোন,	
satarkabhabe,	সতর্কভাবে,	সতর্কভাবে,	
uthe,	উঠে,	উঠে,	
makame,	মাকামে,	মাকামে,	
jeebanjapon,	জীবনজ্যাপন,	জীবনযাপন,	
zubokder,	যুবকদের,	যুবকদের,	
karmojog,	কর্মযোগ,	কর্মযোগ,	
sheepha,	শেফা,	শেফ,	
dadar,	দাদার,	দাদার,	
madhuree,	মধুরী,	মাধুরী,	
monir,	মনির,	মনির,	
gronthowo,	গ্রন্থৌ,	গ্রন্থও,	
ikbaaler,	ইকবালের,	ইকবালের,	
shukraanoo,	শুক্রাণও,	শুক্রানু,	
mukhomandoler,	মুখমন্ডলের,	মুখমণ্ডলের,	
moresbai,	মোরেস্বাই,	মোরেসবাই,	
goshthiti,	গোষ্ঠিতি,	গোষ্ঠীটি,	
lajik,	লাজিক,	লজিক,	
mesenjarer,	মেজেন্জারের,	মেসেঞ্জারের,	
bossoben,	বসবেন,	বসবেন,	
oswasteekor,	অস্বাস্তিকর,	অস্বস্তিকর,	
choshon,	চোষণ,	চোষণ,	
bim,	বিম,	বিম,	
cheef,	চীফ,	শেফ,	
doorger,	ডররগের,	দুর্গের,	
suporichita,	সুপরিচিত,	সুপরিচিত,	
turkyder,	টার্কডিের,	তুর্কিদের,	
grambaseer,	গ্রামবাসীর,	গ্রামবাসীর,	
jati,	জাতি,	যাতি,	
tookrote,	টুকরোতে,	টুকরোতে,	
byapoktor,	ব্যাপক্তর,	ব্যাপকতর,	
vool,	ভুল,	উল,	
oncholgulir,	অঞ্চলগুলির,	অঞ্চলগুলির,	
municipal,	মিউনিসিপাল,	মিউনিসিপ্যাল,	
temone,	টেমোনে,	তেমনই,	
phutonta,	ফুটোন্টা,	ফুটন্ত,	
jonmobhumitir,	জন্মভূমিতির,	জন্মভূমিটির,	
iub,	আইএবিএ,	আইইউবি,	
podotyagsongkranto,	পদত্যাগসংক্রান্ত,	পদত্যাগসংক্রান্ত,	
cantan,	ক্যান্টান,	ক্যান্টন,	
karir,	কারির,	কারীর,	
doltyagi,	দলত্যাগী,	দলত্যাগী,	
seguloi,	সেগুলোই,	সেগুলোই,	
lyataa,	ল্যাটা,	ল্যাটা,	
bayshorkarikarone,	বাইশ্রকরণকারণে,	বেসরকারিকরণ,	
templet,	টেম্পলেট,	টেম্পলেট,	
nirgaman,	নির্গমান,	নির্গমন,	
venush,	ভেনাশ,	ভেনাস,	
poripake,	পরিপাকে,	পরিপাকে,	
ujobekeestan,	উজবেকিন্তান,	উজবেকিস্তান,	
pharmesigulote,	ফার্মেসিগুলোতে,	ফার্মেসীগুলোতে,	
nanilalke,	নানিলালকে,	ননীলালকে,	
bodna,	বোদনা,	বদনা,	
porizoner,	পরিজেনের,	পরিজনের,	
kayech,	কায়েছ,	কায়েছ,	
chhayi,	ছায়ি,	ছাই,	
khappar,	খাপ্পার,	খপ্পর,	
nirbahe,	নির্বাহে,	নির্বাহে,	
shoriph,	শরিফ,	শরিফ,	
chhon,	ছোন,	ছোঁ,	
horas,	হোরাস,	হোরাস,	
bajhyo,	বাঝ্য,	বাহ্য,	
sepha,	সেফা,	শেফ,	
scuvi,	স্কুভি,	স্কুভি,	
nishad,	নিশাদ,	নিষাদ,	
ingrezeeteo,	ইংরেজিতেও,	ইংরেজিতেও,	
lidars,	লিডারস,	লিডার্স,	
khudrokar,	ক্ষুদ্রকার,	ক্ষুদ্রকার,	
khagen,	খাগেন,	খগেন,	
sudrishya,	সুদৃশ্য,	সুদৃশ্য,	
chikitshar,	চিকিত্াার,	চিকিত্সার,	
hattey,	হ্যাটে,	হাঁটতে,	
akram,	আক্রম,	আকরাম,	
encidablu,	এনসিডে্বালু,	এনসিডাব্লু,	
holdim,	হোল্ডিম,	হোল্ডিং,	
bhandti,	ভাণ্ডটি,	ভাণ্ডটি,	
saraiki,	সরাইকি,	সরাইকি,	
okritokarjo,	অক্তিরকার্য,	অকৃতকার্য,	
faskari,	ফস্করী,	ফাঁসকারী,	
goteehin,	গতিহীন,	গতিহীন,	
towraat,	তৌররাত,	তওরাত,	
pitiler,	পিটিলের,	পিটিলের,	
priseflex,	প্রিসেফ্লেক্স,	প্রাইজফ্লেক্স,	
nepchooner,	নেপচুনের,	নেপচুনের,	
abhidhaaneeck,	অভিধানিক,	অভিধানিক,	
protisthan,	প্রতিষ্ঠান,	প্রতিষ্টান,	
naabyota,	নাব্যতা,	নাব্যতা,	
phareeksa,	ফরেকস,	ফরেক্স,	
besur,	বেসুর,	বেসুর,	
jomjamat,	জমজামাত,	জমজমাট,	
samratder,	সমর্তদের,	সম্রাটদের,	
inapharameshana,	ইনামারাফাশন,	ইনফরমেশন,	
lubitz,	লুবিৎজ,	লুবিৎজ,	
cholochchitra,	চলচ্চিত্র,	চলচ্চিত্র,	
ishter,	ইশতের,	ইস্টের,	
difinisian,	ডিফিনিসিয়ান,	ডেফিনেশন,	
shikshagato,	শিক্ষাগত,	শিক্ষাগত,	
siitei,	সিতাই,	শীতেই,	
expreshshion,	এক্সপ্রেশন,	এক্সপ্রেশন,	
shandra,	শান্দ্রা,	শান্দ্রার,	
chalochchitrogulor,	চলচ্চিত্রগুলোর,	চলচ্চিত্রগুলোর,	
kholdhular,	খোলধুলার,	খোলধূলার,	
teunar,	তেউনার,	টিউনার,	
teoyana,	তেওয়ানা,	তাইওয়ান,	
neermol,	নার্মোল,	নির্মল,	
graambashee,	গ্রামবাশে,	গ্রামবাসী,	
teta,	টেইটা,	টেটা,	
husni,	হুসনী,	হুসনি,	
pancbaar,	পাঁচবার,	পাঁচবার,	
dokaangulotey,	দোকানগুলোতে,	দোকানগুলোতে,	
choukato,	চৌকাতো,	চৌকাত,	
paikgachha,	পাইকগাছা,	পাইকগাছা,	
mahafezkhanar,	মহাফেজখানার,	মহাফেজখানার,	
gunje,	গুঞ্জে,	গুঁজে,	
qulim,	কুলিম,	কুলিং,	
chirkoot,	চিরকুট,	চিরকুট,	
kinsa,	কিন্সা,	কিংস,	
tinhazar,	তিনহাজার,	তিনহাজার,	
uzobekeestaan,	উজোবেকিন্তান,	উজবেকিস্তান,	
antarvuktimulak,	আন্তর্ভূতিক্মূলক,	অন্তর্ভুক্তিমূলক,	
nek,	নেক,	নেক,	
gandhariir,	গান্ধারীর,	গান্ধারীর,	
munot,	মুনোট,	মুনোট,	
venice,	ভেনিস,	ভেনিস,	
jewellery,	জিয়েলেরি,	জুয়েলারির,	
militaryr,	মিলিটারির,	মিলিটারির,	
chintakarma,	চিন্তাকর্ম,	চিন্তাকর্ম,	
cheekitsar,	চিকিৎসার,	চিকিত্সার,	
dormroome,	দর্মরূপে,	ডর্মরুমে,	
dagmukta,	দাগমুক্ত,	দাগমুক্ত,	
protectionism,	প্রোটেক্টশিিম,	প্রোটেকশনিজম,	
ghaghat,	ঘাঘাট,	ঘাঘট,	
codee,	কোড়ি,	কোডে,	
gavaskar,	গাভাসকার,	গাভাস্কার,	
joumana,	জৌমানা,	জুমানা,	
bheenisa,	ভীনিসা,	ভেনিস,	
torkarir,	তর্কারির,	তরকারীর,	
kaferderke,	কাফেরদেরকে,	কাফেরদেরকে,	
patininda,	পটিনিন্দা,	পতিনিন্দ,	
horippur,	হরিপুর,	হরিপুর,	
dorneca,	ডর্নেকা,	ডরনেকা,	
brittakare,	বৃত্তকারে,	বৃত্তাকারে,	
chetanagato,	চেতনাগত,	চেতনাগত,	
vins,	ভিন্স,	ভিন্স,	
keyu,	যেই,	কেউ,	
neck,	নেক,	নেক,	
boiporiityen,	বৈপরিত্যেন,	বৈপরীত্যেন,	
johor,	জহর,	জহর,	
aashanka,	আশঙ্কা,	আশংকা,	
sheshardhe,	শেষার্ধে,	শেষার্ধে,	
battery,	ব্যাটারি,	ব্যাটারী,	
michhilti,	মিছলটি,	মিছিলটি,	
blyaka,	ব্লাক,	ব্ল্যাক,	
amanisa,	আমানিসা,	অমানিশা,	
ghoorchen,	ঘুরছেন,	ঘুরেছেন,	
ukeliptas,	উকেলিপ্তস,	ইউক্যালিপ্টাস,	
promodwara,	প্রমোদ্বারা,	প্রমদ্বারা,	
procharjontrogulo,	প্রচারণগ্রন্ুলো,	প্রচারযন্ত্রগুলো,	
salphat,	সেলপাত,	সালফেট,	
anubhutimalar,	অনুভূতিমালার,	অনুভূতিমালার,	
bonshi,	বন্শি,	বংশী,	
disni,	ডিসনি,	ডিজনী,	
milekhaanek,	মিলেখানাকে,	মাইলখানেক,	
show,	শ্বু,	শো,	
uddhritir,	উদ্ধৃতির,	উদ্ধৃতির,	
bhenise,	ভেনিসে,	ভেনিসে,	
chrystal,	ক্রিস্টলা,	ক্রাইস্টাল,	
dabliudabliui,	ডাব্লিউডুলবি,	ডাব্লিউডাব্লিউই,	
chalachchitro,	চালাচ্ছিত্র,	চলচ্চিত্র,	
domonmulok,	ডমনোমূলক,	দমনমূলক,	
mach,	মাছ,	মাছ,	
fasir,	ফ্যাসির,	ফাসীর,	
sexperter,	সেক্পপারটটের,	সেক্সপার্টের,	
gonohotyakey,	গণহত্যাকে,	গণহত্যাকে,	
hizrite,	হিজরিতে,	হিজরীতে,	
shroddhabihin,	শ্রদ্ধাবিহীন,	শ্রদ্ধাবিহীন,	
toching,	টোচিং,	টোচিং,	
poddhotiteyi,	পদ্ধতিতেই,	পদ্ধতিতেই,	
piulir,	পিউলির,	পিউলির,	
drissoteer,	দৃশ্টির,	দৃশ্যটির,	
sutir,	সুতির,	সুতির,	
popke,	পোপকে,	পোপকে,	
hugeke,	হুজেকে,	হিউজকে,	
dekaner,	দেকানের,	দেকানের,	
phutanta,	ফুটান্টা,	ফুটন্ত,	
samajikotar,	সামাজিকতার,	সামাজিকতার,	
atwabishvashi,	অত্বাবিশ্বাসী,	আত্মবিশ্বাসী,	
rajashri,	রাজশরি,	রাজশ্রী,	
ghoomato,	ঘুমাতো,	ঘুমাতো,	
mugdal,	মুগদাল,	মুগডাল,	
unitgulo,	ইউনিটগুলো,	ইউনিটগুলো,	
gemske,	গেম্সকে,	জেমসকে,	
ashirbadatri,	আশীরদাবত্রী,	আশীর্বাদাত্রী,	
dantahin,	দানাাহীন,	দন্তহীন,	
shoreefpur,	শরীফুর,	শরিফপুর,	
abdoone,	আবদুুনে,	আবদুন,	
hundai,	হুন্ডাই,	হুন্দাই,	
vugoley,	ভুগলে,	ভূগোলে,	
aagera,	আজারা,	আগোরা,	
landin,	ল্যান্ডিন,	ল্যান্ডিং,	
residensa,	রেসিডেন্সা,	রেসিডেন্স,	
kaale,	কালে,	কালে,	
byabaharkarike,	ব্যবহারকারীকে,	ব্যবহারকারীকে,	
byaptikaler,	ব্যাপ্তিকালের,	ব্যাপ্তিকালের,	
rinobodh,	ঋণবোধ,	ঋণবোধ,	
survative,	সার্ভেটিভ,	সারভেটিভ,	
surke,	সুরকে,	সুরকে,	
khuliechilam,	খুলিয়েছিলাম,	খুলিয়েছিলাম,	
safiin,	সাফিন,	সাফিন,	
dobhara,	ডোভারা,	ডোভার,	
qlauda,	ক্লাডা,	ক্লাউড,	
hajirhat,	হাজিরহাট,	হাজিরহাট,	
bisnukey,	বিস্কুকে,	বিষ্ণুকে,	
oncholshomuh,	অঞ্চলসমূহ,	অঞ্চলসমূহ,	
dephinishion,	ডিফিনিশন,	ডেফিনেশন,	
foxer,	ফক্সের,	ফক্সের,	
shtona,	স্তনা,	স্টোন,	
chhadite,	ছদিিতে,	ছড়িতে,	
bisheshshyer,	বিশেষ্ঠ্যের,	বিশেষ্যের,	
aatto,	আট্টো,	আত্ম,	
dijijer,	দিজিজের,	ডিজিজের,	
maarmaader,	মার্মাদের,	মারমাদের,	
protizogii,	প্রতিজোগী,	প্রতিযোগী,	
kosambir,	কোসাম্বীর,	কোসাম্বীর,	
musalmanderke,	মুসলমানদেরকে,	মুসলমানদেরকে,	
kalakushalir,	কালাকুশলীর,	কলাকুশলীর,	
aaziz,	আজিজ,	আজিজ,	
peeth,	পিথ,	পীঠ,	
protishtan,	প্রতিষ্টান,	প্রতিষ্টান,	
soolke,	সুলকে,	শুল্কে,	
aalkatraa,	আলকাত্রা,	আলকাতরা,	
elaakaa,	এলাকা,	এলাকা,	
gosthike,	গোষ্ঠীকে,	গোষ্ঠীকে,	
temonvabe,	টেমোনভাবে,	তেমনভাবে,	
saseza,	সাজেজা,	সসেজ,	
lakkhero,	লক্ষেরও,	লক্ষেরও,	
wrighter,	থিগ্টার,	রাইটের,	
hakone,	হাকোন,	হাকোনে,	
premoronge,	প্রেমরোঙ্গে,	প্রেমরঙে,	
siddharther,	সিদ্ধার্থের,	সিদ্ধার্থের,	
elaakaate,	এলাকাতে,	এলাকাতে,	
dakkhinkare,	দক্ষিণকরে,	দক্ষিণকরে,	
roopmatro,	রূপমাত্র,	রূপমাত্র,	
parqa,	পারকা,	পার্ক,	
difinision,	ডিফিনিশন,	ডেফিনেশন,	
neemitte,	নিমিত্বে,	নিমিত্তে,	
shuperheiro,	শুপেরহিরো,	সুপারহিরো,	
sushposhtolikhito,	সুষ্পপ্খলিতিত,	সুষ্পষ্টলিখিত,	
sarder,	সারদের,	সরদার,	
israelbahini,	ইসরাইলবাহিনী,	ইস্রায়েলবাহিনী,	
siddhanto,	সিদ্ধান্ত,	সিদ্ধান্তও,	
songkoloney,	সংকলনে,	সংকলনে,	
mumtajer,	মুমতাজের,	মুমতাজের,	
bojiye,	বজিয়ে,	বজিয়ে,	
oncholke,	অঞ্চলকে,	অঞ্চলকে,	
harja,	হার্জা,	হার্জ,	
pingna,	পিংনা,	পিংনা,	
onurbar,	অনুর্বার,	অনুর্বর,	
dovaar,	দোভার,	ডোভার,	
nischitvabe,	নিশ্চিতভাবে,	নিশ্চিতভাবে,	
relance,	রিল্যান্সে,	রিলায়েন্স,	
alexandar,	আলেক্সানার,	আলেকজান্ডার,	
bbosonto,	ব্বস্তত,	বসন্ত,	
sharansthal,	শরনস্থল,	শরণস্থল,	
elaaka,	এলাকা,	এলাকা,	
phonekari,	ফোনেকারি,	ফোনকারী,	
amorendro,	অমরেন্দ্র,	অমরেন্দ্র,	
sanstha,	সানস্থ,	সংস্থা,	
ul,	উল,	উল,	
zakharovar,	জাখারাভার,	জাখারোভার,	
riphleksa,	রিফললকক্সা,	রিফ্লেক্স,	
as,	এসএস,	অস,	
badargaji,	বাদরগাজী,	বদরগাজী,	
sikkhakromer,	শিক্ষাক্রমের,	শিক্ষাক্রমের,	
dakticket,	ডাক্টিকেট,	ডাকটিকিট,	
ragei,	রাগেই,	রাগেই,	
zommu,	জোম্মু,	জম্মু,	
torkarite,	তর্কারিতে,	তরকারিতে,	
bhromoner,	ভ্রমণের,	ভ্রমণের,	
nationalser,	নেশন্যালেসের,	ন্যাশনালসের,	
oxite,	অক্সিইট,	অক্সাইট,	
kaaferder,	কাফেরদের,	কাফেরদের,	
mugdha,	মুগধা,	মুগ্ধ,	
melborrone,	মেলবোররে,	মেলবোর্নে,	
avetar,	আভেতার,	অবতার,	
kyathlik,	ক্যাটলিক,	ক্যাথলিক,	
whole,	হোলে,	হোল,	
karlei,	কারলেই,	করলেই,	
abdan,	আবদান,	আব্দান,	
byathapather,	ব্যথাপথের,	ব্যথাপথের,	
tintikey,	তিনটিকে,	তিনটিকে,	
machkabar,	মাছাবার,	মাচকাবার,	
karore,	কারোর,	কারোর,	
shekarmani,	শেকর্মণি,	শেকরমানি,	
eokee,	এইকে,	এওকি,	
dwibidho,	দ্বিবিধ,	দ্বিবিধ,	
baju,	বাজু,	বাজু,	
youth,	যৌথ,	ইয়ুথ,	
kormokarke,	কর্মকারকে,	কর্মকারকে,	
jackey,	জ্যাকে,	জকি,	
drabyatah,	দ্রব্যতাহ,	দ্রব্যতঃ,	
manush,	মানুষ,	মানুষ,	
cs,	সিএসএ,	সিএস,	
mahibur,	মহিবুর,	মহিবুর,	
aholya,	আহল্যা,	অহল্যা,	
vaibon,	ভেইবন,	ভাইবোন,	
eeksapreeshana,	এক্সপ্রেশন,	এক্সপ্রেশন,	
drishyogulotey,	দৃশ্যগুলোতে,	দৃশ্যগুলোতে,	
schilling,	স্কিলিং,	শিলিং,	
duio,	দুইও,	দুইও,	
kaamij,	কামিজ,	কামিজ,	
mangolic,	ম্যাঙ্গোলিক,	মাঙ্গলিক,	
probhritike,	প্রভৃতিকে,	প্রভৃতিকে,	
chhadura,	ছদুুরা,	ছাদুরা,	
kheylechen,	খেয়েছেন,	খেলেছেন,	
edaning,	এডানিং,	ইদানিং,	
saver,	সেভার,	সেভার,	
protijogiitamulok,	প্রতিযোগিতামূলক,	প্রতিযোগীতামূলক,	
bostubad,	বস্তুবাদ,	বস্তুবাদ,	
ekroop,	একরূপ,	একরূপ,	
abosare,	অবসারে,	অবসরে,	
makhno,	মাখতো,	মাখনো,	
nirbachokder,	নির্বাচকদের,	নির্বাচকদের,	
larson,	লারসন,	লারসন,	
sheetke,	শীটকে,	শীতকে,	
jounatar,	যৌনাতার,	যৌনতার,	
poroborti,	পরবর্তী,	পরর্বতী,	
senabahinikey,	সেনাবাহিনীকে,	সেনাবাহিনীকে,	
kei,	কেই,	কেই,	
labonaktatar,	লবণকা্ততার,	লবণাক্ততার,	
alkatra,	আলকাত্রা,	আলকাতরা,	
phormat,	ফর্মাট,	ফরম্যাট,	
shakankti,	শাকাঙ্কটি,	শকাঙ্কটি,	
obhijojan,	অভিজোজন,	অভিযোজন,	
baaiq,	বাইক,	বাইক,	
dobhaar,	ডোভার,	ডোভার,	
utkhaat,	উতক্াত,	উত্খাত,	
pathkrom,	পাঠক্রম,	পাঠক্রম,	
uindos,	উইন্ডোস,	উইন্ডোস,	
playtey,	প্লেইট,	প্লেটে,	
peethey,	পিঠে,	পীঠে,	
maladabha,	মালাদাভা,	মলদোভা,	
joubankal,	যৌবনকাল,	যৌবনকাল,	
tateo,	তাতেও,	তাতেও,	
agaldar,	আগালদার,	আগলদার,	
jeelyaand,	জীলায়ন্ড,	জিল্যান্ড,	
konruup,	কোনরুপ,	কোনরূপ,	
maunchostho,	মঞ্চচ্ঠ,	মঞ্চস্থ,	
dorgah,	দরগাহ,	দরগাহ,	
magical,	ম্যাজিক্যাল,	ম্যাজিকাল,	
serology,	সেরোলজি,	সেরোলজি,	
sima,	সিমা,	সীমা,	
lebina,	লেবিনা,	লেবিনা,	
taunship,	টাউনশিপ,	টাউনশিপ,	
bamni,	বাম্নি,	বামনী,	
title,	টিটলে,	টাইটেল,	
addhattikotar,	আদ্ধাত্মিকতার,	আধ্যাত্মিকতার,	
barack,	ব্যারাক,	বারাক,	
somsher,	সম্শের,	সমশের,	
paolasthi,	পাওলাস্থি,	পাওলাসথি,	
noiteekotar,	নৈতিকতার,	নৈতিকতার,	
parqim,	পারকিম,	পার্কিং,	
bifol,	বিফল,	বিফল,	
rajendracholer,	রাজেন্দ্রছোলের,	রাজেন্দ্রচোলের,	
gardeen,	গার্ডিন,	গার্ডেন,	
koreempoor,	করিমপুর,	করিমপুর,	
pujito,	পুজিত,	পুজিত,	
aakkaash,	আক্কাশ,	আককাস,	
shamshere,	শামশেরে,	শমসের,	
vodqa,	ভোডকা,	ভদকা,	
ostad,	ওস্তাদ,	ওস্তাদ,	
chilahatee,	চিলাহাতে,	চিলাহাটি,	
minister,	মিনিস্টের,	মিনিস্টার,	
songbadmadhyame,	সংবাদমাধ্যমে,	সংবাদমাধ্যমে,	
beatleser,	বিটলেসের,	বিটলসের,	
prodiiper,	প্রদীপের,	প্রদীপের,	
vobobibhuti,	বববিভূতি,	ভববিভূতি,	
scholarsip,	স্কলারশিপ,	স্কলারশিপ,	
hurricane,	হাউরিকেনে,	হ্যারিকেন,	
duburir,	ডুবুরির,	ডুবুরির,	
sardar,	সরদার,	সরদার,	
roopdaan,	রূপদান,	রুপদান,	
khuizza,	খুইজ্জা,	খুইজ্জা,	
glanio,	গ্লানিও,	গ্লানিও,	
protijogi,	প্রতিযোগী,	প্রতিযোগী,	
bosontokke,	বসন্তককে,	বসন্তকে,	
firozaa,	ফিরোজা,	ফিরোজা,	
america,	আমেরিকা,	আমেরিকা,	
nilfamarir,	নীলফামারির,	নীলফামারীর,	
jhanjra,	ঝাঁজরা,	ঝাঁজরা,	
karmasampadon,	কর্মসম্পদদন,	কর্মসম্পাদন,	
kobulennechha,	কোবুলেন্েছা,	কবুলেন্নেছা,	
shatan,	শাটান,	শয়তান,	
carlosh,	কারলোশ,	কার্লোস,	
kharar,	খারার,	খরার,	
nodiiteyi,	নদীতেই,	নদীতেই,	
generalissimo,	জেনারালিউসমিি,	জেনারেলিসিমো,	
bipti,	বিপ্তি,	বিপ্তি,	
bhowanipur,	ভোসানিপুর,	ভবানীপুর,	
nartana,	নারাানা,	নর্টন,	
shukrabab,	শুক্রবাব,	শুক্রবাব,	
maail,	মাইল,	মাইল,	
zibonnogor,	জীবনযোগর,	জীবননগর,	
rojapalaner,	রোজাপালনের,	রোজাপালনের,	
kadakhonchar,	কাদাখোঁচার,	কাদাখোঁচার,	
protiakromonei,	প্রতিয়ক্রমণেই,	প্রতিআক্রমণেই,	
bajite,	বাজিতে,	বাজিতে,	
amiya,	আমিয়া,	অমিয়,	
gobeshakgon,	গবেষকগণ,	গবেষকগণ,	
barrageke,	বার্জাকে,	ব্যারেজকে,	
udyem,	উদ্যেম,	উদ্যেম,	
tetela,	টেটেলা,	টাইটেল,	
sathik,	সাথিক,	সঠিক,	
dekhso,	দেখসো,	দেখসো,	
foolkopi,	ফুলকোপি,	ফুলকপি,	
vugorvey,	ভূগর্ভে,	ভূগর্ভে,	
lambi,	ল্যাম্বি,	লম্বি,	
sheekar,	শিকার,	শিকার,	
militarite,	মিলিটারিতে,	মিলিটারিতে,	
deliver,	ডেলিভার,	ডেলিভার,	
ultrasonography,	আল্্ট্রোজন্্রাসি,	আলট্রাসনোগ্রাফিও,	
somoodrotote,	সমুদ্রততে,	সমুদ্রতটে,	
rohasyati,	রোহাস্যাটি,	রহস্যটি,	
utsahamulak,	উৎসমাহুলক,	উৎসাহমূলক,	
kisti,	কিস্তি,	কিস্তি,	
rakhtokkharoner,	রাখতক্ষরণের,	রক্তক্ষরণের,	
kolkarkhana,	কোলকারখানা,	কলকারখানা,	
asaktibandhan,	অসক্তিবন্ধন,	আসক্তিবন্ধন,	
suiza,	সুইজা,	সুইজা,	
scholars,	স্কোলারস,	স্কলার্স,	
khoka,	খোকা,	খোকা,	
canservatian,	ক্যানভার্টেশন,	কনসারভেশন,	
bojata,	বোজাতা,	বোজাটা,	
eupheike,	ইউফিকে,	ইউফেইকে,	
toroonraa,	তোরোনারা,	তরুণরা,	
pacchi,	পাচ্চি,	পাচ্ছি,	
blasterke,	ব্লাস্টারকে,	ব্লাস্টারকে,	
amor,	আমর,	আমর,	
chalachchitra,	চলচ্চিত্র,	চলচ্চিত্র,	
booponer,	বুপনের,	বপনের,	
foreks,	ফোরককস,	ফরেক্স,	
aqram,	আকরাম,	আকরাম,	
abhidhaner,	অভিধানের,	অভিধানের,	
blacq,	ব্ল্যাক,	ব্ল্যাক,	
rajshri,	রাজশ্রী,	রাজশ্রী,	
asommoti,	অসম্মতি,	অসম্মতি,	
michir,	মিচির,	মিচির,	
dokanei,	দোকানেই,	দোকানেই,	
yathaarthabhaabe,	যথার্থভাবে,	যথার্থভাবে,	
samyuktha,	সম্যুক্ষ,	সামিউক্তা,	
mitrata,	মিত্রাটা,	মিত্রতা,	
sookkho,	সুক্ষ,	সুক্ষ্ম,	
bijito,	বিজিত,	বিজিত,	
ase,	আসে,	আসে,	
noiteek,	নৈতিক,	নৈতিক,	
dologuloo,	দলগুলোও,	দলগুলোও,	
sumoo,	সুমু,	সুমো,	
itostatah,	ইত্স্তাাঃ,	ইতস্ততঃ,	
bhyaatikaner,	ভ্যাটিকানের,	ভ্যাটিকানের,	
akkaas,	আক্কাস,	আককাস,	
nagorikderkey,	নাগরিকদেরকেই,	নাগরিকদেরকে,	
fevarite,	ফেভারিতে,	ফেভারিট,	
sanghitar,	সংঘীতার,	সংহিতার,	
scoore,	স্কোর,	স্কোর,	
gandhikey,	গান্ধিকে,	গান্ধীকে,	
mohajot,	মহাযত,	মহাজোট,	
parisankhanvid,	পরিসংখ্যানবিদ,	পরিসংখ্যানবিদ,	
turky,	টার্কি,	তুর্কি,	
salmanul,	সল্মানুল,	সালমানুল,	
kraim,	ক্রেইম,	ক্রাইম,	
land,	ল্যান্ড,	ল্যান্ড,	
sanaktokaran,	সন্কককারণ,	সনাক্তকরণ,	
baugey,	বাগে,	বাগে,	
hafsa,	হাফসা,	হাফসা,	
dijmarescu,	ডিজমারসেকু,	দিজমার্সাকু,	
aflatoxin,	আফ্লাটক্সিন,	আ্যফ্ল্যাটক্সিন,	
graambasheeo,	গ্রামবাসীও,	গ্রামবাসীও,	
saainyo,	সাইন্য,	সৈন্য,	
somratra,	সম্রাত্র,	সম্রাটরা,	
uponeesoder,	উপনিসদের,	উপনিষদের,	
shansthaner,	শানস্থানের,	সংস্থানের,	
khabarsoho,	খাবারসহ,	খাবারসহ,	
votarer,	ভোটারের,	ভোটারের,	
satarka,	সতর্ক,	সতর্ক,	
veenish,	ভেনিশ,	ভেনিস,	
osamarik,	ওসামারিক,	অসামরিক,	
shringa,	শ্রিংগা,	শৃঙ্গ,	
liseensee,	লিসেন্সি,	লাইসেন্স,	
jyaqa,	জ্যাক,	জ্যাক,	
billaho,	বিল্লাহ,	বিল্লাহ,	
samley,	স্যামলি,	সামলে,	
mehsus,	মেহসুস,	মেহসুস,	
rotheen,	রোথেন,	রথীন,	
adbhanced,	অ্যাডভান্ডে,	অ্যাডভান্সড,	
odeb,	ওদেব,	ওদেব,	
karmoi,	কারমোই,	কর্মই,	
joubanbatee,	যৌববানাত,	যৌবনবতী,	
ship,	শিপ,	শিপ,	
heteler,	হেটেলের,	হেটেলের,	
bbosben,	ব্ববসেন,	বসবেন,	
bizito,	বিজিত,	বিজিত,	
romarder,	রোমার্ডের,	রোমারদের,	
utpatti,	উৎপাত্তি,	উতপত্তি,	
plate,	প্লেট,	প্লেটে,	
mohammadi,	মোহম্মদি,	মুহাম্মদী,	
utotoro,	উততর,	উততর,	
champa,	চ্যাম্পা,	চাঁপা,	
residence,	রেসিডেন্সে,	রেসিডেন্স,	
karima,	কারিমা,	করিম,	
asamanyo,	অসামায্য,	অসামান্য,	
chhuti,	ছুটি,	ছুটি,	
firozapure,	ফিরোজপুরে,	ফিরোজাপুরে,	
chakti,	চাক্তি,	চাকতি,	
stoic,	স্টোয়াক,	স্টোয়িক,	
rubidium,	রুবিদিয়াম,	রুবিডিয়াম,	
breq,	ব্রেক,	ব্রেক,	
station,	স্টেশন,	ষ্টেশন,	
nili,	নিলি,	নিলি,	
tigmanshu,	টিগমানশু,	তিগ্মাংশু,	
bamon,	বামোন,	বামন,	
lettere,	লেটারে,	লেটারে,	
pronoti,	প্রণতি,	প্রণতি,	
bandhan,	বানধান,	বাঁধন,	
taronee,	তারণী,	তরণী,	
mulyayonsapekkhe,	মূল্যসয়ককার্শেকে,	মূল্যায়নসাপেক্ষে,	
holuder,	হলুদের,	হলুদের,	
somraat,	সম্রাট,	সম্রাট,	
kinto,	কিন্তো,	কিনত,	
aireshe,	আইরেশে,	আইরেসে,	
europia,	ইউরোপিয়া,	ইউরোপিয়া,	
kagbeni,	কাগবেনী,	কাগবেনি,	
rohosyo,	রোহ্য,	রহস্য,	
oyebjin,	ওয়েবজিন,	ওয়েবজিন,	
brojomohun,	ব্রমমাহন,	ব্রোজোমোহন,	
change,	চাঙ্গে,	চেঞ্জ,	
summer,	সামার,	সামার,	
hyaloyin,	হ্যালোই়ন,	হ্যালোইন,	
chaudhuriyo,	চৌধুরীয়,	চৌধুরীও,	
ghoshanapatratio,	ঘোষণাপত্রটিও,	ঘোষণাপত্রটিও,	
soketgulor,	সোকেটগুলোর,	সকেটগুলোর,	
khoor,	খুর,	ক্ষুর,	
diniphition,	ডাইনিফিশন,	ডেফিনেশন,	
byatari,	ব্যাটারি,	ব্যাটারী,	
achintyabhedaved,	অচিন্যভ্যাদেবেদ,	অচিন্ত্যভেদাভেদ,	
teemothy,	টেমথি,	টিমোথি,	
medilek,	মেডিলেক,	মেডিলেক,	
bhittitei,	ভিত্তিতেই,	ভিত্তিতেই,	
bhiktara,	ভিকটারা,	ভিক্টর,	
ddebet,	ডেডিতেট,	ডিবেট,	
dhanijomite,	ধনিজমিতে,	ধানিজমিতে,	
ghoomachhilo,	ঘুমাছিল,	ঘুমাচ্ছিল,	
parking,	পার্কিং,	পার্কিং,	
teennis,	তেনিস,	টেনিস,	
shommotite,	সম্মতিতে,	সম্মতিতে,	
plato,	প্ল্যাট,	প্লেটো,	
sarollo,	সাোলো,	সারল্য,	
mayily,	মেয়িলি,	মাইলি,	
mashtarsha,	মাষ্টার্শ,	মাস্টার্স,	
korush,	করুশ,	ক্রুশ,	
keu,	কেউ,	কেউ,	
bandhano,	বাঁধানো,	বাঁধানো,	
tolemy,	টোলেমি,	টলেমির,	
toki,	টকি,	তকি,	
harbore,	হার্বোর,	হারবারে,	
shit,	সিট,	শীত,	
agomone,	আগমনে,	আগমনে,	
with,	উইথ,	ভিত,	
chhotogolper,	ছোটগল্পের,	ছোটগল্পের,	
nichols,	নিকোলস,	নিকলস,	
danakana,	দানাকানা,	ডানকান,	
aairish,	আইরিশ,	আইরিস,	
sausagee,	সৌগসী,	সসেজ,	
shikh,	শিখ,	শিখ,	
ujbekistaner,	উজবিকেনস্তানের,	উজবেকিস্তানের,	
patochitra,	পটটোিত্র,	পটচিত্র,	
sotorkobhabey,	সতর্কভাবে,	সতর্কভাবে,	
falak,	ফালাক,	ফলক,	
dianes,	ডিয়ানিস,	ডিএনএস,	
indra,	ইন্দ্রা,	ইন্দ্র,	
miraclee,	মিরাকলি,	মিরাকেল,	
sayanaida,	সায়নাদা,	সায়ানাইড,	
shangkalonti,	সংকলন্তি,	সংকলনটি,	
skirt,	স্কির্ট,	স্কার্ট,	
madhnagar,	মাধনগর,	মাধনগরের,	
satarkakari,	সতর্ককারী,	সতর্ককারী,	
chinito,	চিনিতো,	চিনতো,	
shalook,	শালুক,	শালুক,	
cholocchitrer,	চলচ্চিত্রের,	চলচ্চিত্রের,	
ronangane,	রোনাঙ্গানে,	রণাঙ্গনে,	
drishyer,	দৃশ্যের,	দৃশ্যের,	
bouddho,	বৌদ্ধ,	বৌদ্ধ,	
pooshti,	পুষ্টি,	পুষ্টি,	
keuoi,	কেওই,	কেউই,	
iksaprishana,	এক্সপ্রিশন,	এক্সপ্রেশন,	
bishesyo,	বিশেষ্য,	বিশেষ্য,	
nutan,	নুতান,	নূতন,	
moshzidtike,	মোশজিদটিকে,	মসজিদটিকে,	
abheedhaaneeck,	অভিধানিক,	অভিধানিক,	
philipiner,	ফিলিপিনের,	ফিলিপাইনের,	
hitlere,	হিটলারে,	হিটলারে,	
lyaanding,	লায়ান্ডিং,	ল্যান্ডিং,	
bunot,	বুনোট,	বুনট,	
ispredsiit,	ইসপ্রেডিসটিস,	স্প্রেডশীট,	
charger,	চার্গের,	চার্জার,	
polashir,	পোলাশির,	পলাশীর,	
modhumotii,	মধুমতিই,	মধুমতী,	
oxfordey,	অক্সফোর্ডে,	অক্সফোর্ডে,	
munjur,	মুঞ্জুর,	মুনজুর,	
backflipe,	ব্যাকফ্লেপ,	ব্যাকফ্লিপে,	
ghamta,	ঘামটা,	ঘোমটা,	
shringey,	শ্রিংগে,	শৃঙ্গে,	
santaa,	সান্তা,	সান্তা,	
mekong,	মেকং,	মেকং,	
sipa,	সিপ,	শিপ,	
sohinsotar,	সোহিনসতার,	সহিংসতার,	
poderthobid,	পদের্থবিদ,	পদার্থবিদ,	
aembed,	এ্বাইবেড,	এম্বেড,	
bujhechhila,	বুঝেওছিল,	বুঝেছিল,	
lisense,	লিসেন্স,	লাইসেন্স,	
protizogiita,	প্রতিজোগিততা,	প্রতিযোগীতা,	
poketchorder,	পকেতচরদের,	পকেটচরদের,	
kash,	কাশ,	কাস,	
rudiger,	রুদিগের,	রুদিগের,	
laesensh,	লেয়েসেং,	লাইসেন্স,	
lettar,	লেট্টার,	লেটার,	
arasie,	আরাসি,	আরসিএ,	
chirkut,	চিরকুট,	চিরকুট,	
bonsho,	বন্শ,	বংশ,	
torabgonj,	তরাবগঞ্জ,	তোরাবগঞ্জ,	
bhimsenkei,	ভীমসেনকেই,	ভীমসেনকেই,	
sukumaree,	সুকুমারী,	সুকুমারী,	
mookhomandoler,	মুখমন্ডলের,	মুখমণ্ডলের,	
nagorikra,	নাগরিকরা,	নাগরিকরা,	
lutheerana,	লুথিরানা,	লুথেরান,	
aaireshe,	আইরেশে,	আইরেসে,	
ceramicer,	সেরামিসের,	সিরামিকের,	
bokahoke,	বোকাহোকে,	বকাহকে,	
shilver,	শিলভের,	সিলভার,	
gandagol,	গান্ডাগোল,	গন্ডগোল,	
morathee,	মরাথী,	মরাঠি,	
shahidputra,	শহিদপুত্র,	শহীদপুত্র,	
upobaasee,	উপবাসী,	উপবাসী,	
turbiner,	টারবিনের,	টারবাইনের,	
sthapona,	স্থাপনা,	স্থাপনা,	
bisheshyo,	বিশেষ্য,	বিশেষ্য,	
rahshahi,	রাহশাহী,	রাহশাহী,	
rajtantrey,	রাজতন্ত্রে,	রাজতন্ত্রে,	
monzushree,	মনজুশ্রী,	মঞ্জুশ্রী,	
licencer,	লাইসেন্সের,	লাইসেন্সের,	
chalaabi,	চালাবি,	চালাবে,	
flexta,	ফ্লেস্টটা,	ফ্লেক্সটা,	
sofie,	সোফি,	সোফি,	
suparichito,	সুপারিচিত,	সুপরিচিত,	
palbongser,	পালবংসের,	পালবংশের,	
marketing,	মার্কেটিং,	মার্কেটিং,	
lagchhe,	লাগছে,	লাগছে,	
tep,	টিপ,	ট্যাপ,	
beetloser,	বিটলসের,	বিটলসের,	
dhamshrenite,	ধামশ্রেণীতে,	ধামশ্রেণীতে,	
shoori,	সূরী,	সুরি,	
phising,	ফিসিং,	ফিসিং,	
dhangsachchi,	ধ্বংসচ্চি,	ধ্বংসাচ্ছি,	
kkhur,	কুষুর,	ক্ষুর,	
meghacchonno,	মেঘচ্ছান্ন,	মেঘাচ্ছন্ন,	
prabhritite,	প্রাভৃতিতে,	প্রভৃতিতে,	
graambaasheeo,	গ্রামবাসীও,	গ্রামবাসীও,	
deobonde,	দেওবন্দে,	দেওবন্দে,	
tricksguli,	ট্রিকসগুলি,	ট্রিকসগুলি,	
bosante,	বোসন্তে,	বসন্তে,	
pratool,	প্রাটুল,	প্রতুল,	
obosan,	অবসান,	অবসান,	
shakar,	শাকার,	সকার,	
bosantake,	বসন্তাকে,	বসন্তকে,	
prokolpotike,	প্রকল্পতিকে,	প্রকল্পটিকে,	
irish,	আইরিশ,	আইরিস,	
klaud,	ক্লাউড,	ক্লাউড,	
khiladirao,	খিলাডিরাও,	খিলাড়িরাও,	
darjiling,	ডার্জিলিং,	দার্জিলিং,	
chhootochhuti,	ছোটছুটি,	ছুটোছুটি,	
detik,	ডেটিক,	দেতিক,	
titarer,	তিতারের,	তিতারের,	
akkharkey,	আক্ষরকে,	অক্ষরকে,	
upbasher,	উপবাশের,	উপবাসের,	
digrir,	ডিগ্রির,	ডিগ্রির,	
prosadhaner,	প্রসাধানের,	প্রসাধনের,	
alaoler,	আলাওলের,	আলাওলের,	
neelkamal,	নীলকামাল,	নীলকমল,	
modelkey,	মডেলকে,	মডেলকে,	
giitikobitar,	গীতিকবিতার,	গীতিকবিতার,	
ganoporibahoner,	গণপরিবহণের,	গণপরিবহনের,	
raagei,	রাগেই,	রাগেই,	
mitro,	মিত্রো,	মিত্র,	
corsin,	কর্সিন,	করসিন,	
deraa,	ডিরা,	ডেরা,	
hertj,	হার্টজ,	হার্জ,	
shatoke,	শতকে,	শতকে,	
shahurgulor,	শহুরগুলোর,	শহুরগুলোর,	
chhanada,	ছানাদা,	ছানাদা,	
laagche,	লাগছে,	লাগছে,	
rajnoitik,	রাজনৈতিক,	রাজনৈতীক,	
mukhoshdharir,	মুখোষধারীর,	মুখোশধারীর,	
kindom,	কিন্দম,	কিংডম,	
jamarate,	জামারাতে,	জামারাতে,	
hisaber,	হিসাবের,	হিসাবের,	
dacope,	ডাকোপ,	দাকোপ,	
saalsa,	সালসা,	সালসা,	
plainey,	প্লেইন,	প্লেনে,	
mah,	মাহ,	মাহে,	
bojhaao,	বোঝাও,	বোঝাও,	
qaferder,	কাফেরদের,	কাফেরদের,	
samany,	স্যামানি,	সামান্য,	
nyeta,	নায়েটা,	ম্যাট,	
chakurijibirao,	চাকুরিজীবীরাও,	চাকুরীজীবীরাও,	
dharavahikbhabe,	ধারাভাকীভাবে,	ধারাবাহিকভাবে,	
swostir,	স্বস্তির,	স্বস্তির,	
laaisheesh,	লৈইশ,	লাইসেন্স,	
bufer,	বাফার,	বাফার,	
rodney,	রোডনে,	রেডনি,	
dienes,	ডায়েনিস,	ডিএনএস,	
dokan,	ডোকান,	দোকান,	
prithibir,	পৃথিবীর,	পৃথবীর,	
eekbalke,	ইকবালকে,	ইকবালকে,	
turbine,	টারবিইন,	টারবাইন,	
oshtader,	ওষ্টদের,	ওস্তাদের,	
acrolect,	অ্যাক্রোলেক্ট,	অ্যাক্রোলেক্ট,	
probeshkari,	প্রবেশকারী,	প্রবেশকারী,	
vince,	ভিন্স,	ভিন্স,	
fake,	ফেক,	ফাকে,	
samanyai,	সামা্যই,	সামান্যই,	
chintamani,	চিন্তামণি,	চিন্তামনি,	
niropekshtar,	নিরপেক্ষতার,	নিরপেক্ষতার,	
pothnirdeshona,	পথ্রিন্দেশনা,	পথনির্দেশনা,	
jhumjhumita,	ঝুমঝুমিতা,	ঝুমঝুমিটা,	
wagadada,	ওয়াগাডাড়া,	বাগদাদ,	
megh,	মেঘ,	মেঘ,	
bisheshya,	বিশেষ্য,	বিশেষ্য,	
marmader,	মরমাদের,	মারমাদের,	
badhamuktovabe,	বাধামুক্তভাবে,	বাধামুক্তভাবে,	
ekoghore,	একঘঘরে,	একঘরে,	
noitik,	নৈতিক,	নৈতিক,	
byan,	ব্যান,	ব্যাং,	
modhyekar,	মধ্যেকার,	মধ্যেকার,	
pachchi,	পাচ্ছি,	পাচ্ছি,	
vittimul,	ভিত্তিমূল,	ভিত্তিমূল,	
dharmiyabhabei,	ধর্মীয়ভাবেই,	ধর্মীয়ভাবেই,	
matt,	মাট্ট,	ম্যাট,	
kloud,	কাউল্ড,	ক্লাউড,	
delibhara,	ডেলিভারা,	ডেলিভার,	
akheli,	আখেলি,	আখেলী,	
venuser,	ভেনাসের,	ভেনাসের,	
maila,	মাইলা,	মাইল,	
sompadonkaree,	সম্পাদনকারী,	সম্পাদনকারী,	
mataram,	মাতারাম,	মাতরম,	
obdee,	অব্দী,	অব্দি,	
satyaky,	সত্যক্য,	সাত্যকি,	
registaner,	রেজিস্টানের,	রেগিস্তানের,	
sheets,	শীত,	শীটস,	
sarjur,	সারজুর,	সরযূর,	
akpashe,	আকপাশে,	একপাশে,	
sbajan,	স্বজন,	স্বজন,	
chandrimaa,	চন্দ্রিমা,	চন্দ্রিমা,	
bhejaano,	ভেজানো,	ভেজানো,	
artherer,	আর্থারের,	আর্থারের,	
ramonar,	রামোনার,	রমনার,	
korimkey,	করিমকে,	করিমকে,	
provur,	প্রভুর,	প্রভুর,	
hastantar,	হস্তান্তর,	হস্তান্তর,	
progresh,	প্রোগ্রেশ,	প্রগ্রেস,	
humira,	হুমিরা,	হুমিরা,	
vesselli,	ভেসেল্লি,	ভেসেলি,	
palteche,	পালতেছে,	পাল্টেছে,	
parswer,	পারস্বের,	পার্শ্বের,	
eesa,	ইইএসএ,	আইএএস,	
skolarsip,	স্কোলর্সিপ,	স্কলারশিপ,	
pachattar,	পাঠাত্তর,	পাচাত্তার,	
flirt,	ফ্লার্ট,	ফ্লার্ট,	
karu,	কারু,	কারু,	
somoibo,	সমমোবো,	সমৈব,	
sinaake,	সিনাকে,	সিনাকে,	
booksar,	বুকসার,	বুক্সার,	
rastagulikeo,	রাস্তাগুলিকেও,	রাস্তাগুলিকেও,	
mukhomandaley,	মুখমন্দলে,	মুখমণ্ডলে,	
distance,	ডিসট্যান্স,	ডিসট্যান্স,	
gandharir,	গান্ধারির,	গান্ধারীর,	
tahorir,	তাহরীর,	তাহরীর,	
kushakhali,	কুশাখালি,	কুশাখালি,	
manushsoho,	মানুষসহ,	মানুষসহ,	
kiandi,	কিয়ান্দি,	ক্যান্ডি,	
shudhui,	শুধুই,	শুধুই,	
shtonehenge,	শ্টোহেেেঙ্গে,	স্টোনহেঞ্জ,	
kaathhmaandute,	কাঠমান্ডুতে,	কাঠমান্ডুতে,	
qarqa,	কারকা,	কার্ক,	
bharotchilo,	ভারতচিল,	ভারতছিল,	
uddhrito,	উদ্ধৃত,	উদ্ধৃত,	
shaater,	সাতের,	শ্যুটার,	
evaner,	ইভানের,	ইভানের,	
bhabanipur,	ভবানীপুর,	ভবানীপুর,	
konnoder,	কন্যদের,	কন্যদের,	
safin,	সাফিন,	সাফিন,	
bedanta,	বেদানটা,	বেদান্ত,	
poddhotitei,	পদ্ধতিতেই,	পদ্ধতিতেই,	
fulkapi,	ফুলকাপি,	ফুলকপি,	
ooipoka,	আউপকা,	উইপোকা,	
sangbadmadhyamgulote,	সংবাদমাধ্যমগুলোতে,	সংবাদমাধ্যমগুলোতে,	
foloshrutite,	ফলশ্রুতিতে,	ফলশ্রুতিতে,	
torutoler,	তরুতলের,	তরুতলের,	
sangbadmadhyome,	সংবাদমাধ্যমে,	সংবাদমাধ্যমে,	
narbur,	নারবুর,	নরবুর,	
bitlaser,	বিটলাসের,	বিটলসের,	
bhaisaho,	ভাইসহ,	ভাইসহ,	
senabahineekey,	সেনাবাহিনীকে,	সেনাবাহিনীকে,	
choson,	চোষন,	চোষণ,	
dhanyi,	ধননি,	ধন্যি,	
elaakati,	এলাকাটি,	এলাকাটি,	
kotibondhe,	কতিবন্ধে,	কটিবন্ধে,	
metropalitana,	মেট্রোপলিটাটান,	মেট্রোপলিটন,	
shiropar,	শিরোপার,	শিরোপার,	
concerter,	কনসার্টার,	কানসাটের,	
emerjency,	এমারজেন্সি,	এমার্জেন্সি,	
deaubande,	দেউবা্দে,	দেওবন্দে,	
dewaben,	দেয়াবেন,	দেওয়াবেন,	
quota,	কুওটা,	কোটা,	
ekbakke,	একবাককে,	একবাক্যে,	
dibet,	দিবেত,	ডিবেট,	
krema,	ক্রেম,	ক্রাইম,	
path,	পাথ,	পাথ,	
bairer,	বাইরের,	বাইরের,	
manushe,	মানুষে,	মানুষে,	
palestine,	প্লিস্টাইন,	প্যালেস্টাইনে,	
batistambhatike,	বাতিস্তম্ভটিকে,	বাতিস্তম্ভটিকে,	
foxcon,	ফক্সকন,	ফক্সকন,	
katiusha,	কাটুশ,	কাতিউশা,	
kirke,	কিরকে,	কিরকে,	
valobasen,	ভালোবাসেন,	ভালোবাসেন,	
licencedhari,	লাইসেন্থাদারি,	লাইসেন্সধারী,	
jeher,	জেহের,	জেহের,	
monroe,	মনরো,	মনেরোর,	
prothati,	প্রথাতি,	প্রথাটি,	
tarkareer,	তর্কারীর,	তরকারীর,	
zonsa,	জোনসা,	জোন্স,	
goodamjato,	গুড়াজামাতো,	গুদামজাত,	
ceramiksh,	সেরামিকস,	সিরামিকস,	
zerusaleme,	জেরুসালেমে,	জেরুসালেমে,	
orrgho,	অর্ঘ্,	অর্ঘ্য,	
deenes,	ডিনেস,	দীনেশ,	
nothibhukta,	নথিভুক্ত,	নথিভুক্ত,	
baait,	বাইত,	বাইট,	
srivatsalakshanang,	শ্রীবৎসকলারতং,	শ্রীবৎসলক্ষণং,	
soommo,	সুমোমো,	সুমো,	
shamuker,	শামুকের,	শামুকের,	
niknayman,	নিকনায়মণ,	নিকনেইমান,	
baarnis,	ব্র্নিস,	বার্নিশ,	
ummool,	উম্মুল,	উম্মুল,	
bihar,	বিহার,	বিহার,	
hupile,	হাপিলে,	হুপিলে,	
deefinition,	ডিফিনিইশন,	ডেফিনেশন,	
labonaaktotaar,	লবণনক্ততার,	লবণাক্ততার,	
balaruma,	বালারুমা,	বলরুম,	
sahittekder,	সাহিত্যেদের,	সাহিত্যেকদের,	
byabostho,	ব্যবস্থ,	ব্যাবস্থা,	
lungiti,	লুঙ্গিটি,	লুঙ্গিটি,	
dhangsantup,	ধ্বংসান্তপ,	ধ্বংসন্তুপ,	
prokolpogulikei,	প্রকল্পগুলিকেই,	প্রকল্পগুলিকেই,	
aditisaha,	আদিতিসহ,	অদিতিসহ,	
arthonitir,	অর্থনীতির,	অর্থনীতির,	
rashedul,	রাশেদুল,	রাশিদুল,	
kidambi,	কিদাম্বী,	কিদম্বি,	
anisa,	আনিসা,	আনিস,	
besirbhaagi,	বেসিরভাগী,	বেশিরভাগই,	
otyacharito,	অত্যাচারিত,	অত্যাচারিত,	
lishenshe,	লিশেংশে,	লাইসেন্স,	
oindrila,	ঐন্দ্রিলা,	ঐন্দ্রিলা,	
pyaleshtainer,	প্যালেশ্টাইনের,	প্যালেস্টাইনের,	
kaferder,	কাফেরদের,	কাফেরদের,	
koruna,	কোুনা,	করুণা,	
bidhirnityang,	বিধিরন্তিত্যাং,	বিধির্নিত্যং,	
kanar,	কানার,	কণার,	
gate,	গাতে,	গ্যেটে,	
aamoode,	আমুদে,	আমুদে,	
gabeshonar,	গবেষণার,	গবেষনার,	
suhasini,	সুহাসিনি,	সুহাসিনী,	
segulo,	সেগুলো,	সেগুলো,	
megacaldera,	মেগাকাল্ডারে,	মেগাক্যাল্ডেরা,	
cheekitshar,	চিকিৎসার,	চিকিত্সার,	
bachhaikrito,	বাছাইকৃত,	বাছাইকৃত,	
omkar,	ওমকার,	ওঙ্কার,	
anchalei,	আঁচালেই,	অঞ্চলেই,	
sangbadmadhyame,	সংবাদমাধ্যমে,	সংবাদমাধ্যমে,	
gonona,	গনোনা,	গননা,	
chorban,	চোরবান,	চর্বন,	
siddhantoke,	সিদ্ধান্তকে,	সিদ্ধান্তকে,	
byaboharkareer,	ব্যবহারকারীর,	ব্যবহারকারীর,	
siropa,	সিরোপা,	শিরোপা,	
pranidero,	প্রাণীদেরও,	প্রানীদেরও,	
birishiritey,	বিরিশিরিতে,	বিরিশিরিতে,	
deool,	দেওলু,	দেউল,	
fatakasto,	ফাতাকাস্ত,	ফাটাকেষ্ট,	
tenishe,	টেনিশে,	টেনিসে,	
aamontrito,	আমন্তৃত,	আমন্ত্রিত,	
shumo,	শুমো,	সুমো,	
oporishodhito,	অপরিশিধিত,	অপরিশোধিত,	
bastubad,	বাস্তুবাদ,	বস্তুবাদ,	
rajpur,	রাজপুর,	রাজপুর,	
prothakey,	প্রথাকে,	প্রথাকে,	
apad,	আপাদ,	আপদ,	
shashtra,	সাস্ট্রা,	শাস্ত্র,	
sangkalanti,	সংকল্্ণটি,	সংকলনটি,	
bhalobaas,	ভালোবাস,	ভালোবাসা,	
bulano,	বুলানো,	বুলান,	
nabayug,	নবায়ুগ,	নবযুগ,	
shikkharrthirao,	শিক্ষার্থীররাও,	শিক্ষার্থীরাও,	
harysoner,	হারিসনের,	হ্যারিসনের,	
dhauto,	ধৌত,	ধৌত,	
oiteejye,	ঐতিহ্যে,	ঐতিহ্যে,	
sheshdinti,	শেষদিনটি,	শেষদিনটি,	
adorsho,	আদর্শ,	আর্দশ,	
muradpur,	মুরাদপুর,	মুরাদপুর,	
torunra,	তরুণরা,	তরুণরা,	
simaa,	সিমা,	সীমা,	
asociatis,	এসেসিয়াটিস,	এসোসিয়েটস,	
bajpa,	বাজপা,	বাজপা,	
stagecraft,	স্টেগ্রোক্টাফ,	স্টেজক্রাফট,	
phiksim,	ফিকসিম,	ফিক্সিং,	
laaisens,	লাইসেন্স,	লাইসেন্স,	
pustir,	পুস্তির,	পুষ্টির,	
patishapta,	পতিষপ্ত,	পাটিসাপটা,	
bidghootey,	বিদ্ঘুতে,	বিদঘুটে,	
bowie,	বইয়ে,	বওই,	
postay,	পোস্টা,	পোস্টে,	
habol,	হাবল,	হাবোল,	
orthobochorke,	অর্থবছরকে,	অর্থবছরকে,	
rushod,	রুশদ,	রুশদ,	
mulbhitti,	মূলভিত্তি,	মূলভিত্তি,	
bage,	বাগে,	বাগে,	
nimitte,	নিমিত্বে,	নিমিত্তে,	
banglota,	বাংলোটা,	বাংলোটা,	
harees,	হ্যারিস,	হ্যারিস,	
balabhadra,	বালাভ্রা,	বলভদ্র,	
rajyotiro,	রাজ্যতিরও,	রাজ্যটিরও,	
pracharanamulak,	প্রচারণমূলক,	প্রচারণামূলক,	
asovya,	অসভ্যা,	অসভ্য,	
monjooshree,	মংগুষ্রী,	মঞ্জুশ্রী,	
neerbahe,	নির্বাহে,	নির্বাহে,	
nabatamo,	নবতম,	নবতম,	
milayatane,	মিলায়াতনে,	মিলায়তনে,	
vvimsenn,	ভিভিমসেন,	ভীমসেন,	
sorting,	সর্টিং,	সর্টিং,	
tochhnochh,	তথ্চক,	তছনছ,	
gronthao,	গ্রন্থাও,	গ্রন্থও,	
serveray,	সার্ভারি,	সার্ভারে,	
uposhthit,	উপস্থিত,	উপস্থিত,	
jerusalema,	জেরুসালেমা,	জেরুসালেম,	
annimated,	অ্যানিমেটেড,	এনিমেটেড,	
bejiye,	বেজিয়ে,	বেজিয়ে,	
welaqama,	ওয়েলাকামা,	ওয়েলকাম,	
uchchotara,	উচ্চতারা,	উচ্চতর,	
swartho,	স্বর্থ,	স্বার্থ,	
munshiji,	মুন্সিজি,	মুনশীজি,	
premo,	প্রেমো,	প্রিমো,	
moshjidke,	মোশজীদকে,	মসজিদকে,	
abanishankar,	অবনিশংকর,	অবনিশংকর,	
bikargrosto,	বিকারগ্রস্ত,	বিকারগ্রস্ত,	
srisri,	শ্রীর্ি,	শ্রীশ্রী,	
jontropatigulite,	যন্ত্রপাতিগুলিতে,	যন্ত্রপাতিগুলিতে,	
dakope,	ডাকপপে,	দাকোপ,	
aosafur,	আওসাফুর,	আওশাফুর,	
doorotomo,	দূরতম,	দূরতম,	
latsaheb,	লাতসাহেব,	লাটসাহেব,	
sthaponagulor,	স্থাপনাগুলোর,	স্থাপনাগুলোর,	
average,	এভারেজ,	এভারেজ,	
adhyattikota,	আধ্যাত্মিকতা,	আধ্যাত্মিকতা,	
kamla,	কামলা,	কামলা,	
laaisensh,	লেইসেন্স,	লাইসেন্স,	
chhaikalo,	ছাইকালো,	ছাইকালো,	
daaktikit,	ডাক্তিকিত,	ডাকটিকিট,	
musallati,	মুসল্লাটি,	মুসল্লাটি,	
susamo,	সুসামো,	সুসম,	
argho,	অর্ঘ,	অর্ঘ্য,	
moreecha,	মরিচা,	মরিচা,	
anagarikra,	আনাগারিকরা,	অনাগরিকরা,	
teman,	তেমান,	তেমন,	
chilona,	চিলোনা,	ছিলনা,	
gobeshonar,	গবেষণার,	গবেষনার,	
bhandar,	ভান্ডার,	ভাণ্ডার,	
chirontan,	চিরন্তন,	চিরন্তন,	
manushgulor,	মানুষগুলোর,	মানুষগুলোর,	
cholochchitrake,	চলচ্চিত্রাকে,	চলচ্চিত্রকে,	
oitijhya,	ঐতিহ্যা,	ঐতিহ্য,	
nirapattamulok,	নিরাপত্তামূলক,	নিরাপত্তামূলক,	
bohoodin,	বহুদিন,	বহুদিন,	
somraatra,	সম্রাত্র,	সম্রাটরা,	
sampadoner,	সম্পাদনের,	সম্পাদনের,	
brittakar,	বৃত্তকার,	বৃত্তাকার,	
saarbharti,	সররভর্তি,	সার্ভারটি,	
gingbhalobasen,	গিংভালজেসান,	গিংভালোবাসেন,	
jorury,	জরুরী,	জরূরী,	
godabari,	গোদাবারি,	গোদাবরী,	
pachak,	পাচাক,	পাচক,	
prijon,	প্রিজন,	প্রিজন,	
degree,	ডিগ্রি,	ডিগ্রি,	
gandhike,	গান্ধিকে,	গান্ধীকে,	
opohoron,	অপহরণ,	অপহরন,	
thanvi,	থানভি,	থানভী,	
samanwitovabe,	সামান্িভিতভাবে,	সমন্বিতভাবে,	
engreziteo,	ইংরেজিতেও,	ইংরেজিতেও,	
kobutorer,	কবুতরের,	কবুতরের,	
aalkaatra,	আলকাত্রা,	আলকাতরা,	
daakteekite,	ডাক্তিকীতে,	ডাকটিকিটে,	
esprito,	এস্প্রিত,	এস্পিরিটো,	
ingrejra,	ইংরেজরা,	ইংরেজরা,	
karmokarke,	কর্মকারকে,	কর্মকারকে,	
adhunikkale,	আধুনিক্ষালে,	আধুনিককালে,	
tecno,	টেকনো,	টেকনো,	
paira,	পায়রা,	পাইরা,	
parabortee,	পারাবর্তী,	পরর্বতী,	
grambaaseeder,	গ্রামবাসীদের,	গ্রামবাসীদের,	
zerusalemer,	জেরুসালেমের,	জেরুজালেমের,	
shchalastik,	শ্লাসাক্তিক,	স্কলাস্টিক,	
kusumeshu,	কুসুমেষু,	কুসুমেষু,	
remakri,	রিমাক্রি,	রেমাক্রী,	
vogno,	ভোগ্ন,	ভগ্ন,	
ekla,	একলা,	একলা,	
iqbalke,	ইকবালকে,	ইকবালকে,	
cena,	সেইনা,	সিনা,	
ghumacchilo,	ঘুমাচ্ছিল,	ঘুমাচ্ছিল,	
ispredseet,	ইসপ্রেডশিস্ট,	স্প্রেডশীট,	
bornolikhon,	বর্ণনীলোখন,	বর্ণলিখন,	
chitronattakar,	চিত্রনাট্যাকার,	চিত্রনাট্যকার,	
brail,	ব্রেইল,	ব্রেইল,	
ovarview,	ওভারভেই,	ওভারভিউ,	
shardotsobei,	শার্দোৎসবেই,	শারদোৎসবেই,	
spreedashita,	স্প্রেদশিশটা,	স্প্রেডশীট,	
shaddhi,	শাদ্ধি,	সাধ্বী,	
wedanta,	ওয়াডান্টা,	বেদান্ত,	
site,	সিইট,	সিটে,	
superheroo,	সুপারহিনেরও,	সুপারহিরো,	
rayyaleti,	রাইল্যতে,	রয়্যালটি,	
cholchhee,	চলছি,	চলছে,	
pleena,	প্লেনা,	প্লেন,	
osthisondhi,	অস্থিসন্ধি,	অস্থিসন্ধি,	
ajeejer,	আজীজের,	আজিজের,	
shem,	শেম,	সেম,	
deep,	দীপ,	দীপ,	
raunanganey,	রানাঙ্গনে,	রণাঙ্গনে,	
naagaalyand,	নাগাল্যান্ড,	নাগাল্যান্ড,	
hondooras,	হোন্দুরাস,	হন্ডুরাস,	
prosadhoner,	প্রসাধনের,	প্রসাধনের,	
manatmulak,	মানটমুলক,	মানতমূলক,	
gujob,	গুজব,	গুজব,	
shishupalgarh,	শিশুপলগড়,	শিশুপালগড়ে,	
ray,	রায়ে,	রায়,	
sawam,	সাওয়াম,	সাওম,	
milekhanek,	মিলেখানেক,	মাইলখানেক,	
chai,	ছাই,	ছাই,	
sector,	সেক্টর,	সেক্টর,	
vaphara,	ভফরা,	বাফার,	
muktijuddhojato,	মুক্তিযুদ্ধজাত,	মুক্তিযুদ্ধজাত,	
diiptii,	দীপপ্তিই,	ডেপুটি,	
agomonke,	আগমনকে,	আগমনকে,	
accountdharira,	একাউউন্টধারীরা,	একাউন্টধারীরা,	
ajeeboner,	আজিবনের,	আজীবনের,	
jibanto,	জীবান্ত,	জীবন্ত,	
soceitytey,	সোফেইটেই,	সোসাইটিতে,	
kaia,	কাইয়া,	কায়া,	
bondhukey,	বন্ধুকে,	বন্ধুকে,	
makong,	মাকোং,	মেকং,	
grooth,	গ্রুট,	গ্রোথ,	
ancholtike,	আঁচোলটিকে,	অঞ্চলটিকে,	
eukalyptus,	ইউক্লাপ্পটাস,	ইউক্যালিপ্টাস,	
icelands,	আইসেল্যান্ডস,	আইসল্যান্ডসহ,	
laicenshe,	লেইসেনশে,	লাইসেন্স,	
saqara,	সাকারা,	সাকার,	
modyer,	মড্যের,	মদ্যের,	
vaticaner,	ভ্যাটিকেনার,	ভ্যাটিকানের,	
sollallhu,	সোল্লাহ্লু,	সল্লাল্লাহু,	
pushtee,	পুষ্টি,	পুষ্টি,	
dapadpi,	দপাদপি,	দাপাদপি,	
feemalee,	ফিমালি,	ফিমেল,	
jaaygata,	জাগগাতা,	জায়গাটা,	
ghurte,	ঘুরতে,	ঘুরতে,	
dii,	দিআই,	দিই,	
tomader,	তোমাদের,	তোমাদের,	
bosben,	বসবেন,	বসবেন,	
hood,	হুড,	হুড,	
popaike,	পোপাইকে,	পপাইকে,	
golghare,	গোলঘরে,	গোলঘরে,	
baikalyo,	বাইকাল্য,	বৈকল্য,	
heepatitis,	হেফাটাইটিস,	হেপাটাইটিস,	
ritesh,	রিতেশ,	রিতেশ,	
dormitory,	ডরমিটরি,	ডরমিটরি,	
alonkaran,	আলোককরণ,	অলঙ্করণ,	
shansthagulo,	শাসস্থগুলো,	সংস্থাগুলো,	
lavta,	লাভটা,	লাভটা,	
krishibigyani,	কৃষিবিজ্ঞানী,	কৃষিবিজ্ঞানী,	
grambaasheeo,	গ্রামবাসীও,	গ্রামবাসীও,	
graambaaseer,	গ্রামবাসীর,	গ্রামবাসীর,	
arke,	আর্ক,	আরকে,	
dokaangoolote,	দোকানগুলোতে,	দোকানগুলোতে,	
elakai,	এলাকাই,	এলাকাই,	
moonshi,	মনহী,	মুন্সি,	
armstronz,	আর্মস্ট্রোজ,	আর্মস্ট্রং,	
prakar,	প্রকার,	প্রকার,	
kichutei,	কিছুতেই,	কিছুতেই,	
bipajjanak,	বিপজজনক,	বিপজ্জনক,	
rubidiyaam,	রুবিদিয়াম,	রুবিডিয়াম,	
udvaboney,	উদবাবনে,	উদ্ভাবনে,	
ekhate,	এখাতে,	একহাতে,	
kalnir,	কালনির,	কালনীর,	
durotamo,	দুরতামো,	দূরতম,	
madelim,	ম্যাডিলিম,	মডেলিং,	
rinattak,	ঋণতত্তক,	ঋনাত্মক,	
choritrotakeo,	চরিত্রতাকেও,	চরিত্রটাকেও,	
asaciates,	অ্যাসিয়েটেস,	এসোসিয়েটস,	
drissoke,	দৃশককে,	দৃশ্যকে,	
boshoborti,	বশবর্তী,	বশবর্তী,	
andamana,	আন্দমমন,	আন্দামান,	
ashanka,	আশঙ্কা,	আশংকা,	
ispreedshiit,	ইসপ্রেদশিিট,	স্প্রেডশীট,	
muchi,	মুচি,	মুচি,	
vabaponno,	ভাবাপন্ন,	ভাবাপন্ন,	
bishhnu,	বিষ্ণু,	বিষ্ণু,	
doneta,	ডোনেটা,	ডোনাট,	
faltu,	ফাল্টু,	ফালতু,	
ivil,	আইভিল,	ইভিল,	
aansareer,	আনসারীর,	আনসারীর,	
kanuner,	কানুনের,	কানুনের,	
nirabota,	নিরাবতা,	নিরবতা,	
teamothy,	টিমোথি,	টিমোথি,	
soomita,	সুমিতা,	সুমিতা,	
veniser,	ভেনিসের,	ভেনিসের,	
rajan,	রানান,	রাজন,	
maradeha,	মারােহা,	মরদেহ,	
arsie,	আরসি,	আরসিএ,	
booroon,	বুরুন,	বোরন,	
coons,	কেনস,	কুনস,	
abosan,	অবসান,	অবসান,	
kinenni,	কিনেননি,	কিনেননি,	
karecho,	কারছে,	করেছো,	
saptahokal,	সপ্তাহকাল,	সপ্তাহকাল,	
mitrer,	মিত্রের,	মিত্রের,	
jalbe,	জলবে,	জ্বলবে,	
hul,	হুল,	হুল,	
uporitoler,	উপরিতলের,	উপরিতলের,	
dinara,	দিনারা,	ডিনার,	
nosihote,	নসিহতে,	নসিহতে,	
suiti,	সুইটি,	সুইটি,	
danaqana,	ডানাকানা,	ডানকান,	
horeepur,	হরিপুর,	হরিপুর,	
loombinee,	লুম্বিনি,	লুম্বিনী,	
rakhtokkharone,	রাখতক্ষরণে,	রক্তক্ষরণে,	
gaichhe,	গাইছে,	গাইছে,	
grambaashi,	গ্রামবাশী,	গ্রামবাসী,	
darji,	দার্জি,	দরজি,	
sobche,	সবচে,	সবচে,	
afzol,	আফজল,	আফজল,	
atibiplabi,	অতিবিপ্লবী,	অতিবিপ্লবি,	
khalid,	খালিদ,	খালিদ,	
debdebier,	দেবদেবীর,	দেবদেবীর,	
freekeh,	ফ্রিকেহ,	ফ্রিকেহ,	
sulfatee,	সুলফাতে,	সালফেট,	
sqalastiqa,	স্কলস্তিক,	স্কলাস্টিক,	
chuti,	চুতি,	ছুটি,	
bondhuvabaponyo,	বন্ধুবাবপন্য,	বন্ধুভাবাপন্ন,	
mag,	ম্যাগ,	এমএজি,	
bisnuke,	বিস্াুকে,	বিষ্ণুকে,	
oswastikor,	অস্বাস্তিকর,	অস্বস্তিকর,	
drissogulote,	দৃশসগুলোতে,	দৃশ্যগুলোতে,	
shikhbe,	শিখবে,	শিখবে,	
hypar,	হাইপার,	হাইপার,	
prime,	প্রাইম,	প্রাইম,	
stanahenja,	স্তনাহেজ্জা,	স্টোনহেঞ্জ,	
direqtareta,	ডিরেক্টেটরাটা,	ডিরেক্টরেট,	
shrabastee,	শ্রবস্তি,	শ্রাবস্তী,	
kuhelika,	কুহেলিকা,	কুহেলিকা,	
muchlima,	মুছলিমা,	মুছলিমা,	
lat,	লাত,	লাট,	
setikey,	সেটিকে,	সেটিকে,	
taposgoner,	তাপসগণের,	তাপসগণের,	
sombhobonao,	সম্ভবনাও,	সম্ভবনাও,	
asabhya,	অসভ্য,	অসভ্য,	
baieq,	ব্য়েক,	বাইক,	
mukhomandaler,	মুখমন্দলের,	মুখমণ্ডলের,	
russad,	রুশাদ,	রুশদ,	
uporitaley,	উপরিটেলে,	উপরিতলে,	
venus,	ভেনাস,	ভেনাস,	
aro,	আরও,	আরও,	
baaik,	বাইক,	বাইক,	
langhangulir,	লাঙ্ঘাঙ্গুলির,	লঙ্ঘনগুলির,	
saatzoner,	সাতজনের,	সাতজনের,	
jahara,	জাহারা,	যাহরা,	
pathanatak,	পাঠানাটক,	পথনাটক,	
sarboporee,	সর্বপরী,	সর্বোপরী,	
chakradhare,	চক্রধারে,	চক্রধরে,	
dalee,	ড্লী,	ডালে,	
dembakreeti,	ডেম্বাকৃতি,	ডিম্বাকৃতি,	
flux,	ফ্লাক্স,	ফ্লাস্ক,	
durbhagya,	দুর্ভাগ্য,	দূর্ভাগ্য,	
shubhag,	শুভাগ,	শুভাগ,	
chheher,	ছেহের,	ছেহের,	
echhti,	এখতি,	এছটি,	
swajan,	স্বজন,	স্বজন,	
minilosar,	মিনিলোসার,	মিনিলোসার,	
madeling,	ম্যাডিলিং,	মডেলিং,	
daltagi,	ডালটাগী,	দলত্যাগী,	
vezano,	ভেজানো,	ভেজানো,	
iraner,	ইরানের,	ইরানের,	
shainyader,	শৈন্যদের,	সৈন্যদের,	
ponchashjon,	পঞ্চাশজন,	পঞ্চাশজন,	
tyapa,	ত্যাপা,	ট্যাপ,	
pratisthanik,	প্রতিষ্ঠানিক,	প্রাতিষ্ঠানিক,	
kormoi,	কর্মই,	কর্মই,	
taderek,	তাদেরেক,	তাদেরেক,	
sorano,	সোরানো,	সরানো,	
chhutir,	ছুটির,	ছুটির,	
inziniyarsa,	ইনজিনিয়ারসা,	ইঞ্জিনিয়ার্স,	
cheenja,	চেঞ্জজা,	চেঞ্জ,	
jonee,	জোন,	জনি,	
nehle,	নেহলে,	নেহলে,	
kartona,	কার্নোন,	করতনা,	
toroonra,	তোরুরা,	তরুণরা,	
bodhirota,	বোধিরতা,	বধিরতা,	
ajuhat,	অজুহাত,	অজুহাত,	
reshidensha,	রেশিদেনশা,	রেসিডেন্স,	
proshadhoner,	প্রশাধনের,	প্রসাধনের,	
soundarja,	সৌন্দর্য্য,	সৌর্ন্দয্য,	
ashamarthita,	অশামার্থিত,	অসমর্থিত,	
shikkharthirao,	শিক্ষার্থীরাও,	শিক্ষার্থীরাও,	
bhogno,	ভোগন,	ভগ্ন,	
horash,	হোরাশ,	হোরাস,	
carzar,	কারজার,	চার্জার,	
matorom,	মাতোরম,	মাতরম,	
oedipus,	ওডিপাস,	ইডিপাস,	
cholchhe,	চলছে,	চলছে,	
kirti,	কীর্তি,	কীর্তি,	
nikate,	নিকাতে,	নিকটে,	
karaa,	কারা,	কারো,	
yak,	যাক,	ইয়াক,	
spenser,	স্পেনসের,	স্পেন্সার,	
chasee,	চাষে,	চেস,	
shhashtra,	সাস্ট্রা,	শাস্ত্র,	
naajii,	নাজিই,	নাত্সি,	
durgatsob,	দুর্গাতস,	দুর্গোৎসব,	
ebham,	এভাম,	ইভিএম,	
chikittsar,	চিকিত্সার,	চিকিত্সার,	
gaj,	গজ,	গেজ,	
kandy,	কেন্ডি,	ক্যান্ডি,	
abikaul,	আবিকাল,	অবিকল,	
phood,	ফুড,	ফুড,	
antarctika,	আন্তর্ক্তিকা,	অ্যান্টার্কটিকা,	
antarctica,	অ্যান্টারক্টিকা,	অ্যান্টার্কটিকা,	
nariider,	নারীদের,	নারীদের,	
licensin,	লাইসেন্সিন,	লাইসেন্সিং,	
bhotomulyoke,	ভোটমুল্যকে,	ভোটমূল্যকে,	
mandope,	ম্যান্ডপে,	মন্ডপে,	
hariner,	হরিনের,	হরিণের,	
doobate,	দুবাতে,	ডুবাতে,	
poschime,	পশ্চিমে,	পশ্চিমে,	
geographics,	জিওগ্রাফিক্স,	জিওগ্রাফিকস,	
nirvachokder,	নির্ভাচকদের,	নির্বাচকদের,	
bhabotarini,	ভবতারিণী,	ভবতারিণী,	
sponsorshipe,	স্পন্সরশিপে,	স্পন্সরশীপে,	
antorvukta,	আন্তর্ভূক্ত,	অন্তর্ভুক্ত,	
talgachh,	তালগাছ,	তালগাছ,	
shiter,	শিতের,	শীতের,	
bhorkendra,	ভররকেন্দ্র,	ভরকেন্দ্র,	
projanankal,	প্রজাননকাল,	প্রজননকাল,	
bairey,	বায়ের,	বাইরে,	
sanaktakaran,	সনক্তকরণ,	সনাক্তকরণ,	
attacharito,	অ্যাটাচরিত,	অত্যাচারিত,	
rajnikant,	রাজনীকান্ত,	রাজনীকান্ত,	
peerry,	পিরি,	পেরি,	
jones,	জোনেস,	জোন্স,	
bokul,	বকুল,	বকুল,	
catholicder,	ক্যাথলিকদের,	ক্যাথলিকদের,	
transform,	ট্রান্সফর্ম,	ট্রান্সফর্ম,	
niketaner,	নিকেতানের,	নিকেতনের,	
bisnoo,	বিস্নৌ,	বিষ্ণু,	
olympik,	অলিম্পিক,	অলিম্পিক,	
chandanara,	চান্দানারা,	চন্দনারা,	
alaol,	আলাওল,	আলাওল,	
ji,	জিআই,	জি,	
tarunra,	তরুণরা,	তরুণরা,	
ancholgoolote,	অ্যাঙ্চগুলোতে,	অঞ্চলগুলোতে,	
manir,	মানির,	মনির,	
kaansaat,	কানসাত,	কানসাট,	
bonke,	বনকে,	বনকে,	
naazi,	নাজি,	নাত্সি,	
dhila,	ধীলা,	ঢিলা,	
crime,	ক্রেম,	ক্রাইম,	
onchalti,	অঞ্চলটি,	অঞ্চলটি,	
gejetade,	গেজেটাদে,	গেজেটেড,	
jeebnagore,	জীবনাগরে,	জীবননগর,	
krechi,	ক্রেছি,	করেছি,	
gaphiloti,	গ্যাফিলটি,	গাফিলতি,	
steeit,	স্টিইট,	স্টেইট,	
anchalgoolir,	অঞ্চলগুলির,	অঞ্চলগুলির,	
panchadadu,	পঞ্চদদাদু,	পঞ্চাদাদু,	
prachirer,	প্রাচীরের,	প্রাচিরের,	
contemporary,	কনটেমপ্রেরি,	কন্টেম্পোরারি,	
masto,	মাস্ত,	মাস্ত,	
koyeeri,	কয়েরি,	কোয়েরি,	
prakalpatike,	প্রকল্পটিকে,	প্রকল্পটিকে,	
siddhanter,	সিদ্ধান্তের,	সিদ্ধান্তের,	
degreeo,	ডিগ্রিও,	ডিগ্রিও,	
spreadshiit,	স্প্রেডশিশট,	স্প্রেডশীট,	
malinga,	মালিঙ্গা,	মালিংগা,	
panchasjan,	পঞ্চসজন,	পঞ্চাশজন,	
cathalic,	ক্যাথালিক,	ক্যাথলিক,	
omanisa,	ওমানিসা,	অমানিশা,	
hevy,	হেভি,	হেভি,	
satarkabhabey,	সতর্কভাবে,	সতর্কভাবে,	
jwar,	জ্বর,	জ্বর,	
kormokarer,	কর্মকারের,	কর্মকারের,	
atorkitey,	আতরকীতে,	অতর্কিতে,	
daktikit,	ডাক্তিকিত,	ডাকটিকিট,	
naneer,	নানির,	নানীর,	
dooburira,	ডুবুরিরা,	ডুবুরিরা,	
edic,	এডিক,	এডিক,	
rakhete,	রাখেতে,	রাখেতে,	
nirbaahe,	নির্বাহে,	নির্বাহে,	
overholing,	ওভারহলিং,	ওভারহোলিং,	
chhooteer,	ছুটির,	ছুটির,	
pragreesa,	প্রাগ্রিসা,	প্রগ্রেস,	
sumeeta,	সুমিতা,	সুমিতা,	
maryir,	মারইির,	ম্যারির,	
proteemar,	প্রতিমার,	প্রতিমার,	
sahachke,	সহচকে,	সাহাচকে,	
bagdadii,	বাগদাদী,	বাগদাদী,	
korimpur,	করিমপুরের,	করিমপুর,	
seshardhe,	শেষার্ধে,	শেষার্ধে,	
bhardwaj,	ভর্দ্বাজ,	ভরদ্বাজ,	
camerapersoner,	ক্যামেরাপারসনের,	ক্যামেরাপার্সনের,	
umb,	উম্ব,	ইউএমবি,	
sucre,	সাক্র,	সাকার,	
paroner,	পারনের,	পারণের,	
golimodhye,	গলিমধ্যে,	গলিমধ্যে,	
neshnosh,	নেশনোষ,	নেশনস,	
ashamorthito,	অশামর্থিত,	অসমর্থিত,	
daybhager,	দায়ভাগের,	দায়ভাগের,	
manober,	মানবের,	মানবের,	
gajiipur,	গজিীপুর,	গাজীপুর,	
pooshteer,	পুষ্টির,	পুষ্টির,	
biswashi,	বিশ্বাসী,	বিশ্বাসী,	
muktilav,	মুক্তিলাভ,	মুক্তিলাভ,	
calabe,	চালাবে,	চালাবে,	
sobchey,	সব্চে,	সবচে,	
sallallahu,	সাল্লাল্লাহু,	সল্লাল্লাহু,	
akeeb,	আকিব,	আকিব,	
ghotol,	ঘটল,	ঘটল,	
parikhar,	পরিখর,	পরিখার,	
nothivuktir,	নথিভুক্তির,	নথিভুক্তির,	
ministara,	মিনিস্তারা,	মিনিস্টার,	
kingsh,	কিংস,	কিংস,	
laaz,	লাজ,	লাজ,	
eporjonto,	এপরজন্ত,	এপর্যন্ত,	
jakso,	জাকসো,	যক্ষ,	
platform,	প্ল্যাটফর্ম,	প্লাটফর্ম,	
shapad,	শাপড়,	শ্বাপদ,	
meshmeshya,	মেশমেশ্য,	মেশহমেশহিইয়া,	
pranibigyani,	প্রাণীবিজ্ঞানী,	প্রাণীবিজ্ঞানী,	
video,	ভিদেও,	ভিডিয়োও,	
cholochchitraeeo,	চলচ্চিত্রায়,	চলচ্চিত্রেও,	
obharbhiu,	অভর্ভী,	ওভারভিউ,	
bohudin,	বহুদিন,	বহুদিন,	
naper,	নাপের,	ন্যাপের,	
byabaharkaree,	ব্যবহারকারী,	ব্যবহারকারী,	
pet,	পিট,	পেত,	
songrahak,	সংগ্রাহক,	সংগ্রাহক,	
spredsheet,	স্প্র্ডশিট,	স্প্রেডশীট,	
shikare,	শিকারে,	শিকারে,	
mimgulor,	মিমগুলোর,	মিমগুলোর,	
spredasita,	স্প্রেডাসিটা,	স্প্রেডশীট,	
neerbahi,	নির্বাহী,	নির্বাহি,	
arthonitite,	আর্থনীতিতে,	অর্থনীতিতে,	
bikargrasta,	বিকারগ্রস্ত,	বিকারগ্রস্ত,	
eexpreession,	এক্সপ্রেশন,	এক্সপ্রেশন,	
kinsha,	কিনশা,	কিংস,	
niemond,	নিয়োম্ন্ড,	নিমন্ড,	
zerusalem,	জেরুসালেম,	জেরুজালেম,	
patengar,	প্টেঙ্গার,	পতেঙ্গার,	
teoner,	তেওনের,	টিওনার,	
review,	রিভইউ,	রিভিউও,	
ralf,	রাল্ফ,	রালফ,	
krom,	কোম,	ক্রম,	
daltyagi,	দল্্্গীগী,	দলত্যাগী,	
bahati,	বাহাটি,	বাহাতি,	
amarjito,	অমর্জিত,	অমার্জিত,	
madhabi,	মাধবী,	মাধবী,	
zubokra,	যুবক্র,	যুবকরা,	
kamti,	কামটি,	কমতি,	
swatantrata,	স্বততন্ত্রটা,	স্বতন্ত্রতা,	
rakim,	রকিিম,	রাকিম,	
rohasyer,	রোহাস্যের,	রহস্যের,	
atighataner,	অতিঘাতানের,	অতিঘটনের,	
mandarbani,	মাদ্দাবানী,	মন্দারবাণী,	
nanabornobishishto,	নানাবর্ববিশিষ্ট,	নানাবর্ণবিশিষ্ট,	
taap,	টাপ,	ট্যাপ,	
melbourner,	মেলবোর্নের,	মেলবোর্নের,	
tarkale,	তর্কালে,	তারকালে,	
kathghera,	কথঘেরা,	কাঠঘেরা,	
chorchita,	চর্চিতা,	চর্চিত,	
touraat,	তৌরাত,	তওরাত,	
marpit,	মারপিট,	মারপিট,	
ghuznavi,	ঘুজনাভি,	গজনভি,	
lopjonito,	লোপজনিত,	লোপজনিত,	
rena,	রেনা,	রেনো,	
install,	ইন্সট্যাল,	ইন্সটল,	
shikara,	শিকারা,	শিকার,	
pradoshik,	প্রাদশিক,	প্রাদশিক,	
houzgulite,	হাউজগুলিতে,	হাউজগুলিতে,	
jamkaalo,	জমমালালো,	জমকালো,	
mozdur,	মোদদুর,	মজদুর,	
murader,	মুরাদের,	মুরাদের,	
sommotitey,	সম্মতিতে,	সম্মতিতে,	
graambaashio,	গ্রামবাসীও,	গ্রামবাসীও,	
telakucha,	তেলাকুচা,	তেলাকুচা,	
kampita,	কাম্পিটা,	কম্পিত,	
milton,	মিলনটন,	মিলটন,	
sthapanagulo,	স্থাপানগুলো,	স্থাপনাগুলো,	
dipankar,	দীপানকর,	দিপঙ্কর,	
onupater,	অনুপাতের,	অনুপাতের,	
soomitrar,	সুমিত্রার,	সুমিত্রার,	
shikhaboudi,	শিখাবুদি,	শিখাবৌদি,	
srk,	স্রাঙ্ক,	শাহরুখ,	
shiulijhra,	শিউলিঝরা,	শিউলিঝরা,	
turista,	তুরিস্তা,	টুরিস্ট,	
dibya,	দিব্য,	দিব্যা,	
hazat,	হাজাত,	হজত,	
purbanchaler,	পূর্বাঞ্চলের,	পূর্বাঞ্চলের,	
aakik,	আকিক,	আকিক,	
peri,	পেরী,	পেরি,	
shitei,	শিতেই,	শীতেই,	
kaande,	কান্ডে,	কাণ্ডে,	
licenshe,	লিইসেন্স,	লাইসেন্স,	
uponishad,	উপনিষাদ,	উপনিষদ,	
taranee,	তরনে,	তরণী,	
ishahak,	ইশাহাক,	ইসাহাক,	
deenesh,	দিনেশ,	দীনেশ,	
firoze,	ফিরোজে,	ফিরোজ,	
maritimer,	মেরিটিমের,	মেরিটাইমের,	
stana,	স্তানা,	স্টোন,	
bhittow,	ভিত্তৌ,	ভিত্তিও,	
hunine,	হুনিন,	হুনাইন,	
batikromi,	বাতিক্রমি,	ব্যতিক্রমী,	
ruby,	রুবি,	রুবী,	
sompadon,	সম্পাদন,	সম্পাদন,	
heawy,	হিয়ে,	হেভি,	
kaley,	কালে,	কালে,	
shkalarashhipa,	স্কলারশাপা,	স্কলারশিপ,	
lyaataa,	ল্যাটা,	ল্যাটা,	
comoros,	কমরোস,	কোমোরোস,	
shikkhartheerao,	শিক্ষার্থীরাও,	শিক্ষার্থীরাও,	
jins,	জিন্স,	জিন্স,	
jothartho,	যথার্থ,	যথার্থ,	
vabuk,	ভাবুক,	ভাবুক,	
helloin,	হেলোয়েন,	হ্যালোইন,	
purohitder,	পুরোহিতদের,	পুরোহিতদের,	
ekspression,	এক্সপ্রেশন,	এক্সপ্রেশন,	
bayii,	বায়েই,	বাঈ,	
sokkhomotabriddhi,	সক্ষমাতবৃদ্ধি,	সক্ষমতাবৃদ্ধি,	
orbeet,	অরবিট,	অরবিট,	
shikkhadikkhay,	শিক্ষাদিক্ষায়,	শিক্ষাদিক্ষায়,	
khanonkaj,	খননকাজ,	খননকাজ,	
abti,	আবতি,	আবতি,	
quary,	কোয়ার,	কোয়েরি,	
koomarir,	কামারির,	কুমারীর,	
beshakbar,	বেশকবার,	বেশকবার,	
vault,	ভাউল্ট,	ভল্ট,	
windows,	উইন্ডাস,	উইন্ডোস,	
syfy,	সিইএফএ,	সাইফাই,	
shasankarta,	শশানকক্রতা,	শাসনকর্তা,	
eura,	ইউরা,	ইউরো,	
sikara,	সিকারা,	শিকার,	
shektor,	শেক্টর,	সেক্টর,	
abhidhanick,	অভিধানিক,	অভিধানিক,	
mast,	মাস্ট,	মাস্ত,	
palkee,	পালকি,	পাল্কি,	
jokkher,	যক্ষের,	যক্ষের,	
eporzonto,	এপরজন্ত,	এপর্যন্ত,	
okkhorke,	অক্ষরকে,	অক্ষরকে,	
teter,	টেটের,	টেটের,	
aziza,	আজিজা,	আজিজা,	
supreetira,	সুপ্রিতিরা,	সুপ্রীতিরা,	
edseler,	এডসেলের,	এডসেলের,	
biplabeer,	বিপ্লবীর,	বিপ্লবীর,	
rasunkunchi,	রাসুনকুচ্ছি,	রসুনকুঁচি,	
dhormokorme,	ধর্মকর্মে,	ধর্মকর্মে,	
providere,	প্রভিদেরই,	প্রভাইডারে,	
kutubuddinke,	কুটুবুদ্দিনকে,	কুতুবুদ্দিনকে,	
ghoshito,	ঘোষিত,	ঘোষিত,	
shasonkarta,	শশসনকর্তা,	শাসনকর্তা,	
ramachandranke,	রামাচন্দ্রনকে,	রামাচন্দ্রনকে,	
farna,	ফার্না,	ফার্ন,	
mausumeo,	মৌসুমেও,	মৌসুমেও,	
zarniz,	জার্নিজ,	জারনিজ,	
mukhamandoler,	মুখমন্ডলের,	মুখমণ্ডলের,	
ghumunoi,	ঘুমুনোই,	ঘুমুনোই,	
jontrototto,	যন্ত্রতত্ত্ব,	যন্ত্রতত্ত্ব,	
plate,	প্লেট,	প্লেট,	
farid,	ফারিদ,	ফরিদ,	
lendal,	লেন্ডাল,	লেন্ডল,	
cholochchitro,	চলচ্ছিত্র,	চলচ্চিত্র,	
distibutor,	ডিস্তিবিটুর,	ডিস্টিবিউটারের,	
edmiral,	এডমিরাল,	এডমিরাল,	
korle,	করলে,	করলে,	
kalirkhal,	কালিরখাল,	কালিরখাল,	
mexicoteo,	মেক্সিকোটেও,	মেক্সিকোতেও,	
nirmankarmisaha,	নির্মাণকারীসহ,	নির্মাণকর্মীসহ,	
chilahaati,	চিলাহাটি,	চিলাহাটি,	
byaboharkarir,	ব্যবহারকারির,	ব্যবহারকারীর,	
chaalaabi,	চালাবি,	চালাবে,	
bishwaashshoi,	বিশ্বাস্খই,	বিশ্বাসই,	
ramantic,	র্যামান্টিক,	রোমান্টিক,	
maailey,	মেইলে,	মাইলে,	
swadesh,	স্বদেশ,	স্বদেশ,	
gara,	গারা,	গোর,	
munim,	মুনিম,	মুনিম,	
iuro,	ইইরুর,	ইউরো,	
ekatitto,	একাতিত্ব,	একাতিত্ব,	
jathartho,	যথার্থ,	যথার্থ,	
shulfate,	শুলফাতে,	সালফেট,	
folleni,	ফলেনি,	ফলেনি,	
bardhitansh,	বার্ধিতানশ,	বর্ধিতাংশ,	
horidwar,	হরিদ্বার,	হরিদ্বার,	
amudey,	আমুদে,	আমুদে,	
sharifpur,	শরিফপুর,	শরিফপুর,	
chirantan,	চিরন্তন,	চিরন্তন,	
bishwaashshke,	বিশ্বশ্্কে,	বিশ্বাসকে,	
moorali,	মুরালী,	মুরলী,	
nathivookto,	নাথিভুক্ত,	নথিভুক্ত,	
ganesh,	গনেশ,	গণেশ,	
shaahaabiike,	সাহাবাইকে,	সাহাবীকে,	
gonesher,	গনেশের,	গণেশের,	
hepatetisa,	হেপেটাটেস,	হেপাটাইটিস,	
byatikrami,	ব্যতিক্রমী,	ব্যতিক্রমী,	
graambaaseeder,	গ্রামবাসীদের,	গ্রামবাসীদের,	
segular,	সেগুলার,	সেগুলোর,	
mukherjee,	মুখের্জি,	মুখার্জী,	
abeganuvutir,	আবেগানুভুতির,	আবেগানুভূতির,	
nagorikke,	নাগরিককে,	নাগরিককে,	
nibirbhabe,	নিবীরভাবে,	নিবিরভাবে,	
varma,	ভার্মা,	ভার্মা,	
seoul,	সিওুল,	সোল,	
tantubayer,	তন্তুবায়ের,	তন্তুবায়ের,	
ponthaar,	পন্থার,	পন্থার,	
agora,	আগররা,	আগোরা,	
bishaashke,	বিষাশকে,	বিশ্বাসকে,	
qarpeta,	করর্পটা,	কার্পেট,	
habsi,	হাবসি,	হাবশী,	
jerusalemer,	জেরুসালেমের,	জেরুজালেমের,	
indrakanan,	ইন্দ্রাকানান,	ইন্দ্রকানন,	
tintir,	তিনটির,	তিনটির,	
uddhritto,	উদ্ধৃত্ব,	উদ্ধৃত,	
jonoikaa,	জনৈকা,	জনৈকা,	
dep,	ডিপ,	ডেপ,	
ardasha,	আর্দাশা,	আর্দশ,	
parther,	পার্থের,	পার্থের,	
arifin,	অ্যাফিরিন,	আরিফিন,	
esasiyetasa,	এসাসিয়েত্সা,	এসোসিয়েটস,	
lakshmir,	লাক্ষ্মীর,	লক্ষ্মীর,	
deefinishion,	ডিফিনশন,	ডেফিনেশন,	
monohputo,	মনোপুত,	মনঃপুত,	
shamshernagar,	শামসেরনগর,	শমশেরনগর,	
nachiketa,	নচিকেতা,	নচিকেতা,	
cloudbook,	ক্লাডটুক,	ক্লাউডবুক,	
brekethru,	ব্রেকেঠরু,	ব্রেকথ্রু,	
safiha,	সাফিহা,	সাফিহা,	
matis,	মাতিস,	ম্যাটিস,	
ovidhanik,	অভিধানিক,	অভিধানিক,	
ishton,	ইশ্তন,	স্টোন,	
tikta,	টিকটা,	তিক্ত,	
konagoolo,	কোনাগুলো,	কণাগুলো,	
senabahinio,	সেনাবাহিনীও,	সেনাবাহিনীও,	
ajijer,	অজিজের,	আজিজের,	
fuss,	ফুস,	ফাস,	
salchak,	সালচক,	সালচাক,	
chinto,	চিন্তো,	চিনতো,	
ganaporibahaner,	গণপরিবীহনের,	গণপরিবহনের,	
doorotaumo,	দূরতাৌমো,	দূরতম,	
dolu,	দোলু,	ডলু,	
juktorashtreo,	যুক্তরাষ্ট্রেও,	যুক্তরাষ্ট্রেও,	
sikkharthirao,	শিক্ষার্থীরাও,	শিক্ষার্থীরাও,	
antorvuktimulak,	আন্তর্ভূতিক্তমূলক,	অন্তর্ভুক্তিমূলক,	
osamanno,	ওসামান্য,	অসামান্য,	
oxforde,	অক্সফোর্ডে,	অক্সফোর্ডে,	
narsinghomgulor,	নার্সিংহোমগুলোর,	নার্সিংহোমগুলোর,	
laishenshim,	লেইশেশ্িম,	লাইসেন্সিং,	
satjaner,	সাতজনের,	সাতজনের,	
rca,	রিএসএ,	আরসিএ,	
augustine,	আগস্টিন,	অগাস্টিন,	
cinematographar,	সিনেমাতোগ্রাফার,	সিনেমাটোগ্রাফার,	
ooipokar,	আউপকার,	উইপোকার,	
lampot,	ল্যাম্পট,	লম্পট,	
highcommissionay,	হিগকম্ভিশনা,	হাইকমিশনে,	
sikkhokder,	শিক্ষকদের,	শিক্ষকদের,	
santoshpore,	সন্তোষ্পরে,	সন্তোষপুর,	
jemy,	জেমি,	জেমি,	
krimlin,	ক্রিমলিন,	ক্রিমলিন,	
patrol,	প্যাটরোল,	পেট্রোল,	
ateetkaale,	আতীকলাে,	অতীতকালে,	
mitroder,	মিত্রোদের,	মিত্রদের,	
tonoo,	তনো,	তনু,	
mitrota,	মিত্রোতা,	মিত্রতা,	
bbiswashi,	ব্বিসবাসী,	বিশ্বাসই,	
ganochien,	গণছিয়েন,	গণচীন,	
proo,	প্রূ,	প্রো,	
rilayensha,	রিলায়েনশা,	রিলায়েন্স,	
bandra,	বাঁদ্্রা,	বন্দীরা,	
kram,	ক্রাম,	ক্রম,	
duryogamoyee,	দুর্যোগয়ীই,	দুর্যোগময়ী,	
nazad,	নাজাদ,	নাজাদ,	
kanthar,	কান্থার,	কাঁথার,	
maailkhanek,	মইলখানেক,	মাইলখানেক,	
gopalrao,	গোপালরাও,	গোপালরাও,	
chapchap,	চাপচাপ,	চাপচাপ,	
rachanakal,	রচনাকাল,	রচনাকাল,	
babona,	বাবোনা,	বাবনা,	
anhu,	আনহু,	আনহু,	
shrichaitanyadev,	শ্রীচৈতন্যদেব,	শ্রীচৈতন্যদেব,	
romnar,	রোমনার,	রমনার,	
nirarthak,	নিরার্থক,	নিরর্থক,	
monzooshree,	মংযুথেরী,	মঞ্জুশ্রী,	
bodhir,	বোধির,	বধির,	
barnis,	বার্নিস,	বার্নিশ,	
pillai,	পিল্লাই,	পিল্লাই,	
graambasi,	গ্রামবাসী,	গ্রামবাসী,	
eesosiyeetasa,	ইসোসিয়িস্টাস,	এসোসিয়েটস,	
tongaa,	টোঙ্গা,	টোঙ্গা,	
airish,	আইরিশ,	আইরিস,	
artilary,	আর্টিলারি,	আর্টিলারি,	
udor,	উদর,	উদর,	
graambaashee,	গ্রামবাশী,	গ্রামবাসী,	
soource,	সাউর্স,	সোর্স,	
zohns,	জোনস,	জন্স,	
torabganj,	তরাবগঞ্জ,	তোরাবগঞ্জ,	
remacry,	রিম্যাক্রি,	রেমাক্রী,	
gondogol,	গণ্ডগোল,	গন্ডগোল,	
ragee,	রাগী,	রাগী,	
ekjoge,	একযোগে,	একযোগে,	
pratijogira,	প্রতিযোগীরা,	প্রতিযোগীরা,	
potka,	পটকা,	পটকা,	
manushti,	মনুষ্টি,	মানুষটি,	
sangasthagulo,	সংস্থাগগুলো,	সংস্থাগুলো,	
biphal,	বিইফল,	বিফল,	
chaaktir,	চাক্তির,	চাকতির,	
niketon,	নিকেতন,	নিকেতন,	
chhutee,	ছুটি,	ছুটি,	
edaningkale,	এডানিকলাে,	ইদানীংকালে,	
katateo,	কাটাতেও,	কাটাতেও,	
porishongkhanbid,	পরিশংখ্যানবিদ,	পরিসংখ্যানবিদ,	
edipass,	এডিপাস,	ইডিপাস,	
nirikh,	নিরিখ,	নিরিখ,	
kayed,	কায়েদ,	কায়েদ,	
nachar,	নাচার,	নাচার,	
footbalarer,	ফুটবালারের,	ফুটবলারের,	
khudhartara,	ক্ষুধার্তারা,	ক্ষুধার্তরা,	
neker,	নেকার,	নেকের,	
eigulor,	এইগুলোর,	এইগুলোর,	
mandape,	মণ্ডপে,	মন্ডপে,	
themekey,	থেমেকে,	থিমকে,	
showtey,	সূতে,	শোতে,	
saifai,	সাইফাই,	সাইফাই,	
bonvumitey,	বনভমুতেতে,	বনভূমিতে,	
aborto,	আবর্ত,	আবর্ত,	
niharkantibabu,	নিহারকান্তবাবু,	নিহারকান্তিবাবু,	
mukhabandha,	মুখবন্ধ,	মুখবন্ধ,	
dokkhinangsho,	দক্ষিণাংশ,	দক্ষিণাংশ,	
bhabaaponno,	ভাবাপন্ন,	ভাবাপন্ন,	
planeti,	প্লেনটি,	প্লেনটি,	
metrikoleshana,	মেট্রিকলেশন,	মেট্রিকোলেশন,	
hansasya,	হাঁসস্য,	হংসস্য,	
songasthaner,	সংস্থানের,	সংস্থানের,	
mishal,	মিশাল,	মিশাল,	
deciliter,	ডিসিলিটের,	ডেসিলিটার,	
nutaner,	নুতানের,	নূতনের,	
dharmantor,	ধর্মান্তর,	ধর্মান্তর,	
korimer,	করিমের,	করিমের,	
attorkite,	অ্যাটর্কটি,	অতর্কিতে,	
gobeshana,	গোবেশান,	গবেষনা,	
shhikara,	শিকারা,	শিকার,	
prashikkhane,	প্রশিক্ষণে,	প্রশিক্ষণে,	
alaul,	আলাউল,	আলাওল,	
giitikobita,	গীতিকবিতা,	গীতিকবিতা,	
treend,	ট্রিন্ড,	ট্রেন্ড,	
plasse,	প্লাসে,	প্লাসে,	
taroni,	তারণী,	তরণী,	
nirikho,	নিরিখো,	নিরিখ,	
seekkharthirao,	শিক্ষার্থীরাও,	শিক্ষার্থীরাও,	
bsnleu,	বিএসএনএলইউ,	বিএসএনএলইইউ,	
chhuteer,	ছুটির,	ছুটির,	
horiddar,	হরিদ্দার,	হরিদ্বার,	
swastir,	স্বস্তির,	স্বস্তির,	
sahapathike,	সহপাঠিকে,	সহপাঠীকে,	
elakatay,	এলাকাটা,	এলাকাতে,	
omarader,	ওমারাদের,	ওমারাদের,	
mohit,	মহিত,	মুহিত,	
nirdesika,	নির্দেসিকা,	নির্দেশিকা,	
azijer,	আজিজের,	আজিজের,	
rohosyoti,	রহস্যটি,	রহস্যটি,	
arg,	আর্গ,	আর্গ,	
nirmankaaj,	নির্মাণকজ,	নির্মাণকাজ,	
uporzon,	উপরজন,	উপার্জন,	
saurce,	সোর্স,	সোর্স,	
pharanyeta,	ফরন্েয়ত,	ফরম্যাট,	
sharthe,	শার্থে,	স্বার্থে,	
aporishodhito,	অপরিশিধিত,	অপরিশোধিত,	
uparjon,	উপার্জন,	উপার্জন,	
kaalaam,	কালাম,	কালাম,	
jubokti,	যুবক্তি,	যুবকটি,	
dalnata,	দাননাটা,	ডালনাটা,	
daraider,	দারাইদের,	দরাইদের,	
sudrissho,	সুদৃশ্,	সুদৃশ্য,	
sanghar,	সংঘার,	সংহার,	
roopdan,	রূপদান,	রুপদান,	
renoo,	রেনু,	রেনো,	
bakhyateet,	ব্যাখ্যতিত,	ব্যাখ্যাতীত,	
chalachchitroke,	চালাচ্ছিত্রকে,	চলচ্চিত্রকে,	
sikha,	সিখা,	শিখ,	
janamukhi,	জনামুখী,	জনমুখী,	
nimnosakkharkari,	নিম্নসাক্ষাকারী,	নিম্নস্বাক্ষরকারী,	
krusher,	ক্রুশের,	ক্রুশের,	
abhidhaanick,	অভিধানিক,	অভিধানিক,	
existing,	এক্সিসটিং,	এক্সিসটিং,	
nirmalata,	নির্মলোত,	নির্মলতা,	
taholo,	তাহোলো,	তাহলো,	
ancholsaha,	অঞ্চলসহ,	অঞ্চলসহ,	
dadapur,	দাদাপুর,	দাদাপুর,	
proshtutkarok,	প্রশ্তাতকারক,	প্রস্তুতকারক,	
komanera,	কোমনেরা,	কমানেরা,	
shasheja,	শাজেজা,	সসেজ,	
ganakantha,	গণকন্ঠ,	গণকণ্ঠ,	
middleton,	মিডলটন,	মিডলটন,	
byepass,	বিয়েপসস,	বাইপাস,	
rajnaiteek,	রাজনৈতিক,	রাজনৈতীক,	
hijrite,	হিজরিতে,	হিজরীতে,	
paab,	পাব,	পাব,	
ansarir,	আনসারীর,	আনসারীর,	
cocaine,	কোকেইন,	কোকেইন,	
mahbunur,	মাহবুনুর,	মাহবুনুর,	
chereche,	চেরেছে,	ছেড়েছে,	
soorsa,	সুরসা,	সোর্স,	
bonorajite,	বনরাজিতে,	বনরাজিতে,	
erythrian,	এরিথ্যিয়ান,	এরিথ্রিয়ান,	
sarsa,	সারসা,	সোর্স,	
aakaabaar,	আকাবার,	আকাবার,	
torunderke,	তরুণদেরকে,	তরুণদেরকে,	
hizriite,	হিজরিইতে,	হিজরীতে,	
shhepha,	শেফ,	শেফ,	
scholarship,	স্কলারশিপ,	স্কলারশিপ,	
vitti,	ভিত্তি,	ভিত্তিই,	
konflict,	কনফ্লিক্ট,	কনফ্লিক্ট,	
hoteltite,	হোটেলটিতে,	হোটেলটিতে,	
mokhmoley,	মোখমলে,	মখমলে,	
ahmed,	আহমেদ,	আহামদ,	
kode,	কোড,	কোড,	
aakaabar,	আকাবার,	আকাবার,	
basturoi,	বাস্তুরই,	বস্তুরই,	
tookrokey,	টুকরোকে,	টুকরোকে,	
sthaponagulo,	স্থাপনাগুলো,	স্থাপনাগুলো,	
choudhurike,	চৌধুরীকে,	চৌধুরীকে,	
karpeter,	কারপেটের,	কার্পেটের,	
dai,	দাই,	দিই,	
ankanshilpe,	অঙ্কনশিল্পে,	অঙ্কনশিল্পে,	
bhoolapuka,	ভুলপাকু,	ভোলাপুক,	
suraaropito,	সুরারপিত,	সুরারোপিত,	
blogarra,	ব্লগাররা,	ব্লগাররা,	
daktickete,	ডাক্টিকেে,	ডাকটিকিটে,	
dharabahikvabe,	ধারাবাহিকভাবে,	ধারাবাহিকভাবে,	
basab,	বাসব,	বাসাব,	
tata,	টাট,	তাতা,	
ucchosito,	উচ্চসিত,	উচ্ছসিত,	
durgatsober,	দুর্গতসবের,	দুর্গোৎসবে,	
gajano,	গানানো,	গজানো,	
postac,	পোস্টাক,	পোস্টকে,	
jyesttha,	জ্যেষ্ঠ,	জ্যেষ্ঠা,	
oichchheek,	আইচ্যিক,	ঐচ্ছিক,	
metropolitan,	মেট্রোপলিটান,	মেট্রোপলিটন,	
jansha,	জানস,	জন্স,	
hugheke,	হুগেকে,	হিউজকে,	
lesense,	লেসেন্স,	লাইসেন্স,	
ekghare,	একঘরে,	একঘরে,	
seebiai,	সেবিয়াই,	সিবিআই,	
injiniyarim,	ইনজিনিয়ামির,	ইঞ্জিনিয়ারিং,	
palta,	পাল্টা,	পালটা,	
rabo,	রাবো,	রব,	
prasadhani,	প্রসাধনী,	প্রসাধনী,	
aachhis,	আশীস,	আছিস,	
sookumari,	সুকুমারি,	সুকুমারী,	
becha,	বেচা,	বেচা,	
sangkoolan,	সংকুলান,	সংকুলান,	
artore,	আর্তরে,	আর্টরে,	
elakaai,	এলাকাই,	এলাকাই,	
chalochchitreei,	চালচ্চিত্রী,	চলচ্চিত্রেই,	
parishram,	পরিষ্রম,	পরিশ্রম,	
ratishilatai,	রাতিশীলতাই,	রতিশীলতায়,	
nikote,	নিকোতে,	নিকটে,	
nisader,	নিসাদের,	নিষাদের,	
dankaan,	ডানকান,	ডানকান,	
dooburir,	ডুবুরির,	ডুবুরির,	
daayitto,	দায়িত্ব,	দায়িত্ব,	
varote,	ভারোতে,	ভারতে,	
sumita,	সুমিতা,	সুমিতা,	
siqh,	সিখ,	শিখ,	
kuttake,	কুট্টাকে,	কুত্তাকে,	
nirvachaker,	নির্বাচকের,	নির্বাচকের,	
louhojato,	লৌহজাত,	লৌহজাত,	
kul,	কুল,	কুল,	
atmabishvashi,	আত্মবিশ্বাসী,	আত্মবিশ্বাসী,	
suparharo,	সুপারহারোর,	সুপারহিরো,	
thechar,	থেচার,	থ্যাচার,	
shabkam,	শবকম,	শবকাম,	
thailandsaho,	থাইলানসদাসহ,	থাইল্যান্ডসহ,	
gotihin,	গতিহীন,	গতিহীন,	
impaction,	ইমপ্যাকশন,	ইমপ্যাকশন,	
matrirup,	মাতৃরূপ,	মাতৃরূপ,	
sontoshpur,	সন্তোষপুর,	সন্তোষপুর,	
ardasho,	আরদাসো,	আর্দশ,	
steen,	স্টিন,	স্টেন,	
anchalo,	আঁচালো,	অঞ্চলও,	
chat,	ছাত,	চ্যাট,	
taffsherer,	তাফশারের,	তাফসীরের,	
samaptir,	সমপ্্টির,	সমাপ্তির,	
wictor,	উইক্টর,	ভিক্টর,	
firoza,	ফিরোজা,	ফিরোজা,	
ghumachhe,	ঘুমাছে,	ঘুমাচ্ছে,	
oitijjo,	ঐতিহ্য,	ঐতিহ্য,	
tinage,	তিনাগে,	টিনেজ,	
nottee,	নট্ট,	নোটটি,	
keyboarder,	কেববোর্ডের,	কীবোর্ডের,	
alpakichudin,	অল্পকিচিদিন,	অল্পকিছুদিন,	
saabyastha,	সব্যস্থ,	সাব্যস্থ,	
vogiroth,	ভগুরত,	ভগীরথ,	
dipke,	ডিপকে,	দ্বীপকে,	
amar,	আমার,	আমর,	
naubom,	নাউবম,	নবম,	
anyarup,	অন্যাূপ,	অন্যরূপ,	
gej,	গেজ,	গেজ,	
bhujangta,	ভুজঙ্গটা,	ভুজঙ্গটা,	
braqe,	ব্রেক,	ব্রেক,	
sahojatprobritti,	সহযাত্রবৃত্তিটি,	সহজাতপ্রবৃত্তি,	
saoum,	সুইও,	সাওম,	
shakara,	সাকারা,	সাকার,	
adarsho,	আদার্শ,	আর্দশ,	
bapio,	বাপিও,	বাপিও,	
shlok,	শ্লোক,	শ্লোক,	
chittronatyokar,	চিত্রনাট্যকার,	চিত্রনাট্যকার,	
selim,	সেলিম,	সেলিম,	
lagto,	লাগতো,	লাগতো,	
motkey,	মটকে,	মতকে,	
ranangone,	রানাঙ্গনে,	রণাঙ্গনে,	
treebhuj,	ত্রিভুজ,	ত্রিভূজ,	
bhagnekeo,	ভাগনেকেও,	ভাগ্নেকেও,	
enginiiring,	ইঞ্জিনিয়ারিং,	ইঞ্জিনিয়ারিং,	
headquartus,	হেডকার্রাস,	হেডকোয়ার্টাস,	
rajotta,	রাজোত্তা,	রাজত্ব,	
krisenter,	ক্রিসেন্টার,	ক্রিসেন্টের,	
peeri,	পীরি,	পেরি,	
modelgulo,	মডেলগুলো,	মডেলগুলো,	
beshyasdone,	বেশ্যাসনদে,	বেশ্যাসদনে,	
ispredsheet,	ইস্প্রেশটি,	স্প্রেডশীট,	
mookhomaundoler,	মুখোমান্ডলের,	মুখমণ্ডলের,	
ponchaashjon,	পঞ্চাশযোন,	পঞ্চাশজন,	
dhyana,	ধ্যানা,	ধ্যান,	
ganosochetonota,	গণসচেতনতা,	গণসচেতনতা,	
donat,	ডোনাট,	ডোনাট,	
byabaharkareederke,	ব্যবহারকারীদেরকে,	ব্যবহারকারীদেরকে,	
ujobekeestaner,	উজবেকিন্তানের,	উজবেকিস্তানের,	
mumtaj,	মুমতাজ,	মুমতাজ,	
gotirodh,	গতিরোধ,	গতিরোধ,	
motke,	মোটকে,	মতকে,	
bosonte,	বসন্তে,	বসন্তে,	
naabbota,	নাব্বতা,	নাব্যতা,	
fol,	ফোল,	ফল,	
abheedhanik,	অভিধানিক,	অভিধানিক,	
jamjomat,	জামজমাত,	জমজমাট,	
boner,	বনের,	বনের,	
provritike,	প্রভ্রিতিকে,	প্রভৃতিকে,	
bhogni,	ভোগনি,	ভগ্নী,	
redcrosser,	রেডক্রসের,	রেডক্রসের,	
bonnopran,	বন্যপ্রাণ,	বন্যপ্রাণ,	
ashok,	আশক,	আশোক,	
nabbata,	নব্বতা,	নাব্যতা,	
raagee,	রাগী,	রাগী,	
kajangale,	কাজনগালে,	কজঙ্গলে,	
anichchi,	অনিচ্ছি,	আনিচ্ছি,	
joisttho,	যয়স্থ,	জ্যৈষ্ঠ,	
bm,	বিএমএম,	বিএম,	
bhabarlaler,	ভবরালালের,	ভবরলালের,	
karmakarke,	কর্মকারকে,	কর্মকারকে,	
uthaney,	উঠানে,	উঠানে,	
parshwer,	পার্শ্বের,	পার্শ্বের,	
shariba,	শরিবা,	শরিবা,	
mooney,	মুনে,	মুনে,	
jiland,	জিলান্দ,	জিল্যান্ড,	
direectoratee,	ডিরেক্টরিট,	ডিরেক্টরেট,	
rokibul,	রোকিবুল,	রকিবুল,	
dito,	দিতো,	দিতো,	
ogovir,	ওগোভির,	অগভীর,	
antercticker,	অ্যান্টারক্টিকের,	অ্যান্টার্কটিকের,	
gaandaas,	গান্দাস,	জ্ঞানদাস,	
norfolk,	নরফলক,	নরফোক,	
karim,	কারিম,	করিম,	
shniper,	শ্নিপের,	স্নাইপার,	
kailashrao,	কৈলাশ্রও,	কৈলাশরাও,	
somonwitobhabey,	সমন্তিভভাবে,	সমন্বিতভাবে,	
kada,	কড়া,	কোডা,	
ganokantha,	গণকান্ঠ,	গণকণ্ঠ,	
marodeho,	মাোোহে,	মরদেহ,	
bboponer,	ব্বপপেনের,	বপনের,	
tigmanshu,	টিগমানশু,	তিগমংশু,	
dharmee,	ধর্মী,	ধর্মী,	
chopol,	চোপোল,	চপল,	
abhijitda,	অভিজিতদা,	অভিজিতদা,	
rubala,	রুবালা,	রুবল,	
protibedokrao,	প্রতিবেদকরাও,	প্রতিবেদকরাও,	
chalochchitrei,	চালচ্ছিত্রেই,	চলচ্চিত্রেই,	
bolvodro,	বলভদ্র,	বলভদ্র,	
bishshaasho,	বিশ্বাসহ,	বিশ্বাসও,	
kheshar,	খেশার,	খেশার,	
probolshoktio,	প্রবলশক্তিও,	প্রবলশক্তিও,	
adwanced,	অ্যাডওয়ান্সড,	অ্যাডভান্সড,	
rajotwo,	রাজত্ব,	রাজত্ব,	
taufik,	তাফিক,	তৌফিক,	
koordira,	কোর্দিরা,	কুর্দিরা,	
upacharjo,	উপাচার্য,	উপাচার্য,	
abdi,	আব্দি,	অব্দি,	
shnaipara,	শ্নাইপারা,	স্নাইপার,	
hena,	হেনা,	হেনা,	
shudhir,	শুধীর,	শুধীর,	
katui,	কাতুই,	কাতুই,	
orthanitike,	অর্থানীতিকে,	অর্থনীতিকে,	
turkamena,	তুর্কমেনা,	তুর্কমেন,	
shef,	শেফ,	শেফ,	
mulor,	মুলোর,	মুলোর,	
paramartha,	পরমার্থ,	পরমার্থ,	
abhirupbabuke,	অভিরূপবাবুকে,	অভিরূপবাবুকে,	
suraaropeeto,	সুরারোপিত,	সুরারোপিত,	
reejideencee,	রিজিডেনিি,	রেসিডেন্স,	
avisongson,	অভিশংসন,	অভিশংসন,	
shloker,	শ্লোকের,	শ্লোকের,	
arashie,	আরাশী,	আরসিএ,	
windos,	উইন্ডস,	উইন্ডোস,	
talaal,	তালাল,	তালাল,	
udbhaboney,	উদ্ভাবনে,	উদ্ভাবনে,	
akten,	আক্তেন,	অকটেন,	
gondhe,	গন্ধে,	গন্ধে,	
dolphiny,	ডলফিনি,	ডলফিনি,	
ahalyar,	অহল্যার,	অহল্যার,	
grahoksebai,	গ্রাহকসেবাই,	গ্রাহকসেবায়,	
bandi,	বন্দী,	বন্দী,	
hamburgey,	হ্যাম্বুগ্রে,	হামবুর্গে,	
conservetion,	কনজারভেশন,	কনসারভেশন,	
purple,	পার্পল,	পার্পেল,	
samratra,	সমর্ত্র,	সম্রাটরা,	
mmadhukkori,	ম্মাধুককরি,	মাধুকরী,	
suhayeler,	সুহায়েলের,	সুহায়েলের,	
soundorjotakei,	সৌন্দর্যতাকেই,	সৌন্দর্যটাকেই,	
badaghat,	বাদাঘাট,	বাদাঘাট,	
nowel,	নোয়েল,	নভেল,	
saria,	সারিয়া,	সরিয়া,	
paripakey,	পরিপাকে,	পরিপাকে,	
auttacharer,	অটোটাচারের,	অত্যাচারের,	
marketin,	মার্কেটিন,	মার্কেটিং,	
angsogrohone,	অংশগ্রহণে,	অংশগ্রহনের,	
tanu,	তানু,	তনু,	
ponjikar,	পঞ্জিকার,	পঞ্জিকার,	
janagononar,	জনগণনোনার,	জনগণনার,	
tistar,	তিস্তার,	তিস্তার,	
madhobeer,	মাধবীর,	মাধবীর,	
directorete,	ডিরেক্টরেট,	ডিরেক্টরেট,	
kaash,	কাশ,	কাস,	
ciima,	সিইমা,	সীমা,	
chouhate,	চৌহাতে,	চৌহাটে,	
batikromshalee,	বাটিক্রমশাল,	ব্যতিক্রমধর্মী,	
prosadhani,	প্রসাধানী,	প্রসাধনী,	
definition,	ডিফিনিশন,	ডেফিনেশন,	
ovidhaner,	অভিধানের,	অভিধানের,	
obosorer,	অবসরের,	অবসরের,	
magar,	ম্যাগার,	মাগার,	
kormoke,	কর্মকে,	কর্মকে,	
morodeho,	মরোদহে,	মরদেহ,	
qyantana,	ক্যান্টন,	ক্যান্টন,	
brindabane,	বৃন্দাবনে,	বৃন্দাবনে,	
poriikkhateo,	পরীক্ষাতেও,	পরীক্ষাতেও,	
dada,	ডাডা,	দাদা,	
chalachchitrer,	চলচ্চিত্রের,	চলচ্চিত্রের,	
directorate,	ডিরেক্টরেট,	ডিরেক্টরেট,	
planea,	প্লেন,	প্লেনে,	
koro,	কোরো,	করো,	
deefinision,	ডিফিনিশন,	ডেফিনেশন,	
jini,	জিনি,	যিনি,	
shringgo,	শ্রংংগ,	শৃঙ্গ,	
jinsa,	জিনসা,	জিন্স,	
gaddaafee,	গড্ডাফ,	গাদ্দাফী,	
chet,	চেট,	চ্যাট,	
ap,	এপিএ,	আপ,	
bipradas,	বিপ্রদাস,	বিপ্রদাস,	
edmeeral,	এডিমারল,	এডমিরাল,	
durgotsabe,	দুর্গতসবে,	দুর্গোৎসবে,	
joones,	জুনেস,	জোন্স,	
karadando,	কারাদান্দো,	কারাদণ্ড,	
elaakate,	এলাকাতে,	এলাকাতে,	
nischitobhabe,	নিশ্চিতভাবে,	নিশ্চিতভাবে,	
choopi,	চুপি,	চুপি,	
nutoner,	নূটনের,	নূতনের,	
kaloniir,	কালোীর,	কালনীর,	
balakarak,	বালাকারাক,	বলকারক,	
yuroo,	যুরু,	ইউরো,	
orthoneeti,	অর্থনীতি,	অর্থনীতির,	
jegulur,	যেগুলুর,	যেগুলুর,	
chandrima,	চন্দ্রিমা,	চন্দ্রিমা,	
avidur,	অভিদুর,	আভিদুর,	
ganoparibahaner,	গণপরিবাহনের,	গণপরিবহনের,	
ghotleyo,	ঘটলেও,	ঘটলেও,	
indro,	ইন্দ্রো,	ইন্দ্র,	
chhatrodiger,	ছাত্রদিগের,	ছাত্রদিগের,	
sikarer,	সিকারের,	শিকারের,	
gobeshokgon,	গবেষকগণ,	গবেষকগণ,	
spredashita,	স্প্রেদশশিত,	স্প্রেডশীট,	
skolastik,	স্কোলস্তিক,	স্কলাস্টিক,	
rajtantro,	রাজতন্ত্র,	রাজতন্ত্র,	
sachetanvabe,	সচেতনভাবে,	সচেতনভাবে,	
ekshoti,	একশতি,	একশোটি,	
bolatkar,	বলাটকার,	বলাৎকার,	
bonbhumi,	বনভুমী,	বনভূমি,	
breqathru,	ব্রেকথেরু,	ব্রেকথ্রু,	
ikboler,	ইকবলের,	ইকবলের,	
tuleche,	তুলেছে,	তুলেছে,	
nagorikota,	নাগরিকোটা,	নাগরিকতা,	
talaa,	টালা,	তালা,	
bhenkates,	ভেঙ্কাতেস,	ভেঙ্কটেশ,	
jerushalema,	জেরুশালেমা,	জেরুসালেম,	
zaire,	জাইরে,	জাইরে,	
protisthar,	প্রতিষ্ঠার,	প্রতিষ্ঠার,	
faase,	ফাসে,	ফাঁসে,	
prachando,	প্রাচণ্ড,	প্রচণ্ড,	
ancholgoolir,	অঞ্চলগুলির,	অঞ্চলগুলির,	
jumlalancer,	জুমলাযাল্যান্সের,	জুমলাল্যান্সার,	
bike,	বিকে,	বাইক,	
halding,	হ্যালদিং,	হোল্ডিং,	
romjaner,	রোমজানের,	রমযানের,	
bossonte,	বসন্তে,	বসন্তে,	
bosano,	বোসানো,	বসানো,	
rockibul,	রকিবুল,	রকিবুল,	
logic,	লজিক,	লজিক,	
parkin,	পারকিন,	পার্কিং,	
unchiyechilo,	উঁচিয়েছিল,	উঁচিয়েছিল,	
rupantarer,	রূপান্তারের,	রুপান্তরের,	
hughkey,	হুগকে,	হিউজকে,	
mumtazer,	মুমতাজের,	মুমতাজের,	
ramnathbabur,	রামনাথবাবুর,	রামনাথবাবুর,	
baganoto,	বাগানোটো,	বাগানত,	
chongar,	চোঙ্গার,	চোঙ্গার,	
bondira,	বন্দিরা,	বন্দীরা,	
dakten,	ডাকতেন,	ডাকতেন,	
mukharji,	মুখর্জি,	মুখার্জী,	
dorun,	দোরুন,	দরুণ,	
phox,	ফক্স,	ফক্স,	
nirbaaho,	নির্বাহ,	নির্বাহ,	
fotanor,	ফতানোর,	ফোটানোর,	
thailandshoho,	থালাইন্ডসহ,	থাইল্যান্ডসহ,	
uindoos,	উইন্ডুস,	উইন্ডোস,	
ixprission,	ইক্সপ্রেশন,	এক্সপ্রেশন,	
khonjena,	খোঁজেনা,	খোঁজেনা,	
saom,	সাওম,	সাওম,	
mercedes,	মারসিসেস,	মার্সেডেস,	
amarika,	আমারিকা,	আমেরিকা,	
pathanirdeshona,	পাঠানের্দেশনা,	পথনির্দেশনা,	
asamorik,	আসামরিক,	অসামরিক,	
licensedhari,	লাইসেন্থাদারী,	লাইসেন্সধারী,	
bisshasyi,	বিশ্বস্যি,	বিশ্বাসই,	
sabrakamer,	সব্রকমের,	সবরকমের,	
taims,	টেইম্স,	টাইমস্,	
natshi,	নাতশি,	নাত্সি,	
emarjensi,	এমারফেন্সি,	এমার্জেন্সি,	
siraju,	সিরাজু,	সিরাজু,	
haris,	হারিস,	হ্যারিস,	
toler,	টোলের,	তালের,	
elakasoho,	এলাকাসহ,	এলাকাসহ,	
mercial,	মার্সিয়াল,	মার্শিয়াল,	
kichudinpar,	কিছুদিনপুর,	কিছুদিনপর,	
janoganonar,	জাোগানোনার,	জনগণনার,	
gafeeloti,	গাফেলটি,	গাফিলতি,	
ernad,	এরদাদ,	এরনাড,	
chal,	চাল,	চাল,	
hock,	হক,	হুক,	
rudrasagar,	রুদ্রসাগর,	রুদ্রসাগরের,	
aranyani,	অরণ্যানী,	অরণ্যানী,	
atmira,	আত্মিরা,	আত্মীরা,	
karmazog,	কার্মাগোজ,	কর্মযোগ,	
poriharsoho,	পরিহারসহ,	পরিহারসহ,	
siima,	সিমাা,	সীমা,	
lahano,	লাহানো,	লাহানো,	
pravritir,	প্রাবৃতির,	প্রভৃতির,	
homshke,	হোমশকে,	হোমসকে,	
samajik,	সামাজিক,	সামাজিক,	
songasthatir,	সংস্থাতারির,	সংস্থাটির,	
spredashiita,	স্প্রেডাশিটা,	স্প্রেডশীট,	
mailkhanek,	মইলখানকে,	মাইলখানেক,	
jomoker,	জমকের,	জমকের,	
mononiitoder,	মনোনিতদের,	মনোনীতদের,	
gannaprakasham,	গণ্যপ্রকাশম,	গন্নাপ্রকাশম,	
chalachchitrotike,	চালাচ্ছিত্রটিকে,	চলচ্চিত্রটিকে,	
amiretus,	আমিরেতাস,	এমিরেটাস,	
emargency,	ইমেরজেন্সি,	এমার্জেন্সি,	
poriskoron,	পরিস্করণ,	পরিষ্করণ,	
baibosthar,	বায়বস্থার,	ব্যবস্থার,	
madhoori,	মধুরি,	মাধুরী,	
informetion,	ইনফরমেশন,	ইনফরমেশন,	
krush,	ক্রুশ,	ক্রুশ,	
sarajibonbyapi,	সররজীবনজ্বী,	সারাজীবনব্যাপী,	
modele,	মডেলে,	মডেলে,	
doloo,	দলু,	ডলু,	
miley,	মিলে,	মিলে,	
felto,	ফেল্টো,	ফেলত,	
purushika,	পুরুষিকা,	পুরুষিকা,	
muhuriganj,	মুহুরীগঞ্জ,	মুহুরীগঞ্জ,	
aaeerese,	আই়েরেস,	আইরেসে,	
pinogbagke,	পিনোগাবাগকে,	পিনগবাগকে,	
mukhyo,	মুখ্য,	মুখ্য,	
mithener,	মিথেনের,	মিথেনের,	
ongkush,	অঙ্কুশ,	অংকুশ,	
udbodhani,	উদ্বোধনী,	উদ্বোধনী,	
volapuk,	ভোলাপুক,	ভোলাপুক,	
bangulzai,	বাঙ্গুলাাই,	বঙ্গুলিজাই,	
macbeth,	ম্যাকবেথ,	ম্যাকবেথ,	
fand,	ফান্দ,	ফান্ড,	
gore,	গোর,	গোর,	
mojdur,	মোদদুর,	মজদুর,	
vaabnake,	ভাব্বানকে,	ভাবনাকে,	
nibeditar,	নিবেদিতার,	নিবেদিতার,	
suchanakal,	সুচানাকাল,	সূচনাকাল,	
jipiusamriddha,	জিপিসিউদ্ধির্,	জিপিউসমৃদ্ধ,	
udbhabaney,	উদ্ভাবনে,	উদ্ভাবনে,	
jitpur,	জিতপুর,	জিতপুরের,	
zesa,	জেস,	জেস,	
liceensee,	লিইসন্সি,	লাইসেন্স,	
bongsho,	বংশ,	বংশ,	
qyapasula,	ক্যাপাসুলা,	ক্যাপসুল,	
tukroke,	টুকরোকে,	টুকরোকে,	
dorgaaho,	দরগাহ,	দরগাহ,	
greep,	গ্রীপ,	গ্রিপ,	
alankorana,	আলাঙকোরা,	অলঙ্করণ,	
gazipur,	গাজীপুর,	গাজিপুর,	
armeenian,	আরমেনিয়ান,	আর্মেনিয়ান,	
shommotir,	সম্মতির,	সম্মতির,	
rupert,	রাপার্ট,	রুপার্ট,	
deilee,	দেইলি,	ডেইলি,	
carlo,	কারল,	কার্লো,	
besooro,	বেসুরও,	বেসুর,	
shomostigoto,	শমস্তিগত,	সমষ্টিগত,	
qredita,	ক্রেডিটা,	ক্রেডিট,	
chalochchitraeer,	চলচ্চিত্রীরা,	চলচ্চিত্রের,	
jeten,	জেতেন,	জেতেন,	
nobotom,	নবতম,	নবতম,	
lutherana,	লুথেরানা,	লুথেরান,	
sweety,	স্বিটি,	সুইটি,	
balithubar,	বালিুুবার,	বালিথুবার,	
shfingtar,	স্ফিংটার,	স্ফিংটার,	
khilaphat,	খিলাফাত,	খিলাফত,	
deepan,	দীপান,	দীপন,	
vange,	ভাঙ্গে,	ভাঙ্গে,	
suraropito,	সুরারপিত,	সুরারোপিত,	
prokolpoti,	প্রকল্পটি,	প্রকল্পটি,	
juktorastrer,	যুক্তরাত্র্রের,	যুক্তরাষ্ট্রের,	
fishing,	ফিশিং,	ফিসিং,	
cuti,	কিউটি,	কিউটি,	
habshi,	হাবশি,	হাবশী,	
palbongsher,	পালবংশের,	পালবংশের,	
masjidke,	মাসজিদকে,	মসজিদকে,	
upobashii,	উপবাশী,	উপবাসী,	
futonta,	ফুটোন্টা,	ফুটন্ত,	
sithilotar,	সিথিলতার,	শিথিলতার,	
dholeshwari,	ধোলেশ্বরী,	ধলেশ্বরী,	
prarthitao,	প্রার্থীতাও,	প্রার্থীতাও,	
qrisenta,	ক্রিসেনটা,	ক্রিসেন্ট,	
dhrubaker,	ধ্রুবাকের,	ধ্রুবকের,	
pyore,	প্য়রে,	পিওর,	
hights,	হাইটস্,	হাইটস,	
shrimoti,	শ্রীমটি,	শ্রীমতি,	
tirmijii,	তির্মিজি,	তিরমিজি,	
lekhaksattwar,	লেখকসত্ত্বার,	লেখকসত্ত্বার,	
quartar,	কোয়ার্টার,	কোয়ার্টার,	
prakalpagulor,	প্রকালপগুলোর,	প্রকল্পগুলোর,	
manibhaijaner,	মািবাইজানের,	মণিভাইজানের,	
poscime,	পশ্চিম,	পশ্চিমে,	
sombhobonaao,	সম্ভবনাও,	সম্ভবনাও,	
miraqela,	মিরাকেলা,	মিরাকেল,	
tachnach,	তাচ্াচ,	তছনছ,	
konistho,	কনিষ্ঠ,	কনিষ্ঠ,	
nirmolotaa,	নির্মলোতা,	নির্মলতা,	
neutrinoo,	নিউট্রিনো,	নিউট্রিনো,	
sanaktokaron,	সন্কককাতরণ,	সনাক্তকরণ,	
saramukhe,	সরমুখে,	সারামুখে,	
bhramarotsab,	ভ্রমরোৎসব,	ভ্রমরোৎসব,	
azimpur,	আজিমপুর,	আজিমপুর,	
dombhoke,	দম্ভকে,	দম্ভকে,	
institutione,	ইন্সটিটিশনে,	ইনস্টিটিউশনে,	
machhti,	মাছটি,	মাছটি,	
manjushri,	মঞ্জুষ্রী,	মঞ্জুশ্রী,	
dhani,	ধানি,	ধানি,	
everage,	এভারেজ,	এভারেজ,	
samajikatar,	সমাজিকতার,	সামাজিকতার,	
aatmobishwasi,	আত্মবিশ্বাসী,	আত্মবিশ্বাসী,	
kazianis,	কাজিয়ানিস,	কাজানিস,	
pader,	পাদের,	প্যাডের,	
ancholsomuho,	অঞ্চলসমূহ,	অঞ্চলসমূহ,	
bongshokey,	বংশকে,	বংশকে,	
gazetted,	গ্যাজেটেড,	গেজেটেড,	
brindaboney,	বৃন্দাবেণী,	বৃন্দাবনে,	
vejjanno,	ভেজ্ঞান্য,	ভেজানো,	
bhenasha,	ভেনাশা,	ভেনাস,	
sayatana,	সায়াতানা,	শয়তান,	
abadamoner,	আবাদামনের,	অবদমনের,	
udbhaboni,	উদ্ভাবনি,	উদ্ভাবনী,	
jyesthaa,	জ্যেষ্ঠা,	জ্যেষ্ঠা,	
bhimsen,	ভীমসেন,	ভীমসেন,	
shten,	শ্টেন,	স্টেন,	
bhabaponno,	ভাবাপন্য,	ভাবাপন্ন,	
somonnitobhabe,	সমনন্তিভভাবে,	সমন্বিতভাবে,	
nodimaatrik,	নদীমাত্রিক,	নদীমাতৃক,	
protinito,	প্রতীনিত,	প্রতিনিত,	
bonvumi,	বনভুমী,	বনভূমি,	
smarok,	স্মারক,	স্মারক,	
dubureer,	ডুবুরির,	ডুবুরির,	
samle,	সামলে,	সামলে,	
boudhher,	বৌধের,	বৌদ্ধের,	
monchostho,	মঞ্চস্থ,	মঞ্চস্থ,	
ghatleo,	ঘাটলেও,	ঘটলেও,	
drissotir,	দৃশ্টির,	দৃশ্যটির,	
banshite,	বানশিতে,	বাঁশিতে,	
sangram,	সংগ্রাম,	সঙ্গ্রাম,	
amontronkarider,	আমন্ত্রণকারীদের,	আমন্ত্রণকারীদের,	
grotha,	গ্রথা,	গ্রোথ,	
bisshas,	বিশ্বাস,	বিশ্বাস,	
ganoporibahon,	গণপরিবাহন,	গণপরিবহন,	
firti,	ফিরতি,	ফিরতি,	
creshcent,	ক্রেশনেন্ট,	ক্রিসেন্ট,	
uddharkarmirai,	উদ্ধারকর্মীরাই,	উদ্ধারকর্মীরাই,	
promothesh,	প্রমথেেশ,	প্রমথেশ,	
fimela,	ফিমলে,	ফিমেল,	
nyata,	ন্যাট,	ম্যাট,	
laaishheshh,	লৈশেখ,	লাইসেন্স,	
jacksonke,	জাকসনকে,	জ্যাকসনকে,	
nadnadeer,	নদনাদির,	নদনদীর,	
azaan,	আজান,	আজান,	
deputy,	ডিপিউটি,	ডেপুটি,	
dhache,	ধাছে,	ধাঁচে,	
kaatbey,	কাটবে,	কাটবে,	
zerusalem,	জেরুসালেম,	জেরুসালেম,	
chiraharit,	চিরাহারিত,	চিরহরিৎ,	
paner,	পানের,	পানের,	
peshto,	পেষ্ট,	পেষ্ট,	
obosore,	অবসরে,	অবসরে,	
bondiira,	বন্ডিরা,	বন্দীরা,	
hari,	হারি,	হরি,	
parjotaker,	পার্যতাকের,	পর্যটকের,	
transformaarer,	ট্রান্সফর্মারের,	ট্রান্সফরমারের,	
madrasa,	মাদরাসা,	মাদ্রাসা,	
biswashi,	বিশ্বাসী,	বিশ্বাসই,	
miitar,	মিইতার,	মিত্র,	
sobrakomer,	সব্রাকমের,	সবরকমের,	
scorey,	স্কোর,	স্কোরে,	
jibnagore,	জীবনাগরে,	জীবননগর,	
pack,	প্যাক,	প্ল্যাক,	
shresthoshcho,	শ্রেষ্ঠস্থ,	শ্রেষ্ঠশ্চ,	
shilpajata,	শিল্পজাতা,	শিল্পজাত,	
oojbekistan,	আজবিকেনস্তান,	উজবেকিস্তান,	
bo,	বোও,	বু,	
jommu,	জম্মু,	জম্মু,	
bhaangchur,	ভাংচুর,	ভাংচুর,	
brake,	ব্রেক,	ব্রেক,	
neshadrabyer,	নেশাদ্রব্যের,	নেশাদ্রব্যের,	
akar,	আকার,	একার,	
godamjato,	গদাজমাত,	গুদামজাত,	
bornanukrome,	বর্ণানুক্রমে,	বর্নানুক্রমে,	
satan,	সাতান,	শয়তান,	
taigara,	টাইগারা,	টাইগার,	
gostigulo,	গোস্টিগুলো,	গোষ্ঠীগুলো,	
mythological,	মাইলটোভিক্যাল,	মাইথলজিকাল,	
motabolombira,	মতাবলম্বিরা,	মতাবলম্বীরা,	
homsher,	হোমশের,	হোমসের,	
nariderke,	নারীদেরকে,	নারীদেরকে,	
jaistho,	যাইস্থ,	জ্যৈষ্ঠ,	
jatinkey,	জাতিনকে,	যতীনকে,	
grambaashio,	গ্রামবাসীও,	গ্রামবাসীও,	
mail,	মাইল,	মাইল,	
shhow,	শু,	শো,	
lendol,	লেন্ডল,	লেন্ডল,	
mandanda,	মা্দন্ড,	মানদণ্ড,	
sahocorje,	সহকর্ে,	সাহচর্যে,	
jatata,	জাতাতা,	যতোটা,	
sohokari,	সোকারি,	সহকারী,	
kings,	কিংস,	কিংস,	
korijachilen,	করিয়াছিলেন,	করিযাছিলেন,	
nirgamon,	নির্গমন,	নির্গমন,	
shomser,	শোমসের,	সমশের,	
graambasio,	গ্রামবাসিও,	গ্রামবাসীও,	
dhaanche,	ধাঞ্চে,	ধাঁচে,	
byaktikegreptar,	ব্যাক্তিকেগ্রস্তের,	ব্যক্তিকেগ্রেপ্তার,	
bibadey,	বিবাদে,	বিবাদে,	
yaak,	যাক,	ইয়াক,	
chire,	চিরে,	চিরে,	
suri,	সুরী,	সুরি,	
olympic,	অলিম্পিক,	অলিম্পিক,	
anchalsaho,	অঞ্চলসহ,	অঞ্চলসহ,	
rajtontre,	রাজতন্ত্রে,	রাজতন্ত্রে,	
dei,	দেই,	দিই,	
gyandaas,	জ্ঞানদাস,	জ্ঞানদাস,	
kayartara,	কয়রাতরা,	কোয়ার্টার,	
bhaibon,	ভাইবন,	ভাইবোন,	
francine,	ফ্রান্সিন,	ফ্রান্সিন,	
afrazuler,	আফরাজুলের,	আফরাজুলের,	
procharona,	প্রচারণা,	প্রচারণা,	
meshintao,	মেশিনটাও,	মেশিনটাও,	
kortam,	করতাাম,	করতাম,	
doula,	ডাউলা,	দৌলা,	
fud,	ফুদ,	ফুড,	
chupani,	চুপানী,	চুপানি,	
pleta,	প্লেট,	প্লেটো,	
tokeo,	টকেও,	টোকেও,	
kiuti,	কিউটি,	কিউটি,	
kormobuddhite,	কর্মবুদ্ধিতে,	কর্মবুদ্ধিতে,	
pratishthanik,	প্রতিষ্ঠানিক,	প্রাতিষ্ঠানিক,	
hooldim,	হুলডিম,	হোল্ডিং,	
jotinkey,	জোটিনকে,	যতীনকে,	
ceramicsh,	সেরামিকস,	সিরামিকস,	
ahalya,	অহল্যা,	অহল্যা,	
korkotkraantee,	কর্কক্তারান্ত,	কর্কটক্রান্তি,	
basaalt,	বসযালাল্ট,	ব্যাসল্ট,	
gazeetteed,	গাযাজিট্রিড,	গেজেটেড,	
bopoon,	বোপুন,	বপন,	
rakshanbhag,	রক্ষংভক,	রক্ষণভাগ,	
enjineers,	এনজিনিয়ারস,	ইঞ্জিনিয়ার্স,	
baibosthaar,	বায়বস্থার,	ব্যবস্থার,	
bhittimul,	ভিত্তিমূল,	ভিত্তিমূল,	
probhura,	প্রভুরা,	প্রভুরা,	
harbur,	হারবুর,	হারবার,	
sikarder,	সিকারদের,	শিকারদের,	
brittakarey,	বৃত্তকারে,	বৃত্তাকারে,	
madhumati,	মধুমতী,	মধুমতী,	
dhanche,	ধানচে,	ধাঁচে,	
shchalastic,	স্চলল্যাস্টিক,	স্কলাস্টিক,	
faaj,	ফজ,	ফাজ,	
hol,	হোল,	হোল,	
trenda,	ট্রেন্ড,	ট্রেন্ড,	
shasankorta,	শাসনকর্তা,	শাসনকর্তা,	
sambhabonao,	সম্ভাবনাও,	সম্ভবনাও,	
sqalarashipa,	স্কলারশিপ,	স্কলারশিপ,	
debholopar,	ডেভোলপার,	ডেভলপার,	
poorohitra,	পুরোহিত্রা,	পুরোহিতরা,	
liedtke,	লিডটেক,	লইডটক,	
jamjamat,	জামজমত,	জমজমাট,	
onker,	অঙ্কার,	ওঙ্কার,	
pratiyogitar,	প্রতিযোগীতার,	প্রতিযোগীতার,	
stonehenje,	স্টোনেহেজ্যে,	স্টোনহেঞ্জ,	
query,	কেরি,	কোয়েরি,	
suchonakal,	সূচনাকাল,	সূচনাকাল,	
pratisthanikvabe,	প্রতিস্থানিকভাবে,	প্রাতিষ্ঠানিকভাবে,	
minishtarer,	মিনিস্তারের,	মিনিস্টারের,	
anchalgulir,	অঞ্চলগুলির,	অঞ্চলগুলির,	
saras,	সররাস,	সরস,	
codeti,	কোডেটি,	কোডটি,	
lutharen,	লুথারেন,	লুথেরান,	
anusthane,	অনুষ্ঠানে,	অনুষ্ঠানে,	
asamonjasyopurno,	আসামঞ্জস্বপূর্ণ,	অসামঞ্জস্যপূর্ণ,	
internship,	ইন্টারন্সিপ,	ইন্টার্নশিপ,	
angkita,	অংকিতা,	অঙ্কিতা,	
vimsen,	ভিমসেন,	ভীমসেন,	
pohnpeic,	পোহপেকিক,	ফোনপেইক,	
chadake,	চড়াকে,	চড়াকে,	
plak,	প্ল্ক,	প্ল্যাক,	
shootar,	সুতার,	শ্যুটার,	
ganosachetanata,	গণসচেতনতাতা,	গণসচেতনতা,	
byaktigotovabeo,	ব্যকক্তিগতভাবেও,	ব্যাক্তিগতভাবেও,	
bone,	বোনে,	বনে,	
nischitobhave,	নিশ্চিতভাবে,	নিশ্চিতভাবে,	
kathla,	কাথলা,	কাঠলা,	
sursur,	সুরসুর,	সুরসুর,	
noditir,	নদীটির,	নদীটির,	
proshikkhane,	প্রশিক্ষানে,	প্রশিক্ষণে,	
upobaashee,	উপবাশী,	উপবাসী,	
chapal,	চাপাল,	চপল,	
marri,	মাররি,	ম্যারি,	
utshahomulok,	উৎসাখামূলক,	উৎসাহমূলক,	
romancha,	রোমাঞ্চা,	রোমাঞ্চ,	
beem,	বিম,	বিম,	
arthanitike,	আর্থনীতিকে,	অর্থনীতিকে,	
granada,	গ্র্নাডা,	গ্র্যানাডা,	
teestar,	তিস্তার,	তিস্তার,	
rakkhanvag,	রক্ষণভাগ,	রক্ষণভাগ,	
ched,	চেদ,	ছেদ,	
nibondhocheler,	নিবন্ধদেরলের,	নিবন্ধছেলের,	
shcholastic,	স্চলাস্টিক,	স্কলাস্টিক,	
udvabani,	উদবাবানী,	উদ্ভাবনী,	
qaro,	কারো,	কারো,	
mumtaz,	মুমতাজ,	মুমতাজ,	
grootha,	গ্রুথা,	গ্রোথ,	
jamanataswarup,	জমানাতস্বরূপ,	জামানতস্বরূপ,	
bhenus,	ভেনুস,	ভেনাস,	
daacktickete,	ডাক্কিটকেতে,	ডাকটিকিটে,	
meshenjar,	মেশেনজার,	মেসেঞ্জার,	
maner,	মানের,	মানে,	
sthapanagulor,	স্থাপাননগুলোর,	স্থাপনাগুলোর,	
fiksing,	ফিকসিং,	ফিক্সিং,	
reliance,	রিলিয়েন্স,	রিলায়েন্স,	
daqop,	ডাকোপ,	দাকোপ,	
jahangirbad,	জাহাঙ্গীরবাদ,	জাহাঙ্গীরবাদ,	
raiji,	রাইজি,	রাইজি,	
goora,	গুরা,	গোর,	
qaferderkey,	কাফেরদেরকে,	কাফেরদেরকে,	
gaichey,	গাইছে,	গাইছে,	
grontho,	গ্রন্থ,	গ্রন্থ,	
prokolpogulor,	প্রকল্পগুলোর,	প্রকল্পগুলোর,	
bitertrate,	বিটারট্রেট,	বাইটারট্রেট,	
dreeshtiheen,	দৃষ্টিহীন,	দৃষ্টিহীন,	
bojhao,	বোঝাও,	বোঝাও,	
duhsthanostho,	দুঃস্নাথস্থ,	দুঃস্থানস্থ,	
ajibon,	অজিবন,	আজীবন,	
gorrer,	গোরের,	গোরের,	
swasthohinotay,	স্বাস্থ্যহীনতায়,	স্বাস্থ্যহীনতায়,	
souripurang,	সৌরিপূর্গ,	সৌরিপুরং,	
jakatke,	জাকাতকে,	যাকাতকে,	
crucer,	ক্রুসের,	ক্রুশের,	
chalachchitrei,	চালচ্ছিত্রেই,	চলচ্চিত্রেই,	
kurdider,	কুরদদিদের,	কুর্দিদের,	
notikotar,	নতিকতার,	নৈতিকতার,	
nirmolota,	নির্মলতা,	নির্মলতা,	
ala,	আলা,	আলা,	
heze,	হেজে,	হেজ,	
aasar,	আসার,	আসর,	
janar,	জানার,	জানার,	
bhuushito,	ভূষিত,	ভূষিত,	
ajuhath,	অযুহাঠ,	অজুহাত,	
ramchander,	রামচন্ডের,	রামচন্দরের,	
innahu,	ইন্নাহু,	ইন্নাহু,	
sachetonvabe,	সচেতনভাবে,	সচেতনভাবে,	
kleentoner,	ক্লিনটটনের,	ক্লিনটনের,	
ajibooner,	অজিবুনের,	আজীবনের,	
adhikartai,	অধিকার্তই,	অধিকর্তাই,	
graminphonor,	গ্রামিফনোোর,	গ্রামীণফোনর,	
hitaishi,	হিতাইি,	হিতৈষী,	
prasadhoni,	প্রাসাধনী,	প্রসাধনী,	
pravura,	প্রভারু,	প্রভুরা,	
bishnoo,	বিষ্ণু,	বিষ্ণু,	
jonomukhi,	জনমুখী,	জনমুখী,	
durgotsab,	দুর্গোৎসব,	দুর্গোৎসব,	
nilkuthir,	নীলকুঠির,	নীলকুঠির,	
samoshtigato,	সামস্তিগত,	সমষ্টিগত,	
buth,	বুথ,	বুথ,	
ssahocorze,	সাহকর্জে,	সাহচর্যে,	
pratiyogita,	প্রতিযোগীতা,	প্রতিযোগীতা,	
vedanta,	বেদানটা,	বেদান্ত,	
qor,	কোর,	কর,	
fansi,	ফ্যান্সি,	ফাঁসী,	
osthishondhi,	অস্থিশন্ধি,	অস্থিসন্ধি,	
ghotleo,	ঘটলেও,	ঘটলেও,	
sthitiko,	স্থিতিকো,	স্থিতিকো,	
nischoy,	নিশ্চয়,	নিশ্চয়,	
cn,	সিএনও,	সিএন,	
durgotshob,	দুর্গতশ,	দুর্গোৎসব,	
noitikota,	নৈতিকতা,	নৈতিকতা,	
panchashjan,	পঞ্চশজন,	পঞ্চাশজন,	
choudhursoho,	চৌধুরসহ,	চৌধুরসহ,	
musolmanera,	মুসলমানেরা,	মুসলমানেরা,	
bouddher,	বৌদ্ধের,	বৌদ্ধের,	
carloos,	কারললিস,	কার্লোস,	
noteti,	নটেটি,	নোটটি,	
nopdnodir,	নপদন্দির,	নদনদীর,	
elbamtite,	এলবাম্িতে,	এলবামটিতে,	
zeeland,	জিল্যান্ড,	জিল্যান্ড,	
gejeted,	জেজেটেড,	গেজেটেড,	
mirakela,	মিরাকেলা,	মিরাকেল,	
mukhobondho,	মুখবন্ধ,	মুখবন্ধ,	
gratha,	গ্রাথা,	গ্রোথ,	
autopromotioner,	অটোপ্রোমেশনের,	অটোপ্রমোশনের,	
porjotoker,	পর্যটকের,	পর্যটকের,	
gyada,	জ্ঞাদা,	গ্যাদা,	
volivoler,	ভলিভোলের,	ভলিভলের,	
chalchhe,	চাল্ছে,	চলছে,	
fanding,	ফ্যান্ডিং,	ফান্ডিং,	
mahakabi,	মহাকাবী,	মহাকবি,	
totokson,	ততককসন,	ততক্ষন,	
caramiks,	ক্যারামিকস,	সিরামিকস,	
engrezder,	এংরেজদের,	ইংরেজদের,	
byboshthar,	বিব্থথার,	ব্যাবস্থার,	
daaun,	ডাউন,	ডাউন,	
atmobonchito,	আত্মবন্চিত,	আত্মবঞ্চিত,	
sift,	সিফ্ট,	শিফট,	
infarmatian,	ইনফারমেইনান,	ইনফরমেশন,	
bbiswash,	বিবসবিশ,	বিশ্বাস,	
chhedon,	ছেদন,	ছেদন,	
ghatla,	ঘাটলা,	ঘটল,	
ahong,	আহং,	অহং,	
rajbandir,	রাজবন্দির,	রাজবন্দীর,	
chopal,	চোপাল,	চপল,	
bhangchur,	ভাংচুর,	ভাংচুর,	
bedey,	বেদী,	বেদে,	
kade,	কাদে,	কোড,	
tophaat,	তোফাত,	তফাৎ,	
supplenza,	সাপ্লেংজা,	সাপলেঞ্জা,	
poschimey,	পশ্চিমে,	পশ্চিমে,	
shahabike,	শাহাবিকে,	সাহাবীকে,	
pratista,	প্রতিস্তা,	প্রতিষ্টা,	
anutpadanshil,	অনুৎপাদনশীল,	অনুৎপাদনশীল,	
khude,	খুদে,	ক্ষুদে,	
gaujano,	গৌজানো,	গজানো,	
boikalyo,	বৈকা্য,	বৈকল্য,	
ganochin,	গণছিন,	গণচীন,	
mesenjjar,	মেজেঞ্জাার,	মেসেঞ্জার,	
jund,	জান্ড,	জুন্দ,	
phokser,	ফকসের,	ফক্সের,	
bishwasho,	বিশ্বাস,	বিশ্বাসও,	
venisey,	ভেনিসে,	ভেনিসে,	
surakarder,	সুরাকরদের,	সুরকারদের,	
mawdeel,	মাওডেল,	মডেল,	
dera,	ডিরা,	ডেরা,	
nagorikkey,	নাগরিক্ষে,	নাগরিককে,	
barder,	বার্দার,	বার্ডের,	
yanqee,	যানকি,	ইয়াংকি,	
elaakaati,	এলাকাটি,	এলাকাটি,	
binee,	বিনি,	বেনি,	
sadbi,	সাদবি,	সাধ্বী,	
nirvaha,	নির্ভাহ,	নির্বাহ,	
sqolastiq,	স্কোলস্তিক,	স্কলাস্টিক,	
bosturoi,	বস্তুরই,	বস্তুরই,	
ghotaibe,	ঘটটাইবে,	ঘটাইবে,	
bishasey,	বিশাসে,	বিশ্বাসে,	
yuro,	যুরো,	ইউরো,	
bhenom,	ভেনম,	ভেনম,	
nederlande,	নেদেরল্যাণ্ডে,	নেদারল্যান্ডে,	
andra,	আন্দ্রা,	আন্ড্রা,	
taunsheep,	টাউনশিপ,	টাউনশিপ,	
shikshakrom,	শিক্ষাক্রম,	শিক্ষাক্রম,	
manobikotao,	মানবিকতাও,	মানবিকতাও,	
dai,	দাই,	ডে,	
nothivukta,	নথিভুক্ত,	নথিভুক্ত,	
masjidsaha,	মসজিদসহ,	মসজিদসহ,	
karecho,	কারছে,	করেছ,	
grushko,	গ্রুষ্ক,	গ্রুশকো,	
poripaker,	পরিপাকের,	পরিপাকের,	
queri,	কুইরি,	কোয়েরি,	
shikhra,	শিখরা,	শিখরা,	
mele,	মেলে,	মাইল,	
thailand,	থাইলান্ড,	থাইল্যান্ড,	
seniar,	সেনিয়ার,	সিনিয়র,	
ashor,	আশার,	আসর,	
angshogrohon,	অংশগ্রহণ,	অংশগ্রহন,	
heart,	হার্ট,	হার্ট,	
hosbaleke,	হোসবালেকে,	হোসবালেকে,	
everestey,	এভারেস্টে,	এভারেস্টে,	
shikkhakram,	শিক্ষাক্রম,	শিক্ষাক্রম,	
choddo,	চোদ্দো,	চোদ্দো,	
bondishalatei,	বন্দিশালাতেই,	বন্দিশালাতেই,	
roy,	রোই,	রায়,	
salapheeta,	স্যালেটিয়া,	সালফেট,	
shho,	ঝো,	শো,	
aajeej,	আজিজ,	আজিজ,	
swadhinotatukui,	স্বাধীনতাটুকুই,	স্বাধীনতাটুকুই,	
dristiheen,	দৃষ্টিহীন,	দৃষ্টিহীন,	
abodamaner,	অবদামানের,	অবদমনের,	
shorifer,	শরিফার,	শরিফের,	
blacker,	ব্ল্কাকার,	ব্ল্যাকের,	
bijepi,	বিজেপি,	বিজেপি,	
nazranar,	নাজরানার,	নাজরানার,	
ghomta,	ঘোমটা,	ঘোমটা,	
maktum,	মক্তুম,	মাকতুম,	
murad,	মুরাদ,	মুরাদ,	
chalai,	চালাই,	চালাবে,	
saralya,	সরল্যা,	সারল্য,	
hughes,	হুঘেস,	হিউজেস,	
meropenemer,	মেরোপেনেমের,	মেরোপেনেমের,	
shringge,	শ্রিংগে,	শৃঙ্গে,	
gasthii,	গাসথিই,	গোষ্ঠীই,	
nazad,	নাজাদ,	নজদ,	
qirq,	কির্ক,	কার্ক,	
hames,	হ্যামেস,	হোমস,	
muradkey,	মুরাডকে,	মুরাদকে,	
nirmol,	নির্মল,	নির্মল,	
jonesh,	জনেশ,	জোন্স,	
sumi,	সুমি,	সুমি,	
spancer,	স্প্যান্সের,	স্পেন্সার,	
kakhnoba,	কাখনোবা,	কখনওবা,	
dharavahiker,	ধারাভাকিরের,	ধারাবাহিকের,	
dubaate,	দুবাতে,	ডুবাতে,	
esoosiyetasa,	এসোসিয়েটাস,	এসোসিয়েটস,	
sangosrobomukto,	সংস্রব্যমুক্ত,	সংস্রবমুক্ত,	
muhaiminer,	মুহাইমিনের,	মুহাইমিনের,	
jaandrel,	যান্দ্রেল,	জাঁদরেল,	
armshtrong,	আর্মোষ্ট্রং,	আর্মস্ট্রং,	
turkeyder,	তার্কেডের,	তুর্কিদের,	
bosoben,	বসবেন,	বসবেন,	
gananatyo,	গণনন্ত,	গণনাট্য,	
jhonkar,	ঝোঁকার,	ঝঙ্কার,	
indrani,	ইন্দ্রানী,	ইন্দ্রাণী,	
bonobhumi,	বনভূমি,	বনভূমি,	
fongli,	ফোঙ্গলি,	ফংলি,	
tookror,	টুকরোর,	টুকরোর,	
mekon,	মেকন,	মেকং,	
qara,	কারা,	কর,	
sondhisthaponer,	সন্ধিস্থাপনের,	সন্ধিস্থাপনের,	
seeramiks,	সেরামিকস,	সিরামিকস,	
difinishion,	ডিফিনশশন,	ডেফিনেশন,	
prokolpow,	প্রকল্প,	প্রকল্পও,	
byomkes,	ব্যামকেস,	ব্যোমকেশ,	
chalochchitraeeo,	চলচ্চিত্রায়,	চলচ্চিত্রেও,	
gaje,	গাজ,	গেজ,	
firalem,	ফিরালেম,	ফিরালেম,	
prajanankal,	প্রজাননকাল,	প্রজননকাল,	
argead,	আর্গিড,	আর্জিদ,	
oblivion,	অব্লিভিওন,	অবলিভিয়ন,	
sonaicha,	সোনাইচা,	সোনাইচা,	
adorso,	আদর্ষ,	আর্দশ,	
mardud,	মারদদুদ,	মরদুদ,	
bulan,	বুলান,	বুলান,	
abheedhanic,	আভিধানিক,	অভিধানিক,	
eevil,	ইভিল,	ইভিল,	
dibug,	দিবুগ,	ডিবাগ,	
dikpal,	ডিকপাল,	দিকপাল,	
mile,	মিলে,	মিলে,	
moddhyoshtho,	মধ্যশ্্থ,	মধ্যস্থ,	
patjata,	পাটজাতা,	পাটজাত,	
aieesha,	আইসা,	আইএএস,	
otyacharer,	অত্যাচারের,	অত্যাচারের,	
sumitrar,	সুমিত্রার,	সুমিত্রার,	
johny,	জোহনি,	জনি,	
nathivukta,	নািভুক্ত,	নথিভুক্ত,	
behrampurer,	বেহরামপুরের,	বহরমপুরের,	
kadam,	কাদাম,	কদম,	
nothibhukteer,	নথিভুক্তির,	নথিভুক্তির,	
aashtikotaa,	আষ্টিকতা,	আস্তিকতা,	
sorsa,	সর্সা,	সোর্স,	
ateetkale,	আতীকলাে,	অতীতকালে,	
deh,	দেহ,	দেহ্,	
duuma,	ডাউমা,	দুমা,	
vobani,	ভোবানি,	ভবানী,	
kooshumba,	কুশুম্বা,	কুশুম্বা,	
keui,	কেই,	কেউই,	
manoharpur,	মনোহরপুর,	মনোহরপুর,	
bupher,	বুফার,	বাফার,	
omeettrakkhor,	অমিত্রাক্ষর,	অমিত্রাক্ষর,	
neerbachoker,	নির্বাচকের,	নির্বাচকের,	
akai,	আকাই,	একাই,	
haripur,	হরিপুর,	হরিপুর,	
jaanachhe,	যানাছে,	জানাচ্ছে,	
oisamoyer,	ঐসাময়ের,	ঐসময়ের,	
dwipke,	দ্বিপকে,	দ্বীপকে,	
mathieu,	ম্যাথিউ,	ম্যাথিউ,	
bade,	বাদে,	বাদে,	
muhurtati,	মুহুর্তটি,	মুহুর্তটি,	
abheedhaaneek,	অভিদানিক,	অভিধানিক,	
armashtram,	আর্মাশ্ট্রাম,	আর্মস্ট্রং,	
futote,	ফুটোতে,	ফুটোতে,	
shekender,	শেকেন্ডের,	সেকেন্ডের,	
proboleme,	প্রবলেমে,	প্রবলেমে,	
orunima,	ওরুনিমা,	অরুণিমা,	
dupleks,	ডুপ্লেক্স,	ডুপ্লে,	
dhandu,	ধন্দু,	ধন্দু,	
chitlar,	চিতলার,	চিতলার,	
dharavahik,	ধারাভাকি,	ধারাবাহিক,	
hozot,	হজত,	হজত,	
sahab,	সাহাব,	সাহাব,	
dharmadasbabu,	ধর্মদাসবাবু,	ধর্মদাসবাবু,	
registrikrito,	রেজিস্ট্রকৃত,	রেজিস্ট্রীকৃত,	
nisshongotake,	নিঃশংগতকে,	নিঃসঙ্গতাকে,	
myathiou,	ম্যাথিও,	ম্যাথিউ,	
euqalyptus,	ইউক্লাপ্প্টাস,	ইউক্যালিপ্টাস,	
nanir,	নানির,	নানীর,	
audiotike,	অডিওটিকে,	অডিওটিকে,	
bollov,	বলোলভ,	বল্লভ,	
shudden,	শুদ্দেন,	সাডেন,	
welcome,	ওয়েলকম,	ওয়েলকাম,	
sangsakti,	সংসকক্তি,	সংসক্তি,	
enamela,	এনামেলা,	এনামেল,	
thabai,	থাবাই,	থাবাই,	
ekbakye,	একবক্যে,	একবাক্যে,	
sainyader,	সৈন্যদের,	সৈন্যদের,	
huqa,	হুকা,	হুক,	
jani,	জানি,	জনি,	
punorabortonte,	পুনরাবর্তন্তে,	পুনরাবর্তন্তে,	
raghubar,	রঘুবার,	রঘুবীর,	
niutrino,	নিউট্রিনো,	নিউট্রিনো,	
judge,	জুদ্গে,	জাজ,	
karaponner,	কারাপণ্যের,	কারাপণ্যের,	
nabyata,	নব্যতা,	নাব্যতা,	
thakeni,	থাকেনি,	থাকেনি,	
monzeele,	মনজিলে,	মঞ্জিলে,	
juddhahato,	যুদ্ধাহাট,	যুদ্ধাহত,	
taateo,	তাতেও,	তাতেও,	
jerusaleme,	জেরুসালেমে,	জেরুসালেমে,	
remission,	রিমিশন,	রিমিশন,	
mousumeo,	মৌসুমেও,	মৌসুমেও,	
tawnship,	টাউনশিপ,	টাউনশিপ,	
ebhara,	এভারা,	এভার,	
laga,	লাগা,	লগ,	
prokar,	প্রকার,	প্রকার,	
bidyadanke,	বিদ্যাদানকে,	বিদ্যাদানকে,	
armori,	আর্মরি,	আরমোরি,	
ganohotyake,	গণহত্যকে,	গণহত্যাকে,	
bhaandar,	ভান্ডার,	ভাণ্ডার,	
antennal,	অ্যান্টেন্যাল,	অ্যান্টেনাল,	
deqe,	দেকে,	ডেকে,	
roktokhoron,	রক্তকরণ,	রক্তক্ষরণের,	
mojlish,	মজলিশ,	মজলিশ,	
lutharan,	লুথারান,	লুথেরান,	
bisshaskey,	বিশ্বসেকে,	বিশ্বাসকে,	
chenza,	চেঞ্জা,	চেঞ্জ,	
landing,	ল্যান্ডিং,	ল্যান্ডিং,	
marathi,	মারাথী,	মরাঠি,	
kanader,	কানাদের,	কণাদের,	
akhhunno,	আখুন্ন,	অক্ষুণ্ণ,	
salmaner,	সালমানের,	সালমানের,	
beekaargrasta,	বিকারগ্রাস্তা,	বিকারগ্রস্ত,	
robot,	রোবোট,	রোবোট,	
girilal,	গিরিলাল,	গিরিলাল,	
thandabhabe,	থান্ডভাবে,	ঠাণ্ডাভাবে,	
refleks,	রিফলেক্স,	রিফ্লেক্স,	
daakten,	ডাক্েন,	ডাকতেন,	
tyap,	ত্যাপ,	ট্যাপ,	
wodka,	ওয়াডকা,	ভদকা,	
protistha,	প্রতিষ্ঠা,	প্রতিষ্টা,	
jotota,	জতোতা,	যতোটা,	
khalidke,	খালিদকে,	খালিদকে,	
parinati,	পরিণাটি,	পরিণতি,	
elakaatite,	এলাকাটিতে,	এলাকাটিকে,	
gitikobita,	গীতিকবিতা,	গীতিকবিতা,	
sethai,	সেথাই,	সেথাই,	
daaktikite,	দাক্তিকিতে,	ডাকটিকিটে,	
forex,	ফোরেক্স,	ফরেক্স,	
durtomo,	দুর্তমো,	দূরতম,	
probondhobhittik,	প্রবন্ধভিক্তিক,	প্রবন্ধভিত্তিক,	
wishnu,	উইশ্ণু,	বিষ্ণু,	
samaveshke,	সমভাষেকে,	সমাবেশকে,	
courtcaser,	কোর্টক্সের,	কোর্টকেসের,	
anektai,	অনেকটাই,	অনেকটাই,	
paadee,	পাড়ি,	পাড়ে,	
greenald,	গ্রিনাল্ড,	গ্রিনল্ড,	
lotharan,	লোাারান,	লুথেরান,	
baarbadoj,	বার্বাদো,	বার্বাডোজ,	
kyatgarite,	ক্যাটগারিতে,	ক্যাটগারিতে,	
deares,	ডিয়ার্স,	ডিআরএস,	
parkasa,	পারকাসা,	পার্কস,	
cbi,	সিবিআই,	সিবিআই,	
laishensha,	লৈশেশ্চ,	লাইসেন্স,	
hert,	হার্ট,	হার্ট,	
yucalyptus,	কুক্যালপ্প্সাস,	ইউক্যালিপ্টাস,	
votar,	ভোটার,	ভোটার,	
kk,	কেক,	কেকে,	
baibasthaar,	বৈবস্থার,	ব্যবস্থার,	
sylvi,	সিলভি,	সিলভি,	
cinemapremider,	সিনেমাপ্রেমীদের,	সিনেমাপ্রেমীদের,	
chalake,	চালাকে,	চালকে,	
dosha,	দোষা,	দোসা,	
somosto,	সমস্ত,	সমস্ত,	
tennys,	টেনিস,	টেনিস,	
jolrong,	জলরং,	জলরঙ,	
mirina,	মিরিনা,	মিরিনা,	
elgoridom,	এলগোরিডম,	এলগরিদম,	
chyeta,	চ্যেট,	চ্যাট,	
duiekdiner,	দুই়েকদিনের,	দুইএকদিনের,	
meghachchanno,	মেঘচ্ছান্ন,	মেঘাচ্ছন্ন,	
tolemyr,	টোলেমির,	টলেমির,	
fitarsaho,	ফিতারসহ,	ফিতরসহ,	
gronthoti,	গ্রন্থটি,	গ্রন্থটি,	
helly,	হেলি,	হিলি,	
turisht,	টুরিষ্ট,	টুরিস্ট,	
pare,	পারে,	পাড়ে,	
setike,	সেটিকে,	সেটিকে,	
tunaita,	টুনাইটা,	টুনাইট,	
postar,	পোস্টার,	পোস্টের,	
samajeek,	সমজাইক,	সামাজিক,	
mutar,	মুতার,	মুতার,	
soleel,	সোলিল,	সলিল,	
times,	টাইমস,	টাইমস্,	
evereste,	এভারেস্টে,	এভারেস্টে,	
tukrowti,	টুকরোমটি,	টুকরোটি,	
rohinibabu,	রোহিনীবাবু,	রোহিনীবাবু,	
pakistanira,	পাকিস্তানিরা,	পাকিস্তানীরা,	
bhushito,	ভূষিত,	ভূষিত,	
confliqt,	কনফ্লিক্ট,	কনফ্লিক্ট,	
chhintayikari,	ছিন্তায়ককারী,	ছিনতাইকারী,	
asiatic,	এসযয়াটিক,	এশিয়াটিক,	
maudelti,	মাউডেলটি,	মডেলটি,	
aziboner,	আজিবনের,	আজীবনের,	
sahozlabhbhotar,	সহজ্যভল্লতার,	সহজলভ্যতার,	
phaltu,	ফাল্টু,	ফালতু,	
peterke,	পেটারকে,	পিটারকে,	
rifleksa,	রিফললক্সা,	রিফ্লেক্স,	
baire,	বাইরে,	বাইরে,	
assexe,	আসেক্সে,	অ্যাসেক্সে,	
qonfliqt,	কনফ্লিক্ট,	কনফ্লিক্ট,	
bharotiyotar,	ভারতীয়তার,	ভারতীয়তার,	
gorjon,	গর্জন,	গর্জন,	
domone,	ডোমোন,	দমনে,	
taunasipa,	টাউনসীপা,	টাউনশিপ,	
digri,	দিগ্রি,	ডিগ্রি,	
suparahiro,	সুপারাহীরও,	সুপারহিরো,	
baharamporer,	বহররম্পরের,	বহরমপুরের,	
ooporoshtho,	অপরশ্থ,	উপরস্থ,	
sarbhaarti,	সর্ভারটি,	সার্ভারটি,	
bosontoke,	বসন্তকে,	বসন্তকে,	
aarmstrong,	এ্যার্সম্র্রং,	আর্মস্ট্রং,	
ashociatesh,	আশোসিয়েথ,	এসোসিয়েটস,	
vandar,	ভান্ডার,	ভাণ্ডার,	
baipash,	বাইপাশ,	বাইপাস,	
gonjona,	গঞ্জনা,	গঞ্জনা,	
restuarant,	রেস্টুরেন্ট,	রেষ্টুরেন্ট,	
oitijje,	ঐতিহ্যে,	ঐতিহ্যে,	
chalochchitro,	চালচ্ছিত্র,	চলচ্চিত্র,	
logotype,	লোগোটেপি,	লোগোটাইপ,	
guzober,	গুজববের,	গুজবের,	
masjidti,	মসজিদটি,	মসজিদটি,	
sahooseekotar,	সহসুকিতার,	সাহসিকতার,	
beam,	বিআইএম,	বিম,	
rayyalati,	রাইল্যাটি,	রয়্যালটি,	
gaaddafee,	গাদ্দাফি,	গাদ্দাফী,	
kuronir,	কুরোনির,	কুরনীর,	
parq,	পার্ক,	পার্ক,	
fatakesto,	ফাটাকেস্ত,	ফাটাকেষ্ট,	
majlishpur,	মজলিশপুর,	মজলিশপুর,	
hitokor,	হিটককোর,	হিতকর,	
andon,	আ্যান্ডন,	আন্দোন,	
dharabahiktite,	ধারাবাহিকটিতে,	ধারাবাহিকটিতে,	
cheentaikaree,	চেন্টাইকারী,	ছিনতাইকারী,	
windo,	উইন্ডো,	উইন্ডো,	
chandil,	চানদিল,	চান্ডিল,	
pretty,	প্রেটি,	প্রিটি,	
ponchaasjon,	পঞ্চাসোজন,	পঞ্চাশজন,	
seramiks,	সেরামিকস,	সিরামিকস,	
karuna,	করুনা,	করুণা,	
breel,	ব্রিল,	ব্রিল,	
erajyobasi,	এরাজ্যবাসী,	এরাজ্যবাসী,	
poribahokotto,	পরিবাহক্ত,	পরিবাহকত্ব,	
nojder,	নজদের,	নজদের,	
lendl,	লেন্ডল,	লেন্ডল,	
idipasha,	ইডিপাশ,	ইডিপাস,	
kabutorer,	কাবুতরের,	কবুতরের,	
marry,	ম্যারি,	ম্যারি,	
besirvagei,	বেসিরভাজেই,	বেশিরভাগেই,	
toranganj,	তোরাঞ্জগ,	তোরাবগঞ্জ,	
kadapaker,	কাড়াপকের,	কড়াপাকের,	
ramantika,	রামানটিকা,	রোমান্টিক,	
steena,	স্তেন,	স্টেন,	
urey,	উরে,	ইউরি,	
mochlekha,	মোছলেখা,	মোছলেখা,	
toufiq,	তৌফিক,	তৌফিক,	
monjurul,	মঞ্জুরুল,	মনজুরুল,	
sadeep,	সদদীপ,	সদীপ,	
himchi,	হিমচি,	হিমচি,	
senabahineeow,	সেনাবাহিনীত,	সেনাবাহিনীও,	
audioguloke,	অডিওগুলোকে,	অডিওগুলোকে,	
osomorthito,	অসমর্থিত,	অসমর্থিত,	
chaiten,	চেইতেন,	চাইতেন,	
jotharthovabey,	যথার্থভাবে,	যথার্থভাবে,	
dinifitian,	ডাইনিফিটিয়ান,	ডেফিনেশন,	
chiroharit,	চিরোহারিত,	চিরহরিৎ,	
antarctica,	অ্যান্টারক্টিকা,	অ্যান্টার্কটিকার,	
chhuteete,	ছুটিতে,	ছুটিতে,	
vaider,	ভাইদের,	ভাইদের,	
khalidkay,	খলিদকায়,	খালিদকে,	
dajhyo,	দাঝ্য,	দাহ্য,	
bashoborty,	বাশবর্তি,	বশবর্তী,	
thaii,	থাইই,	থাই,	
nichupattir,	নিচুপত্তির,	নিচুপট্টির,	
heerani,	হিরানী,	হিরানি,	
erokomer,	এরকমের,	এরকমের,	
eduardo,	এডুয়ার্ডো,	এডুয়ার্দো,	
dibate,	দিবাতে,	ডিবেট,	
jens,	জেন্স,	জিন্স,	
madhoboir,	মাধবৈর,	মাধবীর,	
nathivukteer,	নািভুক্তির,	নথিভুক্তির,	
rakkhandurga,	রক্ষণদূর্গ,	রক্ষণদুর্গ,	
chalochchitreer,	চালচ্চিত্রীর,	চলচ্চিত্রের,	
karam,	কারাম,	কেরাম,	
osommotite,	অসম্মতিতে,	অসম্মতি,	
fising,	ফিসিং,	ফিসিং,	
aalaa,	আলা,	আলা,	
achintopurer,	অচিন্তপুরের,	অচিন্তপুরের,	
dabarer,	দাবারের,	দাবারের,	
juboksoho,	যুবকসহ,	যুবকসহ,	
purbancoler,	পারব্যাকলের,	পূর্বাঞ্চলের,	
fostar,	ফস্তার,	ফস্টার,	
amanisha,	আমানিশা,	অমানিশা,	
chaloke,	চালোকে,	চালকে,	
machgulo,	মাছগুলো,	মাছগুলো,	
shatokeo,	শতকেও,	শতকেও,	
alexanderke,	অ্যালেক্সান্দারকে,	আলেকজান্ডারকে,	
elakaate,	এলাকাতে,	এলাকাতে,	
shucharita,	শুচারিতা,	সুচরিতা,	
female,	ফেমালে,	ফিমেল,	
