monur,	মনুর,	মনুর,	
hevy,	হেভি,	হেভি,	
kekru,	কেকরু,	কেকরু,	
welcome,	ওয়েকমে,	ওয়েলকাম,	
songbadmadhyomer,	সংবাদধ্যমমের,	সংবাদমাধ্যমের,	
minilosar,	মিনিলোসার,	মিনিলোসার,	
shiqara,	শিকারা,	শিকার,	
planey,	প্লানে,	প্লেনে,	
dalee,	ডলি,	ডালে,	
teksuser,	টেকসাসের,	টেক্সাসের,	
krom,	ক্রোম,	ক্রম,	
rekhapat,	রেখাপাত,	রেখাপাত,	
rajtontro,	রাজতন্ত্র,	রাজতন্ত্র,	
shardotsobei,	শার্দোতসেই,	শারদোৎসবেই,	
paroner,	পারণের,	পারণের,	
hukar,	হুকার,	হুকার,	
chikitsar,	চিকিৎসার,	চিকিত্সার,	
ajeeboner,	অজেবনের,	আজীবনের,	
rakhtokkharoner,	রাকতক্ষরাণের,	রক্তক্ষরণের,	
narbur,	নাববুর,	নরবুর,	
supparak,	সুপ্পরাক,	সুপ্পারক,	
pakhtunistan,	পাখতুনিস্তান,	পাখতুনিস্তান,	
orthobochorke,	অর্থবছরকে,	অর্থবছরকে,	
gopalrao,	গোপালরাও,	গোপালরাও,	
drissotir,	দৃশ্টোটির,	দৃশ্যটির,	
gandhike,	গান্ধীকে,	গান্ধীকে,	
eshiyetika,	এসিয়েতিকা,	এশিয়াটিক,	
choukato,	চৌকাতো,	চৌকাত,	
aairees,	আইরেস,	আইরিস,	
bapokotor,	বাপকতর,	ব্যাপকতর,	
dharabahikvabe,	ধারাবাহিকভাবে,	ধারাবাহিকভাবে,	
rifleksa,	রিফলেকসস,	রিফ্লেক্স,	
renoo,	রেনুর,	রেনো,	
dianes,	ডায়ানিস,	ডিএনএস,	
anhu,	আনুন,	আনহু,	
mitrer,	মিত্রের,	মিত্রের,	
ummool,	উম্মুল,	উম্মুল,	
ray,	রাইয়,	রায়,	
prokolpotike,	প্রকল্পটিকে,	প্রকল্পটিকে,	
land,	ল্যান্ড,	ল্যান্ড,	
bikretara,	বিক্রেতারা,	বিক্রেতারা,	
atarkitey,	আতারকিতে,	অতর্কিতে,	
manushgulor,	মাুষগুলোর,	মানুষগুলোর,	
qirq,	কার্ক,	কার্ক,	
dovaar,	ডোভার,	ডোভার,	
coons,	কুনস,	কুনস,	
samajik,	সমাজিক,	সামাজিক,	
choudhursoho,	চৌধুরসহ,	চৌধুরসহ,	
meshmeshya,	মেশ্মেষ্য,	মেশহমেশহিইয়া,	
oncholke,	অঞ্চলকে,	অঞ্চলকে,	
bonnypran,	বননিপ্রান,	বন্যপ্রাণ,	
bossonte,	বসনন্তে,	বসন্তে,	
sushposhtolikhito,	সুষ্পশ্্থিখিত,	সুষ্পষ্টলিখিত,	
bisnoo,	বিসনু,	বিষ্ণু,	
kkomandar,	ক্মমান্ডার,	কমাণ্ডার,	
nagarikera,	নাগারিকেরা,	নাগরিকেরা,	
bagdadii,	বাগদাদী,	বাগদাদী,	
licensedhari,	লাইসেন্সধারী,	লাইসেন্সধারী,	
deebug,	দেবুগ,	ডিবাগ,	
scholarsip,	স্কলারসিপ,	স্কলারশিপ,	
melbourner,	মেলবোর্নের,	মেলবোর্নের,	
jor,	জর,	জ্বর,	
hock,	হক,	হুক,	
duio,	দুইও,	দুইও,	
hundai,	হুন্ডাই,	হুন্দাই,	
engreziteo,	এংরেজিজিতেও,	ইংরেজিতেও,	
kruser,	ক্রুসের,	ক্রুশের,	
mumtajer,	মুমতাজের,	মুমতাজের,	
koomarir,	কোমারির,	কুমারীর,	
bhugol,	ভুগোল,	ভূগোল,	
salmaner,	সালমানের,	সালমানের,	
neck,	নেক,	নেক,	
booroon,	বুরুন,	বোরন,	
zohns,	জোহনস,	জন্স,	
bhabotarini,	ভবতারিণী,	ভবতারিণী,	
bhangchur,	ভাংচুর,	ভাংচুর,	
naubom,	নৌবম,	নবম,	
akreetokarjo,	আক্রিতার্য্য,	অকৃতকার্য,	
upobaasee,	উপবাসী,	উপবাসী,	
salmanul,	সালমানুল,	সালমানুল,	
madrasa,	মাদ্রাসা,	মাদ্রাসা,	
abdan,	আবদান,	আব্দান,	
accountdharira,	অক্যান্ধরীরা,	একাউন্টধারীরা,	
bollov,	বলোলভ,	বল্লভ,	
cinemapremider,	সিনেমাপ্রেমীদের,	সিনেমাপ্রেমীদের,	
ovidhaner,	অভিধানের,	অভিধানের,	
norfolk,	নরফোলক,	নরফোক,	
manushera,	মনুষেরা,	মানুষেরা,	
machsoho,	মাচসহ,	মাছসহ,	
miraqela,	মিরাকেলা,	মিরাকেল,	
hastantar,	হস্তান্তর,	হস্তান্তর,	
review,	রেভিউড,	রিভিউও,	
blacker,	ব্ল্যাকার,	ব্ল্যাকের,	
karim,	কারিম,	করিম,	
satyaky,	সত্যকি,	সাত্যকি,	
narsinghomgulor,	নর্সিংহমগুলোর,	নার্সিংহোমগুলোর,	
shikshakbrinda,	শিক্ষাবৃন্দ,	শিক্ষকবৃন্দ,	
paripakey,	পরিপাকে,	পরিপাকে,	
mmadhukkori,	ম্যামাধুকরী,	মাধুকরী,	
peerry,	পিরি,	পেরি,	
vogiroth,	ভোগিরথ,	ভগীরথ,	
huk,	হুক,	হুক,	
sarsa,	সার্স,	সোর্স,	
beshakbar,	বেশকবার,	বেশকবার,	
kade,	কাদে,	কোড,	
laishensha,	লাইশেনসা,	লাইসেন্স,	
daaktikite,	দাকটিকিতে,	ডাকটিকিটে,	
pachak,	পাচাক,	পাচক,	
norpholk,	নরফলক,	নরফোক,	
prijon,	প্রিজন,	প্রিজন,	
borkhastokritora,	বরখাস্তকরারা,	বরখাস্তকৃতরা,	
balithubar,	বালিতুবার,	বালিথুবার,	
phonekari,	ফোনেকারি,	ফোনকারী,	
shnaipara,	শ্নাইপরা,	স্নাইপার,	
shasonamoleri,	শাসনামলেরই,	শাসনামলেরই,	
ralf,	রালফ,	রালফ,	
nottee,	নট্টি,	নোটটি,	
orthanitike,	অর্থানীতিকে,	অর্থনীতিকে,	
miley,	মিলে,	মিলে,	
megh,	মেঘ,	মেঘ,	
kamla,	কামলা,	কামলা,	
ramnathbabur,	রামনাথবাবুর,	রামনাথবাবুর,	
kormokarke,	কর্মকারকে,	কর্মকারকে,	
monir,	মনির,	মনির,	
shasyadi,	শস্যাদি,	শস্যাদি,	
quary,	কোয়ারি,	কোয়েরি,	
tarkale,	তারকালে,	তারকালে,	
jackey,	জ্যাকে,	জকি,	
drishyer,	দৃশ্যের,	দৃশ্যের,	
koruna,	কোরুনা,	করুণা,	
ganesh,	গণেশ,	গণেশ,	
gronther,	গ্রন্থের,	গ্রন্থের,	
myat,	মাযাট,	ম্যাট,	
oindrila,	ঐন্দ্রিলা,	ঐন্দ্রিলা,	
scuvi,	স্কুভি,	স্কুভি,	
dajhyo,	দাঝ্য,	দাহ্য,	
gasthii,	গাস্থি,	গোষ্ঠীই,	
maradeha,	মারাদেহ,	মরদেহ,	
dakteekiter,	ডাক্তিকীতের,	ডাকটিকিটের,	
teestar,	টিস্টার,	তিস্তার,	
progresh,	প্রোগ্রেশ,	প্রগ্রেস,	
serup,	সেরুপ,	সেরূপ,	
tecnokret,	টেকনক্রেট,	টেকনোক্র্যাট,	
bosontoke,	বসন্তকে,	বসন্তকে,	
drissogulote,	দৃশ্যগুলোতে,	দৃশ্যগুলোতে,	
ganoparibahaner,	গণপরিবাহনের,	গণপরিবহনের,	
ghuznavi,	গুজনাভি,	গজনভি,	
anutpadanshil,	অনুতঃপদনশিল,	অনুৎপাদনশীল,	
ghotaibe,	ঘটাইবে,	ঘটাইবে,	
sthapona,	স্থাপোনা,	স্থাপনা,	
rajotta,	রাজত্তা,	রাজত্ব,	
byabostho,	ব্যবস্থ,	ব্যাবস্থা,	
bhowanipur,	ভোয়ানীপুর,	ভবানীপুর,	
tolemyr,	টোলেমির,	টলেমির,	
mythological,	মাইলোলজিকাল,	মাইথলজিকাল,	
antarctica,	অ্যান্টর্কটিকা,	অ্যান্টার্কটিকার,	
osthisondhi,	অস্থিসন্ধি,	অস্থিসন্ধি,	
siqh,	সিখ,	শিখ,	
manibhaijaner,	মণিভাইজনের,	মণিভাইজানের,	
sooya,	সুয়া,	সোয়া,	
muchlima,	মুছলিমা,	মুছলিমা,	
ganochien,	গানোচিয়েন,	গণচীন,	
elaakate,	এলাকাটে,	এলাকাতে,	
conservetion,	কনসাভারেশন,	কনসারভেশন,	
tecno,	টেকনো,	টেকনো,	
aagera,	আগেরা,	আগোরা,	
mataram,	মাতারাম,	মাতরম,	
ala,	আলা,	আলা,	
lirikti,	লিরিক্তি,	লিরিকটি,	
samanyai,	সামানই,	সামান্যই,	
lahano,	লাহানো,	লাহানো,	
dapadpi,	দাপদপি,	দাপাদপি,	
shchalastik,	শ্চললষ্টিক,	স্কলাস্টিক,	
madhoboir,	মাধবৈর,	মাধবীর,	
nagorikra,	নাগরিকরা,	নাগরিকরা,	
abhidhaanick,	অভিধানিক,	অভিধানিক,	
faltu,	ফাল্টু,	ফালতু,	
panchashjon,	পঞ্চশজন,	পঞ্চাশজন,	
capsul,	ক্যাপসুল,	ক্যাপসুল,	
sahojlovyotar,	সহলবয্যতার,	সহজলভ্যতার,	
windos,	উইন্ডোস,	উইন্ডোস,	
nischitvabe,	নিশ্চিতভাবে,	নিশ্চিতভাবে,	
poketchorder,	পকেটচরদের,	পকেটচরদের,	
muradkey,	মুরাদকে,	মুরাদকে,	
neemeetto,	নিমেত্ত,	নিমিত্ত,	
hijri,	হিজরি,	হিজরী,	
provritike,	প্রভৃতিকে,	প্রভৃতিকে,	
gejeted,	জেজেটেড,	গেজেটেড,	
bhabaaponno,	ভাবাপন্ন,	ভাবাপন্ন,	
pet,	পেট,	পেত,	
asthishondhi,	অস্থিসন্ধি,	অস্থিসন্ধি,	
gajiipur,	গাজিপুর,	গাজীপুর,	
byaboharkarie,	ব্যবহারকারীকেই,	ব্যবহারকারীই,	
umb,	উম্ব,	ইউএমবি,	
byboshthar,	বিবশ্থার,	ব্যাবস্থার,	
chiroharit,	চিরোহারিত,	চিরহরিৎ,	
ameettrakkhor,	অমিত্রাক্ষর,	অমিত্রাক্ষর,	
talgachh,	তালগাছ,	তালগাছ,	
bhebechili,	ভেবেছিলি,	ভেবেছিলি,	
aarmstrong,	এর্মস্ট্রিং,	আর্মস্ট্রং,	
bipajjanak,	বিপাজনাক,	বিপজ্জনক,	
aamoode,	আমোদে,	আমুদে,	
aarke,	আরকে,	আরকে,	
sarbhaarti,	সার্ভারটি,	সার্ভারটি,	
unchuporjayer,	উঁচুপর্যায়ের,	উঁচুপর্যায়ের,	
engrejra,	এংরেজরা,	ইংরেজরা,	
syfy,	সিফি,	সাইফাই,	
duiekdiner,	দুইেক্িনের,	দুইএকদিনের,	
abodamaner,	আবদামানের,	অবদমনের,	
grushko,	গ্রুষ্কো,	গ্রুশকো,	
yatharthabhabe,	যাথর্থভাবে,	যথার্থভাবে,	
ispredsiit,	ইসপ্রেডসিট,	স্প্রেডশীট,	
mochlekha,	মচলেখা,	মোছলেখা,	
geja,	জেজা,	গেজ,	
parking,	পার্কিং,	পার্কিং,	
eesosiyeetasa,	ইসোসিয়াতাস,	এসোসিয়েটস,	
brindaboney,	বৃন্দাবনে,	বৃন্দাবনে,	
postac,	পোস্টাক,	পোস্টকে,	
jemy,	জেমি,	জেমি,	
suparharo,	সুপারহোরো,	সুপারহিরো,	
punorabortonte,	পুনরাবর্তন্তে,	পুনরাবর্তন্তে,	
shatoke,	শাটকে,	শতকে,	
osommotite,	অসম্মতিতে,	অসম্মতি,	
mahasava,	মহাসভ,	মহাসভা,	
sima,	সিমা,	সীমা,	
elakasoho,	এলাকাসহ,	এলাকাসহ,	
times,	টাইমস,	টাইমস্,	
nimnosakkharkari,	নিম্নসারকারকারী,	নিম্নস্বাক্ষরকারী,	
canservatian,	ক্যান্সারভেেন,	কনসারভেশন,	
victor,	ভিক্টর,	ভিক্টর,	
protijogiitamulok,	প্রতিযোগিতামূলক,	প্রতিযোগীতামূলক,	
byaboharkari,	ব্যবহারকারী,	ব্যবহারকারী,	
firozapure,	ফিরোজাপুরে,	ফিরোজাপুরে,	
mokhmoley,	মখমলে,	মখমলে,	
telakucha,	তেলাকুচা,	তেলাকুচা,	
shansthaner,	শানস্থানের,	সংস্থানের,	
keyboarder,	কেইববর্ডার,	কীবোর্ডের,	
jamarate,	জামারাতে,	জামারাতে,	
prachirer,	প্রাচিরের,	প্রাচিরের,	
mookhomaundoler,	মুখমানন্ডলের,	মুখমণ্ডলের,	
tonoo,	টনু,	তনু,	
amontronkarider,	আমন্ত্রনকারীদের,	আমন্ত্রণকারীদের,	
kraim,	ক্রেম,	ক্রাইম,	
jeshtha,	জেসথা,	জ্যেষ্ঠা,	
mail,	মাইল,	মাইল,	
seoul,	সিওল,	সোল,	
deenesh,	দীনেশ,	দীনেশ,	
bornolikhon,	বর্ণলিখন,	বর্ণলিখন,	
hena,	হেনা,	হেনা,	
krishibigyani,	কৃষিবিজ্ঞানী,	কৃষিবিজ্ঞানী,	
kantojir,	কান্তজির,	কান্তজির,	
prodiiper,	প্রদীপের,	প্রদীপের,	
inafarameshana,	ইনারাফেশন,	ইনফরমেশন,	
ardasha,	অর্দশ,	আর্দশ,	
cbi,	সিবিআই,	সিবিআই,	
spredshiit,	স্প্রেডশিত,	স্প্রেডশীট,	
chikitsanirbhar,	চিকিৎসন্বরর,	চিকিৎসানির্ভর,	
qyapasula,	ক্যাপাসুলা,	ক্যাপসুল,	
laishensh,	লাইশেন্স,	লাইসেন্স,	
songrahak,	সংগ্রাহক,	সংগ্রাহক,	
weenis,	বিউনিস,	ভেনিস,	
hajeerhatt,	হাজেরহাট,	হাজিরহাট,	
rajpur,	রাজপুর,	রাজপুর,	
sthapanagulo,	স্থাপানাগুলো,	স্থাপনাগুলো,	
perry,	পেরি,	পেরি,	
ajeejer,	আজীজের,	আজিজের,	
mane,	মানে,	মানে,	
cholochchitrai,	চলচচ্চিত্রায়,	চলচ্চিত্রই,	
somsher,	সমশের,	সমশের,	
taigara,	তাইগারা,	টাইগার,	
hakone,	হাকোন,	হাকোনে,	
bizito,	বিজিত,	বিজিত,	
scoore,	স্কোর,	স্কোর,	
sikara,	সিকারা,	শিকার,	
shikare,	শিকারে,	শিকারে,	
kayartara,	কায়ারটার,	কোয়ার্টার,	
oporishodhito,	অপরিষদিত,	অপরিশোধিত,	
teoner,	টেওনের,	টিওনার,	
horeepur,	হরিপুর,	হরিপুর,	
nirikhe,	নিরিখে,	নিরিখ,	
lavta,	লাভটা,	লাভটা,	
shipley,	শিপলি,	শিপলে,	
champa,	চাম্পা,	চাঁপা,	
spreadshiit,	স্প্রেডশিি,	স্প্রেডশীট,	
palkee,	পালকি,	পাল্কি,	
jaubankal,	যৌবনকাল,	যৌবনকাল,	
artherer,	আর্থেরের,	আর্থারের,	
highcomissione,	হাইকমিশনে,	হাইকমিশনে,	
jontrangshogulor,	যন্ত্রাংশগুলোর,	যন্ত্রাংশগুলোর,	
steena,	স্টিন,	স্টেন,	
asommoti,	অসম্মতি,	অসম্মতি,	
vezano,	ভেজানো,	ভেজানো,	
jounotar,	যৌনতার,	যৌনতার,	
elbamtite,	এলবামটিতে,	এলবামটিতে,	
bangobandhu,	বঙ্গবন্ধু,	বঙ্গবন্ধু,	
asabhya,	অসভ্য,	অসভ্য,	
shiter,	শিতের,	শীতের,	
brekthrough,	ব্রেক্টরোগ,	ব্রেকথ্রু,	
dipankar,	দীপনকর,	দিপঙ্কর,	
madhuree,	মধধীরী,	মাধুরী,	
heerani,	হীরানী,	হিরানি,	
postar,	পোস্তার,	পোস্টের,	
shattoki,	শাট্তকি,	সাত্যকি,	
mukhomandaler,	মুখমান্ডলের,	মুখমণ্ডলের,	
torkarite,	তর্কারিতে,	তরকারিতে,	
chirkut,	চিরকুট,	চিরকুট,	
besooro,	বেশোরো,	বেসুর,	
qarpeta,	কর্েটা,	কার্পেট,	
shotodha,	শতধা,	শতধা,	
station,	স্টেশন,	ষ্টেশন,	
bharotchilo,	ভারতচিল,	ভারতছিল,	
meloonborrone,	মেলবনবরর্ন,	মেলবোর্নে,	
riazuddin,	রিয়াজউদ্দিন,	রিয়াজউদ্দীন,	
informetion,	ইনফরমেশন,	ইনফরমেশন,	
uddhritto,	উদ্ধৃত্ত,	উদ্ধৃত,	
marpit,	মারপিত,	মারপিট,	
konistho,	কনিষ্ঠ,	কনিষ্ঠ,	
lutheerana,	লুঠিরানা,	লুথেরান,	
jwar,	জ্বর,	জ্বর,	
minishtarer,	মিনিশ্তারের,	মিনিস্টারের,	
shrimoti,	শ্রীমটি,	শ্রীমতি,	
nodimaatrik,	নদিমাত্রিক,	নদীমাতৃক,	
forma,	ফরমা,	ফর্মা,	
panchasjan,	পঞ্চজন,	পঞ্চাশজন,	
dii,	ডিই,	দিই,	
turkyder,	টার্কডিইডের,	তুর্কিদের,	
toufiq,	তাউফিক,	তৌফিক,	
boner,	বনের,	বনের,	
markeetim,	মারককিটিম,	মার্কেটিং,	
liceensee,	লাইসেন্সি,	লাইসেন্স,	
bachhaikrito,	বাছাইকৃত,	বাছাইকৃত,	
graambaasheeo,	গ্রামবাশশীও,	গ্রামবাসীও,	
felto,	ফেল্টো,	ফেলত,	
shommotir,	সম্মটির,	সম্মতির,	
ceramiksh,	সেরামিক্স,	সিরামিকস,	
mukhmondole,	মুখমন্ডলে,	মুখমণ্ডলে,	
lebina,	লেবিনা,	লেবিনা,	
samaveshke,	সমাভেশকে,	সমাবেশকে,	
sithilotar,	সিথিলতার,	শিথিলতার,	
neerbachoker,	নির্বাচকের,	নির্বাচকের,	
ostad,	ওস্তাদ,	ওস্তাদ,	
abti,	আবিটিআই,	আবতি,	
ultrasonography,	আল্টারস্রাসোরং,	আলট্রাসনোগ্রাফিও,	
vesselli,	ভেসেলি,	ভেসেলি,	
gabhaaskar,	গাভাসকার,	গাভাস্কার,	
prakar,	প্রকার,	প্রকার,	
philipiner,	ফিলিপিনের,	ফিলিপাইনের,	
sylvi,	সিলভি,	সিলভি,	
ongshogrohoner,	অংশগ্রহণের,	অংশগ্রহনের,	
ganochin,	গণচিন,	গণচীন,	
obharbhiu,	অভর্ভিউ,	ওভারভিউ,	
venkates,	ভেঙ্কেটসহ,	ভেঙ্কটেশ,	
fatakesto,	ফাযাটকেস্টো,	ফাটাকেষ্ট,	
furio,	ফুরিও,	ফুরিও,	
nirmol,	নির্মল,	নির্মল,	
nadike,	নাদীকে,	নদীকে,	
niutrino,	নিউট্রিনো,	নিউট্রিনো,	
aatmobishwasi,	আত্মবিশ্বাসী,	আত্মবিশ্বাসী,	
wrighter,	উর্তের,	রাইটের,	
peethey,	পেঠে,	পীঠে,	
paadee,	পাদি,	পাড়ে,	
daakticketer,	ডাক্িকেটের,	ডাকটিকিটের,	
bhramarotsab,	ভ্রামারোতসব,	ভ্রমরোৎসব,	
internship,	ইন্টারনশিপ,	ইন্টার্নশিপ,	
aakkas,	আক্কাস,	আককাস,	
qyantana,	ক্যান্টনা,	ক্যান্টন,	
pacbar,	পাঁবার,	পাঁচবার,	
breqathru,	ব্রেকেঠ্রু,	ব্রেকথ্রু,	
uddhrito,	উদ্ধৃত,	উদ্ধৃত,	
udvaboney,	উদ্ভাবনে,	উদ্ভাবনে,	
asovarno,	অসভার্ন,	অসবর্ণ,	
besur,	বেসুর,	বেসুর,	
omanisa,	ওমানিসা,	অমানিশা,	
sikarer,	সিকারের,	শিকারের,	
seniar,	সেনিয়ার,	সিনিয়র,	
vedanta,	ভেদান্তা,	বেদান্ত,	
jeher,	জেহের,	জেহের,	
raunanganey,	রউননগানে,	রণাঙ্গনে,	
sqolastiq,	স্কোলাস্তিক,	স্কলাস্টিক,	
kottar,	কোট্তার,	কট্টর,	
plate,	প্ল্যাট,	প্লেটে,	
neshnosh,	নেশনোষ,	নেশনস,	
nanir,	নানির,	নানীর,	
chhotogolper,	ছোটগল্পের,	ছোটগল্পের,	
nomo,	নমো,	নমো,	
dakticket,	ডাকটিকেট,	ডাকটিকিট,	
uponishad,	উপনিশাদ,	উপনিষদ,	
jocqey,	জোকে,	জকি,	
moreecha,	মরিচা,	মরিচা,	
orthonitir,	অর্থনীতির,	অর্থনীতির,	
platform,	প্ল্যাটফোর্ম,	প্লাটফর্ম,	
uqeliptas,	ইকেলিপ্তাস,	ইউক্যালিপ্টাস,	
bopoon,	বপুন,	বপন,	
swostir,	স্বস্তির,	স্বস্তির,	
korijachilen,	করিযাছিলেন,	করিযাছিলেন,	
shrabastee,	শ্রাবস্তি,	শ্রাবস্তী,	
oncoltike,	অঙ্কলটিকে,	অঞ্চলটিকে,	
romarder,	রোমারদের,	রোমারদের,	
karadandey,	কারাদানদে,	কারাদণ্ডে,	
restuarant,	রেস্টুরেয়ান্ট,	রেষ্টুরেন্ট,	
nirobota,	নিরবতা,	নিরবতা,	
tetela,	টেটেলা,	টাইটেল,	
manoharpur,	মনোহারপুর,	মনোহরপুর,	
konisttha,	কনিষ্ঠা,	কনিষ্ঠ,	
dadapur,	দাদাপুর,	দাদাপুর,	
domone,	ডমনে,	দমনে,	
nothiboddho,	নথিবদ্ধ,	নথিবদ্ধ,	
katiusha,	কাতিউশা,	কাতিউশা,	
palestine,	প্যালেস্টিন,	প্যালেস্টাইনে,	
baait,	বাইত,	বাইট,	
khudhartara,	ক্ষুধার্তরা,	ক্ষুধার্তরা,	
teliha,	তেলিহা,	তেলিহা,	
shtona,	স্তোনা,	স্টোন,	
manushe,	মানুষে,	মানুষে,	
nirarthak,	নিরার্থক,	নিরর্থক,	
kiuti,	কিউটি,	কিউটি,	
bulano,	বুলানো,	বুলান,	
andra,	আন্দ্রা,	আন্ড্রা,	
ji,	জিই,	জি,	
plusey,	প্লাউসে,	প্লাসে,	
chal,	চাল,	চাল,	
nirbaho,	নির্বাহ,	নির্বাহ,	
phokser,	ফোক্সের,	ফক্সের,	
bonnopran,	বন্যপ্রাণ,	বন্যপ্রাণ,	
gujab,	গুজাব,	গুজব,	
manjushree,	মঞ্জুশ্রী,	মঞ্জুশ্রী,	
chakradhare,	চক্রধারে,	চক্রধরে,	
chargar,	চরগর,	চার্জার,	
dharmiyabhabei,	ধর্মীয়ভাবেই,	ধর্মীয়ভাবেই,	
harris,	হ্যারিস,	হ্যারিস,	
sbajan,	স্বজন,	স্বজন,	
noditir,	নদীতির,	নদীটির,	
palbongsher,	পালবংশের,	পালবংশের,	
shoreefpur,	শরিফপুর,	শরিফপুর,	
polashir,	পলাশির,	পলাশীর,	
shaahaabiike,	সাহাবিকে,	সাহাবীকে,	
dara,	দারা,	দারা,	
kurdira,	কুরদিরা,	কুর্দিরা,	
bojhey,	বোঝে,	বোঝে,	
karecho,	কারেছো,	করেছো,	
diiptii,	দিপটটিই,	ডেপুটি,	
hajirhat,	হাজিরহাট,	হাজিরহাট,	
oncholtee,	অঞ্চলটি,	অঞ্চলটি,	
doorotaumo,	ডূরোটামো,	দূরতম,	
oiteejye,	ঐতিজ্যে,	ঐতিহ্যে,	
shansthagulo,	শাঁসথাগুলো,	সংস্থাগুলো,	
eporjonto,	এপর্যন্ত,	এপর্যন্ত,	
shudhui,	শুধুই,	শুধুই,	
nabyata,	নব্যতা,	নাব্যতা,	
dhila,	ধীলা,	ঢিলা,	
mojlish,	মজলিশ,	মজলিশ,	
sanaktokaran,	সননক্তকরণ,	সনাক্তকরণ,	
gandhiir,	গান্ধির,	গান্ধীর,	
pooshti,	পুষ্টি,	পুষ্টি,	
naabbota,	নাব্বতা,	নাব্যতা,	
shatokeo,	শতকেও,	শতকেও,	
arashie,	আরাশিয়,	আরসিএ,	
omarader,	ওমারাদের,	ওমারাদের,	
gazeetteed,	গেজেট্টিড,	গেজেটেড,	
khorsed,	খোরসেড,	খোরশেদ,	
ansarir,	আনসারীর,	আনসারীর,	
nothibhukta,	নথিভুক্ত,	নথিভুক্ত,	
panchadadu,	পঞ্চদাদু,	পঞ্চাদাদু,	
ostheesandhi,	অস্থিসন্ধী,	অস্থিসন্ধি,	
shibraj,	শিবরাজ,	শিবরাজ,	
samoshtigato,	সামোষ্টিগত,	সমষ্টিগত,	
lopjonito,	লপজনিত,	লোপজনিত,	
kandy,	কান্ডি,	ক্যান্ডি,	
vabook,	ভ্যাবুক,	ভাবুক,	
juakhelar,	জুয়াখালের,	জুয়াখেলার,	
shommoteer,	সম্মতির,	সম্মতির,	
akmato,	আক্মতো,	একমত,	
sambhabonao,	সম্ভাবনাও,	সম্ভবনাও,	
ponchasjon,	পঞ্চাসজন,	পঞ্চাশজন,	
prajanankal,	প্রজননকাল,	প্রজননকাল,	
besirvagei,	বেসিরবাগেই,	বেশিরভাগেই,	
ujobekeestan,	উজবেকসিস্তান,	উজবেকিস্তান,	
kadam,	কাদাম,	কদম,	
jolaatonko,	জলাতানকো,	জলাতঙ্ক,	
jalarong,	জালারং,	জলরঙ,	
amanisa,	আমানিসা,	অমানিশা,	
shunani,	শুনানি,	শুনানী,	
pleto,	প্লেটো,	প্লেটো,	
neemeette,	নিমেত্তে,	নিমিত্তে,	
engrezder,	এংরেজদের,	ইংরেজদের,	
torabgonj,	তরাবগঞ্জ,	তোরাবগঞ্জ,	
bonke,	বনকে,	বনকে,	
sommotite,	সম্মতিতে,	সম্মতিতে,	
saptahokal,	সপ্তাহকাল,	সপ্তাহকাল,	
raagei,	রাগেই,	রাগেই,	
becha,	বেচা,	বেচা,	
ardasho,	অর্দাশও,	আর্দশ,	
asiatic,	এসিয়াটিক,	এশিয়াটিক,	
jorury,	জোরি,	জরূরী,	
niurolaji,	নিউরলাজি,	নিউরোলজি,	
dobhara,	ডোভারা,	ডোভার,	
taposgoner,	তাপসগণের,	তাপসগণের,	
oitijje,	ঐতিহ্যে,	ঐতিহ্যে,	
ghatiti,	ঘটিটি,	ঘাঁটিটি,	
mumtaj,	মুমতাজ,	মুমতাজ,	
chalachchitra,	চলচচ্চিত্র,	চলচ্চিত্র,	
balatkar,	বালাতকর,	বলাৎকার,	
jaistho,	জাযসস্থ,	জ্যৈষ্ঠ,	
joubanbatee,	যৌবনবাতি,	যৌবনবতী,	
parqim,	পারকিম,	পার্কিং,	
shpredshiit,	স্পর্ডশেষিত,	স্প্রেডশীট,	
dristiheen,	দৃষ্টিহীন,	দৃষ্টিহীন,	
chalchhe,	চালছে,	চলছে,	
steen,	স্টিন,	স্টেন,	
vushito,	ভুষিত,	ভূষিত,	
modelkey,	মডেলকে,	মডেলকে,	
lesense,	লেসেন্স,	লাইসেন্স,	
duryogamoyee,	দুর্যোগাময়ী,	দুর্যোগময়ী,	
residensa,	রেসিডেন্স,	রেসিডেন্স,	
samaptir,	সমাপ্তির,	সমাপ্তির,	
dhaleshorii,	ধলেশরী,	ধলেশ্বরী,	
karmake,	কারমাকে,	কর্মকে,	
bondiira,	বন্ডিরা,	বন্দীরা,	
drishi,	দৃশি,	দৃশ্যই,	
bhenus,	ভেনুস,	ভেনাস,	
koyekbare,	কয়েকবারে,	কয়েকবারে,	
obosore,	অবসরে,	অবসরে,	
musabbirul,	মুসাব্বিরুল,	মুসাব্বিরুল,	
taunship,	টাউনশিপ,	টাউনশিপ,	
balabhadra,	বালাভাদরা,	বলভদ্র,	
miitar,	মিতার,	মিত্র,	
jeebanjapon,	জীবন্াপন,	জীবনযাপন,	
mukhomondoler,	মুখমন্ডলের,	মুখমণ্ডলের,	
konflict,	কনফ্লিক্ট,	কনফ্লিক্ট,	
michhilti,	মিছিলটি,	মিছিলটি,	
hazat,	হাজাত,	হজত,	
bijepi,	বিজেপী,	বিজেপি,	
boikalyo,	বৈকল্য,	বৈকল্য,	
muktilav,	মুক্তিলাভ,	মুক্তিলাভ,	
rasunkunchi,	রসুনকুঞ্চি,	রসুনকুঁচি,	
manatmulak,	মানাতমূলক,	মানতমূলক,	
sahab,	সাহাব,	সাহাব,	
kaathhaamaandu,	কাঠামান্ডু,	কাঠমান্ডু,	
daktickete,	ডাক্িকেটকে,	ডাকটিকিটে,	
stoonahenja,	স্তেনােজ্জ,	স্টোনহেঞ্জ,	
adbhanced,	অ্যাডভান্সড,	অ্যাডভান্সড,	
korimkey,	করিমকে,	করিমকে,	
zozyota,	যোজ্যতা,	যোজ্যতা,	
gunje,	গুঞ্জে,	গুঁজে,	
edaningkale,	এদানিংকালে,	ইদানীংকালে,	
elaakati,	এলাকাটি,	এলাকাটি,	
cheekitshar,	চিকিৎসার,	চিকিত্সার,	
rupantarer,	রুপান্তরের,	রুপান্তরের,	
priseflex,	প্রিসফফেক্স,	প্রাইজফ্লেক্স,	
mekon,	মেকন,	মেকং,	
injiniyarim,	ইঞ্জিনিরিয়মমি,	ইঞ্জিনিয়ারিং,	
shoori,	শূরী,	সুরি,	
tiger,	টিগের,	টাইগার,	
zeland,	জেল্যান্ড,	জিল্যান্ড,	
khuizza,	খুইজ্জা,	খুইজ্জা,	
chopal,	চোপাল,	চপল,	
atak,	আটক,	আটক,	
reetesh,	রিটেশ,	রিতেশ,	
tennis,	টেনিস,	টেনিস,	
holding,	হলডিং,	হোল্ডিং,	
siddhanto,	সিদ্ধান্ত,	সিদ্ধান্তও,	
oxfordey,	অক্সফোর্ডেই,	অক্সফোর্ডে,	
nirvachaker,	নির্ভাচকের,	নির্বাচকের,	
chaudhuriyo,	চৌধুরিও়,	চৌধুরীও,	
dwipke,	দ্বিপকে,	দ্বীপকে,	
aakabar,	আকাবার,	আকাবার,	
ramonar,	রামনার,	রমনার,	
rockibul,	রকিবুল,	রকিবুল,	
freekeh,	ফ্রীকেহ,	ফ্রিকেহ,	
sthaponagulor,	স্থাপনাগুলোর,	স্থাপনাগুলোর,	
hepatitis,	হেপাটিটিইটস,	হেপাটাইটিস,	
beatleser,	বিটলিসের,	বিটলসের,	
omeettrakkhor,	অমিত্রক্ষ্র,	অমিত্রাক্ষর,	
dhyanastha,	ধ্যানস্থ,	ধ্যানস্থ,	
gronthoti,	গ্রন্থটি,	গ্রন্থটি,	
beshyasdone,	বেশ্যাস্দনে,	বেশ্যাসদনে,	
anchalsaho,	অঞ্চলসহ,	অঞ্চলসহ,	
prosadhoner,	প্রসাধনের,	প্রসাধনের,	
parshwer,	পার্শ্বের,	পার্শ্বের,	
nothivuktir,	নথিভুক্তির,	নথিভুক্তির,	
hisabagyan,	হিসাবজ্ঞান,	হিসাবজ্ঞান,	
khali,	খালি,	খালি,	
satarkatar,	সতর্কতার,	সতর্কতার,	
chereche,	চেরেছে,	ছেড়েছে,	
ramantic,	র্যানাম্টিক,	রোমান্টিক,	
baaiq,	বাইক,	বাইক,	
khalidkay,	খালিকডা,	খালিদকে,	
govindarajan,	গোবিন্দরাজন,	গোবিন্দরাজন,	
longhan,	লংঘান,	লংঘন,	
anchalgulir,	আঞ্চলগুলির,	অঞ্চলগুলির,	
durgotsab,	দুর্গোৎসব,	দুর্গোৎসব,	
lampot,	লামপোট,	লম্পট,	
shef,	শেফ,	শেফ,	
mmehonoti,	ম্মেহননটি,	মেহনতি,	
gorjon,	গর্জন,	গর্জন,	
gafeeloti,	গাফিলোটি,	গাফিলতি,	
saria,	সারিয়া,	সরিয়া,	
shatan,	শতন,	শয়তান,	
proshadhoner,	প্রশাধনের,	প্রসাধনের,	
vince,	ভিন্স,	ভিন্স,	
angshogrohon,	অংশগ্রহণ,	অংশগ্রহন,	
nirbahey,	নির্বাহে,	নির্বাহে,	
malinga,	মালিঙ্গা,	মালিংগা,	
khargosher,	খারগোষের,	খরগোসের,	
kajangale,	কাজানগলে,	কজঙ্গলে,	
bhotomulyoke,	ভটোমূল্যকে,	ভোটমূল্যকে,	
rashedul,	রাশেদুল,	রাশিদুল,	
horas,	হোরাস,	হোরাস,	
ghetu,	ঘেটু,	ঘেটু,	
sompadon,	সম্পাদন,	সম্পাদন,	
chaanoo,	চানো,	চানু,	
bibecchyo,	বিবেচ্ছ্য,	বিবেচ্য,	
artilary,	আর্টিলারি,	আর্টিলারি,	
pujito,	পূজিত,	পুজিত,	
baptics,	ব্যাপ্টিক্স,	ব্যাপটিকস,	
hupile,	হুপিলে,	হুপিলে,	
uchchotara,	উচ্চতারা,	উচ্চতর,	
daltagi,	দাতাগী,	দলত্যাগী,	
sobaiderke,	সোবাইদেরকে,	সবাইদেরকে,	
diibug,	দিববুগ,	ডিবাগ,	
chalai,	চালাই,	চালাবে,	
koordira,	কোরদিরা,	কুর্দিরা,	
harasta,	হারস্তা,	হারাস্তা,	
roopdan,	রূপদান,	রুপদান,	
huqa,	হুকা,	হুক,	
modhyekar,	মধ্যেকার,	মধ্যেকার,	
nodiitei,	নদীতেই,	নদীতেই,	
durgatsob,	দুর্গাতস,	দুর্গোৎসব,	
dei,	দেই,	দিই,	
lishenshe,	লিশেনসে,	লাইসেন্স,	
istoone,	ইস্টুন,	স্টোন,	
enjineers,	এনজিন্সার,	ইঞ্জিনিয়ার্স,	
brixfield,	ব্রিক্সফিল্ড,	ব্রিক্সফিল্ড,	
bbosonto,	ব্বসন্ত,	বসন্ত,	
dhadhiye,	ধাধিয়ে,	ধাধিয়ে,	
bite,	বিটে,	বাইট,	
oojbekistan,	অজবেকসিতান,	উজবেকিস্তান,	
bashoborty,	বাশবর্তী,	বশবর্তী,	
munsi,	মুনসি,	মুন্সী,	
ruby,	রুবি,	রুবী,	
alaoler,	আলাওলের,	আলাওলের,	
bangulzai,	বাঙ্গুলজাই,	বঙ্গুলিজাই,	
satarkabhabe,	সতর্কভাবে,	সতর্কভাবে,	
bhandar,	ভান্দার,	ভাণ্ডার,	
nowel,	নোেল,	নভেল,	
venush,	ভেনুশ,	ভেনাস,	
ashociatesh,	অসযাসিওয়েশ,	এসোসিয়েটস,	
bboponer,	ব্বপনের,	বপনের,	
mozlis,	মজলিস,	মজলিশ,	
kiandi,	কিয়ান্দি,	ক্যান্ডি,	
chakti,	চাকটি,	চাকতি,	
laaisheesh,	লাইসিস,	লাইসেন্স,	
ghatleo,	ঘাটলেও,	ঘটলেও,	
plate,	প্ল্যাট,	প্লেট,	
madeling,	ম্যাডেলিং,	মডেলিং,	
notey,	নোটে,	নোটে,	
crashlands,	ক্র্যাশল্যান্ডস,	ক্র্যাশল্যান্ডস,	
tiunara,	টিউনারা,	টিউনার,	
parkin,	পারকিন,	পার্কিং,	
dajjha,	দাঝঝা,	দাহ্য,	
shubhag,	শুভাগ,	শুভাগ,	
horiddare,	হরিদ্ারে,	হরিদ্বারে,	
safin,	সাফিন,	সাফিন,	
soundarja,	সৌন্দর্যা,	সৌর্ন্দয্য,	
masjidtir,	মাসজিদটির,	মসজিদটির,	
sheekar,	শিকার,	শিকার,	
emargency,	এমারজেন্সি,	এমার্জেন্সি,	
haripur,	হরিপুর,	হরিপুর,	
pratiyogitar,	প্রতিয়গিতার,	প্রতিযোগীতার,	
bowie,	বোইয়ে,	বওই,	
shiropar,	শিরোপার,	শিরোপার,	
plator,	প্ল্যাটটর,	প্লেটোর,	
juktorashtreo,	যুক্তরাষ্ট্রেও,	যুক্তরাষ্ট্রেও,	
dhandu,	ধন্দু,	ধন্দু,	
oichchheek,	ঐচ্ছিক,	ঐচ্ছিক,	
kodorer,	কদরের,	কদরের,	
bibadey,	বিবদে,	বিবাদে,	
deaubande,	ডিউবান্ডে,	দেওবন্দে,	
atmira,	আতমিরা,	আত্মীরা,	
gasthi,	গাস্থি,	গোষ্ঠী,	
ateetkale,	আতীতকালে,	অতীতকালে,	
colgirl,	কলগার্ল,	কলগার্ল,	
hosney,	হোসনে,	হোসনে,	
grontho,	গ্রন্থ,	গ্রন্থ,	
gobeshakgon,	গবেষকগণ,	গবেষকগণ,	
nabatarange,	নবরাঙ্গে,	নবতরঙ্গে,	
dipgulote,	ডিপগুলোতে,	দ্বীপগুলোতে,	
cheenja,	চিঞ্জা,	চেঞ্জ,	
adwanced,	অ্যাডব্যান্স,	অ্যাডভান্সড,	
juddhahato,	যুদ্ধাহাতো,	যুদ্ধাহত,	
tikto,	তিকটো,	তিক্ত,	
zeeland,	জিল্যান্ড,	জিল্যান্ড,	
pinogbagke,	পিনগবাগকে,	পিনগবাগকে,	
amorendro,	অমরেন্দ্র,	অমরেন্দ্র,	
michir,	মিচির,	মিচির,	
dhani,	ধনী,	ধানি,	
uthaney,	উঠানে,	উঠানে,	
balakarak,	বালাকার,	বলকারক,	
doula,	দৌলা,	দৌলা,	
spashtotai,	স্পাষ্টতাই,	স্পষ্টতই,	
mugdal,	মুগদাল,	মুগডাল,	
dipke,	দিপকে,	দ্বীপকে,	
udor,	উডোর,	উদর,	
aranyani,	আরণ্যানি,	অরণ্যানী,	
kleentoner,	ক্লিন্টনের,	ক্লিনটনের,	
sambatsarkal,	সম্ববসর্কল,	সম্বৎসরকাল,	
srabosty,	স্রাবোস্টি,	শ্রাবস্তী,	
shikkhadikkhay,	শিক্ষাকিখায়,	শিক্ষাদিক্ষায়,	
jonosomaj,	জনসমাজ,	জনসমাজ,	
khoakshir,	খোয়াক্ষীর,	খোয়াক্ষীর,	
edic,	এডিক,	এডিক,	
rajendracholer,	রাজেন্দ্রচচলের,	রাজেন্দ্রচোলের,	
daaradaa,	দারাদা,	দারদা,	
dakter,	ডাক্তের,	ডাকতের,	
sahozlabhbhatar,	সহললালভাভাতার,	সহজলভ্যতার,	
shoodhooi,	শুধুই,	শুধুই,	
nili,	নিলি,	নিলি,	
protishta,	প্রতিষ্টা,	প্রতিষ্টা,	
bojiye,	বজিয়ে,	বজিয়ে,	
chotogolper,	চটগল্পের,	ছোটগল্পের,	
pariyech,	পারিয়েছ,	পরিয়েছ,	
maley,	মালে,	মালে,	
planeti,	প্লানেটি,	প্লেনটি,	
pratishthanik,	প্রতিষ্ঠানিক,	প্রাতিষ্ঠানিক,	
sausagee,	সৌসাগী,	সসেজ,	
iqbalke,	ইকবালকে,	ইকবালকে,	
ghurechen,	ঘুরেছেন,	ঘুরেছেন,	
jeebnagore,	জীবনাগরে,	জীবননগর,	
cs,	সিএস,	সিএস,	
mujuru,	মুজুরু,	মুজুরু,	
assaciates,	অ্যাসাসিয়েটস,	এসোসিয়েটস,	
uindoos,	উইন্ডোস,	উইন্ডোস,	
dola,	দোলা,	দলা,	
mukherjee,	মুখেরজ্যি,	মুখার্জী,	
nisshongotake,	নিঃশঙ্গতাকে,	নিঃসঙ্গতাকে,	
vogno,	ভগ্ন,	ভগ্ন,	
scorey,	স্কোরি,	স্কোরে,	
kkhur,	ক্রুর,	ক্ষুর,	
girilal,	গিরিলাল,	গিরিলাল,	
bedantodhormo,	বেদন্তধর্ম,	বেদান্তধর্ম,	
ahong,	আহোং,	অহং,	
onupater,	অনুপাতের,	অনুপাতের,	
sompadonkaree,	সম্পাদনকারী,	সম্পাদনকারী,	
ranangane,	রাণাঙ্গনে,	রণাঙ্গনে,	
baire,	বাইরে,	বাইরে,	
motabolombira,	মতাবলম্বীরা,	মতাবলম্বীরা,	
ekoghore,	একঘরে,	একঘরে,	
dharavahiker,	ধারাভাহিকের,	ধারাবাহিকের,	
ekekrokom,	একেক্রকম,	একেকরকম,	
parisankhanbid,	পরিসাংখ্বিদ,	পরিসংখ্যানবিদ,	
zakharovar,	যাখারোভার,	জাখারোভার,	
khanonkaj,	খানকজান,	খননকাজ,	
bbiswasho,	বিবিস্বাসও,	বিশ্বাসও,	
idyi,	ইদিই,	আইডিই,	
kindom,	কিন্দোম,	কিংডম,	
kathghera,	কাঠঘেরা,	কাঠঘেরা,	
khappar,	খাপ্ার,	খপ্পর,	
jothon,	যথন,	যথন,	
myathiou,	ম্যাথিও,	ম্যাথিউ,	
neelkamal,	নেলকমাল,	নীলকমল,	
prokolpoti,	প্রকল্পটি,	প্রকল্পটি,	
ekok,	একক,	একক,	
shikhra,	শিখরা,	শিখরা,	
dai,	দাই,	ডে,	
sepha,	সেফা,	শেফ,	
soorsa,	সুরসা,	সোর্স,	
agomoney,	অগমনে,	আগমনে,	
monzushree,	মঞ্জুশ্রী,	মঞ্জুশ্রী,	
chomski,	চমস্কি,	চমস্কি,	
chhuteer,	ছুটির,	ছুটির,	
pnouchute,	প্নুছুতে,	পৌঁছুতে,	
abadamoner,	আবাদমনের,	অবদমনের,	
nothivukta,	নথিভুক্ত,	নথিভুক্ত,	
karore,	কারোরে,	কারোর,	
jaanachhe,	যানাচ্ছে,	জানাচ্ছে,	
phutonta,	ফুটন্টা,	ফুটন্ত,	
debdebyr,	দেবদেবীর,	দেবদেবীর,	
postay,	পোস্তায়,	পোস্টে,	
patengar,	পাটেঙ্গার,	পতেঙ্গার,	
iling,	ইলিং,	ইলিং,	
boiporiityen,	বৈপরিত্যেন,	বৈপরীত্যেন,	
monroe,	মনরয়ে,	মনেরোর,	
dikpal,	ডিকপাল,	দিকপাল,	
laga,	লাগা,	লগ,	
bokahoke,	বোকাহকে,	বকাহকে,	
pratijogira,	প্রতিযোগীরা,	প্রতিযোগীরা,	
tigmanshu,	তিগমন্চু,	তিগ্মাংশু,	
setike,	সেতিকে,	সেটিকে,	
cholochchitraeeo,	চলচ্চিত্রারই,	চলচ্চিত্রেও,	
korush,	করুশ,	ক্রুশ,	
baju,	বাজু,	বাজু,	
chaloke,	চালোকে,	চালকে,	
uponeeshod,	উপনেশদ,	উপনিষদ,	
poriharsoho,	পরিহারসহ,	পরিহারসহ,	
skirt,	স্কির্ট,	স্কার্ট,	
fotanor,	ফোটানোর,	ফোটানোর,	
nyata,	নায়াতা,	ম্যাট,	
sawam,	সায়াম,	সাওম,	
sazanor,	সাজানোর,	সাজানোর,	
kk,	কেকি,	কেকে,	
elakatike,	এলাকাটিকে,	এলাকাটিকে,	
baibosthaar,	বৈবস্থার,	ব্যবস্থার,	
dhache,	ধাচে,	ধাঁচে,	
addhattikotar,	আদ্ধাতিত্বকতার,	আধ্যাত্মিকতার,	
ved,	ভেদ,	বেদ,	
taffsherer,	তফফেশের,	তাফসীরের,	
nirikh,	নিরিখ,	নিরিখ,	
dweepgoolotey,	দ্বিপগুলোতে,	দ্বীপগুলোতে,	
padee,	পাড়ি,	পাড়ে,	
protijogiider,	প্রতিযোগীদের,	প্রতিযোগীদের,	
shilpikuler,	শিল্পিকুলের,	শিল্পীকুলের,	
atibiplabi,	অতিবিপ্লাবী,	অতিবিপ্লবি,	
mast,	মাস্ত,	মাস্ত,	
peengna,	পিংনা,	পিংনা,	
indrakanan,	ইন্দ্রকান,	ইন্দ্রকানন,	
path,	পাথ,	পাথ,	
nabotom,	নাবতোম,	নবতম,	
mashtarsha,	মাষ্টর্শ,	মাস্টার্স,	
roopdaan,	রূপদান,	রুপদান,	
lekhaksattwar,	লেখাস্তত্বর,	লেখকসত্ত্বার,	
wedanta,	ওয়াডান্টা,	বেদান্ত,	
scholastik,	স্কললাস্তিক,	স্কলাস্টিক,	
byaboharkarike,	ব্যবহারকারীকে,	ব্যবহারকারীকে,	
halding,	হ্যালডিং,	হোল্ডিং,	
digri,	ডিগ্রি,	ডিগ্রি,	
gudamjat,	গুদমজাত,	গুদামজাত,	
conflikt,	কনফ্লিক্ট,	কনফ্লিক্ট,	
sangram,	সংগ্রাম,	সঙ্গ্রাম,	
rajnikant,	রাজনীকান্ত,	রাজনীকান্ত,	
nopdnodir,	নপ্দনদির,	নদনদীর,	
generalissimo,	জেনারেলোসিমো,	জেনারেলিসিমো,	
kalirkhal,	কালিরখাল,	কালিরখাল,	
kormoi,	কর্মই,	কর্মই,	
eukalyptus,	ইউক্লাপাইপাস,	ইউক্যালিপ্টাস,	
chaka,	চাকা,	চাকা,	
shekarmani,	শেকর্মণি,	শেকরমানি,	
mukhbondho,	মুখবন্ধ,	মুখবন্ধ,	
protijogii,	প্রতিযোগী,	প্রতিযোগী,	
somoodrotote,	সমদ্রততে,	সমুদ্রতটে,	
rata,	রাতা,	রত,	
grahoksebai,	গ্রাহকসেবাই,	গ্রাহকসেবায়,	
baet,	বেইট,	বাইট,	
madelim,	ম্যাডেলিম,	মডেলিং,	
dokanei,	দোকানেই,	দোকানেই,	
elakatay,	এলাকাতেয়,	এলাকাতে,	
pujit,	পূজিত,	পুজিত,	
patjata,	পাটজাতা,	পাটজাত,	
pinglateo,	পিংলাতেও,	পিংলাতেও,	
keu,	কেউ,	কেউ,	
goshthiti,	গোষ্ঠিতি,	গোষ্ঠীটি,	
distibutor,	ডিস্টিবিটুর,	ডিস্টিবিউটারের,	
moushumei,	মৌশুমেই,	মৌসুমেই,	
raagee,	রাজি,	রাগী,	
udbhaboni,	উদ্ভাবনি,	উদ্ভাবনী,	
feroza,	ফেরোজা,	ফিরোজা,	
mukhabandha,	মুখববন্ধ,	মুখবন্ধ,	
ujobekeestaner,	উজবেকিস্তানের,	উজবেকিস্তানের,	
bhuushito,	ভূষিত,	ভূষিত,	
bostubad,	বস্তুবাদ,	বস্তুবাদ,	
abanishankar,	অবনিশঙ্কর,	অবনিশংকর,	
eexpreession,	এক্স্রিশনশ,	এক্সপ্রেশন,	
thakeni,	থাকেনি,	থাকেনি,	
nibeditar,	নিবেদিতার,	নিবেদিতার,	
niroja,	নিরোজা,	নিরোজা,	
poripaker,	পরিপাকের,	পরিপাকের,	
bheenisa,	ভীনিসা,	ভেনিস,	
elakatite,	এলাকাটিতে,	এলাকাটিকে,	
dharabahiktite,	ধারাবাহিকটিতে,	ধারাবাহিকটিতে,	
joisttho,	জৈস্থথ,	জ্যৈষ্ঠ,	
arg,	আর্গ,	আর্গ,	
basakey,	বাসাকে,	বাসাকে,	
guzober,	গুজবের,	গুজবের,	
manohputa,	মনঃপুতা,	মনঃপুত,	
ovarview,	ওভারভিউ,	ওভারভিউ,	
nariderke,	নারীদেরকে,	নারীদেরকে,	
bishwaashshoi,	বিশ্বাস্শই,	বিশ্বাসই,	
piulir,	পিউলির,	পিউলির,	
booponer,	বুপনের,	বপনের,	
oshtader,	অষ্টাদের,	ওস্তাদের,	
qaferderkey,	কাফারডেরকে,	কাফেরদেরকে,	
bapio,	বাপিও,	বাপিও,	
video,	ভিদেও,	ভিডিয়োও,	
byabosthar,	ব্যবস্থার,	ব্যাবস্থার,	
zaire,	জাইরে,	জাইরে,	
elahabade,	এলাহাবাদে,	এলাহাবাদে,	
ekla,	একলা,	একলা,	
si,	সি,	এসআই,	
oncholsomuho,	অঞ্চলসমূহ,	অঞ্চলসমূহ,	
vaticaner,	ভ্যাটিকেনার,	ভ্যাটিকানের,	
sursur,	সুরসুর,	সুরসুর,	
whole,	হোলে,	হোল,	
schilling,	স্কিলিং,	শিলিং,	
soteciety,	সোটেসিটি,	সোসাইটিতে,	
siit,	সিয়াট,	শীত,	
cena,	সেনাইএ,	সিনা,	
procharona,	প্রচারণা,	প্রচারণা,	
cathalic,	ক্যাথালিক,	ক্যাথলিক,	
liaodong,	লিয়াডওং,	লিয়াওদং,	
chittronatyokar,	চিত্তরণাত্যকার,	চিত্রনাট্যকার,	
atmobonchito,	আত্মবঞ্চিত,	আত্মবঞ্চিত,	
jamaanor,	জামানোর,	জমানোর,	
ekbai,	একবাই,	একবাই,	
ronodeep,	রনদীপ,	রণদীপ,	
abheedhaneek,	অভিধনাক,	অভিধানিক,	
fanding,	ফ্যান্ডিং,	ফান্ডিং,	
bonvumitey,	বনভুমিতে,	বনভূমিতে,	
chilahatee,	চিলাহাটি,	চিলাহাটি,	
audioguloke,	অডিওগুলোকে,	অডিওগুলোকে,	
shuchonakal,	শুচনাকাল,	সূচনাকাল,	
taufiq,	তাফিক,	তৌফিক,	
morathee,	মরাথী,	মরাঠি,	
idipasha,	ইডিপাপাশা,	ইডিপাস,	
hijritey,	হিজরিতে,	হিজরীতে,	
karaa,	কারা,	কারো,	
grooth,	গ্রথ,	গ্রোথ,	
faase,	ফাসে,	ফাঁসে,	
ekbakye,	একবাক্যে,	একবাক্যে,	
eucalyptus,	ইউক্লাল্টাপস,	ইউক্যালিপ্টাস,	
khaaneker,	খানেকের,	খানেকের,	
dhangsachchi,	ধংসাং্চি,	ধ্বংসাচ্ছি,	
chakundite,	চাকুন্ডিতে,	চাকুন্দিতে,	
shahabike,	শাহাবীকে,	সাহাবীকে,	
chalake,	চালাকে,	চালকে,	
mangoleek,	মঙ্গলীক,	মাঙ্গলিক,	
munjur,	মুঞ্জুর,	মুনজুর,	
bodhirta,	বোধিরটা,	বধিরতা,	
ekoirokom,	একরোকম,	একইরকম,	
bosontokke,	বসনতককে,	বসন্তকে,	
cheentaikaree,	চিনতাইকারী,	ছিনতাইকারী,	
mozdoor,	মজদুর,	মজদুর,	
forex,	ফরেক্স,	ফরেক্স,	
taronee,	তারণী,	তরণী,	
siddhantoo,	সিদ্ধান্তই,	সিদ্ধান্তও,	
firoze,	ফিরোজে,	ফিরোজ,	
ghoshito,	ঘোষিতো,	ঘোষিত,	
shikhbe,	শিখবে,	শিখবে,	
difinision,	ডিফিনিশন,	ডেফিনেশন,	
nagorikra,	নাগরিকরা,	নাগরিকেরা,	
jyaqasana,	জ্যাকাসন,	জ্যাকসন,	
prrajanankaal,	প্রজননকাল,	প্রজননকাল,	
grootha,	গ্রুথা,	গ্রোথ,	
anubhutimalar,	অনুভূতিমালার,	অনুভূতিমালার,	
jatata,	জাতাটা,	যতোটা,	
swatantrata,	স্বতন্ত্রতা,	স্বতন্ত্রতা,	
america,	আমেরিকা,	আমেরিকা,	
rejidens,	রেজিডেন্স,	রেসিডেন্স,	
antorvukta,	আন্তর্ভুক্ত,	অন্তর্ভুক্ত,	
lisense,	লিসেন্স,	লাইসেন্স,	
bee,	বিই,	বি,	
tasminer,	তাসমিনের,	তাসমিনের,	
hosto,	হস্ত,	হস্ত,	
dokan,	দোকান,	দোকান,	
antercticker,	অ্যান্টার্কটিকের,	অ্যান্টার্কটিকের,	
navaratri,	নবরাত্রী,	নবরাত্রি,	
ghumachche,	ঘুমাচ্ছে,	ঘুমাচ্ছে,	
towraat,	তৌরাত,	তওরাত,	
perri,	পেরি,	পেরি,	
senabahinikey,	সেনাবাহিনীকে,	সেনাবাহিনীকে,	
deil,	ডেইল,	ডেইল,	
shikhaboudi,	শিখাবৌডি,	শিখাবৌদি,	
gotihin,	গতিহীন,	গতিহীন,	
andamana,	আন্দামনা,	আন্দামান,	
chalachchitrer,	চলচচ্চিত্রের,	চলচ্চিত্রের,	
provur,	প্রভুর,	প্রভুর,	
santoshpore,	সন্তোষ্পরে,	সন্তোষপুর,	
bim,	বিমিআ,	বিম,	
neshadrabyer,	নেশাদ্রব্যের,	নেশাদ্রব্যের,	
sokkhomotabriddhi,	সক্ষমতাবৃদ্ধি,	সক্ষমতাবৃদ্ধি,	
onshogrohoner,	অংশগ্রহণের,	অংশগ্রহনের,	
aamor,	আমোর,	আমর,	
suchonakal,	সূচনাকাল,	সূচনাকাল,	
prakare,	প্রাকারে,	প্রকারে,	
inziniyarsa,	ইনজিনিয়ারসা,	ইঞ্জিনিয়ার্স,	
bojhaao,	বোঝাও,	বোঝাও,	
chandanara,	চন্দনারা,	চন্দনারা,	
aborto,	আবর্ত,	আবর্ত,	
romancha,	রোমাঞ্চা,	রোমাঞ্চ,	
eupheike,	ইউফেইকে,	ইউফেইকে,	
ancholgoolir,	আঁচলগুলির,	অঞ্চলগুলির,	
pharmesigulote,	ফার্মেসিগুলোতে,	ফার্মেসীগুলোতে,	
chenza,	চেঞ্জা,	চেঞ্জ,	
esoosiyetasa,	এসোসিয়েটাস,	এসোসিয়েটস,	
boikolyo,	বৈকল্য,	বৈকল্য,	
futonta,	ফুটন্টা,	ফুটন্ত,	
chouhate,	চৌহাতে,	চৌহাটে,	
sahooseekotar,	সহুসীকতার,	সাহসিকতার,	
carlos,	কার্লোস,	কার্লোস,	
neemitte,	নিমিত্বে,	নিমিত্তে,	
minister,	মিনিস্টের,	মিনিস্টার,	
ayumi,	আইয়ুমি,	আয়ুমি,	
zerusalemer,	জেরুসালেমের,	জেরুজালেমের,	
sthitiko,	স্থিতিকও,	স্থিতিকো,	
hights,	হাইটস,	হাইটস,	
armori,	আর্মোরি,	আরমোরি,	
nek,	নেক,	নেক,	
arke,	আর্কে,	আরকে,	
title,	টিটলে,	টাইটেল,	
uporitaley,	উপরিতালে,	উপরিতলে,	
chinito,	চিনিত,	চিনতো,	
show,	শোব,	শো,	
jaruri,	জারুরি,	জরূরী,	
neshnos,	নেশনোস,	নেশনস,	
kadapaker,	কাড়াপাকের,	কড়াপাকের,	
bidghootey,	বিদঘুটে,	বিদঘুটে,	
daqop,	ডাকোপ,	দাকোপ,	
musalmani,	মুসলমনি,	মুসলমানই,	
saifai,	সাইফাই,	সাইফাই,	
sharoker,	শারকের,	স্মারকের,	
dhanyi,	ধন্যি,	ধন্যি,	
nirikho,	নিরিখো,	নিরিখ,	
phox,	ফক্স,	ফক্স,	
ratishilatai,	রতিশীলতায়,	রতিশীলতায়,	
juboke,	যুবকে,	যুবকে,	
chirantan,	চিরান্তান,	চিরন্তন,	
sift,	সাফট,	শিফট,	
utsahi,	উৎসাহী,	উৎসাহী,	
jarmaniteo,	জর্মানীতেও,	জার্মানিতেও,	
ponthaar,	পন্থার,	পন্থার,	
vabuk,	ভ্যাবুক,	ভাবুক,	
kaferder,	কাফেরদের,	কাফেরদের,	
lutharan,	লুথারণ,	লুথেরান,	
kinto,	কিন্টো,	কিনত,	
talaa,	তালা,	তালা,	
hoteltite,	হোটেলটিতে,	হোটেলটিতে,	
kobutorer,	কবূতরের,	কবুতরের,	
bhadaka,	ভড়াকা,	ভদকা,	
murali,	মুরালি,	মুরলী,	
laps,	লাপস,	ল্যাপস,	
kyatagorir,	ক্যাটাগরির,	ক্যাটাগরির,	
kalakushalir,	কালকুশলীর,	কলাকুশলীর,	
gabhaskaar,	গাভাসকার,	গাভাস্কার,	
erythrian,	এরিথ্রিয়ান,	এরিথ্রিয়ান,	
anisa,	আনিস,	আনিস,	
gosthike,	গোষ্ঠীকে,	গোষ্ঠীকে,	
maarmaader,	মার্মাদের,	মারমাদের,	
commissionvogider,	কমিসনগোভীদের,	কমিশনভোগীদের,	
dokaangulotey,	দকানগুলোতে,	দোকানগুলোতে,	
erokomer,	এরকমের,	এরকমের,	
plasse,	প্লাস,	প্লাসে,	
dhanijomite,	ধনিজমিতে,	ধানিজমিতে,	
cinematographar,	সিনেমেটাগ্রাফোর,	সিনেমাটোগ্রাফার,	
bosoben,	বসবেন,	বসবেন,	
moushum,	মৌশুম,	মৌসুম,	
tapdei,	তাপদেই,	তাপড়েই,	
ikbaaler,	ইকবালের,	ইকবালের,	
asovyo,	অসভ্য,	অসভ্য,	
teamothy,	টিমোথি,	টিমোথি,	
laaishenshh,	লেইশেন্স,	লাইসেন্স,	
olympic,	ওলিমপিক,	অলিম্পিক,	
songkoloney,	সংকলনে,	সংকলনে,	
gazipur,	গাজীপুর,	গাজিপুর,	
contemporary,	কন্টেমপররি,	কন্টেম্পোরারি,	
matis,	মাতিস,	ম্যাটিস,	
nachar,	নাচার,	নাচার,	
pouchute,	পৌছুতে,	পৌঁছুতে,	
mirina,	মিরিনা,	মিরিনা,	
falak,	ফালাক,	ফলক,	
rushod,	রুশোদ,	রুশদ,	
tottorat,	তত্তরাত,	তওরাত,	
noitik,	নৈতিক,	নৈতিক,	
sosoa,	সসোয়া,	শশা,	
akhhunno,	আখুন্য,	অক্ষুণ্ণ,	
proteemake,	প্রতিমাকে,	প্রতিমাকে,	
suiza,	সুইজা,	সুইজা,	
heze,	হেজে,	হেজ,	
dipti,	দিপটি,	ডেপুটি,	
sangaskritipreme,	সংস্কৃতিপ্রেমে,	সংস্কৃতিপ্রেমে,	
koro,	করো,	করো,	
beam,	বিআইএম,	বিম,	
bikretaara,	বিক্রেতার,	বিক্রেতারা,	
laaisensh,	লাইসেন্স,	লাইসেন্স,	
pratisthanikvabe,	প্রতিস্থিনিকভাবে,	প্রাতিষ্ঠানিকভাবে,	
ajuhat,	অজুহাত,	অজুহাত,	
soinyora,	সৈন্যরা,	সৈন্যরা,	
zesa,	জেসা,	জেস,	
pranidero,	প্রাণীদেরও,	প্রানীদেরও,	
jyaqa,	জ্যাকা,	জ্যাক,	
dharavahikbhabe,	ধারাহাহিকভাবে,	ধারাবাহিকভাবে,	
tyapa,	ত্যাপা,	ট্যাপ,	
bbiseshyer,	বিবিশেষ্যের,	বিশেষ্যের,	
pacchi,	পাচি,	পাচ্ছি,	
hepatetisa,	হেপাটেটিসা,	হেপাটাইটিস,	
bo,	বব,	বু,	
tongaa,	টঙ্গা,	টোঙ্গা,	
bhangle,	ভাঙ্গে,	ভাঙলে,	
temanti,	তেমানটি,	তেমনটি,	
nichupattir,	নিচুপত্তির,	নিচুপট্টির,	
toki,	তোকি,	তকি,	
chatrorai,	চাতররাই,	ছাত্ররাই,	
bhromonkaale,	ভ্রমণকালে,	ভ্রমণকালে,	
stanahenja,	স্তনহেনন্জা,	স্টোনহেঞ্জ,	
bisshasi,	বিশশাসি,	বিশ্বাসী,	
sinakey,	সিনাকে,	সিনাকে,	
bishnoo,	বিষ্ণও,	বিষ্ণু,	
philo,	ফিলো,	ফিলো,	
marodeho,	মারোদেহ,	মরদেহ,	
maudelgulo,	মাউডেলগুলো,	মডেলগুলো,	
sobrakomer,	সব্রকোমের,	সবরকমের,	
prasadhoner,	প্রাসাধনের,	প্রসাধনের,	
bisshaskey,	বিশ্বসকে,	বিশ্বাসকে,	
rinobodh,	ঋণবোধ,	ঋণবোধ,	
siqhar,	সিখার,	শিকার,	
kanasarabheeshana,	কনসরেভেশন,	কনসারভেশন,	
adhunikkaley,	আধুনিকলাকে,	আধুনিককালে,	
byabosthar,	ব্যবস্থার,	ব্যবস্থার,	
shithilata,	শীথিলতা,	শিথিলতা,	
mugdha,	মুগ্ধা,	মুগ্ধ,	
hooldim,	হুডডিং,	হোল্ডিং,	
ongkush,	অংকুশ,	অংকুশ,	
rupert,	রুপার্ট,	রুপার্ট,	
jinsa,	জিনসা,	জিন্স,	
uindos,	উইন্ডোস,	উইন্ডোস,	
swarther,	স্বার্থের,	স্বার্থের,	
rajtontre,	রাজতন্ত্রে,	রাজতন্ত্রে,	
summer,	সুমের,	সামার,	
change,	চাঙ্গে,	চেঞ্জ,	
suraaropito,	সুরারপিত,	সুরারোপিত,	
orhan,	ওরহান,	ওরহান,	
showtey,	শোটে,	শোতে,	
thailandsaho,	থাইলানদাসহ,	থাইল্যান্ডসহ,	
jetam,	জেতাম,	যেতাম,	
tantubayer,	তান্তুবায়ের,	তন্তুবায়ের,	
lagto,	লাগতো,	লাগতো,	
ruptan,	রূপ্তন,	রূপটান,	
nederlande,	নেডারল্যান্ডে,	নেদারল্যান্ডে,	
ajibooner,	অজিবুনের,	আজীবনের,	
narishwar,	নারীষ্বর,	নারীশ্বরের,	
bosonte,	বসন্তে,	বসন্তে,	
gamdan,	গামদান,	গামদান,	
cxt,	সিসিসিটি,	সিএক্সটি,	
sulfatee,	সুলফাতি,	সালফেট,	
taufik,	তাফিক,	তৌফিক,	
vault,	ভাউল্ট,	ভল্ট,	
sangbadmadhyome,	সংবাদধ্ধমময়ে,	সংবাদমাধ্যমে,	
phiksa,	ফিক্স,	ফিক্স,	
flexta,	ফ্লেক্সটা,	ফ্লেক্সটা,	
chalachchitroke,	চালাচিত্রকে,	চলচ্চিত্রকে,	
porbotmala,	পর্বতমালা,	পর্বতমালা,	
subade,	সুবাদে,	সুবাদে,	
dakshinangsho,	দক্ষিণাংশ,	দক্ষিণাংশ,	
turkeyder,	টুরকেডিদের,	তুর্কিদের,	
songasthatir,	সংস্থাতির,	সংস্থাটির,	
noiteek,	নৈতিক,	নৈতিক,	
baganoto,	বাগানতো,	বাগানত,	
shootar,	সূতার,	শ্যুটার,	
chhuteete,	ছুটেতে,	ছুটিতে,	
jothartho,	যথার্থ,	যথার্থ,	
superheroo,	সুপারহেরও,	সুপারহিরো,	
kanshater,	কাঁশাতের,	কানসাটের,	
sobche,	সবছে,	সবচে,	
laiseensim,	লাইসেন্সিং,	লাইসেন্সিং,	
konoroop,	কনোরূপ,	কোনরূপ,	
moonshi,	মুনশি,	মুন্সি,	
anagarikra,	অনাগাকীরা,	অনাগরিকরা,	
tinhazar,	তিনহাজার,	তিনহাজার,	
jomjamat,	জমজামাত,	জমজমাট,	
borendroke,	বরেন্দ্রকে,	বরেন্দ্রকে,	
deepan,	দীপান,	দীপন,	
debdebier,	দেবডেবিয়ের,	দেবদেবীর,	
ghumunoi,	ঘুমুনোই,	ঘুমুনোই,	
bisheshya,	বিশেষ্য,	বিশেষ্য,	
dokkhinangsho,	দক্ষিণাংশ,	দক্ষিণাংশ,	
abheedhanic,	অভিধানিক,	অভিধানিক,	
suisharke,	সুইশারকে,	সুইশারকে,	
mukhya,	মুখ্যা,	মুখ্য,	
baffer,	বাফের,	বাফার,	
aporishodhito,	অপরিষদিত,	অপরিশোধিত,	
cholechi,	চলেছি,	চলেছি,	
prokolpogulor,	প্রকল্পগুলোর,	প্রকল্পগুলোর,	
obdee,	অব্দি,	অব্দি,	
gyada,	জ্যাদা,	গ্যাদা,	
serology,	সেরোলজি,	সেরোলজি,	
bahjya,	বাহজ্যা,	বাহ্য,	
guzon,	গুজন,	গুজব,	
assexe,	অসেস্সে,	অ্যাসেক্সে,	
kichutei,	কিছুতেই,	কিছুতেই,	
dharavassokar,	ধারাভাষককর,	ধারাভাষ্যকার,	
amanisha,	আমানিশা,	অমানিশা,	
khamotagulor,	ক্ষমতাগুলোর,	ক্ষমতাগুলোর,	
byabaharkaree,	ব্যবহারকারী,	ব্যবহারকারী,	
dormetori,	ডর্মেটোরি,	ডরমিটরি,	
byaboharkareer,	ব্যবহারকারীর,	ব্যবহারকারীর,	
messengerer,	মেসেঞ্জারের,	মেসেঞ্জারের,	
probeshan,	প্রবেশন,	প্রবেশন,	
sangbadmadhyamgulote,	সংবাদমাধমযগুলোতে,	সংবাদমাধ্যমগুলোতে,	
suporichita,	সুপরিচিতা,	সুপরিচিত,	
shhashtra,	শাস্ত্র,	শাস্ত্র,	
songasthaner,	সংস্ঠানের,	সংস্থানের,	
nanilalke,	নানিলালকে,	ননীলালকে,	
mohajot,	মহাযোত,	মহাজোট,	
ghotolen,	ঘটলেন,	ঘটলেন,	
bhimsenkei,	ভীমসেনকেই,	ভীমসেনকেই,	
rakkhanbhag,	রক্ষণভাগ,	রক্ষণভাগ,	
ganaporibahaner,	গণপরিবহণের,	গণপরিবহনের,	
anchalgoolir,	আঁচালগুলির,	অঞ্চলগুলির,	
mononiitoder,	মনননীতদের,	মনোনীতদের,	
avidur,	আভিদুর,	আভিদুর,	
sakshatkarer,	সাক্ষাৎকারের,	সাক্ষাৎকারের,	
harbare,	হরবারে,	হারবারে,	
badhamuktovabe,	বাধামুক্তভাবে,	বাধামুক্তভাবে,	
confliqt,	কনফ্লিক্ট,	কনফ্লিক্ট,	
municipal,	মুনিসিপাল,	মিউনিসিপ্যাল,	
chintamani,	চিন্তমনি,	চিন্তামনি,	
sohinsotar,	সহিনসতার,	সহিংসতার,	
damodar,	দামোদার,	দামদর,	
konroop,	কন্রপ,	কোনরূপ,	
shangkalonti,	শাংকলন্তি,	সংকলনটি,	
parther,	পার্থের,	পার্থের,	
deraa,	দেরা,	ডেরা,	
tookror,	টুকরর,	টুকরোর,	
cloudbook,	ক্লাউডবুক,	ক্লাউডবুক,	
bongshokey,	বংশকে,	বংশকে,	
pack,	পাক,	প্ল্যাক,	
buth,	বুথ,	বুথ,	
aakik,	আকিক,	আকিক,	
hondooras,	হন্ডারাস,	হন্ডুরাস,	
sportstar,	স্পোট্সস্টার,	স্পোর্টসস্টার,	
sharifpur,	শরিফপুর,	শরিফপুর,	
ramolino,	রামোলিনো,	রামোলিনো,	
rena,	রেনা,	রেনো,	
jens,	জেন্স,	জিন্স,	
tawnship,	তাঁশশিপ,	টাউনশিপ,	
vvimsenn,	ভিভিমেন্ন,	ভীমসেন,	
probondhobhittik,	প্রবণ্ধভিত্তিক,	প্রবন্ধভিত্তিক,	
sbaajan,	স্বজন,	স্বজন,	
neker,	নেকের,	নেকের,	
antarctica,	অ্যান্টর্কটিকা,	অ্যান্টার্কটিকা,	
proshtotto,	প্রশ্তত্ব,	প্রস্ত্তত,	
dankaan,	ডাঁকান,	ডানকান,	
saazano,	সাজানো,	সাজানো,	
onurbar,	অনুর্বার,	অনুর্বর,	
aakaabaar,	আকাবার,	আকাবার,	
ekspression,	এক্সপ্রেশন,	এক্সপ্রেশন,	
bike,	বিকে,	বাইক,	
nirvachokder,	নির্ভাচকদের,	নির্বাচকদের,	
bisnuke,	বিস্নুকে,	বিষ্ণুকে,	
aabarte,	আবর্তে,	আবর্তে,	
sangasthagulo,	সংস্থাগুলো,	সংস্থাগুলো,	
adhyattikota,	অধ্যাত্তিকতা,	আধ্যাত্মিকতা,	
nathivukteer,	নাথিভুক্তির,	নথিভুক্তির,	
queri,	কোয়েরি,	কোয়েরি,	
orrgho,	অর্ঘ,	অর্ঘ্য,	
manabmaner,	মানবম্নের,	মানবমনের,	
bondira,	বন্ডিরা,	বন্দীরা,	
shishu,	শিশু,	শিশু,	
senabahinio,	সেনাবাহিনীও,	সেনাবাহিনীও,	
thechar,	থেচার,	থ্যাচার,	
rabo,	রাবো,	রব,	
youth,	ইৌথ,	ইয়ুথ,	
abeganuvutir,	আবেগানুবুটির,	আবেগানুভূতির,	
dai,	দাই,	দিই,	
ganokantha,	গণকান্থা,	গণকণ্ঠ,	
elaaka,	এলাকা,	এলাকা,	
mekapgulo,	মেকাপগুলো,	মেকআপগুলো,	
kram,	ক্রম,	ক্রম,	
bohorompurer,	বহরমপুরের,	বহরমপুরের,	
pretti,	প্রেতটি,	প্রিটি,	
bondhukey,	বন্ধুকেে,	বন্ধুকে,	
tachnach,	তাচনাচ,	তছনছ,	
sotorkobhabey,	সতর্কভাবে,	সতর্কভাবে,	
naajii,	নাজি,	নাত্সি,	
browser,	ব্রাউসের,	ব্রাউজার,	
kaatbey,	কাতবে,	কাটবে,	
ashirbadatri,	আশির্বাদাত্রী,	আশীর্বাদাত্রী,	
somonnitobhabe,	সমন্নিতভাবে,	সমন্বিতভাবে,	
dheke,	ধেকে,	ঢেকে,	
koordider,	কুরদিদের,	কুর্দিদের,	
nabbata,	নব্বতা,	নাব্যতা,	
distance,	ডিসট্যান্স,	ডিসট্যান্স,	
hojurer,	হজুরের,	হজুরের,	
sipa,	সিপা,	শিপ,	
sumeeta,	সুমিতা,	সুমিতা,	
obosorer,	অবসরের,	অবসরের,	
utpatti,	উৎপত্তি,	উতপত্তি,	
sadeena,	সাদিনা,	সাডেন,	
orunima,	ওরুনিমা,	অরুণিমা,	
maailkhanek,	মাইলখানক,	মাইলখানেক,	
saifullahil,	সাইফুল্লাহিল,	সাইফুল্লাহিল,	
shudhir,	শুধীর,	শুধীর,	
khoka,	খোকা,	খোকা,	
ixprission,	ইক্সপ্রিশন,	এক্সপ্রেশন,	
bhageri,	ভাগেরি,	ভাগেরই,	
avetar,	আভেতার,	অবতার,	
romjaner,	রোমজানের,	রমযানের,	
snehban,	স্নেহবান,	স্নেহবান,	
mentither,	মেন্টিথের,	মেনটিথের,	
suparahiro,	সুপারাহীরও,	সুপারহিরো,	
vugorvey,	ভাগরভে,	ভূগর্ভে,	
doltyagi,	দল্ত্যাগী,	দলত্যাগী,	
shasheja,	শাশেজা,	সসেজ,	
bishesyo,	বিশেষ্য,	বিশেষ্য,	
shajano,	শাজানো,	সাজানো,	
kanuner,	কানুনের,	কানুনের,	
swairacharibirodhi,	স্বৈরাচারিরোধী,	স্বৈরাচারীবিরোধী,	
parswer,	পারস্বের,	পার্শ্বের,	
charpanch,	চারপাংচ,	চারপাঁচ,	
bhoolapuka,	ভূলপুকা,	ভোলাপুক,	
bolbo,	বলবো,	বলবো,	
dombhoke,	দম্ভকে,	দম্ভকে,	
byatikrami,	ব্যতিক্রমী,	ব্যতিক্রমী,	
korle,	করলে,	করলে,	
bhenicer,	ভেনিসের,	ভেনিসের,	
naraphoka,	নারাফোকা,	নরফোক,	
lambaate,	লাম্বাতে,	লম্বাটে,	
fasir,	ফাসির,	ফাসীর,	
anusthane,	অনুষ্ঠানে,	অনুষ্ঠানে,	
armeenian,	আর্মিনিয়ান,	আর্মেনিয়ান,	
humira,	হুমিরা,	হুমিরা,	
torunosomriddho,	তরুণসমৃদ্ধ,	তরুণসমৃদ্ধ,	
plaiin,	প্লেইন,	প্লেন,	
jokkher,	যক্ষের,	যক্ষের,	
treend,	ট্রিন্ড,	ট্রেন্ড,	
aansaareer,	আনসারীর,	আনসারীর,	
shringge,	শ্রিং,	শৃঙ্গে,	
nirabota,	নিরাবতা,	নিরবতা,	
bhaisaho,	ভাইসহঃ,	ভাইসহ,	
anchalei,	আঞ্চালেই,	অঞ্চলেই,	
sheepha,	শিফা,	শেফ,	
okritokarjo,	অক্রিতকর্য,	অকৃতকার্য,	
protizogiita,	প্রতিযোগীতা,	প্রতিযোগীতা,	
upobashii,	উপবাশিই,	উপবাসী,	
drabyatah,	দ্রব্যতঃ,	দ্রব্যতঃ,	
simaa,	সিমা,	সীমা,	
obosan,	অবসান,	অবসান,	
bhromoner,	ভ্রমণের,	ভ্রমণের,	
cholochchitro,	চলচচ্চিত্র,	চলচ্চিত্র,	
pratijogitamulak,	প্রতিযোগিতামূলক,	প্রতিযোগীতামূলক,	
gandharir,	গান্ধারীর,	গান্ধারীর,	
trutimatra,	ট্রুতিমাত্র,	ত্রুটিমাত্র,	
harishankar,	হরিষণকর,	হরিশংকর,	
aanaan,	আনন,	আনান,	
uddhrita,	উদ্ধৃতা,	উদ্ধৃত,	
noditei,	নদিতেই,	নদীতেই,	
akhandata,	আখন্ডতা,	অখণ্ডতা,	
kheshar,	খেশার,	খেশার,	
scholarship,	স্কলারশিপ,	স্কলারশিপ,	
awatar,	আয়াতার,	অবতার,	
chalochchitro,	চালচচ্ছিত্র,	চলচ্চিত্র,	
dayitta,	দাই়িত্া,	দায়িত্ব,	
akatwa,	আকাত্ব,	একাত্ব,	
jitpur,	জিতপুর,	জিতপুরের,	
vishnuu,	বিষ্ণু,	বিষ্ণু,	
kharavel,	খারাবেল,	খারবেল,	
gabinius,	গাবিনিয়াস,	গাবিনিআস,	
bohoodin,	বহুদিন,	বহুদিন,	
crucer,	ক্রাসার,	ক্রুশের,	
parinati,	পরিণাটি,	পরিণতি,	
nazad,	নাজাড়,	নজদ,	
impaction,	ইমপ্যাশন,	ইমপ্যাকশন,	
motkey,	মটকে,	মতকে,	
pharn,	ফার্ন,	ফার্ন,	
brail,	ব্রেইল,	ব্রেইল,	
vimsen,	ভিমসেন,	ভীমসেন,	
awrbit,	আরবিত,	অরবিট,	
pyore,	প্য়ার,	পিওর,	
reshidensha,	রেশিদেন্স,	রেসিডেন্স,	
liseensee,	লিসেন্সি,	লাইসেন্স,	
jumlalancer,	জুমলাল্নাসের,	জুমলাল্যান্সার,	
irana,	ইরানা,	ইরান,	
nothibhukteer,	নথিভুক্তির,	নথিভুক্তির,	
difinisian,	ডিফিনিসিয়ান,	ডেফিনেশন,	
arekdol,	আরেকডল,	আরেকদল,	
pachchi,	পাচ্চি,	পাচ্ছি,	
jansa,	জানসা,	জন্স,	
poscime,	পশ্চাইম,	পশ্চিমে,	
upobasee,	উপবাসী,	উপবাসী,	
cheess,	চেস,	চেস,	
aieesha,	আইশা,	আইএএস,	
temonvabe,	তেমনভাবে,	তেমনভাবে,	
chalochchitraeei,	চলচচ্ষিত্রায়,	চলচ্চিত্রেই,	
soceitytey,	সোস্টিইতে,	সোসাইটিতে,	
sheshdinti,	শেষদিনটি,	শেষদিনটি,	
sathik,	সাথিক,	সঠিক,	
grambasheeo,	গ্রামবাশীও,	গ্রামবাসীও,	
blasterke,	ব্লাস্টারকে,	ব্লাস্টারকে,	
doobate,	দূবতে,	ডুবাতে,	
abhirupbabuke,	অভিরূপবাবুকে,	অভিরূপবাবুকে,	
hindutirtha,	হিন্দুতির্থ,	হিন্দুতীর্থ,	
prosadhoni,	প্রসাধনী,	প্রসাধনী,	
baugey,	বাউজে,	বাগে,	
sikkhakromer,	শিক্ষাক্রমের,	শিক্ষাক্রমের,	
pravritir,	প্রাভৃতির,	প্রভৃতির,	
mojdur,	মজদুর,	মজদুর,	
poschime,	পশ্চিমে,	পশ্চিমে,	
jeebonnogor,	জীবননগর,	জীবননগর,	
adorsho,	আদর্শ,	আর্দশ,	
plainey,	প্লেইন,	প্লেনে,	
breakthrough,	ব্রেক্টরুগ,	ব্রেকথ্রু,	
ceramiker,	সেরামিকের,	সিরামিকের,	
mukhyo,	মুখ্যো,	মুখ্য,	
paikgachha,	পাইকগাছা,	পাইকগাছা,	
biswashi,	বিশ্বাশী,	বিশ্বাসই,	
chyeta,	চ্যাতা,	চ্যাট,	
munim,	মুনিম,	মুনিম,	
delibhara,	দেলিভরা,	ডেলিভার,	
patininda,	পাটিনিন্ড,	পতিনিন্দ,	
rajyotiro,	রাজ্যতিরও,	রাজ্যটিরও,	
zubokra,	যুবকরা,	যুবকরা,	
bodna,	বোদনা,	বদনা,	
kanar,	কানার,	কণার,	
ooipoka,	উইপকা,	উইপোকা,	
bondhuvabaponyo,	বন্ধুভাবনপয্য,	বন্ধুভাবাপন্ন,	
erajyobasi,	এরাজ্যবাসী,	এরাজ্যবাসী,	
homsher,	হোমশের,	হোমসের,	
neelfamarir,	নেলফামারির,	নীলফামারীর,	
hyaloyin,	হ্যালিয়ন,	হ্যালোইন,	
ghumacchilo,	ঘুমাক্ছিল,	ঘুমাচ্ছিল,	
mitrata,	মিত্রাটা,	মিত্রতা,	
catholicder,	ক্যাথোলিকদের,	ক্যাথলিকদের,	
jaatti,	জাত্তি,	জাতটি,	
annimated,	অ্যানিমেটেড,	এনিমেটেড,	
parikha,	পারিখা,	পরিখার,	
quota,	কুতো,	কোটা,	
ekatitto,	একাতিত্ব,	একাতিত্ব,	
ekshoti,	একশটি,	একশোটি,	
muktijuddhojato,	মুক্তিযুদ্ধজাত,	মুক্তিযুদ্ধজাত,	
hizrite,	হিজরিতে,	হিজরীতে,	
biphal,	বিফল,	বিফল,	
relance,	রিল্যান্স,	রিলায়েন্স,	
bhogni,	ভগ্নি,	ভগ্নী,	
kaash,	কাশ,	কাস,	
naneer,	নানীর,	নানীর,	
sudrissho,	সুদ্রিষ,	সুদৃশ্য,	
bishwaashshke,	বিশ্বাশককে,	বিশ্বাসকে,	
poriskoron,	পরিস্করণ,	পরিষ্করণ,	
byathapather,	ব্যথপথঠের,	ব্যথাপথের,	
prachando,	প্রাচাঁডো,	প্রচণ্ড,	
raiialati,	রায়ালালাটি,	রয়্যালটি,	
karam,	কররম,	কেরাম,	
asovya,	অসভ্যা,	অসভ্য,	
providere,	প্রভীদেরে,	প্রভাইডারে,	
taalaal,	তালাল,	তালাল,	
transhapharma,	ট্রান্সফর্ম,	ট্রান্সফর্ম,	
kortona,	কর্তনা,	করতনা,	
byabaharkarike,	ব্যবহারকারীকে,	ব্যবহারকারীকে,	
chilahaati,	চিলাহাটি,	চিলাহাটি,	
jones,	জনেস,	জোন্স,	
kushumba,	কুশুমবা,	কুশুম্বা,	
kul,	কুল,	কুল,	
sossar,	সোসার,	সকার,	
manushsoho,	মানুষসহ,	মানুষসহ,	
chirontan,	চিরন্তান,	চিরন্তন,	
nathibhuktir,	নথিভুক্তির,	নথিভুক্তির,	
shudden,	শুদ্দেন,	সাডেন,	
korimpur,	করিমপুরের,	করিমপুর,	
shomostigoto,	মমস্তিগত,	সমষ্টিগত,	
maunchostho,	মাঞ্চস্থ,	মঞ্চস্থ,	
mele,	মেল,	মাইল,	
uporoshtho,	উপরস্থ,	উপরস্থ,	
daybhager,	ডাইভাগের,	দায়ভাগের,	
puroheetder,	পুরোহেতদের,	পুরোহিতদের,	
bharpur,	ভারপুর,	ভরপুর,	
milekhaanek,	মিলেখানেক,	মাইলখানেক,	
drissogulo,	দৃষ্যগুলো,	দৃশ্যগুলো,	
laesens,	লেসেন্স,	লাইসেন্স,	
maktum,	মক্তুম,	মাকতুম,	
iub,	আইআব,	আইইউবি,	
porizoner,	পরিজনের,	পরিজনের,	
indra,	ইন্দ্রা,	ইন্দ্র,	
protul,	প্রতুল,	প্রতুল,	
ghumachchila,	ঘুমাচ্ছিলা,	ঘুমাচ্ছিল,	
carlo,	কারলো,	কার্লো,	
ajij,	আজিজ,	আজিজ,	
nirmolotaa,	নির্মলতা,	নির্মলতা,	
sadbi,	সাদবি,	সাধ্বী,	
johny,	জোন্নি,	জনি,	
sharthe,	শার্থে,	স্বার্থে,	
sorsa,	সোরসা,	সোর্স,	
taap,	টাপ,	ট্যাপ,	
metropalitana,	মেট্রোপ্লালিটানা,	মেট্রোপলিটন,	
somratra,	সম্রাত্র,	সম্রাটরা,	
bisshasyi,	বিশ্বস্যি,	বিশ্বাসই,	
protiakromonei,	প্রতিয়াক্রমণেই,	প্রতিআক্রমণেই,	
charukala,	চারুকালা,	চারুকলা,	
homshke,	হোমশকে,	হোমসকে,	
rubidiyaam,	রুবিদিমায়,	রুবিডিয়াম,	
somabeshti,	সমাবেষটি,	সমাবেশটি,	
langhoner,	ল্যাংঘনের,	লংঘনের,	
suparichito,	সুপারিচিত,	সুপরিচিত,	
maadla,	ম্যাডলা,	মাদলা,	
musalmanderke,	মুসলমন্ডেরকে,	মুসলমানদেরকে,	
vabaponno,	ভাবাপন্ন,	ভাবাপন্ন,	
alexanderke,	আলেক্সান্ডারকে,	আলেকজান্ডারকে,	
barrageke,	বারাজেজকে,	ব্যারেজকে,	
parijaner,	পারিজনের,	পরিজনের,	
aashanka,	আশঙ্কা,	আশংকা,	
chai,	চাই,	ছাই,	
elakaatite,	এলাকাটিতে,	এলাকাটিকে,	
jaanar,	জানার,	জানার,	
licencedhari,	লাইসেন্সধারী,	লাইসেন্সধারী,	
akram,	আকরাম,	আকরাম,	
dephinishion,	ডেফিশিনেশন,	ডেফিনেশন,	
fatkabazare,	ফতকাবাজারে,	ফাটকাবাজারে,	
holuder,	হলুদের,	হলুদের,	
krisenter,	ক্রিসেন্টের,	ক্রিসেন্টের,	
volapuk,	ভোলাপুক,	ভোলাপুক,	
soource,	সুর্স,	সোর্স,	
armshtrong,	আর্মস্ট্রিং,	আর্মস্ট্রং,	
qlauda,	ক্লাউড,	ক্লাউড,	
blogarra,	ব্লগাররা,	ব্লগাররা,	
baibasthaar,	বৈবস্থার,	ব্যবস্থার,	
milekhanek,	মিলেখানেক,	মাইলখানেক,	
nehle,	নেহলে,	নেহলে,	
orthanitir,	অর্থানিটির,	অর্থনীতির,	
aairish,	আইরিশ,	আইরিস,	
kaamij,	কামিজ,	কামিজ,	
bakhyateet,	বাখ্যাটিত,	ব্যাখ্যাতীত,	
stagecraft,	স্ট্যাটাক্রাফ্ট,	স্টেজক্রাফট,	
jini,	জিনি,	যিনি,	
oikhan,	ঐখান,	ঐখান,	
ponjikar,	পঞ্জিকার,	পঞ্জিকার,	
nirgomon,	নির্গমন,	নির্গমন,	
sip,	সিপ,	শিপ,	
saoum,	সুউজম,	সাওম,	
booksar,	বুকসার,	বুক্সার,	
pader,	পাদের,	প্যাডের,	
alaul,	আলাউল,	আলাওল,	
mookhomandoler,	মুখমানন্ডলের,	মুখমণ্ডলের,	
attacharito,	অট্টাচারিত,	অত্যাচারিত,	
johor,	জরর,	জহর,	
poripakey,	পরিপাকে,	পরিপাকে,	
thyachar,	থ্যাচার,	থ্যাচার,	
aaziz,	আজিজ,	আজিজ,	
utsahamulak,	উৎসাহূলকল,	উৎসাহমূলক,	
bouddho,	বৌদ্ধ,	বৌদ্ধ,	
balatarin,	বালাতারিন,	বালাতারিয়ান,	
nanabornobishishto,	নানাবর্নবিষিষ্ট,	নানাবর্ণবিশিষ্ট,	
byaboharkariyi,	ব্যবহারকারী,	ব্যবহারকারীই,	
gonesher,	গনেশের,	গণেশের,	
steeit,	স্টিট,	স্টেইট,	
gonohotyakey,	গণহত্যাকে,	গণহত্যাকে,	
nagorikke,	নাগরিককে,	নাগরিককে,	
teentir,	তিন্টির,	তিনটির,	
quartar,	কোয়ার্তার,	কোয়ার্টার,	
teennis,	টিনিস,	টেনিস,	
oitijjha,	ঐতিজ্ঝা,	ঐতিহ্য,	
zarniz,	জার্নিজ,	জারনিজ,	
ispreedshiit,	ইস্প্রেশিত,	স্প্রেডশীট,	
noitikota,	নৈতিকতা,	নৈতিকতা,	
abdoone,	আব্নুউন,	আবদুন,	
said,	সাইদ,	সাইদ,	
charger,	চার্গের,	চার্জার,	
mohammadi,	মোহাম্মদি,	মুহাম্মদী,	
byaktikegreptar,	ব্যক্তিকেপ্রগ্্তর,	ব্যক্তিকেগ্রেপ্তার,	
deh,	দেহ,	দেহ্,	
narsaari,	নারসারী,	নার্সারি,	
jati,	জাতি,	যাতি,	
ponero,	পনেরও,	পনের,	
phising,	ফিসিং,	ফিসিং,	
vobani,	ভোবানি,	ভবানী,	
upacharjo,	উপাচার্য,	উপাচার্য,	
poste,	পস্তে,	পোস্টে,	
hosne,	হোসনে,	হোসনে,	
bhenom,	ভেনোম,	ভেনম,	
haridware,	হরিদ্বারে,	হরিদ্বারে,	
shukrabab,	শুক্রবাব,	শুক্রবাব,	
swartho,	স্বার্থ,	স্বার্থ,	
kuhelika,	কুহেলিকা,	কুহেলিকা,	
batom,	বাতোম,	বাটম,	
kaande,	কান্দে,	কাণ্ডে,	
manushti,	মানুষটি,	মানুষটি,	
ganoporibahoner,	গণপরিবাহনের,	গণপরিবহনের,	
harbur,	হারবুর,	হারবার,	
shift,	শিফট,	শিফট,	
rushad,	রুশাদ,	রুশদ,	
innahu,	ইন্নাহু,	ইন্নাহু,	
ancholtike,	আঞ্চলটিকে,	অঞ্চলটিকে,	
mukharji,	মুখর্জি,	মুখার্জী,	
emarjensi,	এমারজেন্সি,	এমার্জেন্সি,	
amittrakkhor,	অমিত্রাক্ষর,	অমিত্রাক্ষর,	
lakkhero,	লক্ষেরও,	লক্ষেরও,	
uter,	উতের,	উটের,	
baaik,	বাইক,	বাইক,	
mulor,	মুলোর,	মুলোর,	
shasonkarta,	শাসনকার্তা,	শাসনকর্তা,	
volivoler,	ভলিভোলের,	ভলিভলের,	
ship,	শিপ,	শিপ,	
jansha,	জনশা,	জন্স,	
modelgulo,	মডেলগুলো,	মডেলগুলো,	
faaj,	ফাযাজ,	ফাজ,	
orbeet,	অরবিত,	অরবিট,	
bitertrate,	বিটারট্রেট,	বাইটারট্রেট,	
gronthao,	গ্রন্থাও,	গ্রন্থও,	
ancholsomuho,	আঞ্চলসমূহ,	অঞ্চলসমূহ,	
dharabahikotitey,	ধারাবাহিকতিতে,	ধারাবাহিকটিতে,	
dibug,	দিবুগ,	ডিবাগ,	
dep,	ডিপ,	ডেপ,	
zerusalem,	জেরুসালেম,	জেরুজালেম,	
mandanda,	মান্দন্দ,	মানদণ্ড,	
bahubar,	বাহুবার,	বহুবার,	
jonoshongjog,	জনশঙ্যোগ,	জনসংযোগ,	
shit,	শীত,	শীত,	
thabai,	থাবাই,	থাবাই,	
sweety,	স্বিটি,	সুইটি,	
shikkharrthirao,	শিক্ষার্থীরাও,	শিক্ষার্থীরাও,	
fastara,	ফাস্তারা,	ফস্টার,	
vagni,	ভাগনি,	ভগ্নী,	
sanstha,	সংস্থা,	সংস্থা,	
safiin,	সাফিন,	সাফিন,	
enamela,	এনামেলা,	এনামেল,	
query,	কোয়ারি,	কোয়েরি,	
medilek,	মেডিলেক,	মেডিলেক,	
chhintayikari,	ছিন্তা়িকারী,	ছিনতাইকারী,	
kyatgarite,	ক্যাটগারিতে,	ক্যাটগারিতে,	
shakara,	শাকারা,	সাকার,	
sikkharthirao,	শিক্ষার্থীরাও,	শিক্ষার্থীরাও,	
zoubankal,	যৌবাঙ্কাল,	যৌবনকাল,	
aaps,	এএপসএস,	এএপিএস,	
shaater,	সাতের,	শ্যুটার,	
bosben,	বসবেন,	বসবেন,	
kayed,	কায়েদ,	কায়েদ,	
rudrasagar,	রুদ্রসাগর,	রুদ্রসাগরের,	
pyaleshtainer,	প্যালেশ্টেইনের,	প্যালেস্টাইনের,	
rokkhonabekkhoner,	রক্ষণাকেবক্ষণের,	রক্ষণাবেক্ষণের,	
glanio,	গ্লানিও,	গ্লানিও,	
anektai,	অনেকতাই,	অনেকটাই,	
bhittimul,	ভিত্তিমূল,	ভিত্তিমূল,	
rakkhanvag,	রক্ষণভাগ,	রক্ষণভাগ,	
ceramicer,	সেরামিসের,	সিরামিকের,	
dorneca,	ডর্নেকা,	ডরনেকা,	
aziza,	আজিজা,	আজিজা,	
armshtronj,	আর্মস্ট্রজ,	আর্মস্ট্রং,	
bbosben,	ব্ববসেন,	বসবেন,	
paira,	পাইরা,	পাইরা,	
aashtikotaa,	আষ্টিকতা,	আস্তিকতা,	
purbanchaler,	পূর্বঞ্চলের,	পূর্বাঞ্চলের,	
masjidsaho,	মাসজিদসহ,	মসজিদসহ,	
chalochchitreer,	চালচচ্ছিত্রির,	চলচ্চিত্রের,	
byomkes,	ব্যমকেস,	ব্যোমকেশ,	
bachai,	বাচাই,	বাছাই,	
bulichev,	বুলিছেভ,	বুলিচেভ,	
japanostho,	জাপানস্থ,	জাপানস্থ,	
societytey,	সোসিটিতে,	সোসাইটিতে,	
breel,	ব্রিল,	ব্রিল,	
aajeej,	আজীজ,	আজিজ,	
bhaangchur,	ভাংচুর,	ভাংচুর,	
moshahidur,	মোশাহিদুর,	মোশাহিদুর,	
yathaarthabhaabe,	যথথ্যর্থভাবে,	যথার্থভাবে,	
dokaanei,	দোকানেই,	দোকানেই,	
bihar,	বিহার,	বিহার,	
horidbar,	হরিদবার,	হরিদ্বার,	
nabayug,	নবায়ুগ,	নবযুগ,	
samashtike,	সমাাষ্টিকে,	সমষ্টিকে,	
drishyogulote,	দৃশ্যগুলোতে,	দৃশ্যগুলোতে,	
vitti,	ভিত্তি,	ভিত্তিই,	
dinar,	দিনার,	ডিনার,	
muhaiminer,	মুহাইমিনের,	মুহাইমিনের,	
donat,	দোনাত,	ডোনাট,	
tigre,	তিগ্রে,	টাইগার,	
seguloi,	সেগুলোই,	সেগুলোই,	
ooipokar,	উইপকার,	উইপোকার,	
existing,	এক্সিস্টিং,	এক্সিসটিং,	
meghachchanno,	মেঘাচ্ছন্ন,	মেঘাচ্ছন্ন,	
saramukhe,	সরমামুখে,	সারামুখে,	
mawdeel,	মওদেল,	মডেল,	
samyuktha,	সমযুক্ঠ,	সামিউক্তা,	
bedey,	বেদে,	বেদে,	
modhumotii,	মধুমোতিই,	মধুমতী,	
chaalkee,	চালকি,	চালকে,	
purborekorde,	পূর্বরেকরদে,	পূর্বরেকর্ডে,	
kogake,	কোগাকে,	কোগাকে,	
lambi,	লাম্বি,	লম্বি,	
reshmirekha,	রেশমিরেখা,	রেশমীরেখা,	
bibader,	বিবাদের,	বিবাদের,	
brookoleen,	ব্রুকোলীন,	ব্রুকলিন,	
flux,	ফ্লাক্স,	ফ্লাস্ক,	
aro,	আরো,	আরও,	
yaq,	যাক,	ইয়াক,	
baikalyo,	বাইকাল্য,	বৈকল্য,	
jaunotar,	যৌনতার,	যৌনতার,	
prarthitao,	প্রার্থীতাও,	প্রার্থীতাও,	
ivil,	ইইভিল,	ইভিল,	
kaalengaa,	কালেঙ্গা,	কালেঙ্গা,	
jotota,	জতটা,	যতোটা,	
ghomtaa,	ঘোমটা,	ঘোমটা,	
chapchap,	চাপচাপ,	চাপচাপ,	
shangkulaan,	শাংকুলান,	সংকুলান,	
mitro,	মিত্র,	মিত্র,	
saamaanya,	সামান্য,	সামান্য,	
madhabike,	মাধাবিকে,	মাধবীকে,	
mangolic,	ম্যানগোলিক,	মাঙ্গলিক,	
kirti,	কীর্তি,	কীর্তি,	
cheef,	চিফ,	শেফ,	
sangitanusthane,	সঙ্গীতানুষ্ঠানে,	সঙ্গীতানুষ্ঠানে,	
rezidence,	রেজিডেন্সে,	রেসিডেন্স,	
nirbaahe,	নির্বাহে,	নির্বাহে,	
sharansthal,	শরনস্থল,	শরণস্থল,	
patrol,	পাত্রল,	পেট্রোল,	
rohinibabu,	রোহিনীবাবু,	রোহিনীবাবু,	
heepatitis,	হিপাটিটিটিস,	হেপাটাইটিস,	
dhormoprobortokder,	ধর্মপ্রবকর্তদের,	ধর্মপ্রবর্তকদের,	
sqalastiqa,	স্কালস্তিকা,	স্কলাস্টিক,	
machkabar,	মাককাবার,	মাচকাবার,	
argho,	অর্ঘ,	অর্ঘ্য,	
batikromee,	বাতিক্রমী,	ব্যতিক্রমী,	
soomitrar,	সুমিত্রার,	সুমিত্রার,	
degreeo,	ডেগরিও,	ডিগ্রিও,	
evereste,	এভেরেস্টে,	এভারেস্টে,	
bonorajite,	বনরাজিতে,	বনরাজিতে,	
kaaferder,	কাফেরদের,	কাফেরদের,	
armashtram,	আর্মশ্ত্রম,	আর্মস্ট্রং,	
supreetira,	সুপ্রিতীরা,	সুপ্রীতিরা,	
ghamta,	ঘামটা,	ঘোমটা,	
ukeliptash,	উকেলিপ্তাস,	ইউক্যালিপ্টাস,	
tukroke,	টুকরোকে,	টুকরোকে,	
parq,	পার্ক,	পার্ক,	
podarthobidder,	পদার্থবিদদের,	পদার্থবিদদের,	
manab,	মানাব,	মানব,	
toxoid,	টক্সোড,	টক্সয়েড,	
primoo,	প্রিমু,	প্রিমো,	
ghoomato,	ঘুমাতো,	ঘুমাতো,	
conflict,	কনফ্লিক্ট,	কনফ্লিক্ট,	
elakaai,	এলাকাই,	এলাকাই,	
sallallahu,	সাল্লাল্লুহু,	সল্লাল্লাহু,	
korkotkraantee,	করকটক্রান্তে,	কর্কটক্রান্তি,	
bhalobaas,	ভালোবাস,	ভালোবাসা,	
bishasey,	বিশাসে,	বিশ্বাসে,	
rajnoitik,	রাজনৈতিক,	রাজনৈতীক,	
sangkulaan,	সংকুলন,	সংকুলান,	
shomser,	শমসের,	সমশের,	
battery,	ব্যাটারি,	ব্যাটারী,	
ghenshei,	ঘেনশেই,	ঘেঁষেই,	
orbi,	অরবি,	ওরবি,	
janamukhi,	জানামুখী,	জনমুখী,	
ministara,	মিনিস্তরর,	মিনিস্টার,	
karima,	কারিমা,	করিম,	
angsogrohone,	অংসগ্রহণে,	অংশগ্রহনের,	
toranganj,	তোরাঙ্গঞ্জ,	তোরাবগঞ্জ,	
shem,	সেম,	সেম,	
nariderke,	নারীদেরকে,	নারিদেরকে,	
poddhotiteyi,	পদ্ধতিতেই,	পদ্ধতিতেই,	
anyarup,	অন্যরূপ,	অন্যরূপ,	
ganonanatto,	গণনানত্ত,	গণনাট্য,	
hadisti,	হাদিস্তি,	হাদিসটি,	
giitikobita,	গীতিকবিতা,	গীতিকবিতা,	
musolmanera,	মুসলমানেরা,	মুসলমানেরা,	
farid,	ফারিদ,	ফরিদ,	
aamontrito,	আমন্ত্রিত,	আমন্ত্রিত,	
suchanakal,	সূচনাকাল,	সূচনাকাল,	
infarmatian,	ইনফররেমেশন,	ইনফরমেশন,	
temonbhabe,	তেমনভাবে,	তেমনভাবে,	
keui,	কেউই,	কেউই,	
yuroo,	যুরু,	ইউরো,	
obhaarbhiu,	অভারভিউ,	ওভারভিউ,	
ajuhath,	অজুনাথ,	অজুহাত,	
chikittsar,	চিকিৎসার,	চিকিত্সার,	
dibya,	দিব্য,	দিব্যা,	
kanasharabheshhana,	কনাশরেভেষণ,	কনসারভেশন,	
graambaaseer,	গ্রামবাসীর,	গ্রামবাসীর,	
sampadon,	সম্পাদন,	সম্পাদন,	
lungiti,	লুঙ্গিটি,	লুঙ্গিটি,	
marketin,	মার্কেটিন,	মার্কেটিং,	
biswashi,	বিশ্বাশী,	বিশ্বাসী,	
codee,	কোডি,	কোডে,	
chalachchitroi,	চলচচ্ছিত্রই,	চলচ্চিত্রই,	
uddharkarmirai,	উদ্ধরকর্মীরাই,	উদ্ধারকর্মীরাই,	
saver,	সাভার,	সেভার,	
transform,	ট্রান্সফর্ম,	ট্রান্সফর্ম,	
bohudin,	বহুদিন,	বহুদিন,	
qraima,	ক্রেইমা,	ক্রাইম,	
gorrer,	গরের,	গোরের,	
porinoti,	পরিণতি,	পরিণতি,	
gurmukh,	গুরমুখ,	গুরমুখ,	
zonsa,	জনসা,	জোন্স,	
chorban,	চরবান,	চর্বন,	
shrichaitanyadev,	শ্রীচাতন্যদেব,	শ্রীচৈতন্যদেব,	
laaisens,	লাইসেন্স,	লাইসেন্স,	
ganakantha,	গণকান্থ,	গণকণ্ঠ,	
dewaben,	দেওয়াবেন,	দেওয়াবেন,	
helloin,	হেলন,	হ্যালোইন,	
karmojog,	কারমযোগ,	কর্মযোগ,	
jontrototto,	যন্ত্রতত্ত্ব,	যন্ত্রতত্ত্ব,	
europia,	ইউরোপিয়া,	ইউরোপিয়া,	
bisheshyo,	বিশেষ্য,	বিশেষ্য,	
taroni,	তারোনি,	তরণী,	
tiuning,	টিউনিং,	টিউনিং,	
boudhher,	বৌধের,	বৌদ্ধের,	
saom,	সাওম,	সাওম,	
vodqa,	ভোডকা,	ভদকা,	
sukumaree,	সুকুমারী,	সুকুমারী,	
sangosrobomukto,	সংস্রবমুক্ত,	সংস্রবমুক্ত,	
bijito,	বিজিত,	বিজিত,	
kings,	কিংস,	কিংস,	
danaqana,	দানাকানা,	ডানকান,	
rajbandir,	রাজবন্দীর,	রাজবন্দীর,	
eevil,	ইভিল,	ইভিল,	
miraclee,	মিরাকলি,	মিরাকেল,	
fishing,	ফিশিং,	ফিসিং,	
streegon,	স্ট্রীগন,	স্ত্রীগণ,	
neutrinoo,	নিউট্রিনু,	নিউট্রিনো,	
bhittitei,	ভিত্তিতেই,	ভিত্তিতেই,	
dakten,	ডাকটেন,	ডাকতেন,	
loombinee,	লুম্বিনি,	লুম্বিনী,	
shekender,	শেকেন্দর,	সেকেন্ডের,	
utshahomulok,	উৎসাহমূলক,	উৎসাহমূলক,	
black,	ব্ল্যাক,	ব্ল্যাক,	
batsmanei,	ব্যাটসম্যানেই,	ব্যাটসম্যানই,	
phartha,	ফার্থা,	ফার্থ,	
tenishe,	তেনিশে,	টেনিসে,	
blacq,	ব্ল্যাক,	ব্ল্যাক,	
bamni,	বামনি,	বামনী,	
tomader,	তমাদের,	তোমাদের,	
eura,	ইউররা,	ইউরো,	
jhijhi,	ঝিঝি,	ঝিঝি,	
porirshoder,	পরিশ্ষদের,	পরির্ষদের,	
ghoorchen,	ঘুরছেন,	ঘুরেছেন,	
swadhinotatukui,	স্বাধীনতাটুকুই,	স্বাধীনতাটুকুই,	
onker,	অঙ্কার,	ওঙ্কার,	
tochhnochh,	তনছন্চ,	তছনছ,	
sangkalanti,	সংকলন্তি,	সংকলনটি,	
ancholsaha,	আঞ্চলসহ,	অঞ্চলসহ,	
chhedon,	ছেদন,	ছেদন,	
ghoomachhe,	ঘুমাছে,	ঘুমাচ্ছে,	
laiseensee,	লাইসেন্সি,	লাইসেন্স,	
reflex,	রিফ্লেক্স,	রিফ্লেক্স,	
olpo,	অল্প,	অল্প,	
dibate,	দিবাতে,	ডিবেট,	
bhupal,	ভুপাল,	ভূপাল,	
laat,	লাতো,	লাট,	
abhijitda,	অভিজিতদা,	অভিজিতদা,	
basermick,	বাসেরমিক,	বেসারমিক,	
aatto,	এটিই,	আত্ম,	
sthaponagulo,	স্থাপনাগুলো,	স্থাপনাগুলো,	
prokalpagulo,	প্রকালপুগলো,	প্রকল্পগুলো,	
aarik,	আরিক,	আরিক,	
parkasa,	পারকাসা,	পার্কস,	
shikshakbrindo,	শিক্ষাবৃৃন্দ,	শিক্ষকবৃন্দ,	
aprasangikbhabei,	অপ্রাসঙ্গীকভাবেই,	অপ্রাসঙ্গিকভাবেই,	
otyacharer,	অত্যাচারের,	অত্যাচারের,	
chintakarma,	চিন্তাকর্ম,	চিন্তাকর্ম,	
wagadada,	ওয়াগাদাড়া,	বাগদাদ,	
matorom,	মাতোরোম,	মাতরম,	
segular,	সেগুলার,	সেগুলোর,	
lubitz,	লুবিটজ,	লুবিৎজ,	
directorate,	ডিরেক্টরেট,	ডিরেক্টরেট,	
paab,	পাব,	পাব,	
ashok,	আশক,	আশোক,	
shite,	শীতে,	শীতে,	
urey,	উরে,	ইউরি,	
nirapattamulok,	নিরাপত্তমূলক,	নিরাপত্তামূলক,	
ghumachhe,	ঘুমাচ্ছে,	ঘুমাচ্ছে,	
chaalaabi,	চালাবি,	চালাবে,	
baibosthar,	বৈবস্থার,	ব্যবস্থার,	
russad,	রুসাদ,	রুশদ,	
chapal,	চাপাল,	চপল,	
hamburgey,	হ্যামবার্গে,	হামবুর্গে,	
dacope,	ডাকোপ,	দাকোপ,	
supplenza,	সাপলেঞ্জা,	সাপলেঞ্জা,	
ghotleyo,	ঘটলেও,	ঘটলেও,	
ponchaashjon,	পঞ্চাশজন,	পঞ্চাশজন,	
dighol,	দিঘল,	দীঘল,	
gingbhalobasen,	গিংভাবাসেন,	গিংভালোবাসেন,	
poripake,	পরিপাকে,	পরিপাকে,	
ohalyar,	ওহাল্যার,	অহল্যার,	
chalochchitraeeo,	চলচচ্ছিত্রীও,	চলচ্চিত্রেও,	
bii,	বিআইআই,	বি,	
madhukori,	মাধুকরি,	মাধুকরী,	
armeeniyana,	আর্মিনীয়ন,	আর্মেনিয়ান,	
heart,	হার্ট,	হার্ট,	
duhsthanostho,	দুঃখ্যানস্থ,	দুঃস্থানস্থ,	
noteti,	নোটেটি,	নোটটি,	
giitikobitar,	গীতিকবিতার,	গীতিকবিতার,	
lyataa,	ল্যাটা,	ল্যাটা,	
prokolpow,	প্রকল্পও,	প্রকল্পও,	
shuri,	শুরি,	সুরি,	
bhalobasar,	ভালোবাসার,	ভালোবাসার,	
tanshree,	তাঁশ্রী,	তানশ্রী,	
kompeeto,	কম্পিত,	কম্পিত,	
hastamathun,	হস্তমথন,	হস্তমথুন,	
mayily,	মেয়িলি,	মাইলি,	
manir,	মানির,	মনির,	
anichchi,	আনিচ্ছি,	আনিচ্ছি,	
choshon,	চোষন,	চোষণ,	
aalkaatra,	আলকাত্র,	আলকাতরা,	
mumtazer,	মুমতাজের,	মুমতাজের,	
bharatey,	ভারাতে,	ভারতে,	
gitikobita,	গীতিকবিতা,	গীতিকবিতা,	
paolasthi,	পাওলাস্থি,	পাওলাসথি,	
shektor,	শেকটর,	সেক্টর,	
huka,	হুকা,	হুক,	
chhutochhooti,	ছুটোছুটি,	ছুটোছুটি,	
jhonkar,	ঝোঁকার,	ঝঙ্কার,	
birishiritey,	বিরিশিরিতে,	বিরিশিরিতে,	
jonesh,	জনেশ,	জোন্স,	
maritimer,	মারিতিমের,	মেরিটাইমের,	
bosantake,	বসানটাকে,	বসন্তকে,	
themekey,	থেমেকে,	থিমকে,	
nathivukta,	নাথিভুক্ত,	নথিভুক্ত,	
silabhara,	সিলাভরা,	সিলভার,	
eshtoniya,	এষ্টনীয়,	এস্তোনিয়া,	
latsaheb,	লাতসাহেব,	লাটসাহেব,	
durgatsabe,	দুর্গতসবে,	দুর্গোৎসবে,	
madhoori,	মধুরী,	মাধুরী,	
footbalarra,	ফুটবলররা,	ফুটবলাররা,	
ekghare,	একঘাে,	একঘরে,	
sobchey,	সবছে,	সবচে,	
makong,	মাকং,	মেকং,	
binee,	বিনী,	বেনি,	
vortuki,	ভর্ুটিকি,	ভর্তুকি,	
pathanatak,	পাথানাটাক,	পথনাটক,	
avinetar,	অভিনেতার,	অভিনেতার,	
dekaner,	দেকানের,	দেকানের,	
milton,	মিলটন,	মিলটন,	
shorifer,	শরীফের,	শরিফের,	
bage,	বাগে,	বাগে,	
site,	সিতে,	সিটে,	
purple,	পুর্পল,	পার্পেল,	
dormroome,	ডর্মরুমে,	ডর্মরুমে,	
oyebjin,	ওয়েজ্নিন,	ওয়েবজিন,	
liedtke,	লিডেটকে,	লইডটক,	
manobikotao,	মানবিকতাও,	মানবিকতাও,	
munot,	মুনোত,	মুনোট,	
corymb,	করমম্ব,	করিম,	
cantan,	ক্যান্টান,	ক্যান্টন,	
ramantika,	রামন্তিকা,	রোমান্টিক,	
taatey,	তাতে,	তাতে,	
logotype,	লগোটাইপ,	লোগোটাইপ,	
horipur,	হরিপুর,	হরিপুর,	
matt,	ম্যাট,	ম্যাট,	
graambasider,	গ্রামবাসীদের,	গ্রামবাসীদের,	
arsie,	আর্সি,	আরসিএ,	
qaro,	কারো,	কারো,	
bajpa,	বজপা,	বাজপা,	
jamjomat,	জামোজমত,	জমজমাট,	
rohasyer,	রোহাস্যের,	রহস্যের,	
digree,	ডিগ্রি,	ডিগ্রি,	
bishshasho,	বিশ্বাসও,	বিশ্বাসও,	
cheerontan,	চিরন্তান,	চিরন্তন,	
toptoshele,	তপ্তশেলে,	তপ্তশেলে,	
atmiyasulabh,	আত্মিয়সমূল,	আত্মীয়সুলভ,	
favorite,	ফাভরিতে,	ফেভারিট,	
haitasha,	হাইতাশা,	হাইটস,	
yucalyptus,	যুকালেপ্টাস,	ইউক্যালিপ্টাস,	
deelibhara,	দীলিভরা,	ডেলিভার,	
bbiswashi,	বিবিস্বাশী,	বিশ্বাসই,	
daraider,	ডারাইদের,	দরাইদের,	
panchbar,	পাঁচবার,	পাঁচবার,	
bojhao,	বোঝাও,	বোঝাও,	
bhiktara,	ভিকটারা,	ভিক্টর,	
sollallhu,	সোল্লাহলু,	সল্লাল্লাহু,	
sommotitey,	সম্মতিতে,	সম্মতিতে,	
aizulke,	আইজুলকে,	আইজুলকে,	
geographics,	জেওগ্রাফিক্স,	জিওগ্রাফিকস,	
pisach,	পিসাচ,	পিশাচ,	
amarika,	অমারিকা,	আমেরিকা,	
meshintao,	মেশিনটাও,	মেশিনটাও,	
ghaghat,	ঘঘঘট,	ঘাঘট,	
azimpur,	আজিমপুর,	আজিমপুর,	
muhuriganj,	মুহুরীগঞ্জ,	মুহুরীগঞ্জ,	
bangalore,	বাঙ্গালোর,	ব্যাঙ্গালুরে,	
stoic,	স্টোইক,	স্টোয়িক,	
ghoor,	ঘুর,	ঘুর,	
bulan,	বুলান,	বুলান,	
debete,	দেবেতে,	ডিবেট,	
marathi,	মারাথি,	মরাঠি,	
beekaargrasta,	বীকারগ্রস্ত,	বিকারগ্রস্ত,	
average,	অভারেজ,	এভারেজ,	
adhyatmikata,	অধ্যাত্মিকতা,	আধ্যাত্মিকতা,	
siropa,	সিরোপা,	শিরোপা,	
eoki,	ইউকি,	এওকি,	
yak,	যাক,	ইয়াক,	
protijogitamulok,	প্রতিযোগিতামূলক,	প্রতিযোগীতামূলক,	
brojomohun,	ব্রজোমমূহন,	ব্রোজোমোহন,	
jotharthovabey,	যথার্থভাবে,	যথার্থভাবে,	
antorbhuktimulak,	আন্তর্ভূমিকামক,	অন্তর্ভুক্তিমূলক,	
mukhamandoler,	মুখামান্ডলের,	মুখমণ্ডলের,	
cloring,	ক্লোরিং,	ক্লোরিং,	
heena,	হীনা,	হেনা,	
rananganey,	রাণঙ্গনে,	রণাঙ্গনে,	
sealvi,	সিলভি,	সিলভি,	
cholocchitrer,	চলচচিত্রের,	চলচ্চিত্রের,	
hugeke,	হুগেকে,	হিউজকে,	
bidyadanke,	বিদ্যাদানকে,	বিদ্যাদানকে,	
okkhorke,	অক্ষরকে,	অক্ষরকে,	
seekkhaou,	শিক্ষাুৌ,	শিক্ষাও,	
lettar,	লেট্টার,	লেটার,	
anandamahale,	আনন্দমহলে,	আনন্দমহলে,	
torutoler,	তরুতলের,	তরুতলের,	
machhti,	মাছটি,	মাছটি,	
jontropatigulite,	যন্ত্রপাতিগুলিতে,	যন্ত্রপাতিগুলিতে,	
farhetin,	ফারহেটিন,	ফারহেতিন,	
sofie,	সোফি,	সোফি,	
deeares,	ডিয়ারস,	ডিআরএস,	
pingna,	পিংনা,	পিংনা,	
asociatis,	অসোসায়িটিস,	এসোসিয়েটস,	
argead,	আর্জেড,	আর্জিদ,	
songbadmadhyame,	সংবাদধ্ধামমে,	সংবাদমাধ্যমে,	
habathu,	হাবাথু,	হাবাথু,	
saranor,	সারানোর,	সরানোর,	
nick,	নিক,	নিক্,	
vangley,	ভ্যাংলেই,	ভাঙলে,	
capshule,	ক্যাপশুলে,	ক্যাপসুল,	
deputee,	দেপুতি,	ডেপুটি,	
kirke,	কিরকে,	কিরকে,	
robot,	রবত,	রোবোট,	
ramchander,	রামচন্দের,	রামচন্দরের,	
jommu,	জম্মু,	জম্মু,	
shingping,	শিংপিং,	শিংপিং,	
goora,	গুরা,	গোর,	
sahozlabhbhotar,	সহললালভভাতার,	সহজলভ্যতার,	
rahi,	রাহি,	রাহী,	
samley,	সামলে,	সামলে,	
jaandrel,	যান্দ্রেল,	জাঁদরেল,	
dojo,	দোজো,	ডোজো,	
danata,	দানাটা,	ডোনাট,	
khiladirao,	খিলাড়িরাও,	খিলাড়িরাও,	
chaudhurider,	চৌধুরীদের,	চৌধুরীদের,	
odeb,	ওদেব,	ওদেব,	
gobeshokgon,	গবেষকগণ,	গবেষকগণ,	
stona,	স্টোনা,	স্টোন,	
fongli,	ফংলি,	ফংলি,	
tukrowti,	টুকরোটি,	টুকরোটি,	
kale,	কালে,	কালে,	
babare,	বাবারে,	বাবারে,	
eokee,	ইউকি,	এওকি,	
fostar,	ফোস্টার,	ফস্টার,	
hugheke,	ঘুঘেকে,	হিউজকে,	
mosjidtir,	মসজিদটির,	মসজিদটির,	
varote,	ভারোতে,	ভারতে,	
standards,	স্ট্যান্ডার্ডস,	স্টান্ডার্ডস,	
kingsh,	কিংশ,	কিংস,	
bipti,	বিপ্তি,	বিপ্তি,	
veemsen,	ভিমসেন,	ভীমসেন,	
chetanagato,	চেতানাগত,	চেতনাগত,	
magical,	ম্যাজিক্যাল,	ম্যাজিকাল,	
samany,	সামান্নি,	সামান্য,	
jomoker,	জমকের,	জমকের,	
lutharen,	লুথারেন,	লুথেরান,	
panchashjan,	পঞ্চশজন,	পঞ্চাশজন,	
wilderske,	উিলডার্সকে,	উইল্ডার্সকে,	
prokolpogulikei,	প্রকল্পগুলিকেই,	প্রকল্পগুলিকেই,	
seqtara,	সেক্তারা,	সেক্টর,	
shringa,	শ্রিংগা,	শৃঙ্গ,	
katateo,	কাটাতেও,	কাটাতেও,	
nabatamo,	নবতামো,	নবতম,	
myari,	ম্যারি,	ম্যারি,	
taunasipa,	টাউনাসিপা,	টাউনশিপ,	
srivatsalakshanang,	শ্রীবৎৎকাসকালং,	শ্রীবৎসলক্ষণং,	
onchalgulir,	অঞ্চালগুলির,	অঞ্চলগুলির,	
vugoley,	ভাগোলে,	ভূগোলে,	
ap,	এপিপিআ,	আপ,	
teemothy,	টেমোথি,	টিমোথি,	
baarnis,	বার্নিস,	বার্নিশ,	
haris,	হারিস,	হ্যারিস,	
jatinke,	জাতিনকে,	যতীনকে,	
kheylechen,	খেইলেছেন,	খেলেছেন,	
bouddher,	বৌদ্ধের,	বৌদ্ধের,	
arshie,	আরশি,	আরসিএ,	
dembakreeti,	দেম্বাকরিটি,	ডিম্বাকৃতি,	
osoborno,	অসবর্ণ,	অসবর্ণ,	
bibhinno,	বিভিন্ন,	বিভন্ন,	
biplabeer,	বিপ্লাবীর,	বিপ্লবীর,	
ched,	চেড,	ছেদ,	
kobulennechha,	কবুলেনেেছা,	কবুলেন্নেছা,	
hitaishi,	হিতাইশি,	হিতৈষী,	
babona,	বাবোনা,	বাবনা,	
tooku,	টুকু,	টুকু,	
emerjency,	এমারজেন্সি,	এমার্জেন্সি,	
karmosansthan,	কর্মসানস্থান,	কর্মসংস্থান,	
dhos,	ধোস,	ধস,	
nirmankaaj,	নির্মানকাজ,	নির্মাণকাজ,	
digrir,	দিগ্রীর,	ডিগ্রির,	
lagchhe,	লাগছে,	লাগছে,	
mexicoteo,	মেক্সিকোটেও,	মেক্সিকোতেও,	
touraat,	তৌরাত,	তওরাত,	
riphleksa,	রিফলেকসা,	রিফ্লেক্স,	
amudey,	আমুদে,	আমুদে,	
horiddar,	হরিদ্দার,	হরিদ্বার,	
bodhukeo,	বোধুকেও,	বধুকেও,	
addabaj,	আদ্দাবাজ,	আড্ডাবাজ,	
sondhisthaponer,	সন্ধিস্থাপনের,	সন্ধিস্থাপনের,	
pothnirdeshona,	পথন্ির্ডেশশন,	পথনির্দেশনা,	
naazee,	নাজে,	নাত্সি,	
dera,	দেরা,	ডেরা,	
bone,	বনে,	বনে,	
subader,	সুবাদের,	সুবাদে,	
meloonborroner,	মেলবনবর্নের,	মেলবোর্নের,	
ateetkaale,	আতেতকালে,	অতীতকালে,	
monzeele,	মন্জিলে,	মঞ্জিলে,	
edipass,	এডিপাস,	ইডিপাস,	
shariba,	শারিবা,	শরিবা,	
prashikkhane,	প্রশীক্ষণে,	প্রশিক্ষণে,	
siddhante,	সিদ্ধান্তে,	সিদ্ধান্তে,	
rachonakal,	রচনাকাল,	রচনাকাল,	
langhangulir,	লঙ্গনগুলির,	লঙ্ঘনগুলির,	
taler,	তালের,	তালের,	
bikargrasta,	বিকারগ্রস্ত,	বিকারগ্রস্ত,	
tahorir,	তাহরীর,	তাহরীর,	
jamjamat,	জাজমামাত,	জমজমাট,	
masjidke,	মাসজিদকে,	মসজিদকে,	
korimer,	করিমের,	করিমের,	
deputy,	ডিপিটি,	ডেপুটি,	
billaho,	বিল্লাহো,	বিল্লাহ,	
bolatkar,	বলাটকার,	বলাৎকার,	
nathivookto,	নাথিভক্ত,	নথিভুক্ত,	
ernad,	এরনাদ,	এরনাড,	
rajdhani,	রাজধানি,	রাজধানি,	
mandope,	ম্যান্ডপে,	মন্ডপে,	
sahittekder,	সাহিত্েদকের,	সাহিত্যেকদের,	
qara,	কারা,	কর,	
ovidhanik,	অভিধানিক,	অভিধানিক,	
kharar,	খারার,	খরার,	
kareer,	কারের,	কারীর,	
monjooshree,	মঞ্জুশ্রী,	মঞ্জুশ্রী,	
premoronge,	প্রেমোঙ্গো,	প্রেমরঙে,	
modele,	মডেল,	মডেলে,	
proboleme,	প্রবলেমে,	প্রবলেমে,	
itostatah,	ইতস্তাতাহ,	ইতস্ততঃ,	
manjushri,	মঞ্জুষ্রী,	মঞ্জুশ্রী,	
qulim,	কুলিম,	কুলিং,	
saatzoner,	সাতজনের,	সাতজনের,	
bornanukrome,	বর্ণানুক্রমে,	বর্নানুক্রমে,	
directorete,	ডিরেক্টরিতে,	ডিরেক্টরেট,	
bastubad,	বস্তুবাদ,	বস্তুবাদ,	
barack,	বার্ক,	বারাক,	
seconder,	সেকন্ডার,	সেকেন্ডের,	
welaqama,	ওেেকামা,	ওয়েলকাম,	
horippur,	হরিপপুর,	হরিপুর,	
siitei,	সিতেই,	শীতেই,	
karmokarke,	কার্মকারকে,	কর্মকারকে,	
jeten,	জেতেন,	জেতেন,	
nogore,	নগরে,	নগরে,	
pancbaar,	পাযান্কবার,	পাঁচবার,	
grambaashio,	গ্রামবাশিও,	গ্রামবাসীও,	
keuoi,	কেউই,	কেউই,	
matrirup,	মাতৃরূপ,	মাতৃরূপ,	
ganosochetonota,	গণসোচেেনতা,	গণসচেতনতা,	
mette,	মেটে,	ম্যাট,	
pratista,	প্রতিস্তা,	প্রতিষ্টা,	
drissoke,	দৃষ্দকে,	দৃশ্যকে,	
kinsha,	কিনশা,	কিংস,	
nirbahi,	নিরবাহী,	নির্বাহি,	
mohit,	মোহিত,	মুহিত,	
augustine,	অগস্টিন,	অগাস্টিন,	
foxcon,	ফক্সকন,	ফক্সকন,	
angkita,	আংকিটা,	অঙ্কিতা,	
pratisthanik,	প্রতিস্থানিক,	প্রাতিষ্ঠানিক,	
murader,	মুরাদের,	মুরাদের,	
satan,	সাতান,	শয়তান,	
torikher,	তরিখের,	তরিখের,	
arthanitike,	অর্থনীতিকে,	অর্থনীতিকে,	
byke,	বিকে,	বাইক,	
temone,	টেমনে,	তেমনই,	
gostigulo,	গস্তিগুলো,	গোষ্ঠীগুলো,	
dharabahikbhabe,	ধারাবাহিকভাবে,	ধারাবাহিকভাবে,	
dakkhinkare,	দক্ষিণকারে,	দক্ষিণকরে,	
bohudeen,	বহুদুন,	বহুদিন,	
arifin,	আরিফিন,	আরিফিন,	
uzobekeestaan,	উজবেকসিত্যান,	উজবেকিস্তান,	
karadando,	কারাদান্ডো,	কারাদণ্ড,	
chemjong,	চেমজং,	চেমজং,	
lyandim,	ল্যান্ডিম,	ল্যান্ডিং,	
dinara,	দিনারা,	ডিনার,	
shoreefer,	শরীফের,	শরিফের,	
sontoshpur,	সন্তশপুর,	সন্তোষপুর,	
rilayensha,	রিলা়েনশশ,	রিলায়েন্স,	
bairey,	বাইরে,	বাইরে,	
zommu,	জম্,	জম্মু,	
annorup,	অন্নরূপ,	অন্যরূপ,	
fand,	ফান্দ,	ফান্ড,	
kuresher,	কুরেশের,	কুরেশের,	
detik,	ডেটিক,	দেতিক,	
saras,	সারাস,	সরস,	
irish,	ইরিশ,	আইরিস,	
dolphiny,	ডলফিনি,	ডলফিনি,	
swastir,	স্বস্তির,	স্বস্তির,	
amarjito,	অমর্যিত,	অমার্জিত,	
bajite,	বাজিতে,	বাজিতে,	
footbalarer,	ফুটবলারের,	ফুটবলারের,	
taims,	টেইমস,	টাইমস্,	
procharjontrogulo,	প্রচারযন্ত্রগুলো,	প্রচারযন্ত্রগুলো,	
militarite,	মিলিটারিতে,	মিলিটারিতে,	
shourshe,	শৌর্শে,	সোর্স,	
chokhwala,	চোখবালা,	চোখওয়ালা,	
nepchooner,	নেপচুনের,	নেপচুনের,	
sangharshik,	সংঘর্ষিক,	সাংঘর্ষিক,	
khudrokar,	ক্ষুদ্রকার,	ক্ষুদ্রকার,	
greep,	গ্রীপ,	গ্রিপ,	
bandhano,	বাঁধানো,	বাঁধানো,	
bhaibon,	ভাইবন,	ভাইবোন,	
jipiusamriddha,	জিপুযসমিদ্ধ,	জিপিউসমৃদ্ধ,	
sethai,	সেথাই,	সেথাই,	
uporitoler,	উপরিতলের,	উপরিতলের,	
lajik,	লাজিক,	লজিক,	
agamane,	আগামানে,	আগমনে,	
bhoutikeshu,	ভৌতিকেষু,	ভৌতিকেষু,	
jounatar,	যৌনাতার,	যৌনতার,	
gyandaas,	জ্ঞানদাস,	জ্ঞানদাস,	
deobonde,	দেওবন্ডে,	দেওবন্দে,	
achintyabhedaved,	অচিন্ত্যব্ধেব,	অচিন্ত্যভেদাভেদ,	
benojir,	বেনজীর,	বেনজীর,	
meghacchonno,	মেঘাচ্ছনননো,	মেঘাচ্ছন্ন,	
humner,	হামনের,	হামনার,	
sinaake,	সিনাকে,	সিনাকে,	
rajnaiteek,	রাজনৈতিক,	রাজনৈতীক,	
akhando,	আখান্ডও,	অখন্ড,	
abheedhaaneek,	অভিধানিক,	অভিধানিক,	
oncholshomuher,	অঞ্চলসমূহের,	অঞ্চলসমূহের,	
sarboporee,	সর্বপরী,	সর্বোপরী,	
phareeksa,	ফারিকসা,	ফরেক্স,	
sures,	সুরেস,	সুরেশ,	
firth,	ফার্থ,	ফার্থ,	
waal,	ওয়াল,	উল,	
chire,	চিরে,	চিরে,	
niropekshtar,	নিরপেক্ষষতার,	নিরপেক্ষতার,	
suraropito,	সুরারোপিত,	সুরারোপিত,	
dufresne,	ডাফরেস্ন,	ডুফরেস্ন,	
danakana,	দানাকানা,	ডানকান,	
skolastik,	স্কলাস্তিক,	স্কলাস্টিক,	
cholchhee,	চলচি,	চলছে,	
pulivendla,	পুলিভেন্ডলা,	পুলিভেন্ডলা,	
zeebonto,	জীবন্ত,	জীবন্ত,	
neerbahi,	নিরবাহী,	নির্বাহি,	
bisheshshyer,	বিশেষ্যের,	বিশেষ্যের,	
bhenise,	ভেনিসে,	ভেনিসে,	
maila,	মাইলা,	মাইল,	
purohitder,	পুরোহিতদের,	পুরোহিতদের,	
chalochchitraeer,	চলচচ্চিত্রীর,	চলচ্চিত্রের,	
ishtone,	ইষ্টনে,	স্টোন,	
nagorikota,	নাগরিকতা,	নাগরিকতা,	
debdebie,	দেবদেবী,	দেবদেবী,	
pleena,	প্লিনা,	প্লেন,	
protibedokrao,	প্রতিবেদকরাও,	প্রতিবেদকরাও,	
eenameela,	ইনামেলিলা,	এনামেল,	
maladabha,	মালাদাভা,	মলদোভা,	
mukhomandoler,	মুখমান্ডলের,	মুখমণ্ডলের,	
janghu,	জাংহু,	জঙ্ঘু,	
surakarder,	সুরাকারদের,	সুরকারদের,	
dhanak,	ধনক,	ধানক,	
geejeeteeda,	গিজেটিড,	গেজেটেড,	
shrabasti,	শ্রাবস্তি,	শ্রাবস্তী,	
heteler,	হেতেলের,	হেটেলের,	
jhumjhumita,	ঝুমঝূটিত,	ঝুমঝুমিটা,	
protishtan,	প্রতিষ্টান,	প্রতিষ্টান,	
rakshanbhag,	রক্ষণভাগ,	রক্ষণভাগ,	
bhogno,	ভগ্ন,	ভগ্ন,	
byabaharkariderke,	ব্যবহারকারীদেরকে,	ব্যবহারকারীদেরকে,	
kiibord,	কিইবর্ড,	কীবোর্ড,	
beauby,	বিউবি,	বিউবি,	
mausumer,	মৌসুমের,	মৌসুমের,	
sarollo,	সারোলো,	সারল্য,	
ashiatic,	আশিয়াটিক,	এশিয়াটিক,	
duuma,	দুউমা,	দুমা,	
chaudhurio,	চৌধুরিও,	চৌধুরীও,	
chalochchitrei,	চালচচ্ছিত্রেই,	চলচ্চিত্রেই,	
bonshi,	বনশি,	বংশী,	
konnoder,	কন্যদের,	কন্যদের,	
kidambi,	কিদাম্বি,	কিদম্বি,	
quata,	কোয়াতা,	কোটা,	
mankisundar,	মানকিসুন্দর,	মানকিসুন্দর,	
sexperter,	সেক্সপার্টের,	সেক্সপার্টের,	
aasirbaad,	আসিরবাদ,	আশির্বাদ,	
cheento,	চিন্ত,	চিনতো,	
prime,	প্রাইম,	প্রাইম,	
basaake,	বাসাকে,	বাসাকে,	
garora,	গারোরা,	গারোরা,	
nimitte,	নিমিত্বে,	নিমিত্তে,	
nirvaha,	নির্হাহ,	নির্বাহ,	
bardhitansh,	বারধীতন্থ,	বর্ধিতাংশ,	
esasiyetasa,	এসাসিয়েটাস,	এসোসিয়েটস,	
chasee,	চাসি,	চেস,	
graambashee,	গ্রামবাসী,	গ্রামবাসী,	
mooney,	মুউনে,	মুনে,	
pravura,	প্রভুরা,	প্রভুরা,	
nagorikkey,	নাগরিককে,	নাগরিককে,	
sarder,	সার্দের,	সরদার,	
byaptikaler,	ব্যাপ্িিকালের,	ব্যাপ্তিকালের,	
sqirt,	স্কিরট,	স্কার্ট,	
badaghat,	বাদাঘাট,	বাদাঘাট,	
harysoner,	হারিসনের,	হ্যারিসনের,	
adhunikkale,	আধুনিককালে,	আধুনিককালে,	
moorali,	মুরালি,	মুরলী,	
notti,	নট্টি,	নোটটি,	
beshirbhaagei,	বেশীরভাগেই,	বেশিরভাগেই,	
satarkabhabey,	সতর্কভাবে,	সতর্কভাবে,	
ajijer,	আজিজের,	আজিজের,	
jaaygata,	জায়গাতা,	জায়গাটা,	
soommo,	সুম্ম,	সুমো,	
gej,	জেজ,	গেজ,	
jerusalema,	জেরুসালেমা,	জেরুসালেম,	
punosthaner,	পুনস্থানের,	পুনঃস্থানের,	
carlosh,	কার্লো,	কার্লোস,	
balokarak,	বালোকারাক,	বলকারক,	
soheensotar,	সহেনসতার,	সহিংসতার,	
kanasarabhesana,	কানারাভেষনা,	কনসারভেশন,	
biplabee,	বিপ্লাবী,	বিপ্লবী,	
madaspushto,	মাদস্পুষ্ট,	মদদপুষ্ট,	
chandil,	চাঁদিল,	চান্ডিল,	
jakso,	জাক্সো,	যক্ষ,	
prosadhaner,	প্রসাধনের,	প্রসাধনের,	
mile,	মিলে,	মিলে,	
hisaber,	হিসাবের,	হিসাবের,	
drissoteer,	দৃষ্টতির,	দৃশ্যটির,	
transformaarer,	ট্রান্সফর্মার,	ট্রান্সফরমারের,	
samajikatar,	সমাজীকতার,	সামাজিকতার,	
elakaasoho,	এলাকাসহ,	এলাকাসহ,	
phiqsa,	ফিকসা,	ফিক্স,	
horash,	হরাশ,	হোরাস,	
musallati,	মুসললাটি,	মুসল্লাটি,	
shurugulo,	শুরুগুলো,	শুরুগুলো,	
protisthar,	প্রতিষ্ঠার,	প্রতিষ্ঠার,	
smarok,	স্মরক,	স্মারক,	
vabnakey,	ভবননকে,	ভাবনাকে,	
podotyagsongkranto,	পদত্যাগসংক্রান্ত,	পদত্যাগসংক্রান্ত,	
swajan,	স্বজন,	স্বজন,	
chuti,	চুটি,	ছুটি,	
ekghore,	একঘরে,	একঘরে,	
upbrazillian,	উপপ্রালিল্যান,	আপব্রাজিলিয়ান,	
popke,	পপকে,	পোপকে,	
proteemar,	প্রতিমার,	প্রতিমার,	
palta,	পালটা,	পালটা,	
tirmijii,	তির্মিজি,	তিরমিজি,	
poschimey,	পশ্চিমে,	পশ্চিমে,	
notikotar,	নতিকতার,	নৈতিকতার,	
edmiral,	এডমিরাল,	এডমিরাল,	
hattey,	হ্যাট,	হাঁটতে,	
shahanara,	শাহানারা,	শাহানারা,	
parisankhanvid,	পরিসানন্ধিব,	পরিসংখ্যানবিদ,	
jathartho,	যাথার্থ,	যথার্থ,	
abhidhaaner,	অভিধানের,	অভিধানের,	
spenser,	স্পেন্সের,	স্পেন্সার,	
daaoon,	ডাওন,	ডাউন,	
jerusaleme,	জেরুসালেমে,	জেরুসালেমে,	
upobasher,	উপবাশের,	উপবাসের,	
nodnodeer,	ননদনীর,	নদনদীর,	
auttacharer,	অট্টচারের,	অত্যাচারের,	
highcommissionay,	হাইকম্সিয়ান,	হাইকমিশনে,	
proshtutkarok,	প্রস্টুতকারক,	প্রস্তুতকারক,	
banglota,	বাংলোটা,	বাংলোটা,	
bagdad,	বাগদাদ,	বাগদাদে,	
gaphiloti,	গ্যাফিলোটি,	গাফিলতি,	
residence,	রেসিডেন্স,	রেসিডেন্স,	
horidwar,	হরিদ্বার,	হরিদ্বার,	
khude,	খুদে,	ক্ষুদে,	
dito,	ডিআোটো,	দিতো,	
satarkokari,	সতর্ককারী,	সতর্ককারী,	
ponchaasjon,	পঞ্চাসজন,	পঞ্চাশজন,	
seramiks,	সেরামিকস,	সিরামিকস,	
kraanti,	ক্রানটি,	ক্রান্তি,	
venuser,	ভেনুসের,	ভেনাসের,	
epiela,	এপিলেলা,	আইপিএল,	
edmeeral,	এডমিরাল,	এডমিরাল,	
bisnukey,	বিস্নুকেই,	বিষ্ণুকে,	
shapad,	শাপাদ়,	শ্বাপদ,	
soketgulor,	সকেটগুলোর,	সকেটগুলোর,	
chorchita,	চর্চিতা,	চর্চিত,	
duple,	ডাপলে,	ডুপ্লে,	
caramiks,	ক্যারামিকস,	সিরামিকস,	
ghotol,	ঘটল,	ঘটল,	
dhwajbhango,	ধ্ববভাঙ্গো,	ধ্বজভঙ্গ,	
jacksoner,	জ্যাকসনের,	জ্যাকসনের,	
gemske,	গেমসকে,	জেমসকে,	
aziboner,	আজীবনের,	আজীবনের,	
adhikartai,	অধিকর্তায়,	অধিকর্তাই,	
chopol,	চপল,	চপল,	
jamanataswarup,	জমনাতাস্বরূপ,	জামানতস্বরূপ,	
chakurijibirao,	চাকুরিজীবারও,	চাকুরীজীবীরাও,	
bonobhumi,	বনভূমি,	বনভূমি,	
hozot,	হজোত,	হজত,	
associatis,	অ্যাসোসিয়াসিস,	এসোসিয়েটস,	
amor,	আমোর,	আমর,	
sthapanatir,	স্থাপানাটির,	স্থাপনাটির,	
chongar,	চঙ্গার,	চোঙ্গার,	
pratisthasaho,	প্রতিস্থাসহ,	প্রতিষ্ঠাসহ,	
chitlar,	চিটলার,	চিতলার,	
gonjona,	গঞ্জনা,	গঞ্জনা,	
seekkhokbrindo,	শিক্ষকবৃন্দ,	শিক্ষকবৃন্দ,	
cocaine,	কোকেনি,	কোকেইন,	
prasadhani,	প্রসাধনী,	প্রসাধনী,	
ebham,	ইভাম,	ইভিএম,	
uporitale,	উপরিতালে,	উপরিতলে,	
semai,	সেমাই,	সেমাই,	
gobeshana,	গবেশন,	গবেষনা,	
pakistanira,	পাকিস্তানীরা,	পাকিস্তানীরা,	
talgach,	তালগাছ,	তালগাছ,	
prangulo,	প্রাণগুলো,	প্রানগুলো,	
atwobishvashi,	আত্ববিষবাসী,	আত্মবিশ্বাসী,	
cuti,	কুটি,	কিউটি,	
sthapanagulor,	স্থাপানাগুলোর,	স্থাপনাগুলোর,	
samratra,	সম্রাত্র,	সম্রাটরা,	
asamonjasyopurno,	অসামঞ্জমাপনযপূর্য,	অসামঞ্জস্যপূর্ণ,	
tinage,	টিনাইজ,	টিনেজ,	
prakalpoguli,	প্রকল্লপুলি,	প্রকল্পগুলি,	
bipradas,	বিপ্রাদস,	বিপ্রদাস,	
deefinition,	ডিফিনিশন,	ডেফিনেশন,	
bishnu,	বিষ্ণু,	বিষ্ণু,	
sthapanar,	স্থাপানার,	স্থাপনার,	
edaning,	এডানিং,	ইদানিং,	
selim,	সেলিম,	সেলিম,	
andon,	আ্যান্ডন,	আন্দোন,	
krema,	ক্রেমা,	ক্রাইম,	
marry,	মারি,	ম্যারি,	
chat,	চাট,	চ্যাট,	
kushakhali,	কুশাখালি,	কুশাখালি,	
dorgah,	দরগাহ,	দরগাহ,	
bhenasha,	ভেনশ,	ভেনাস,	
chirkoot,	চিরকুট,	চিরকুট,	
kabutorer,	কাবুতরের,	কবুতরের,	
meridiane,	মেরিডিয়ান,	মেরিডিয়ানে,	
ruble,	রাবল,	রুবল,	
deqe,	ডিকে,	ডেকে,	
poscater,	পোস্যাটের,	পশ্চাতের,	
poribahokotto,	পরিবাহকত্ব,	পরিবাহকত্ব,	
transapharma,	ট্রান্সফর্ম,	ট্রান্সফর্ম,	
roopmatro,	রূপমত্র,	রূপমাত্র,	
udbodhani,	উদ্বোধনি,	উদ্বোধনী,	
makame,	মাকামে,	মাকামে,	
elakatikay,	এলাকাটিক়া,	এলাকাটিকে,	
hafsa,	হাফসা,	হাফসা,	
pyor,	প্যার,	পিওর,	
vaider,	ভাইদের,	ভাইদের,	
dala,	দালা,	দলা,	
vaibon,	ভাইবন,	ভাইবোন,	
hol,	হোল,	হোল,	
darji,	দারযি,	দরজি,	
eeksapreeshana,	ইক্সপ্রসিন,	এক্সপ্রেশন,	
khagen,	খাগেন,	খগেন,	
bupher,	বুফার,	বাফার,	
akpaase,	আকপাসে,	একপাশে,	
aosafur,	আওওাফুর,	আওশাফুর,	
sikarder,	সিকারদের,	শিকারদের,	
codeti,	কোডেটি,	কোডটি,	
mutar,	মুতার,	মুতার,	
grambaasi,	গ্রামবাসী,	গ্রামবাসী,	
granthatyke,	গ্র্যানথাটাইক,	গ্রন্থটিকে,	
licenshe,	লাইসেন্স,	লাইসেন্স,	
houzgulite,	হাউজগুলিতে,	হাউজগুলিতে,	
marmader,	মারমাদের,	মারমাদের,	
kotibondhe,	কোটিবন্ধে,	কটিবন্ধে,	
shahurgulor,	শহুরগুলোর,	শহুরগুলোর,	
graambasio,	গ্রামবাসিও,	গ্রামবাসীও,	
vobobibhuti,	ভববিভুতি,	ভববিভূতি,	
ponera,	পোনেরা,	পনের,	
madhuri,	মধুরী,	মাধুরী,	
eesa,	ইসা,	আইএএস,	
dwibidho,	দ্বিবিধ,	দ্বিবিধ,	
atorkitey,	আটর্কিতে,	অতর্কিতে,	
ansareer,	আনসারীর,	আনসারীর,	
amiretus,	আমিরেটুস,	এমিরেটাস,	
santaa,	সান্তা,	সান্তা,	
bitlaser,	বিতলাসের,	বিটলসের,	
arthonitir,	অর্থনীতির,	অর্থনীতির,	
laicenshe,	লাইসেন্স,	লাইসেন্স,	
elgoridom,	এলগোরডিম,	এলগরিদম,	
evaner,	ইভানের,	ইভানের,	
bondi,	বন্ডি,	বন্দী,	
thailand,	থাইল্যান্ড,	থাইল্যান্ড,	
hood,	হুড,	হুড,	
futote,	ফুটোতে,	ফুটোতে,	
tyap,	ত্যাপ,	ট্যাপ,	
porishongkhanbid,	পরিষংখ্যানবিদ,	পরিসংখ্যানবিদ,	
saseza,	সাসেজা,	সসেজ,	
titarer,	তিতারের,	তিতারের,	
kokeyin,	কোকেইন,	কোকেইন,	
bhimsen,	ভীমসেন,	ভীমসেন,	
keyu,	কেইউ,	কেউ,	
soinyo,	সৈন্য,	সৈন্য,	
jakatke,	জাকাতকে,	যাকাতকে,	
bhogiroth,	ভোগিরথ,	ভগীরথ,	
prabhritite,	প্রাৃতিতে,	প্রভৃতিতে,	
anusvara,	অনুসেভারা,	অনুস্বার,	
mathieu,	মাঠিউ,	ম্যাথিউ,	
spredsheet,	স্প্রেশশিত,	স্প্রেডশীট,	
grauth,	গ্রাথ,	গ্রোথ,	
roktokhoron,	রক্তখরণ,	রক্তক্ষরণের,	
daayitto,	দায়িত্ত,	দায়িত্ব,	
brake,	ব্র্যাক,	ব্রেক,	
sutir,	সুতির,	সুতির,	
ingrejra,	ইংরেজরা,	ইংরেজরা,	
mukhomandal,	মুখমন্ডল,	মুখমণ্ডল,	
institutione,	ইন্সটিটিউশনে,	ইনস্টিটিউশনে,	
promodwara,	প্রমদ্বারা,	প্রমদ্বারা,	
leaders,	লিডারস,	লিডার্স,	
barnis,	বার্নিস,	বার্নিশ,	
sector,	সেক্টর,	সেক্টর,	
sombhobonao,	সম্ভবনাও,	সম্ভবনাও,	
nikote,	নিকোতে,	নিকটে,	
bojata,	বোজাটা,	বোজাটা,	
hoonayin,	হুনাইন,	হুনাইন,	
taranee,	তারানী,	তরণী,	
nakkal,	নকক্কাল,	নক্কল,	
agomonke,	আগমনকে,	আগমনকে,	
chanoo,	চানু,	চানু,	
morodeho,	মরদেহ,	মরদেহ,	
fulkapi,	ফুলকাপি,	ফুলকপি,	
arthonitite,	অর্থনীতিতে,	অর্থনীতিতে,	
poderthobid,	পদারথোবিদ,	পদার্থবিদ,	
attorkite,	আটরোককিতে,	অতর্কিতে,	
kash,	কাশ,	কাস,	
militarir,	মিলিতারির,	মিলিটারির,	
jotsna,	জোস্স,	জ্যোৎস্না,	
lettere,	লেটেরে,	লেটারে,	
nilkuthir,	নীলকুঠির,	নীলকুঠির,	
toufik,	তাফিক,	তৌফিক,	
mahbunur,	মাহবুনুর,	মাহবুনুর,	
chhutir,	ছুটির,	ছুটির,	
peri,	পেরি,	পেরি,	
gazetted,	গেজেট্টেড,	গেজেটেড,	
gore,	গোর,	গোর,	
asaciates,	অসসিয়াটস,	এসোসিয়েটস,	
ajibon,	অজীবন,	আজীবন,	
dijijer,	ডিজিজের,	ডিজিজের,	
kourabe,	কৌরাবে,	কৌরবে,	
shikara,	শিকারা,	শিকার,	
natshi,	নাটশি,	নাত্সি,	
tookrote,	তুকরতে,	টুকরোতে,	
soolke,	সুলকে,	শুল্কে,	
sikkhakbrinda,	শিক্ষাকবৃন্দ,	শিক্ষকবৃন্দ,	
debate,	দেবাতে,	ডিবেট,	
dhamshrenite,	ধামশ্রেণীতে,	ধামশ্রেণীতে,	
unchiyechilo,	উঁচিয়েছিল,	উঁচিয়েছিল,	
ahmed,	আহমেদ,	আহামদ,	
ganoporibahon,	গণপরিবাহন,	গণপরিবহন,	
siddhantei,	সিদ্ধান্তেই,	সিদ্ধান্তেই,	
chakrapani,	চকররাপনি,	চক্রপানী,	
probhura,	প্রভুরা,	প্রভুরা,	
niketaner,	নিকেতানের,	নিকেতনের,	
mandarbani,	মান্দরবানি,	মন্দারবাণী,	
jiland,	জিলান্ড,	জিল্যান্ড,	
gara,	গারা,	গোর,	
chinto,	চিন্ত,	চিনতো,	
kalkarkhana,	কালকারখানা,	কলকারখানা,	
jund,	জান্ড,	জুন্দ,	
dalip,	দলিপ,	দালিপ,	
naazi,	নাজি,	নাত্সি,	
kormoke,	কর্মকে,	কর্মকে,	
saurce,	সার্স,	সোর্স,	
shrabostee,	শ্রাবস্তি,	শ্রাবস্তী,	
raia,	রায়া,	রায়,	
nagorikderkey,	নাগরিকদেরও,	নাগরিকদেরকে,	
parikhar,	পারিখার,	পরিখার,	
nisader,	নিসাদের,	নিষাদের,	
anchalo,	আঞ্চালো,	অঞ্চলও,	
rajtantrey,	রাজতন্ত্রে,	রাজতন্ত্রে,	
golghare,	গলঘরে,	গোলঘরে,	
satjaner,	সাতজানের,	সাতজনের,	
graambasheeo,	গ্রামবাশীও,	গ্রামবাসীও,	
bhikkharthe,	ভিক্ষার্থে,	ভিক্ষার্থে,	
hansasya,	হাঁসস্য,	হংসস্য,	
kod,	কোড,	কোড,	
chalochchitrogulor,	চালচচিত্রগুলোর,	চলচ্চিত্রগুলোর,	
esprito,	এসপৃত,	এস্পিরিটো,	
bisshonath,	বিশ্বনাথ,	বিশ্বনাথ,	
suhayeler,	সুহায়েলের,	সুহায়েলের,	
tuleche,	তুলেছে,	তুলেছে,	
diniphition,	ডিনিফিশন,	ডেফিনেশন,	
monchosthol,	মন্চস্থল,	মঞ্চস্থল,	
tatey,	তাতে,	তাতে,	
sarjur,	সারজুর,	সরযূর,	
cholochchitratike,	চলচ্চিত্রাটিকে,	চলচ্চিত্রটিকে,	
jonmobhumitir,	জন্মভূমিতির,	জন্মভূমিটির,	
protyokkhovabey,	প্রত্যক্ষ্ভাবে,	প্রত্যক্ষভাবে,	
makhno,	মাখনো,	মাখনো,	
chhatrodiger,	ছাত্রদীগের,	ছাত্রদিগের,	
hossne,	হোসেন,	হোসনে,	
pitiler,	পিতিলের,	পিটিলের,	
bishwasho,	বিশ্বাসও,	বিশ্বাসও,	
maailey,	মাইলে,	মাইলে,	
digreeke,	ডিগ্রীকে,	ডিগ্রিকে,	
reliance,	রেলিয়ান্স,	রিলায়েন্স,	
jandrel,	জান্দ্রেল,	জাঁদরেল,	
weelcomee,	বিউলকমি,	ওয়েলকাম,	
choopi,	চুপি,	চুপি,	
spreedashita,	স্প্রেশীদতা,	স্প্রেডশীট,	
osomorthito,	অসমর্থিত,	অসমর্থিত,	
koreempoor,	করিমপুর,	করিমপুর,	
hijrite,	হিজরিতে,	হিজরীতে,	
bhardwaj,	ভর্দবাজ,	ভরদ্বাজ,	
yuro,	যুরো,	ইউরো,	
nuhas,	নুহাস,	নুহাশ,	
kailashrao,	কৈলশ্রও,	কৈলাশরাও,	
shandra,	শান্দ্রা,	শান্দ্রার,	
difinishion,	ডিফিনিশন,	ডেফিনেশন,	
indrani,	ইন্দ্রাণী,	ইন্দ্রাণী,	
chhuti,	ছুটি,	ছুটি,	
saalsa,	সালসা,	সালসা,	
daap,	দাপ,	ড্যাপ,	
gondhe,	গন্ধে,	গন্ধে,	
mach,	মাচ,	মাছ,	
oncolsoho,	অঙ্কলসহ,	অঞ্চলসহ,	
kichudinpar,	কিছুদিনপার,	কিছুদিনপর,	
tep,	টিপিপ,	ট্যাপ,	
hydrological,	হাইড্রোলোকিকাল,	হাইড্রোলজিক্যাল,	
aalkatraa,	আলকাত্রা,	আলকাতরা,	
kantajir,	কান্তাজির,	কান্তজির,	
kormopontha,	কর্মপন্থা,	কর্মপন্থা,	
phutanta,	ফুটান্তা,	ফুটন্ত,	
ashonkai,	আশনকাই,	আশঙ্কাই,	
karuna,	কারুনা,	করুণা,	
aasar,	আসার,	আসর,	
vushi,	ভুশী,	ভুষি,	
oncholeo,	অঞ্চলেও,	অঞ্চলেও,	
brittakar,	বৃত্তকার,	বৃত্তাকার,	
bikromei,	বিক্রমেই,	বিক্রমেই,	
taitela,	টাইটেলা,	টাইটেল,	
aaireshe,	আইরেশে,	আইরেসে,	
puding,	পুদিং,	পুডিং,	
nikate,	নিকাতে,	নিকটে,	
juktorastrer,	যুক্তরাস্ত্রের,	যুক্তরাষ্ট্রের,	
nibirbhabe,	নিবিরভাবে,	নিবিরভাবে,	
madhnagar,	মধনগর,	মাধনগরের,	
armstronz,	আর্মস্্্্্জন,	আর্মস্ট্রং,	
bamon,	ব্যামন,	বামন,	
machgulo,	মাছগুলো,	মাছগুলো,	
monjurul,	মঞ্জুরুল,	মনজুরুল,	
protizogii,	প্রতিযোগী,	প্রতিযোগী,	
shahjapur,	শাহজাপুর,	শাহজাপুর,	
graambaashee,	গ্রামবাশী,	গ্রামবাসী,	
ankanshilpe,	অঙ্কানশিল্পে,	অঙ্কনশিল্পে,	
rodney,	রডনি,	রেডনি,	
probolshoktio,	প্রবলশক্তিও,	প্রবলশক্তিও,	
rokibul,	রকিবুল,	রকিবুল,	
seeramiks,	সিরামিকস,	সিরামিকস,	
fokskon,	ফক্সকোন,	ফক্সকন,	
vobanipur,	ভবানিপুর,	ভবানীপুর,	
chilona,	চিলনা,	ছিলনা,	
karaponner,	কারাপন্নের,	কারাপণ্যের,	
vejjanno,	ভেজ্জান্ন,	ভেজানো,	
byan,	ব্যান,	ব্যাং,	
toler,	টোলের,	তালের,	
nariider,	নারীদের,	নারীদের,	
yanqee,	যানকি,	ইয়াংকি,	
footballerra,	ফুটবেরলার,	ফুটবলাররা,	
heelser,	হিলসের,	হিলসের,	
godamjato,	গোামজাত,	গুদামজাত,	
dupleks,	ডাপলেকস,	ডুপ্লে,	
karu,	কারু,	কারু,	
canflikt,	ক্যানফ্লিক্ট,	কনফ্লিক্ট,	
kathla,	কাথলা,	কাঠলা,	
braqe,	ব্রাক,	ব্রেক,	
caroline,	ক্যারোলিন,	ক্যরোলিন,	
middleton,	মিডলটেন,	মিডলটন,	
dushtogone,	দুষ্টগণে,	দুষ্টগণে,	
dhhaloor,	ঢালুর,	ঢালুর,	
osamarik,	ওসামারিক,	অসামরিক,	
masjidti,	মাসজিটটি,	মসজিদটি,	
rahee,	রাহি,	রাহী,	
drissogoolote,	দৃশ্যগগুলোতে,	দৃশ্যগুলোতে,	
shikshakrom,	শিক্ষাক্রম,	শিক্ষাক্রম,	
dibet,	দিবেত,	ডিবেট,	
larson,	লারসন,	লারসন,	
elaakaa,	এলাকা,	এলাকা,	
uthe,	উঠে,	উঠে,	
pustir,	পুস্তির,	পুষ্টির,	
jubokti,	যুবকটি,	যুবকটি,	
dip,	ডিআপ,	দীপ,	
kinsa,	কিনসা,	কিংস,	
aalaa,	আলা,	আলা,	
planea,	প্লানে,	প্লেনে,	
janoganonar,	জনোগননার,	জনগণনার,	
dholeshwari,	ধলেশ্বরী,	ধলেশ্বরী,	
shamuker,	শামুকের,	শামুকের,	
superheiroo,	সুপারহেরের,	সুপারহিরো,	
chetanagoto,	চেতানোগত,	চেতনাগত,	
rayyaleti,	রায়ালেটি,	রয়্যালটি,	
inphormeshon,	ইনফরর্শনেস,	ইনফরমেশন,	
shekarone,	শেকারণে,	সেকারণে,	
ooporoshtho,	অপরস্থ,	উপরস্থ,	
sanghatakder,	সংঘটকদের,	সংঘটকদের,	
granada,	গ্রানাডা,	গ্র্যানাডা,	
ashanka,	আশাঙ্কা,	আশংকা,	
thanvi,	থানভি,	থানভী,	
everestey,	এভারেস্টে,	এভারেস্টে,	
cheerokoomari,	চিরকমারি,	চিরকুমারী,	
katui,	কাতুই,	কাতুই,	
gaddaphii,	গাড্ডাফি,	গাদ্দাফী,	
fuss,	ফিউস,	ফাস,	
chaiten,	চাইতেন,	চাইতেন,	
fakhrul,	ফাখরুল,	ফাখরুল,	
orbit,	অরবিট,	অরবিট,	
sedikei,	সেদিকেই,	সেদিকেই,	
obdi,	ওব্দি,	অব্দি,	
gonona,	গণনা,	গননা,	
wictor,	উইকটর,	ভিক্টর,	
falasrutite,	ফলাস্রুতিতে,	ফলশ্রুতিতে,	
nazad,	নাজাড়,	নাজাদ,	
jamseder,	জামসেদের,	জামসেদের,	
sahojatprobritti,	সহজাতপ্রবৃত্তি,	সহজাতপ্রবৃত্তি,	
aembed,	এম্বেড,	এম্বেড,	
abhiyojan,	অভিজয়নজ,	অভিযোজন,	
abarte,	আবর্তে,	আবর্তে,	
firozaa,	ফিরোজা,	ফিরোজা,	
avisongson,	অভিসংসন,	অভিশংসন,	
protijogi,	প্রতিযোগী,	প্রতিযোগী,	
vetrillocuism,	ভেট্রিললললিসম,	ভেট্রিলোকুইজম,	
umedpoor,	উমেদপুর,	উমেদপুর,	
oboshore,	অবররে,	অবসরে,	
sommoteer,	সম্মতির,	সম্মতির,	
setikey,	সেতিকে,	সেটিকে,	
habol,	হাবল,	হাবোল,	
bondishalatei,	বন্দিশালাতেই,	বন্দিশালাতেই,	
ebhara,	এভারা,	এভার,	
nirbachakder,	নির্বাচকদের,	নির্বাচকদের,	
fasi,	ফ্যাসি,	ফাঁসী,	
bonvumi,	বনভুমি,	বনভূমি,	
khanabale,	খননবলে,	খানাবলে,	
majdur,	মাজদুর,	মজদুর,	
alpakichudin,	আল্পকুচিনিদ,	অল্পকিছুদিন,	
saarbharti,	সার্ভরটি,	সার্ভারটি,	
dekhso,	দেখসো,	দেখসো,	
senabahineeow,	সেনাবাহিবিও,	সেনাবাহিনীও,	
sookkho,	সুক্ষ,	সুক্ষ্ম,	
teman,	তেমান,	তেমন,	
borlen,	বররলেন,	বরলেন,	
harja,	হারজা,	হার্জ,	
bishaashke,	বিশাষকে,	বিশ্বাসকে,	
nirbachokder,	নির্বাচকদের,	নির্বাচকদের,	
bolechile,	বলেছিলে,	বলেছিলে,	
tahalo,	তাহালো,	তাহলো,	
poddhotitei,	পদ্ধতিতেই,	পদ্ধতিতেই,	
kaansaat,	কানসাত,	কানসাট,	
dhyana,	ধ্যানা,	ধ্যান,	
kuldip,	কুলদীপ,	কুলদীপ,	
udbodhaney,	উদ্বধানে,	উদ্বোধনে,	
omkar,	ওমকার,	ওঙ্কার,	
eekbalke,	ইকবালকে,	ইকবালকে,	
bhagnekeo,	ভাগনেকেও,	ভাগ্নেকেও,	
ipl,	ইইপিএল,	আইপিএল,	
lidars,	লিডারস,	লিডার্স,	
tophaat,	তোফাত,	তফাৎ,	
tokeo,	টোকেও,	টোকেও,	
sithilota,	সিথিলতা,	শিথিলতা,	
sohojlovyotar,	সহজল্যব্যতার,	সহজলভ্যতার,	
chet,	চেত,	চ্যাট,	
sainyader,	সৈন্যদের,	সৈন্যদের,	
ikboler,	ইকবলের,	ইকবলের,	
feemalee,	ফেমালী,	ফিমেল,	
install,	ইনস্টেল,	ইন্সটল,	
sanghitar,	সংঘিতার,	সংহিতার,	
hurricane,	হুরিকানে,	হ্যারিকেন,	
with,	উইথ,	ভিত,	
trenda,	ট্রেন্ডা,	ট্রেন্ড,	
samajeek,	সমাজিক,	সামাজিক,	
tintikey,	তিনটিকে,	তিনটিকে,	
srk,	স্রাস,	শাহরুখ,	
pare,	পারে,	পাড়ে,	
vins,	ভিন্,	ভিন্স,	
teemothi,	তেমোথি,	টিমোথি,	
abosare,	অবসারে,	অবসরে,	
byomkesh,	ব্যমকেশ,	ব্যোমকেশ,	
rajashri,	রাজশ্রি,	রাজশ্রী,	
onucheeder,	অনুচেদের,	অনুচ্ছেদের,	
shucharita,	শুচরিতা,	সুচরিতা,	
madraser,	মাদ্রাসের,	মাদ্রাজের,	
chhooteete,	ছুটেতে,	ছুটিতে,	
khabarsoho,	খাবারসহ,	খাবারসহ,	
audiotike,	অডিওটিকে,	অডিওটিকে,	
shhepha,	শেফা,	শেফ,	
firoza,	ফিরোজা,	ফিরোজা,	
blyaka,	ব্ল্যাকা,	ব্ল্যাক,	
amiya,	অমিয়া,	অমিয়,	
nutunotto,	নুতুনত্ব,	নতুনত্ব,	
seo,	সিও,	সেও,	
cheekitsar,	চিকিতসার,	চিকিত্সার,	
romantik,	রোমানটিক,	রোমান্টিক,	
tricksguli,	ট্রিকসগুলি,	ট্রিকসগুলি,	
kuthibarike,	কুঠিবারীকে,	কুঠিবাড়ীকে,	
lagche,	লাগছে,	লাগছে,	
societyke,	সোসিটিকে,	সোসাইটিকে,	
domonmulok,	দমনমূলক,	দমনমূলক,	
ekhate,	এখাতে,	একহাতে,	
landin,	ল্যান্ডিন,	ল্যান্ডিং,	
pooshteer,	পুষ্টির,	পুষ্টির,	
mag,	ম্যাগ,	এমএজি,	
dosha,	দোশা,	দোসা,	
thandabhabe,	থান্ডাভাবে,	ঠাণ্ডাভাবে,	
teenisa,	টিনিসা,	টেনিস,	
shtonehenge,	স্তেহেঙ্গে,	স্টোনহেঞ্জ,	
adhyatmik,	অধ্যাত্মিক,	আধ্যাত্মিক,	
casper,	ক্যাসপার,	ক্যাসপার,	
hillse,	হিলসে,	হিলসে,	
tolemy,	টোলেমি,	টলেমির,	
ovinetar,	অভিনেতার,	অভিনেতার,	
ishahak,	ইশাহাক,	ইসাহাক,	
baarnish,	বার্নিশ,	বার্নিশ,	
udbhaboney,	উদ্ভাবনে,	উদ্ভাবনে,	
hosbaleke,	হোসবালেকে,	হোসবালেকে,	
batikromi,	বাতিক্রমি,	ব্যতিক্রমী,	
bhejaano,	ভেজানো,	ভেজানো,	
onchalti,	অঞ্চলটি,	অঞ্চলটি,	
chhon,	ছোন,	ছোঁ,	
pyetarna,	প্যাটের্ন,	প্যাটার্ন,	
turky,	টার্কি,	তুর্কি,	
vorkendra,	ভরকেন্ড্র,	ভরকেন্দ্র,	
kalki,	কালকি,	কালকি,	
alonkaran,	আলঙ্কারন,	অলঙ্করণ,	
templet,	টেম্পলেট,	টেম্পলেট,	
bhutbhut,	ভূতভূত,	ভুটভুট,	
dooburir,	দুবুরীর,	ডুবুরির,	
plato,	প্ল্যাট,	প্লেটো,	
mulyabriddhikale,	মূল্যবৃদ্ধিকালে,	মূল্যবৃদ্ধিকালে,	
alexandar,	আলেক্সান্দার,	আলেকজান্ডার,	
bisheshshyo,	বিশেষ্য,	বিশেষ্য,	
baipass,	বাইপাস,	বাইপাস,	
rotheen,	রথীন,	রথীন,	
bbiswashke,	বিবিস্বাষকে,	বিশ্বাসকে,	
moshjidke,	মোশজীদকে,	মসজিদকে,	
prapokkey,	প্রাপককে,	প্রাপককে,	
themeke,	থেমেকে,	থিমকে,	
gaujano,	গৌজানও,	গজানো,	
nichols,	নিচলস,	নিকলস,	
alpo,	অল্পো,	অল্প,	
nischitobhave,	নিশ্চিতভাবে,	নিশ্চিতভাবে,	
jyesthaa,	জ্যেষ্ঠা,	জ্যেষ্ঠা,	
osthishondhi,	অস্থিসন্ধি,	অস্থিসন্ধি,	
ramzaner,	রামজানের,	রমযানের,	
remacry,	রিম্যাক্রি,	রেমাক্রী,	
teoyana,	তেওয়ানা,	তাইওয়ান,	
ranangone,	রানাঙ্গনে,	রণাঙ্গনে,	
photanor,	ফোটানোর,	ফোটানোর,	
hughkey,	হুঘকে,	হিউজকে,	
durtomo,	দূর্তম,	দূরতম,	
jolrang,	জলরাং,	জলরঙ,	
rastagulikeo,	রাস্তাগুলিকেও,	রাস্তাগুলিকেও,	
rca,	আরএকএ,	আরসিএ,	
sikha,	সিখা,	শিখ,	
nartana,	নার্তানা,	নর্টন,	
ekbakke,	একবাককে,	একবাক্যে,	
overholing,	ওভারহোলিং,	ওভারহোলিং,	
dubureer,	দুবুরীর,	ডুবুরির,	
kaia,	কাইয়া,	কায়া,	
beila,	বেইলা,	বেইলা,	
logic,	লোজিক,	লজিক,	
nodiiteyi,	নদীতেই,	নদীতেই,	
byapoktor,	ব্যাপক্তর,	ব্যাপকতর,	
nischoy,	নিশ্চয়,	নিশ্চয়,	
byaktigotovabeo,	ব্যক্তিগতভাবেও,	ব্যাক্তিগতভাবেও,	
abhidhaanic,	অভিধানিক,	অভিধানিক,	
akai,	আকাই,	একাই,	
tennys,	টেনিস,	টেনিস,	
ingrezeeteo,	ইংরেজেতেও,	ইংরেজিতেও,	
shakar,	শাকার,	সকার,	
landing,	ল্যান্ডিং,	ল্যান্ডিং,	
karecho,	কারেছো,	করেছ,	
shitei,	শিতেই,	শীতেই,	
dong,	ডোং,	ডং,	
mercedes,	মারসেডস,	মার্সেডেস,	
bangladesh,	বাংলাদেশ,	বঙ্গালাদেস,	
dokaangoolote,	দোকাগনগুলোতে,	দোকানগুলোতে,	
rudiger,	রুডিগের,	রুদিগের,	
dorun,	ডরুন,	দরুণ,	
mukhoshdharir,	মুখোষধারীর,	মুখোশধারীর,	
gejetade,	জেজেটাদে,	গেজেটেড,	
pradoshik,	প্রাদশিক,	প্রাদশিক,	
tukroti,	তুকররটি,	টুকরোটি,	
bairer,	বাইরের,	বাইরের,	
fanse,	ফ্যান্স,	ফাঁসে,	
janmat,	জানমত,	জন্মাত,	
shiulijhra,	শিউলিিরা,	শিউলিঝরা,	
chamski,	চাম্কি,	চমস্কি,	
xpose,	ক্কস্পোস,	এক্সপোজ,	
antennal,	অ্যান্টেননাল,	অ্যান্টেনাল,	
gaaddafee,	গাড্ডাফি,	গাদ্দাফী,	
fibergulote,	ফাইবারগুলোতে,	ফাইবারগুলোতে,	
rakhete,	রাখেতে,	রাখেতে,	
nirmankarmisaha,	নির্মণকর্ণীসহ,	নির্মাণকর্মীসহ,	
ekroop,	একরুপ,	একরূপ,	
graambaaseeo,	গ্রামবাসীও,	গ্রামবাসীও,	
mercial,	মার্সিয়াল,	মার্শিয়াল,	
amburi,	আম্বুরি,	আম্বুরি,	
sombhobonaao,	সম্ভবনাও,	সম্ভবনাও,	
groth,	গ্রথ,	গ্রোথ,	
pathanirdeshona,	প্যাথানির্ডশেশন,	পথনির্দেশনা,	
bisshas,	বিশ্বাস,	বিশ্বাস,	
gandogol,	গান্দগোল,	গন্ডগোল,	
rajyabhogi,	রাজ্যভগগী,	রাজ্যভোগী,	
hypar,	হাইপার,	হাইপার,	
purushika,	পুরুশিকা,	পুরুষিকা,	
directarate,	ডিরেক্টরেট,	ডিরেক্টরেট,	
bosante,	বসন্তে,	বসন্তে,	
rakim,	রাকিম,	রাকিম,	
ajeem,	আজেম,	আজিম,	
sobrakamer,	সোবরাকামের,	সবরকমের,	
starker,	স্টার্কের,	স্টার্কের,	
abosan,	অবসান,	অবসান,	
pracharanamulak,	প্রচারণামূলক,	প্রচারণামূলক,	
beem,	বিম,	বিম,	
darjiling,	ডার্জিলিং,	দার্জিলিং,	
dhalur,	ধালুর,	ঢালুর,	
maudelder,	মাউদেলদের,	মডেলদের,	
rakhtokkharone,	রাখতকর্ষণে,	রক্তক্ষরণে,	
binakar,	বিনাকার,	বিনাকার,	
bokul,	বকুল,	বকুল,	
prarthonakokkher,	প্রার্থনাকাষকের,	প্রার্থনাকক্ষের,	
fake,	ফাকে,	ফাকে,	
addata,	আদ্ডাতা,	আড্ডাটা,	
mailkhanek,	মাইলখানক,	মাইলখানেক,	
gronthowo,	গ্রন্থও,	গ্রন্থও,	
qrisenta,	ক্রিসেন্টা,	ক্রিসেন্ট,	
sarajibonbyapi,	সারাজিনব্যবনী,	সারাজীবনব্যাপী,	
khuliechilam,	খুলিয়েছিলাম,	খুলিয়েছিলাম,	
surke,	সুরকে,	সুরকে,	
aholya,	অহল্য,	অহল্যা,	
godabari,	গোদাবারি,	গোদাবরী,	
ddebet,	দ্যেবেত,	ডিবেট,	
torunra,	তরুণরা,	তরুণরা,	
thailandshoho,	থাইলান্ডশহ,	থাইল্যান্ডসহ,	
poorohitder,	পুরহিতদের,	পুরোহিতদের,	
madrasake,	মাদ্রাসাকে,	মাদ্রাসাকে,	
abhidhaaneeck,	অভিধানিক,	অভিধানিক,	
oncoleo,	অঙ্কলেও,	অঞ্চলেও,	
ukeliptas,	উকেলিপ্তাস,	ইউক্যালিপ্টাস,	
megacaldera,	মেগাকাল্ডারে,	মেগাক্যাল্ডেরা,	
sheshardhe,	শেষার্ধে,	শেষার্ধে,	
manush,	মানুষ,	মানুষ,	
yura,	যুয়ার,	ইউরো,	
goonoman,	গুনমান,	গুণমান,	
ganaparibahan,	গণপরিবহণ,	গণপরিবহন,	
shasankorta,	শাসনকর্তা,	শাসনকর্তা,	
masjidsaha,	মজসিদসহ,	মসজিদসহ,	
fevarite,	ফেভারিতে,	ফেভারিট,	
dantahin,	দান্তাহীন,	দন্তহীন,	
daaktikit,	দাকতিকিট,	ডাকটিকিট,	
teter,	টেতের,	টেটের,	
peterke,	পেটারকে,	পিটারকে,	
souripurang,	সৌরিপুরং,	সৌরিপুরং,	
disni,	ডিসনি,	ডিজনী,	
deefinishion,	ডিফিনিশন,	ডেফিনেশন,	
shloker,	শ্লোকের,	শ্লোকের,	
qredita,	ক্রেডিতা,	ক্রেডিট,	
sanaktakaran,	সননক্তকরণ,	সনাক্তকরণ,	
bhabanir,	ভবনীর,	ভবানীর,	
hunine,	হুনিন,	হুনাইন,	
diznee,	ডিজনি,	ডিজনী,	
chalachchitrei,	চলচচ্ছিত্রেই,	চলচ্চিত্রেই,	
sausage,	সৌসাগে,	সসেজ,	
segulo,	সেগুলো,	সেগুলো,	
disposes,	ডিসপোসেস,	ডিসপোজেস,	
bikargrosto,	বিকারগ্রস্ত,	বিকারগ্রস্ত,	
bonbhumi,	বন্ভুমি,	বনভূমি,	
alpa,	আলপা,	অল্প,	
kramp,	ক্রাম্প,	ক্র্যাম্প,	
bonsho,	বনশো,	বংশ,	
sonaktokaran,	সনাক্তকরণ,	সনাক্তকরণ,	
shukraanoo,	শুকরানু,	শুক্রানু,	
jewellery,	জিউলেরি,	জুয়েলারির,	
udbhabaney,	উদ্ভাবানে,	উদ্ভাবনে,	
foloshrutite,	ফলশ্রুতিতে,	ফলশ্রুতিতে,	
hool,	হুল,	হুল,	
karpeter,	কারপেটের,	কার্পেটের,	
pohnpeic,	পোহ্পেইক,	ফোনপেইক,	
shishupalgarh,	শিশুপালগর,	শিশুপালগড়ে,	
panthar,	পান্থার,	পন্থার,	
shhow,	শোব,	শো,	
shainyader,	শৈন্যদের,	সৈন্যদের,	
basab,	বাসাব,	বাসাব,	
dhojovongo,	ধববঙ্গ,	ধ্বজভঙ্গ,	
degree,	ডেগরি,	ডিগ্রি,	
akkelpure,	আক্কেলপুরে,	আক্কেলপুরে,	
kaalaam,	কালাম,	কালাম,	
lendal,	লেন্ডাল,	লেন্ডল,	
motke,	মটকে,	মতকে,	
taunsheep,	টাউনশিপ,	টাউনশিপ,	
aachhis,	আছিস,	আছিস,	
scholastic,	স্কোলাস্টিক,	স্কলাস্টিক,	
vromonkaley,	ভ্রমণকালে,	ভ্রমণকালে,	
somraatra,	সম্রাত্র,	সম্রাটরা,	
poorohitra,	পূরহিত্রা,	পুরোহিতরা,	
gaichhe,	গাইছে,	গাইছে,	
cholochchitrake,	চলচচিত্রাকে,	চলচ্চিত্রকে,	
jamkaalo,	জামকালো,	জমকালো,	
shilpojaat,	শিল্পজাত,	শিল্পজাত,	
marketing,	মার্কেটিং,	মার্কেটিং,	
cholochchitrer,	চলচচিত্রের,	চলচ্চিত্রের,	
niropekkho,	নিরপেক্ষ,	নিরপেক্ষ,	
pharanyeta,	ফরণ্যেতা,	ফরম্যাট,	
jibonnogor,	জীবননগর,	জীবননগর,	
harza,	হারজা,	হার্জ,	
jerushalema,	জেরুশালেমা,	জেরুসালেম,	
rojapalaner,	রোজাপালানের,	রোজাপালনের,	
purbancoler,	পূর্বানকোলের,	পূর্বাঞ্চলের,	
dadar,	দাদার,	দাদার,	
expreshshion,	এক্সপ্রেশন,	এক্সপ্রেশন,	
magrey,	ম্যাগ্রি,	ম্যাগ্রে,	
aniyantrita,	অনিনয়ন্ত্রিত,	অনিয়ন্ত্রিত,	
brahmanera,	ব্রাহ্মণেরা,	ব্রাহ্মণেরা,	
jaadrel,	জাদ্রেল,	জাঁদরেল,	
pronoti,	প্রণতি,	প্রণতি,	
echhti,	এছটি,	এছটি,	
sikkharrtheerao,	শিক্ষার্থরীরাও,	শিক্ষার্থীরাও,	
tukrote,	টুকররোতে,	টুকরোতে,	
deool,	দেওল,	দেউল,	
mousumeo,	মৌসুমেও,	মৌসুমেও,	
siraju,	সিরাজু,	সিরাজু,	
shahoshikatar,	শাহসীকতার,	সাহসিকতার,	
teta,	তেত,	টেটা,	
saabyastha,	সাব্যস্থা,	সাব্যস্থ,	
pathkrom,	পাকক্রম,	পাঠক্রম,	
peshto,	পেষতো,	পেষ্ট,	
chandrima,	চাঁদ্রিমা,	চন্দ্রিমা,	
taderek,	তাদেরক,	তাদেরেক,	
hafej,	হাফেজ,	হাফেয,	
aflatoxin,	আফলোটক্সিন,	আ্যফ্ল্যাটক্সিন,	
krimlin,	ক্রিমলিন,	ক্রিমলিন,	
meropenemer,	মেরোপেনেমের,	মেরোপেনেমের,	
gaichey,	গাইছে,	গাইছে,	
gaandaas,	গান্ডাস,	জ্ঞানদাস,	
muradpur,	মুরাদপুর,	মুরাদপুর,	
bayii,	বাইই,	বাঈ,	
samajikotar,	সমাজীকতার,	সামাজিকতার,	
habshi,	হাবসি,	হাবশী,	
labonaaktotaar,	লাবনাক্ততার,	লবণাক্ততার,	
khoor,	খুর,	ক্ষুর,	
rahimed,	রাহিম্ড,	রহিমেদ,	
turkii,	টুরকিই,	তুর্কি,	
songasthatike,	সংস্থাটিকে,	সংস্থাটিকে,	
pichte,	পিছতে,	পিছতে,	
mosjidsoho,	মসজিদসহ,	মসজিদসহ,	
samanwitovabe,	সামনন্বিতভাবে,	সমন্বিতভাবে,	
venice,	ভেনিসে,	ভেনিস,	
chokrantosoho,	চক্রান্তসহ,	চক্রান্তসহ,	
shringey,	শ্রিং,	শৃঙ্গে,	
swadesh,	স্বদেশ,	স্বদেশ,	
bahati,	বাহাটি,	বাহাতি,	
oxite,	অক্সিতে,	অক্সাইট,	
kinenni,	কিনেননি,	কিনেননি,	
saraiki,	সারাইকি,	সরাইকি,	
labonaktatar,	লাবণাকটারার,	লবণাক্ততার,	
alkatra,	আলকাত্রা,	আলকাতরা,	
prasadhoni,	প্রাসাধনি,	প্রসাধনী,	
probhur,	প্রভূর,	প্রভুর,	
parka,	পারকা,	পার্ক,	
dabliudabliui,	ডাব্লিউলবল্লি,	ডাব্লিউডাব্লিউই,	
sangsakti,	সংসক্তি,	সংসক্তি,	
krus,	ক্রুস,	ক্রুশ,	
spredasita,	স্প্রেডসিতা,	স্প্রেডশীট,	
joki,	জোকি,	জকি,	
sookumari,	সুকুমারি,	সুকুমারী,	
difinishian,	ডিফিনিশিয়ান,	ডেফিনেশন,	
doloo,	দলু,	ডলু,	
naabyota,	নাব্যতা,	নাব্যতা,	
veenish,	ভিনিশ,	ভেনিস,	
ekjoge,	একযোগে,	একযোগে,	
parjotaker,	পার্যতাকের,	পর্যটকের,	
sumitrar,	সুমিত্রার,	সুমিত্রার,	
daktikit,	ডাক্তিকিত,	ডাকটিকিট,	
asamorik,	আসামরিক,	অসামরিক,	
eshtonia,	এস্তনিয়া,	এস্তোনিয়া,	
shresthoshcho,	শ্রেষ্ঠস্চ,	শ্রেষ্ঠশ্চ,	
zoojyota,	যুজ্যতা,	যোজ্যতা,	
oswasteekor,	অস্বস্তিকর,	অস্বস্তিকর,	
komanera,	কোমানেরা,	কমানেরা,	
kaalki,	কালকি,	কালকি,	
gatibege,	গতিবেগে,	গতিবেগে,	
udyem,	উদ্যেম,	উদ্যেম,	
prothati,	প্রথাটি,	প্রথাটি,	
laaz,	লাজ,	লাজ,	
konagoolo,	কোনাগুলো,	কণাগুলো,	
sudrishya,	সূদৃশ্য,	সুদৃশ্য,	
shanno,	শান্নো,	সান্নো,	
shchalastic,	স্কললাস্তিক,	স্কলাস্টিক,	
hertj,	হার্টজ,	হার্জ,	
dibi,	ডিবি,	দিবি,	
aaeerese,	আয়েরেস,	আইরেসে,	
freelancerra,	ফ্রিল্যান্সররা,	ফ্রিল্যান্সাররা,	
zibonnogor,	জীবন্নগর,	জীবননগর,	
goodamjato,	গুদমজাত,	গুদামজাত,	
vandar,	ভান্দার,	ভাণ্ডার,	
deep,	দীপ,	দীপ,	
elakai,	এলাকাই,	এলাকাই,	
mumtaz,	মুমতাজ,	মুমতাজ,	
nibondhocheler,	নিবন্ধচেলের,	নিবন্ধছেলের,	
gaddaafee,	গাড্ডাফি,	গাদ্দাফী,	
jalbe,	জালবে,	জ্বলবে,	
plack,	প্ল্যাক,	প্ল্যাক,	
votarer,	ভোটারের,	ভোটারের,	
calabe,	ক্যালাবে,	চালাবে,	
sardar,	সারদার,	সরদার,	
carbus,	কার্বাস,	কারবাস,	
boshoborti,	বশবর্তী,	বশবর্তী,	
shikshagata,	শিক্ষগাটা,	শিক্ষাগত,	
prottokkhovabe,	প্রত্যক্ষভাবে,	প্রত্যক্ষভাবে,	
vaphara,	ভাফারা,	বাফার,	
varma,	ভারমা,	ভার্মা,	
atwabishvashi,	অত্ববিবাশী,	আত্মবিশ্বাসী,	
karmoi,	কার্মই,	কর্মই,	
deejeejer,	দেজেজের,	ডিজিজের,	
elakatir,	এলাকাটির,	এলাকাটির,	
jins,	জিন্স,	জিন্স,	
baman,	বামান,	বামন,	
shringgo,	শ্রিং,	শৃঙ্গ,	
alankorana,	আলানকরণা,	অলঙ্করণ,	
monchostho,	মন্চস্থ,	মঞ্চস্থ,	
dipon,	দিপন,	দীপন,	
somonwitobhabey,	সমন্বতিভাবে,	সমন্বিতভাবে,	
paner,	পানের,	পানের,	
shoriph,	শরিফ,	শরিফ,	
farna,	ফার্না,	ফার্ন,	
kholdhular,	খোলধূলার,	খোলধূলার,	
saarbhaarti,	সার্ভারটি,	সার্ভারটি,	
eigulor,	এইগুলোর,	এইগুলোর,	
kanader,	কানাডের,	কণাদের,	
salafeta,	সালাফেতা,	সালফেট,	
tata,	তাতা,	তাতা,	
shniper,	শ্নিপের,	স্নাইপার,	
mukhobondho,	মুখবন্ধ,	মুখবন্ধ,	
akhandota,	আখান্ডতা,	অখণ্ডতা,	
bhushito,	ভূষিত,	ভূষিত,	
qonflict,	কনফ্লিক্ট,	কনফ্লিক্ট,	
vool,	ভুল,	উল,	
torabganj,	তরাবগঞ্জ,	তোরাবগঞ্জ,	
suraaropeeto,	সুরারপিরিত,	সুরারোপিত,	
euqalyptus,	ইউক্লালপাপাস,	ইউক্যালিপ্টাস,	
barder,	বার্দের,	বার্ডের,	
chupani,	চুপানি,	চুপানি,	
fimela,	ফিমেলা,	ফিমেল,	
ispredseet,	ইসপ্রেডসিট,	স্প্রেডশীট,	
jonomukhi,	জনমুখী,	জনমুখী,	
bethikata,	বেথিকাটা,	বেঠিকতা,	
oxforde,	অক্সপোর্ডে,	অক্সফোর্ডে,	
soori,	সুরি,	সুরি,	
safiha,	সফিহা,	সাফিহা,	
heavy,	হিভি,	হেভি,	
fitarsaho,	ফিতারসহ,	ফিতরসহ,	
nutan,	নুতান,	নূতন,	
thyachara,	থ্যাচারা,	থ্যাচার,	
pranibigyani,	প্রাণিবিজ্ঞানী,	প্রাণীবিজ্ঞানী,	
soommita,	সুম্িতা,	সুমিতা,	
deefinision,	ডিফিনিশন,	ডেফিনেশন,	
dorgaaho,	দর্গাহো,	দরগাহ,	
shilbar,	শিলবার,	সিলভার,	
kathmandute,	কাঠমন্ডুতে,	কাঠমান্ডুতে,	
somraatder,	সম্রাতদের,	সম্রাটদের,	
bhabarlaler,	ভাবরলের,	ভবরলালের,	
ashor,	আশোর,	আসর,	
shikh,	শিখ,	শিখ,	
dalnata,	দালনাটা,	ডালনাটা,	
sponsorshipe,	স্পনস্রর্ষীপে,	স্পন্সরশীপে,	
kartona,	কার্তনা,	করতনা,	
registrikrito,	রেজিস্ট্রিকৃত,	রেজিস্ট্রীকৃত,	
ul,	উলি,	উল,	
laagche,	লাগছে,	লাগছে,	
qor,	করর,	কর,	
yaak,	যাক,	ইয়াক,	
siddharther,	সিদ্ধার্থের,	সিদ্ধার্থের,	
hoteltee,	হোটেলটি,	হোটেলটি,	
kormyi,	কর্মি,	কর্মই,	
taholo,	তাহলো,	তাহলো,	
milea,	মিলে,	মাইলে,	
taxikeo,	ট্যাক্সিকেও,	ট্যাক্সিকেও,	
poste,	পস্তে,	পোষ্টে,	
ghamtaa,	ঘামটা,	ঘোমটা,	
dada,	দাদা,	দাদা,	
landey,	ল্যান্ডে,	ল্যান্ডে,	
bayshorkarikarone,	বাইশরকারীকরণকে,	বেসরকারিকরণ,	
upobaashee,	উপবাশী,	উপবাসী,	
khilaphat,	খিলাফাট,	খিলাফত,	
kada,	কাড়া,	কোডা,	
karmazog,	কারমাযোগ,	কর্মযোগ,	
baieq,	বাই়েক,	বাইক,	
simons,	সিমন্স,	সিমন্স,	
vittio,	ভিত্তিও,	ভিত্তিও,	
chalachchitro,	চলচচচিত্র,	চলচ্চিত্র,	
sorano,	সোরানো,	সরানো,	
venus,	ভেনাস,	ভেনাস,	
joubankal,	যৌবনকাল,	যৌবনকাল,	
uponeesoder,	উপনীসদের,	উপনিষদের,	
mesenjjar,	মেসেঞ্জার,	মেসেঞ্জার,	
doorotomo,	দূরতম,	দূরতম,	
rajan,	রাজান,	রাজন,	
sadeep,	সাদীপ,	সদীপ,	
laaishheshh,	লাইসেস,	লাইসেন্স,	
aditisaha,	আদিতিসহ,	অদিতিসহ,	
ragee,	রাজি,	রাগী,	
kyathlik,	ক্যাথলিক,	ক্যাথলিক,	
kaleo,	কালেও,	কালেও,	
thaanobhi,	থানোভি,	থানভী,	
zubokder,	যুবকদের,	যুবকদের,	
asamanyo,	অসমান্য,	অসামান্য,	
rilayensa,	রিলায়েনসস,	রিলায়েন্স,	
sangbadmadhyame,	সংবাদমধ্যমে,	সংবাদমাধ্যমে,	
bishashke,	বিষাষকে,	বিশ্বাসকে,	
kolkarkhana,	কোলকারখানা,	কলকারখানা,	
dreeshtiheen,	দৃষ্টিহীন,	দৃষ্টিহীন,	
katbe,	কাতবে,	কাটবে,	
nazranar,	নজরনার,	নাজরানার,	
manbe,	মানবে,	মানবে,	
kamti,	কামটি,	কমতি,	
muchi,	মুচি,	মুচি,	
taateo,	তাতেও,	তাতেও,	
kaale,	কালে,	কালে,	
gratha,	গ্রাথা,	গ্রোথ,	
milayatane,	মিলায়়তনে,	মিলায়তনে,	
kuronir,	কুরনির,	কুরনীর,	
chikitshar,	চিকিৎসার,	চিকিত্সার,	
valobasen,	ভালোবাসেন,	ভালোবাসেন,	
drishyogulotey,	দৃশ্যগুলোতে,	দৃশ্যগুলোতে,	
ghoomachhilo,	ঘুমাছিল,	ঘুমাচ্ছিল,	
bhyatikaner,	ভ্যাটিকানের,	ভ্যাটিকানের,	
windo,	উইন্দ,	উইন্ডো,	
palbongser,	পালবংসের,	পালবংশের,	
bifol,	বিফল,	বিফল,	
nirmolota,	নির্মলতা,	নির্মলতা,	
chhanada,	ছানাড়া,	ছানাদা,	
kadakhonchar,	কাদাচঞ্চার,	কাদাখোঁচার,	
mathews,	ম্যাথিউস,	ম্যাথিউস,	
chalachchitrotike,	চালাচ্তিত্রটিকে,	চলচ্চিত্রটিকে,	
osamanno,	ওসামান্য,	অসামান্য,	
dhormokorme,	ধর্মকর্মে,	ধর্মকর্মে,	
foolkopi,	ফুলকোপি,	ফুলকপি,	
masto,	মাস্তো,	মাস্ত,	
biplobi,	বিপ্লবি,	বিপ্লবী,	
bhabanipur,	ভবনীপুর,	ভবানীপুর,	
folleni,	ফলেনি,	ফলেনি,	
jhimochchilo,	ঝিমচ্ছিলো,	ঝিমোচ্ছিলো,	
upbasher,	উপবাশের,	উপবাসের,	
niketon,	নিকেটন,	নিকেতন,	
niknayman,	নিকনায়ম,	নিকনেইমান,	
jibanto,	জীবান্ত,	জীবন্ত,	
boshoborty,	বশবর্তী,	বশবর্তী,	
durgatsober,	দুর্গাতসবের,	দুর্গোৎসবে,	
chalaabi,	চালাবি,	চালাবে,	
orthisoho,	অর্থিসহ,	অর্থিসহ,	
yukeliptash,	যুকেলিপ্তাস,	ইউক্যালিপ্টাস,	
dhonni,	ধননি,	ধন্যি,	
comoros,	কমোরোস,	কোমোরোস,	
jegulur,	জেগুলুর,	যেগুলুর,	
obhijojan,	অভিজযান,	অভিযোজন,	
niphelheim,	নিফেলহেইইম,	নিফেলহেইম,	
phormat,	ফরম্যাট,	ফরম্যাট,	
ponchashjon,	পঞ্চাশন,	পঞ্চাশজন,	
lokhindorer,	লখিন্দরের,	লখিন্দরের,	
bongsho,	বংশো,	বংশ,	
kisti,	কিস্তি,	কিস্তি,	
madhabi,	মাধাবি,	মাধবী,	
kaferderke,	কাফেরদেরকে,	কাফেরদেরকে,	
adarsho,	আদার্শ,	আর্দশ,	
bishshaasho,	বিশ্বাসও,	বিশ্বাসও,	
spredashita,	স্প্রেডশশিতা,	স্প্রেডশীট,	
emarjenshi,	এমরজেন্সি,	এমার্জেন্সি,	
asantosh,	অসন্তোষ,	অসন্তোষ,	
niharkantibabu,	নিঃর্কনন্তিবাবু,	নিহারকান্তিবাবু,	
aqram,	আকরাম,	আকরাম,	
abikaul,	অবিকাউল,	অবিকল,	
poriikkhateo,	পরীক্ষাতেও,	পরীক্ষাতেও,	
promothesh,	প্রমথেষ,	প্রমথেশ,	
damakalkarmirao,	দামকলর্মীরাও,	দমকলকর্মীরাও,	
chiraharit,	চিরাহারিত,	চিরহরিৎ,	
premo,	প্রেমো,	প্রিমো,	
ghoshanapatratio,	ঘোষণাপাত্রওটিও,	ঘোষণাপত্রটিও,	
nathivookteer,	নাথিভক্তির,	নথিভুক্তির,	
suri,	সুরি,	সুরি,	
rohosyoti,	রহস্যটি,	রহস্যটি,	
oswastikor,	অস্বাস্তকর,	অস্বস্তিকর,	
moresbai,	মরেসবাই,	মোরেসবাই,	
hari,	হারি,	হরি,	
kaathhmaandute,	কাঠমন্ডুতে,	কাঠমান্ডুতে,	
torkarir,	তর্কারীর,	তরকারীর,	
sarbhare,	সার্ভারে,	সার্ভারে,	
charban,	চরবান,	চর্বন,	
shho,	শোর,	শো,	
enginiiring,	ইঙ্গিনিরিং,	ইঞ্জিনিয়ারিং,	
pabo,	পাবো,	পাব,	
aakaabar,	আকাবার,	আকাবার,	
teenej,	তেইনজ,	টিনেজ,	
louhojato,	লৌহযোজত,	লৌহজাত,	
pretty,	প্রেটটি,	প্রিটি,	
brekethru,	ব্রেকেট্রু,	ব্রেকথ্রু,	
choson,	চসন,	চোষণ,	
ritesh,	রিতেশ,	রিতেশ,	
bibechyo,	বিবেচ্য,	বিবেচ্য,	
wodka,	ওয়াডকা,	ভদকা,	
stana,	স্টননা,	স্টোন,	
mardud,	মার্দুদ,	মরদুদ,	
uttor,	উত্তর,	উওর,	
dhaanche,	ধাঁছে,	ধাঁচে,	
aviyojan,	অভিবয়নজ,	অভিযোজন,	
protectionism,	প্রটটকিন্স,	প্রোটেকশনিজম,	
parabortee,	পারাবর্তী,	পরর্বতী,	
tarunra,	তারুরা,	তরুণরা,	
graambaashio,	গ্রামবাশীও,	গ্রামবাসীও,	
ishter,	ইস্তের,	ইস্টের,	
ghurte,	ঘুরতে,	ঘুরতে,	
rubidium,	রুবিডিয়াম,	রুবিডিয়াম,	
pleeta,	প্লিটা,	প্লেট,	
sangkoolan,	সংকুলন,	সংকুলান,	
khelechen,	খেলেছেন,	খেলেছেন,	
sayanaida,	সায়ানদাই,	সায়ানাইড,	
tikta,	টিকটা,	তিক্ত,	
azin,	আজিন,	আজিন,	
nibobondhonkrito,	নিববন্ধকৃত,	নিববন্ধনকৃত,	
atighataner,	অতিঘাটনের,	অতিঘটনের,	
phund,	ফান্ড,	ফান্ড,	
mehsus,	মেহসুউস,	মেহসুস,	
maaktoome,	ম্যাকটুমে,	মাকতুম,	
debholopar,	ডেভোলোপার,	ডেভলপার,	
fastag,	ফাস্টাগ,	ফ্যাসট্যাগ,	
mishal,	মিশাল,	মিশাল,	
ganohotyake,	গণহত্যাকে,	গণহত্যাকে,	
artore,	আর্তরে,	আর্টরে,	
durgotshob,	দুর্গতস্ব,	দুর্গোৎসব,	
durgotsabe,	দুর্গোৎসাবে,	দুর্গোৎসবে,	
dimbacriti,	ডিম্বাকৃতি,	ডিম্বাকৃতি,	
aireshe,	আইরেশে,	আইরেসে,	
breq,	ব্রেক,	ব্রেক,	
tokee,	টোকি,	তকি,	
shilver,	শিলভের,	সিলভার,	
sadadyarao,	সদদ্যাারও,	সদদ্যরাও,	
dobhaar,	ডোভার,	ডোভার,	
apad,	অপাদ,	আপদ,	
sampadoner,	সম্পাদনের,	সম্পাদনের,	
laishenshim,	লাইশেনশিম,	লাইসেন্সিং,	
sahapathike,	সহপাঠিকে,	সহপাঠীকে,	
kakhnoba,	কাখনবা,	কখনওবা,	
sarboshokteeman,	সর্বশক্তিমন,	সর্বশক্তিমান,	
pyatarne,	প্যাটার্ন,	প্যাটার্নে,	
dhhaabi,	ঢাবি,	ঢাবি,	
spredashiita,	স্প্রেডশশিত,	স্প্রেডশীট,	
gabeshonar,	গবেষণার,	গবেষনার,	
vittimul,	ভিত্তিমূল,	ভিত্তিমূল,	
dishani,	দিশানি,	দিশানি,	
metropolitan,	মেট্রোপলিটাতন,	মেট্রোপলিটন,	
ashankai,	আশাঙ্কাই,	আশঙ্কাই,	
juktarashtrasaha,	যুক্তারস্রসাসহ,	যুক্তরাষ্ট্রসহ,	
definition,	ডিফিনিশন,	ডেফিনেশন,	
vagini,	ভাগিনি,	ভগিনী,	
shhikara,	শিকারা,	শিকার,	
chowdhurir,	চৌধুরির,	চৌধুরীর,	
khalidke,	খালিদকে,	খালিদকে,	
seebiai,	সিবিয়াই,	সিবিআই,	
uparjon,	উপার্যজন,	উপার্জন,	
chheher,	ছেহের,	ছেহের,	
mastarsa,	মাস্তারসা,	মাস্টার্স,	
modyer,	মদ্যের,	মদ্যের,	
timathi,	তিমাথি,	টিমোথি,	
smarak,	স্মরক,	স্মারক,	
bolvodro,	বলভদ্র,	বলভদ্র,	
turista,	তুরিস্তা,	টুরিস্ট,	
bejiye,	বেজিয়ে,	বেজিয়ে,	
korley,	কররিল,	করলে,	
dologuloo,	দলগুলোও,	দলগুলোও,	
hilser,	হিলসের,	হিলসের,	
rahee,	রাহি,	রাহি,	
kumbhalnar,	কুম্ভলনর,	কুম্ভালনার,	
beetloser,	বিটলোসের,	বিটলসের,	
bharotiyotar,	ভারতীয়তার,	ভারতীয়তার,	
ronangane,	রোনাঙ্গনে,	রণাঙ্গনে,	
shamijir,	শামিজির,	স্বামীজীর,	
durotamo,	দূরতামো,	দূরতম,	
remission,	রেমিশন,	রিমিশন,	
somoibo,	সময়বো,	সমৈব,	
utotoro,	উততর,	উততর,	
madhobeer,	মধধীীর,	মাধবীর,	
akpashe,	আক্পাশে,	একপাশে,	
kormokarer,	কর্মকারের,	কর্মকারের,	
srichoitonnodeb,	শ্রীচৈতন্যৈনেব,	শ্রীচৈতন্যদেব,	
totokhon,	ততকখন,	ততক্ষন,	
chalochchitreei,	চালচচ্ছিত্রীই,	চলচ্চিত্রেই,	
adorso,	আদরসো,	আর্দশ,	
unitgulo,	উনিতগুলো,	ইউনিটগুলো,	
mimgulor,	মিমগুলোর,	মিমগুলোর,	
khitkar,	খিটকার,	ক্ষিতকর,	
shrabosty,	শ্রাবোস্টি,	শ্রাবস্তী,	
qarlosa,	কারলোসা,	কার্লোস,	
choddo,	চদ্য,	চোদ্দো,	
phutbolarder,	ফাটবললারদের,	ফুটবলারদের,	
kuttake,	কুট্টাকে,	কুত্তাকে,	
remakri,	রেমাক্রি,	রেমাক্রী,	
srisri,	শ্রীশ্রী,	শ্রীশ্রী,	
hizriite,	হিজরিতে,	হিজরীতে,	
ganjana,	গঞ্জনা,	গঞ্জনা,	
ekirokom,	একিরোকম,	একইরকম,	
mithener,	মিথেনের,	মিথেনের,	
fol,	ফোল,	ফল,	
shikkharthirao,	শিক্ষার্থীরাও,	শিক্ষার্থীরাও,	
vange,	ভাঙ্গে,	ভাঙ্গে,	
senior,	সেনিওর,	সিনিয়র,	
bujhechhila,	বুঝেছিলা,	বুঝেছিল,	
lyaandeeng,	ল্যান্ডিং,	ল্যান্ডিং,	
asbab,	আসবাব,	আসবাব,	
bandhan,	বানধধ,	বাঁধন,	
barbadoj,	বারবাদজ,	বার্বাডোজ,	
klaud,	ক্লাউড,	ক্লাউড,	
songkulan,	সংকুলান,	সংকুলান,	
amar,	আমার,	আমর,	
bhumija,	ভূমিজা,	ভূমিজ,	
afrazuler,	আফরাজুলের,	আফরাজুলের,	
pray,	প্রায়,	প্রায়,	
karmasampadon,	কর্মসম্পাদন,	কর্মসম্পাদন,	
antarbhutto,	অন্তর্ভূত্ত,	অন্তর্ভুক্ত,	
playtey,	প্লেট,	প্লেটে,	
sheetke,	শীককে,	শীতকে,	
batistambhatike,	বাতিস্তামভাতিকে,	বাতিস্তম্ভটিকে,	
scholars,	স্কলারস,	স্কলার্স,	
siddhanter,	সিদ্ধান্তের,	সিদ্ধান্তের,	
kayech,	কায়েছ,	কায়েছ,	
deenes,	ডিনেস,	দীনেশ,	
ashamorthito,	আশামর্থিত,	অসমর্থিত,	
basturoi,	বাস্তুরই,	বস্তুরই,	
koota,	কোটা,	কোটা,	
catholicbad,	ক্যাথোলিব্যাদ,	ক্যাথলিকবাদ,	
balaruma,	বালারুমা,	বলরুম,	
chhooti,	ছুটি,	ছুটি,	
creshcent,	ক্রেশেন্ট,	ক্রিসেন্ট,	
serveray,	সার্ভেরা,	সার্ভারে,	
gaziipur,	গাজিপুর,	গাজীপুর,	
akheli,	আখেলি,	আখেলী,	
mohajote,	মহাযোতে,	মহাজোট,	
tistar,	তিস্তার,	তিস্তার,	
agaldar,	আগলাদার,	আগলদার,	
mitroder,	মিট্রোদের,	মিত্রদের,	
bhramapraban,	ভ্রমপ্রবণ,	ভ্রমপ্রবণ,	
purohitra,	পুরোহিত্রা,	পুরোহিতরা,	
boudher,	বৌধের,	বৌদ্ধের,	
societykey,	সোসিটিকে,	সোসাইটিকে,	
hariken,	হারিকেন,	হ্যারিকেন,	
pratiyogita,	প্রতিযোগিত,	প্রতিযোগীতা,	
bagicha,	বাগিছা,	বাগিচা,	
grambaseer,	গ্রামবাসীর,	গ্রামবাসীর,	
hank,	হ্যাং,	হাঙ্ক,	
deares,	ডিয়ারস,	ডিআরএস,	
fud,	ফুদ,	ফুড,	
anyorup,	অন্যরূপ,	অন্যরূপ,	
foreks,	ফোরেক্স,	ফরেক্স,	
opohoron,	অপহরণ,	অপহরন,	
sumi,	সুমি,	সুমি,	
chandrimaa,	চন্দ্রিমা,	চন্দ্রিমা,	
brittakare,	বৃত্তকারে,	বৃত্তাকারে,	
jonoikaa,	জননাইকা,	জনৈকা,	
bedanta,	বেদন্ত,	বেদান্ত,	
jatinkey,	জাতিনকে,	যতীনকে,	
prity,	প্রিটি,	প্রিটি,	
kusumeshu,	কুসুমেশু,	কুসুমেষু,	
shroddhabihin,	শ্রদ্ধাবিহীন,	শ্রদ্ধাবিহীন,	
nirbahe,	নিরবাহে,	নির্বাহে,	
airish,	আইরিশ,	আইরিস,	
ghomta,	ঘোমটা,	ঘোমটা,	
collaborators,	কোলালারোটরস,	কলাবরেটরস,	
hoondayi,	হুন্ডাই,	হুন্দাই,	
banshite,	বাঁশিতে,	বাঁশিতে,	
dagmukta,	ডাগমুক্ত,	দাগমুক্ত,	
batikromshalee,	বাতিক্রমশালে,	ব্যতিক্রমধর্মী,	
choritrotakeo,	চরিত্রতাকেও,	চরিত্রটাকেও,	
oitijhya,	ঐতিহ্যা,	ঐতিহ্য,	
apolokbhabe,	অপলকভাবে,	অপলকভাবে,	
mirakela,	মিরাকেলা,	মিরাকেল,	
sumita,	সুমিতা,	সুমিতা,	
shector,	শেকটটর,	সেক্টর,	
murad,	মুরাদ,	মুরাদ,	
saralya,	সারললয়া,	সারল্য,	
byatari,	ব্যাটারি,	ব্যাটারী,	
goteehin,	গোতিহীন,	গতিহীন,	
himchi,	হিমচি,	হিমচি,	
mulbhitti,	মূলভিত্তি,	মূলভিত্তি,	
somosto,	সমস্ত,	সমস্ত,	
bandra,	বন্দ্রা,	বন্দীরা,	
sten,	স্টেন,	স্টেন,	
fansi,	ফাঁসি,	ফাঁসী,	
thaii,	থাই,	থাই,	
fiksing,	ফিক্সিং,	ফিক্সিং,	
nirgoon,	নির্গুন,	নির্গুণ,	
chikkingsasoho,	চিক্চিংসহ,	চিকিংসাসহ,	
gandhikey,	গাঁধিকে,	গান্ধীকে,	
slatgulor,	স্লাটগুলোর,	স্ল্যাটগুলোর,	
jhalkanite,	ঝালকানীতে,	ঝলকানীতে,	
hoil,	হোইল,	হইল,	
laesensh,	লেযেশেন,	লাইসেন্স,	
wishnu,	উষিনু,	বিষ্ণু,	
karmakarke,	কার্মকরকে,	কর্মকারকে,	
bhittow,	ভিটটোভ,	ভিত্তিও,	
muhurtati,	মুহুরটাটি,	মুহুর্তটি,	
marmaraa,	মারমারা,	মারমারা,	
chhooteer,	ছুটির,	ছুটির,	
bhaandar,	ভাঁদর,	ভাণ্ডার,	
kanthar,	কাঁথার,	কাঁথার,	
prakalpatike,	প্রকল্পতিকে,	প্রকল্পটিকে,	
ciima,	সিমা,	সীমা,	
abheedhanik,	অভিধনীক,	অভিধানিক,	
potka,	পটকা,	পটকা,	
dakope,	ডাকোপ,	দাকোপ,	
nirdesika,	নির্দেসিকা,	নির্দেশিকা,	
ganosachetanata,	গণসাচেতনা,	গণসচেতনতা,	
probhuder,	প্রভুদের,	প্রভুদের,	
ancholgoolote,	আঁচলগুলোতে,	অঞ্চলগুলোতে,	
nirgaman,	নির্গমন,	নির্গমন,	
hul,	হাল,	হুল,	
rakkhandurga,	রক্ষণদূর্গ,	রক্ষণদুর্গ,	
kortam,	কর্তাম,	করতাম,	
moddhyoshtho,	মধ্যস্থ্থ,	মধ্যস্থ,	
iraner,	ইরানের,	ইরানের,	
krush,	ক্রুশ,	ক্রুশ,	
bufer,	বুফের,	বাফার,	
shten,	স্টেন,	স্টেন,	
suhasini,	সুহাসিনি,	সুহাসিনী,	
rubala,	রুবালা,	রুবল,	
salchak,	সালচক,	সালচাক,	
sonaicha,	সোনাইছা,	সোনাইচা,	
bsnleu,	বিএসএনএলইউ,	বিএসএনএলইইউ,	
rajshri,	রাজশ্রি,	রাজশ্রী,	
konruup,	কনরুপ,	কোনরূপ,	
maryir,	মারিয়ির,	ম্যারির,	
plak,	প্ল্যাক,	প্ল্যাক,	
simantarkkhibahinir,	সীমান্তর্কিরবাহিনীর,	সীমান্তরক্ষীবাহিনীর,	
soundorjotakei,	সৌন্দর্যতাকেই,	সৌন্দর্যটাকেই,	
turisht,	টুউরিস্ট,	টুরিস্ট,	
manober,	মানবের,	মানবের,	
magar,	মাগার,	মাগার,	
akkhunno,	অক্ষুন্ন,	অক্ষুণ্ণ,	
bishhnu,	বিষ্ণু,	বিষ্ণু,	
dhrubaker,	ধ্রুবাকের,	ধ্রুবকের,	
utkhaat,	উৎখাত,	উত্খাত,	
gandhiio,	গান্ধিও,	গান্ধীও,	
stander,	স্ট্যান্ডার,	স্ট্যাণ্ডের,	
patishapta,	পাটিশাপ্টা,	পাটিসাপটা,	
monzooshree,	মঞ্জশ্রী,	মঞ্জুশ্রী,	
akten,	আকতেন,	অকটেন,	
akkharkey,	অক্ষরকে,	অক্ষরকে,	
nojder,	নজদের,	নজদের,	
shabkam,	শবকাম,	শবকাম,	
manob,	মানব,	মানব,	
deciliter,	ডিসিলাইটার,	ডেসিলিটার,	
mukhomandaley,	মুখমান্ডলে,	মুখমণ্ডলে,	
nutaner,	নুতানের,	নূতনের,	
nadnadeer,	নাদনদীর,	নদনদীর,	
ucchosito,	উচ্চশিত,	উচ্ছসিত,	
rajbandi,	রাজবন্দী,	রাজবন্দী,	
nischitobhabe,	নিশ্চিতভাবে,	নিশ্চিতভাবে,	
sucre,	সাক্রে,	সাকার,	
sanaktokaron,	সননক্তকারণ,	সনাক্তকরণ,	
toroonra,	তরণরা,	তরুণরা,	
direqtareta,	ডিরেক্েরত,	ডিরেক্টরেট,	
shilpajata,	শিল্পাজতা,	শিল্পজাত,	
townshhip,	তাউনশিপ,	টাউনশিপ,	
shektore,	শেকটরে,	সেক্টরে,	
romnar,	রোমনার,	রমনার,	
refleks,	রেফেল্কস,	রিফ্লেক্স,	
dhangsantup,	ধংসং্ুপ,	ধ্বংসন্তুপ,	
aholyar,	অহল্যার,	অহল্যার,	
phakay,	ফাকায়,	ফাকে,	
harees,	হারিস,	হ্যারিস,	
nachiketa,	নাচিকেটা,	নচিকেতা,	
mandape,	মান্ডাপে,	মন্ডপে,	
sohokari,	সহাকারী,	সহকারী,	
jesh,	জেশ,	জেস,	
vaabnake,	বাবনাকে,	ভাবনাকে,	
kaloniir,	কালনীর,	কালনীর,	
gaj,	গাজ,	গেজ,	
behrampurer,	বেহরমপুরের,	বহরমপুরের,	
mosharroph,	মোসারফো,	মশাররফ,	
madhumati,	মধুমতি,	মধুমতী,	
veniser,	ভেনিসের,	ভেনিসের,	
krisenta,	ক্রিসেন্টা,	ক্রিসেন্ট,	
lobbytey,	লব্বিতে,	লবিতে,	
kanshat,	কানশাত,	কানসাট,	
asif,	আশিফ,	আসিফ,	
timoothi,	তিমথথি,	টিমোথি,	
sheets,	সেইটস,	শীটস,	
oitijjo,	ঐতিহ্য,	ঐতিহ্য,	
tateo,	তাতেও,	তাতেও,	
maudelti,	মাউডেলটি,	মডেলটি,	
alsaar,	আলসার,	আলসার,	
azijer,	আজিজের,	আজিজের,	
mulvitti,	মূলভিত্তি,	মূলভিত্তি,	
nodimatrik,	নদিমাত্রিক,	নদীমাতৃক,	
gyandas,	জ্ঞানদাস,	জ্ঞানদাস,	
suiti,	সুইটি,	সুইটি,	
saainyo,	সাইনয়,	সৈন্য,	
dinifitian,	ডিনিফিইন,	ডেফিনেশন,	
shasankarta,	শাসনকার্ত,	শাসনকর্তা,	
parqa,	পারকা,	পার্ক,	
bhorkendra,	ভরকেন্দ্র,	ভরকেন্দ্র,	
elaakaati,	এলাকাটি,	এলাকাটি,	
byepass,	ব্যাপেস,	বাইপাস,	
mah,	মাহ,	মাহে,	
gandagol,	গান্ডাগোল,	গন্ডগোল,	
rachanakal,	রচনাকাল,	রচনাকাল,	
mekong,	মেকং,	মেকং,	
oncholgulir,	অঞ্চলগুলির,	অঞ্চলগুলির,	
madhobi,	মাধবী,	মাধবী,	
panda,	পাণ্ডা,	পান্ডে,	
tigmanshu,	তিগমন্চু,	তিগমংশু,	
stonehenje,	স্তোনেেন্জে,	স্টোনহেঞ্জ,	
phiksim,	ফিক্সিম,	ফিক্সিং,	
abheedhaaneeck,	অভিধানিক,	অভিধানিক,	
daakten,	ডাকতেন,	ডাকতেন,	
moomtaj,	মুমতাজ,	মুমতাজ,	
iksaprishana,	ইক্সপ্রিশন,	এক্সপ্রেশন,	
mitrota,	মিত্রতা,	মিত্রতা,	
sahachke,	সাহাকে,	সাহাচকে,	
windows,	উইনডোস,	উইন্ডোস,	
jyesttha,	জ্যেষ্ঠা,	জ্যেষ্ঠা,	
goolen,	গুলেন,	গুলেন,	
nishad,	নিশাদ,	নিষাদ,	
alimpiqa,	আলিম্পিকা,	অলিম্পিক,	
ashamarthita,	আশামর্থিতা,	অসমর্থিত,	
croak,	ক্রোক,	ক্রোক,	
nirbaaho,	নির্বাহ,	নির্বাহ,	
ogovir,	ওগভির,	অগভীর,	
gloria,	গ্লোরিয়া,	গ্লোরিয়া,	
bhittiti,	ভিত্তিটি,	ভিত্তিটি,	
qonfliqt,	কনফ্লিক্ট,	কনফ্লিক্ট,	
firalem,	ফিরালেম,	ফিরালেম,	
niemond,	নিয়েন্ড,	নিমন্ড,	
nationalser,	নেটিওনালসের,	ন্যাশনালসের,	
elaakaate,	এলাকাতে,	এলাকাতে,	
porobortii,	পরবর্তীই,	পরর্বতী,	
lyaataa,	ল্যাটা,	ল্যাটা,	
zerusaleme,	জেরুসালেমে,	জেরুসালেমে,	
phaltu,	ফাল্টু,	ফালতু,	
veenis,	ভিনিস,	ভেনিস,	
jahangirbad,	জাহাঙ্গীরবাদ,	জাহাঙ্গীরবাদ,	
tanu,	তানু,	তনু,	
guha,	গুহা,	গোহ,	
melborrone,	মেলবর্নো,	মেলবোর্নে,	
redcrosser,	রেডক্রসের,	রেডক্রসের,	
camerapersoner,	ক্যামেরাপরসসের,	ক্যামেরাপার্সনের,	
kutubuddinke,	কুটুবুদ্দীনকে,	কুতুবুদ্দিনকে,	
bhandti,	ভাঁদটি,	ভাণ্ডটি,	
tuni,	টুনি,	টুনি,	
rinattak,	ঋণত্বক,	ঋনাত্মক,	
mahafezkhanar,	মাহাফেখ্জানার,	মহাফেজখানার,	
chadake,	চড়াকে,	চড়াকে,	
shahidputra,	শহিদপুত্র,	শহীদপুত্র,	
trabuco,	ট্রাবুকো,	ট্র্যাবুকো,	
shikkhartheerao,	শিক্ষার্থীরাও,	শিক্ষার্থীরাও,	
licencer,	লাইসেন্সের,	লাইসেন্সের,	
udvabani,	উদ্ভাবাণী,	উদ্ভাবনী,	
gajetted,	গেজেট্টেড,	গেজেটেড,	
gavaskar,	গাভাসকর,	গাভাস্কার,	
ssahocorze,	স্হাকর্জে,	সাহচর্যে,	
jahara,	জাহারা,	যাহরা,	
rohasyati,	রোহাস্যটি,	রহস্যটি,	
sachetonvabe,	সচেতনভাবে,	সচেতনভাবে,	
sahittopritite,	সাহিত্যপ্রিতিতে,	সাহিত্যপ্রীতিতে,	
mulyayonsapekkhe,	মূল্যয়নাপেক্ষে,	মূল্যায়নসাপেক্ষে,	
protinito,	প্রতিনিত,	প্রতিনিত,	
maail,	মাইল,	মাইল,	
ishton,	ইসতন,	স্টোন,	
buddhitii,	বুদ্ধিতিই,	বুদ্ধিটিই,	
gagee,	গ্যাগি,	গেজ,	
aakkaash,	আক্কাশ,	আককাস,	
sachetanvabe,	সচেতাননভে,	সচেতনভাবে,	
brindabane,	বৃন্দাবানে,	বৃন্দাবনে,	
ujbekistaner,	উজবেকসিৎনানের,	উজবেকিস্তানের,	
doorger,	ডার্গের,	দুর্গের,	
protistha,	প্রতিষ্ঠা,	প্রতিষ্টা,	
byaboharkarir,	ব্যবহারকারীর,	ব্যবহারকারীর,	
dormitory,	ডর্মিটরি,	ডরমিটরি,	
foxer,	ফক্সের,	ফক্সের,	
nirmalata,	নির্মলতা,	নির্মলতা,	
rayyalati,	রায়য়লাটি,	রয়্যালটি,	
bojhe,	বোঝে,	বোঝে,	
olympik,	অলিমপিক,	অলিম্পিক,	
jibnagore,	জীবনাগরে,	জীবননগর,	
baipash,	বাইপাশ,	বাইপাস,	
bajhyo,	বাঝ্য,	বাহ্য,	
headquartus,	হেডকোরয়াস,	হেডকোয়ার্টাস,	
gananatyo,	গণনত্য,	গণনাট্য,	
pothon,	পথন,	পঠন,	
raghubar,	রঘুবার,	রঘুবীর,	
zerusalem,	জেরুসালেম,	জেরুসালেম,	
juboksoho,	যুবকসহ,	যুবকসহ,	
mozdur,	মজদুর,	মজদুর,	
soleel,	সলেল,	সলিল,	
ekatto,	একাত্ত,	একাত্ব,	
capsule,	ক্যাপসুলে,	ক্যাপ্সুল,	
helly,	হেলি,	হিলি,	
encidablu,	এনসিড্যাবল,	এনসিডাব্লু,	
shcholastic,	স্কলোস্টিক,	স্কলাস্টিক,	
duburir,	ডুবুরির,	ডুবুরির,	
literacy,	লিটারেসি,	লিটারেসি,	
concerter,	কনসার্টের,	কানসাটের,	
raiji,	রাইজি,	রাইজি,	
porjotoker,	পর্যটকের,	পর্যটকের,	
doneta,	ডোনেটা,	ডোনাট,	
choudry,	চৌড্রি,	চৌধুরী,	
probeshkari,	প্রবেশকারী,	প্রবেশকারী,	
alumni,	আলুমনি,	অ্যালমনি,	
courtcaser,	কোর্টসেসের,	কোর্টকেসের,	
talaal,	তালাল,	তালাল,	
sharif,	শরিফ,	শরিফ,	
aswasteekor,	অস্বস্তিকর,	অস্বস্তিকর,	
prakalpagulor,	প্রকল্পাগুলোর,	প্রকল্পগুলোর,	
antarctika,	অন্টর্কটিকা,	অ্যান্টার্কটিকা,	
inapharameshana,	ইনারফেশন,	ইনফরমেশন,	
nosihote,	নসহতে,	নসিহতে,	
sumoo,	সুমু,	সুমো,	
elakaate,	এলাকাতে,	এলাকাতে,	
acrolect,	অ্যাক্রোলেক্ট,	অ্যাক্রোলেক্ট,	
eporzonto,	এপর্ণ্য,	এপর্যন্ত,	
bosano,	বসানো,	বসানো,	
lendl,	লেন্ডল,	লেন্ডল,	
chahidapotrer,	চাহিদাপত্রের,	চাহিদাপত্রের,	
chrystal,	ক্রিস্টাল,	ক্রাইস্টাল,	
ayantarqatiqa,	আয়ন্তরকাটিকা,	অ্যান্টার্কটিকা,	
husni,	হুসনি,	হুসনি,	
kooshumba,	কোশুমবা,	কুশুম্বা,	
nothivukto,	নথিভুক্ত,	নথিভুক্ত,	
harbore,	হারবরে,	হারবারে,	
gotirodh,	গতিরোধ,	গতিরোধ,	
mausumeo,	মৌসুমেও,	মৌসুমেও,	
saqara,	সাকারা,	সকার,	
bbiswash,	বিবিস্বাস,	বিশ্বাস,	
greenald,	গ্রিনল্ড,	গ্রিনল্ড,	
ddheela,	ঢিলা,	ঢিলা,	
deputi,	দেপুতি,	ডেপুটি,	
khonjena,	খোঁজেনা,	খোঁজেনা,	
alraji,	আলরাজি,	আলরাজী,	
siramikasa,	সিরামিকাসা,	সিরামিকস,	
dubaate,	দুবাতে,	ডুবাতে,	
debeting,	দেবেতিং,	ডিবেটিং,	
mandondo,	মান্দনদো,	মানদণ্ড,	
khaschandpur,	খাসচাঁদপুর,	খাসচাঁদপুর,	
shangsthatikey,	সাংস্থাতিকে,	সংস্থাটিকে,	
licensin,	লাইসেনসিন,	লাইসেন্সিং,	
olympicer,	অলিমপিসের,	অলিম্পিকের,	
bouddha,	বৌদ্ধ,	বৌদ্ধ,	
sectore,	সেক্টরে,	সেক্টরে,	
grambaasheeo,	গ্রামবাশীও,	গ্রামবাসীও,	
phuda,	ফুডা,	ফুড,	
akkheperi,	অক্ষেপেরই,	আক্ষেপেরই,	
ceramicsh,	সেরামিক্স,	সিরামিকস,	
kosambir,	কোসাম্বীর,	কোসাম্বীর,	
gobeshonar,	গবেষণার,	গবেষনার,	
dooburira,	দূবুরীরা,	ডুবুরিরা,	
shangsthaner,	সাংস্ঠানের,	সংস্থানের,	
israelbahini,	ইস্রিয়ালহিনি,	ইস্রায়েলবাহিনী,	
satarka,	সতর্কা,	সতর্ক,	
asaktibandhan,	অসক্তিবা্ধন,	আসক্তিবন্ধন,	
shikkhakram,	শিক্ষাক্রম,	শিক্ষাক্রম,	
bhagno,	ভাগনো,	ভগ্ন,	
ramachandranke,	রামচন্দ্রনকে,	রামাচন্দ্রনকে,	
karir,	কারির,	কারীর,	
majlishpur,	মজজিশপুর,	মজলিশপুর,	
kachhakaachhi,	কাছাকাচি,	কাছাকাছি,	
lutherana,	লুথেরানা,	লুথেরান,	
bm,	বিএম,	বিএম,	
kathmandu,	কাঠমন্ডু,	কাঠমান্ডু,	
jhamala,	ঝামালা,	ঝামালা,	
sqalarashipa,	স্কলরাশিপা,	স্কলারশিপ,	
everage,	এভারেজ,	এভারেজ,	
dienes,	ডায়েনেস,	ডিএনএস,	
alaol,	আলাওল,	আলাওল,	
fising,	ফিসিং,	ফিসিং,	
golimodhye,	গোলিমধ্যে,	গলিমধ্যে,	
uddhritir,	উদ্ধৃতির,	উদ্ধৃতির,	
bossoben,	বস্বেন,	বসবেন,	
lendol,	লেন্ডোল,	লেন্ডল,	
kormobuddhite,	কর্মবুদ্ধিতে,	কর্মবুদ্ধিতে,	
nilfamarir,	নীলফামারীর,	নীলফামারীর,	
shumo,	শুমো,	সুমো,	
akkaas,	আক্কাস,	আককাস,	
uthhaane,	উঠানে,	উঠানে,	
naobihar,	নাবিবাহার,	নৌবিহার,	
naitikatavodh,	নৈতিকাতাধ,	নৈতিকতাবোধ,	
nobotom,	নবতম,	নবতম,	
dhaleshwari,	ধলেশ্বরী,	ধলেশ্বরী,	
badargaji,	বদররগজজি,	বদরগাজী,	
chhadura,	ছাড়ুরা,	ছাদুরা,	
rashider,	রাশীদের,	রশিদের,	
remacri,	রিম্যাকরি,	রেমাক্রী,	
parishram,	পরিশ্রম,	পরিশ্রম,	
tookrokey,	তুকরোকে,	টুকরোকে,	
azaan,	আজান,	আজান,	
shlok,	শ্লোক,	শ্লোক,	
as,	আসেএস,	অস,	
jeshh,	জেস,	জেস,	
daqten,	ডাকটেন,	ডাকতেন,	
munshiji,	মুনশিজি,	মুনশীজি,	
shikshagato,	শিক্ষাগত,	শিক্ষাগত,	
moshzidtike,	মোশজজটিকে,	মসজিদটিকে,	
peeth,	পীথ,	পীঠ,	
hooq,	হুক,	হুক,	
toroonraa,	তরণরা,	তরুণরা,	
rahshahi,	রাহশাহি,	রাহশাহী,	
mesenjarer,	মেসেন্জারের,	মেসেঞ্জারের,	
koyeeri,	কয়েরি,	কোয়েরি,	
uporzon,	উপরজন,	উপার্জন,	
chhadite,	ছাড়িতে,	ছড়িতে,	
durarohini,	দুরারহিনী,	দুরারোহিণী,	
agomone,	আগমনে,	আগমনে,	
cholchhe,	চলচে,	চলছে,	
reejideencee,	রিজিডেন্সে,	রেসিডেন্স,	
shaddhi,	শাদ্ধি,	সাধ্বী,	
meshenjar,	মেশেন্জার,	মেসেঞ্জার,	
muradke,	মুরাদকে,	মুরাদকে,	
female,	ফেমালে,	ফিমেল,	
jeelyaand,	জিল্যান্ড,	জিল্যান্ড,	
angibhutovabe,	অঙ্গিভূতভাবে,	অঙ্গীভূতভাবে,	
somraat,	সম্রাত,	সম্রাট,	
choudhurike,	চৌধুরীকে,	চৌধুরীকে,	
deilee,	দেইলী,	ডেইলি,	
uparzoner,	উপারজনের,	উপার্জনের,	
nikela,	নিকেলা,	নিকেল,	
engrejer,	এংরেজের,	ইংরেজের,	
dhauto,	ধৌতো,	ধৌত,	
mahakabi,	মহাকাবি,	মহাকবি,	
ase,	এএসইএস,	আসে,	
cholochchitra,	চলচচ্চিত্র,	চলচ্চিত্র,	
marri,	মারি,	ম্যারি,	
chhutee,	ছুতি,	ছুটি,	
chowdhuryke,	চৌধুরীকে,	চৌধুরীকে,	
kazianis,	কাজিয়ানিস,	কাজানিস,	
macbeth,	ম্যাবেথ,	ম্যাকবেথ,	
oncholshomuh,	অঞ্চলসমূহ,	অঞ্চলসমূহ,	
bunot,	বুনোট,	বুনট,	
pettern,	পেটার্ন,	প্যাটার্ন,	
firti,	ফার্তি,	ফিরতি,	
nutoner,	নূটনের,	নূতনের,	
mmadhuri,	ম্মাধুরী,	মাধুরী,	
byabaharkareer,	ব্যবহররকারীর,	ব্যবহারকারীর,	
corsin,	কর্সিন,	করসিন,	
pratool,	প্রাটুল,	প্রতুল,	
popaike,	পপাইকে,	পপাইকে,	
toching,	তচিং,	টোচিং,	
abdi,	আবদি,	অব্দি,	
venisey,	ভেনিসে,	ভেনিসে,	
dharmee,	ধর্মী,	ধর্মী,	
shalook,	শালুক,	শালুক,	
kagbeni,	কাগবেনি,	কাগবেনি,	
rohosyo,	রহস্য,	রহস্য,	
annanere,	আন্নানেরে,	অন্যানেরে,	
sanghar,	সংঘর,	সংহার,	
jhanjra,	ঝাঁজরা,	ঝাঁজরা,	
shamshernagar,	শমেশরনগর,	শমশেরনগর,	
rajtantro,	রাজতন্ত্র,	রাজতন্ত্র,	
oitijhyotike,	ঐতিহ্যটিকে,	ঐতিহ্যটিকে,	
proshikkhane,	প্রশিক্ষণে,	প্রশিক্ষণে,	
turbine,	টারবাইন,	টারবাইন,	
shfingtar,	স্ফিংটর,	স্ফিংটার,	
jani,	জানি,	জনি,	
orgho,	অর্ঘ,	অর্ঘ্য,	
protisthan,	প্রতিষ্ঠান,	প্রতিষ্টান,	
hariner,	হারিনের,	হরিণের,	
daacktickete,	ডাকটিকেট,	ডাকটিকিটে,	
arasie,	আরাসিই,	আরসিএ,	
direectoratee,	ডিরেক্টরিতি,	ডিরেক্টরেট,	
gujob,	গুজব,	গুজব,	
ghatla,	ঘাটলা,	ঘটল,	
chhootochhuti,	ছুটোছুটি,	ছুটোছুটি,	
pluck,	প্লাক,	প্ল্যাক,	
janagononar,	জানাগনার,	জনগণনার,	
shashtra,	শাস্ত্র,	শাস্ত্র,	
durbhagya,	দুর্ভাগ্য,	দূর্ভাগ্য,	
joumana,	জৌমানা,	জুমানা,	
brittakarey,	বৃত্তকরে,	বৃত্তাকারে,	
paste,	পাসতে,	পেষ্ট,	
icelands,	ইসিল্যান্ডস,	আইসল্যান্ডসহ,	
lakshmir,	লক্ষ্মীর,	লক্ষ্মীর,	
grotha,	গ্রথা,	গ্রোথ,	
autopromotioner,	অটোপ্রোটেশনের,	অটোপ্রমোশনের,	
kurdider,	কুর্দিদের,	কুর্দিদের,	
cooda,	কুড,	কোডা,	
paramartha,	পরমর্থ্থ,	পরমার্থ,	
habsi,	হাবসি,	হাবশী,	
janosamaj,	জনসমাজ,	জনসমাজ,	
biprodas,	বিপ্রদাস,	বিপ্রদাস,	
vittiteo,	ভিত্তিতেও,	ভিত্তিতেও,	
hughes,	হুগেস,	হিউজেস,	
hames,	হামস,	হোমস,	
iuro,	আইওর,	ইউরো,	
khalid,	খালিদ,	খালিদ,	
chhaikalo,	ছাইকালো,	ছাইকালো,	
kloud,	ক্লাউড,	ক্লাউড,	
konorup,	কনোরূপ,	কোনরূপ,	
konar,	কোনার,	কণার,	
torkareer,	তর্কারীর,	তরকারীর,	
gate,	গেট,	গ্যেটে,	
daaun,	দাউন,	ডাউন,	
bosturoi,	বস্তুরই,	বস্তুরই,	
foks,	ফক্স,	ফক্স,	
neerbahe,	নির্বাহে,	নির্বাহে,	
deliver,	ডেলিভার,	ডেলিভার,	
probhritike,	প্রভৃতিকে,	প্রভৃতিকে,	
senabahineekey,	সেনাবাহিনীকে,	সেনাবাহিনীকে,	
prosadhani,	প্রসাধানি,	প্রসাধনী,	
grambaaseeder,	গ্রামবাসীদের,	গ্রামবাসীদের,	
tunaita,	টুনাইটা,	টুনাইট,	
turkamena,	তুর্কামেনা,	তুর্কমেন,	
pratijogider,	প্রাতিযোগীদের,	প্রতিযোগীদের,	
ragei,	রাগেই,	রাগেই,	
antorvuktimulak,	আন্তর্ভুমিকমক,	অন্তর্ভুক্তিমূলক,	
dumaa,	দুমা,	দুমা,	
siddhantoke,	সিদ্ধানটকে,	সিদ্ধান্তকে,	
jatotaa,	জাতোা,	যতোটা,	
pillai,	পিল্লাই,	পিল্লাই,	
bhabatarini,	ভবতারিণী,	ভবতারিণী,	
gondogol,	গণ্ডগল,	গন্ডগোল,	
soomita,	সুমিতা,	সুমিতা,	
noiteekotar,	নৈতিকতার,	নৈতিকতার,	
dharmadasbabu,	ধর্মদসবাবু,	ধর্মদাসবাবু,	
monohputo,	মনঃপুতো,	মনঃপুত,	
terlarang,	টেরলারং,	তেরলারং,	
sahajlabhbhotar,	সহলালভোভতার,	সহজলভ্যতার,	
bodhirota,	বোধিরতা,	বধিরতা,	
poroborti,	পরবর্তী,	পরর্বতী,	
elakayi,	এলাকায়ি,	এলাকাই,	
sahocorje,	সহকর্যে,	সাহচর্যে,	
qaferder,	কাফেরদের,	কাফেরদের,	
kampita,	কম্পিতা,	কম্পিত,	
chhutochhuti,	ছুটোছুটি,	ছুটোছুটি,	
bodhir,	বোধির,	বধির,	
matthews,	ম্যাথেউস,	ম্যাথিউস,	
roy,	রয়়,	রায়,	
dhanche,	ধাচে,	ধাঁচে,	
rijoor,	রিজুর,	রিজুর,	
oblivion,	অবলিভিওন,	অবলিভিয়ন,	
totokson,	ততকসন,	ততক্ষন,	
janar,	জানার,	জানার,	
holdim,	হোল্ডিং,	হোল্ডিং,	
patigoniter,	পাটিগণিতের,	পাটিগণিতের,	
railliner,	রেল্লিনের,	রেললাইনের,	
uparjoner,	উপার্জনের,	উপার্জনের,	
groundta,	গ্রান্ডটা,	গ্রাউন্ডটা,	
kani,	কানি,	কানি,	
bhyaatikaner,	ভ্যাতিকানের,	ভ্যাটিকানের,	
nyeta,	ন্যাটা,	ম্যাট,	
daltyagi,	দলত্যাগী,	দলত্যাগী,	
himsrot,	হিমস্রোত,	হিমস্রোত,	
hetimganje,	হেতিমাঙ্জে,	হেতিমগঞ্জে,	
bhabaponno,	ভাবাপন্ন,	ভাবাপন্ন,	
antarvuktimulak,	অন্তর্ভূতিকমূলক,	অন্তর্ভুক্তিমূলক,	
sorting,	সর্টিং,	সর্টিং,	
palashir,	পালাশির,	পলাশীর,	
patochitra,	পাটোচিত্র,	পটচিত্র,	
krechi,	ক্রেচি,	করেছি,	
dharavahik,	ধারাভাহিক,	ধারাবাহিক,	
bandi,	বা্দি,	বন্দী,	
sabrakamer,	সব্রকমের,	সবরকমের,	
kommandar,	কম্মান্দার,	কমাণ্ডার,	
pleta,	প্লেটা,	প্লেটো,	
emiratas,	এমিরাতাস,	এমিরেটাস,	
metrikoleshana,	মেট্রিকোলেশন,	মেট্রিকোলেশন,	
pragreesa,	প্রাগ্রিসা,	প্রগ্রেস,	
danab,	দানাব,	দানব,	
prithibir,	পৃথিবীর,	পৃথবীর,	
devolapar,	দেবলাপার,	ডেভলপার,	
siima,	সিমমা,	সীমা,	
vaisoho,	ভাইসহ,	ভাইসহ,	
proo,	প্রয়,	প্রো,	
bujhtepari,	বুঝতেপারী,	বুঝতেপারি,	
abhidhanick,	অভিধানিক,	অভিধানিক,	
arthurer,	অর্থুরের,	আর্থারের,	
shulfate,	শুলফাতে,	সালফেট,	
pachattar,	পাচাত্তর,	পাচাত্তার,	
gaje,	গাজে,	গেজ,	
kode,	কোডে,	কোড,	
nothibhukto,	নথিভুক্ত,	নথিভুক্ত,	
sayatana,	সায়াতনা,	শয়তান,	
kaley,	কালে,	কালে,	
carzar,	কারজার,	চার্জার,	
dharmantor,	ধর্মান্তর,	ধর্মান্তর,	
bhenkates,	ভেঙ্কেটসহ,	ভেঙ্কটেশ,	
graminphonor,	গ্রামিনফোনোর,	গ্রামীণফোনর,	
heawy,	হিউ,	হেভি,	
thare,	থারে,	থরে,	
jolbe,	জলবে,	জ্বলবে,	
rajotwo,	রাজত্ব,	রাজত্ব,	
jonee,	জনী,	জনি,	
samle,	সামলে,	সামলে,	
treebhuj,	ত্রীগজু,	ত্রিভূজ,	
indro,	ইন্দ্রো,	ইন্দ্র,	
turbiner,	টার্বিইনের,	টারবাইনের,	
dwijenbabuder,	দ্বিজেনবাবুদের,	দ্বিজেনবাবুদের,	
graambaaseeder,	গ্রামবাসীদের,	গ্রামবাসীদের,	
gannaprakasham,	গন্নপ্রকাশ,	গন্নাপ্রকাশম,	
ghotleo,	ঘটলেও,	ঘটলেও,	
tarkareer,	তারকারীর,	তরকারীর,	
militaryr,	মিলিটারির,	মিলিটারির,	
fooloo,	ফুলু,	পোলো,	
crime,	ক্রাইম,	ক্রাইম,	
lotharan,	লোথারান,	লুথেরান,	
langhaner,	ল্যাংঘানের,	লংঘনের,	
homeser,	হোমেসের,	হোমসের,	
dijmarescu,	ডিজমারেস্চু,	দিজমার্সাকু,	
akar,	আকার,	একার,	
hitokor,	হিটোকর,	হিতকর,	
chitronattakar,	চিত্রনাট্টকার,	চিত্রনাট্যকার,	
susamo,	সুসামো,	সুসম,	
flirt,	ফ্লিরট,	ফ্লার্ট,	
lat,	লাত,	লাট,	
jacksonke,	জ্যাকসনকে,	জ্যাকসনকে,	
daebug,	দাইবুগ,	ডিবাগ,	
gandhariir,	গান্ধারীর,	গান্ধারীর,	
afzol,	আফজোল,	আফজল,	
saqara,	সাকারা,	সাকার,	
durlabhatwang,	দুর্লভবত্বং,	দুর্লভত্বং,	
akeeb,	আকিব,	আকিব,	
rudroke,	রুদ্রকে,	রুদ্রকে,	
krusher,	ক্রুশের,	ক্রুশের,	
agora,	আগোরা,	আগোরা,	
eduardo,	এডুয়ার্ড,	এডুয়ার্দো,	
oisamoyer,	ঐসাময়ের,	ঐসময়ের,	
gajano,	গাজানো,	গজানো,	
votar,	ভোটার,	ভোটার,	
pushtee,	পুষ্টি,	পুষ্টি,	
birmuktijoddhagan,	বির্মুক্তিযোধ্যাগণ,	বীরমুক্তিযোদ্ধাগণ,	
sikkhagata,	শিক্ষাগত,	শিক্ষাগত,	
survative,	সার্ভেটিভ,	সারভেটিভ,	
mahibur,	মাহিবুর,	মহিবুর,	
judge,	জুদগে,	জাজ,	
itastata,	ইতাস্তাটা,	ইতস্তত,	
baarbadoj,	বার্বাদজ,	বার্বাডোজ,	
mase,	মাসে,	মাসে,	
prokar,	প্রকার,	প্রকার,	
naper,	নাপের,	ন্যাপের,	
shuperheiro,	শুপেরহেরো,	সুপারহিরো,	
maner,	মানের,	মানে,	
qanasarabheshana,	কোনাসারেভন,	কনসারভেশন,	
salapheeta,	সালফফিতা,	সালফেট,	
suparichiti,	সুপারিচিতি,	সুপরিচিতি,	
cn,	সিএন,	সিএন,	
abhidhaner,	অভিধানের,	অভিধানের,	
salphat,	সালফাত,	সালফেট,	
baasaate,	বাসাতে,	বাসাতে,	
naagaalyand,	নাগাল্যান্ড,	নাগাল্যান্ড,	
shatodha,	শতোধা,	শতধা,	
chaaktir,	চাক্তির,	চাকতির,	
hert,	হার্ত,	হার্ট,	
valobase,	ভালোবাসে,	ভালোবাসে,	
jotinkey,	জোটিনকে,	যতীনকে,	
aansareer,	আনসারীর,	আনসারীর,	
otyacharito,	অত্যাচারিত,	অত্যাচারিত,	
skolarsip,	স্কলার্সিপ,	স্কলারশিপ,	
jolrong,	জলরং,	জলরঙ,	
faskari,	ফাসকারি,	ফাঁসকারী,	
gardeen,	গার্ডিন,	গার্ডেন,	
rajbondir,	রাজবন্দির,	রাজবন্দীর,	
dabarer,	ডাবারের,	দাবারের,	
sahinsatar,	সাহিনসাতার,	সহিংসতার,	
bandhubhaabaapanna,	বন্ধুভাবন্ন,	বন্ধুভাবাপন্ন,	
kalnir,	কালনির,	কালনীর,	
grambaashi,	গ্রামবাশী,	গ্রামবাসী,	
ahalya,	অহাল্যা,	অহল্যা,	
ingreziteo,	ইংরেজিতেও,	ইংরেজিতেও,	
khelaphate,	খেলাফাতে,	খেলাফতে,	
registaner,	রেজিস্টানের,	রেগিস্তানের,	
shommotite,	সম্মতিতে,	সম্মতিতে,	
songkolonti,	সংকলন্তি,	সংকলনটি,	
tintir,	তিনটির,	তিনটির,	
daakteekite,	দাক্তিকীতে,	ডাকটিকিটে,	
onkush,	অঙ্কুষ,	অংকুশ,	
shakankti,	শাকাঙ্কটি,	শকাঙ্কটি,	
qarqa,	কারকা,	কার্ক,	
baharamporer,	বহরাম্পরের,	বহরমপুরের,	
karlei,	কারলেই,	করলেই,	
churger,	চার্গের,	চার্জের,	
seshardhe,	শেশার্ধে,	শেষার্ধে,	
spancer,	স্প্যান্সের,	স্পেন্সার,	
desiseyer,	দেসিসেয়ের,	ডিজিজের,	
ispredsheet,	ইসপ্রেশশিত,	স্প্রেডশীট,	
phood,	ফুড,	ফুড,	
prothakey,	প্রথাকে,	প্রথাকে,	
peeri,	পীরি,	পেরি,	
sikkhokder,	শিক্ষকদের,	শিক্ষকদের,	
edseler,	এডসেলের,	এডসেলের,	
teunar,	টিউনার,	টিউনার,	
utpotti,	উৎপট্তি,	উতপত্তি,	
kalenga,	কালেঙ্গা,	কালেঙ্গা,	
bade,	বাদে,	বাদে,	
byabaharkareederke,	ব্যবহারকারীদেরকে,	ব্যবহারকারীদেরকে,	
bhujangta,	ভূজাগতা,	ভুজঙ্গটা,	
rajtantra,	রাজতন্ত্র,	রাজতন্ত্র,	
ahalyar,	অহল্যার,	অহল্যার,	
prothar,	প্রথার,	প্রথার,	
salsa,	সালসা,	সালসা,	
palteche,	পালতেছে,	পাল্টেছে,	
hingsar,	হিংসার,	হিংসার,	
neermol,	নিরমল,	নির্মল,	
seekkharthirao,	সিক্ষার্থীরাও,	শিক্ষার্থীরাও,	
joones,	জুন্স,	জোন্স,	
shkalarashhipa,	স্কললররশীপ,	স্কলারশিপ,	
laatimer,	লাটিমের,	লাটিমের,	
kei,	কেই,	কেই,	
satarkakari,	সতর্কাকারী,	সতর্ককারী,	
bane,	বানে,	বনে,	
torunderke,	তরুণ্দেরকে,	তরুণদেরকে,	
francine,	ফ্রান্সিন,	ফ্রান্সিন,	
nothivookta,	নথিভকুক্ত,	নথিভুক্ত,	
fatakasto,	ফাতাকাস্ত,	ফাটাকেষ্ট,	
swasthohinotay,	স্বাস্থ্যহীনতায়,	স্বাস্থ্যহীনতায়,	
boiragirhat,	বৈরাগীহটা,	বৈরাগিরহাট,	
projanankal,	প্রজানাকলাল,	প্রজননকাল,	
bidhirnityang,	বিধির্ণিঙ্তাং,	বিধির্নিত্যং,	
chhayi,	ছাইয়ি,	ছাই,	
carloos,	কার্লাস,	কার্লোস,	
backflipe,	ব্যাকল্লিই,	ব্যাকফ্লিপে,	
madrasi,	মাদ্রাসি,	মাদ্রাজি,	
recondishon,	রেকন্ডিশন,	রিকন্ডিশন,	
oedipus,	ওডিপিয়াস,	ইডিপাস,	
lyaanding,	ল্যান্ডিং,	ল্যান্ডিং,	
shamshere,	শমেসেরে,	শমসের,	
orthoneeti,	অর্থনীতি,	অর্থনীতির,	
samratder,	সমররতদের,	সম্রাটদের,	
achintopurer,	অচিন্তপুরের,	অচিন্তপুরের,	
graambasi,	গ্রামবাসী,	গ্রামবাসী,	
hitlere,	হিটলারে,	হিটলারে,	
sangbadmadhyomgulote,	সংবাদমধ্যমগুলোতে,	সংবাদমাধ্যমগুলোতে,	
nirgamon,	নির্গামন,	নির্গমন,	
basaalt,	বাসাল্ত,	ব্যাসল্ট,	
jerusalemer,	জেরুসালেমের,	জেরুজালেমের,	
besirbhaagi,	বেসীরভাগি,	বেশিরভাগই,	
atmabishvashi,	আত্মবিভাষী,	আত্মবিশ্বাসী,	
uposhthit,	উপস্থিত,	উপস্থিত,	
nobotomo,	নবতম,	নবতম,	
dolu,	দলু,	ডলু,	
