rena,	রেনা,	রেনো,	
ancholsomuho,	আঞ্চলসমূহ,	অঞ্চলসমূহ,	
themekey,	থেমেকে,	থিমকে,	
teksuser,	টেকসুসের,	টেক্সাসের,	
tunaita,	টুনাইটা,	টুনাইট,	
sangkalanti,	সংকলন্তী,	সংকলনটি,	
scholars,	স্কলারস,	স্কলার্স,	
bairer,	বাইরের,	বাইরের,	
karmake,	কারমেক,	কর্মকে,	
diiptii,	দিপটিই,	ডেপুটি,	
bondhuvabaponyo,	বন্ধুপাবজ্যবও,	বন্ধুভাবাপন্ন,	
ekghore,	একঘরে,	একঘরে,	
audiotike,	অডিওটিকে,	অডিওটিকে,	
shiqara,	শিকারা,	শিকার,	
qarqa,	কারকা,	কার্ক,	
lavta,	লাভটা,	লাভটা,	
shakara,	শাকারা,	সাকার,	
forex,	ফরেক্স,	ফরেক্স,	
shashtra,	শাষ্ট্র,	শাস্ত্র,	
phonekari,	ফোনেকারি,	ফোনকারী,	
utkhaat,	উৎকাঠ,	উত্খাত,	
kanasharabheshhana,	কনশারেশাভন,	কনসারভেশন,	
lambi,	লাম্বি,	লম্বি,	
tyap,	ত্যাপ,	ট্যাপ,	
kokeyin,	কোকেইন,	কোকেইন,	
adwanced,	অ্যাডব্যান্ডে,	অ্যাডভান্সড,	
susamo,	সুসামো,	সুসম,	
dokaanei,	দোকানেই,	দোকানেই,	
rastagulikeo,	রাস্তাগুলিকেও,	রাস্তাগুলিকেও,	
ruble,	রাবলে,	রুবল,	
notikotar,	নতিকতার,	নৈতিকতার,	
chandrimaa,	চন্দ্রীমা,	চন্দ্রিমা,	
kinenni,	কিনেননি,	কিনেননি,	
asiatic,	অ্যাসিয়াটিক,	এশিয়াটিক,	
graambasheeo,	গ্রামবাশীও,	গ্রামবাসীও,	
bhoutikeshu,	ভৌতিকেশু,	ভৌতিকেষু,	
inphormeshon,	ইনফরমমেশন,	ইনফরমেশন,	
protisthar,	প্রতিষ্ঠার,	প্রতিষ্ঠার,	
sbajan,	স্বজান,	স্বজন,	
amarika,	আমারিকা,	আমেরিকা,	
adorsho,	আদর্শ,	আর্দশ,	
mach,	মাচ,	মাছ,	
associatis,	অ্যাসোসিয়েটিস,	এসোসিয়েটস,	
swarther,	স্বার্থের,	স্বার্থের,	
upacharjo,	উপাচর্য,	উপাচার্য,	
hoondayi,	হন্দায়ি,	হুন্দাই,	
tintikey,	টিনটিকে,	তিনটিকে,	
pingna,	পিংনা,	পিংনা,	
karu,	করু,	কারু,	
mochlekha,	মোচলেখা,	মোছলেখা,	
youth,	যথু,	ইয়ুথ,	
byomkesh,	ব্যামকোখে,	ব্যোমকেশ,	
elakatike,	এলাকাটিকে,	এলাকাটিকে,	
murali,	মুরালি,	মুরলী,	
everage,	এভেরেজ,	এভারেজ,	
angibhutovabe,	অঙ্গীভুতভাবে,	অঙ্গীভূতভাবে,	
samley,	স্যামলি,	সামলে,	
bhittow,	ভিট্টব,	ভিত্তিও,	
playtey,	প্লেটে,	প্লেটে,	
amudey,	আমুদে,	আমুদে,	
chaalaabi,	চালাবী,	চালাবে,	
schilling,	স্লিলিং,	শিলিং,	
ganoparibahaner,	গণপরিবাহনের,	গণপরিবহনের,	
gosthike,	গোষ্ঠীকে,	গোষ্ঠীকে,	
dhormoprobortokder,	ধর্মপ্রবর্তদকদের,	ধর্মপ্রবর্তকদের,	
ala,	আলা,	আলা,	
abhidhaanick,	অভিচানিক,	অভিধানিক,	
adarsho,	আদার্শ,	আর্দশ,	
rajbandir,	রাজবন্দীর,	রাজবন্দীর,	
soceitytey,	সোসেয়াটিতে,	সোসাইটিতে,	
sudrissho,	সুদৃশ্,	সুদৃশ্য,	
bheenisa,	ভিনিসা,	ভেনিস,	
hozot,	হজত,	হজত,	
nariider,	নারিদের,	নারীদের,	
farhetin,	ফারহাতিন,	ফারহেতিন,	
konorup,	কোনরূপ,	কোনরূপ,	
madrasi,	মাদ্রাসি,	মাদ্রাজি,	
anektai,	অনেকটাই,	অনেকটাই,	
medilek,	মেডিলেক,	মেডিলেক,	
asovyo,	আসোভো,	অসভ্য,	
abdoone,	আবদদুন,	আবদুন,	
sadbi,	সাদবী,	সাধ্বী,	
okritokarjo,	অকৃতকার্য,	অকৃতকার্য,	
monroe,	মনরিও,	মনেরোর,	
grooth,	গ্রুথ,	গ্রোথ,	
drissogulote,	দৃশ্যগুলোতে,	দৃশ্যগুলোতে,	
bufer,	বুফার,	বাফার,	
kalnir,	কালনির,	কালনীর,	
breqathru,	ব্রেকাঠরু,	ব্রেকথ্রু,	
pohnpeic,	পোন্নি,	ফোনপেইক,	
rilayensha,	রিলায়েশন,	রিলায়েন্স,	
ruptan,	রূপ্তন,	রূপটান,	
aakik,	আকিক,	আকিক,	
baffer,	বাফের,	বাফার,	
jyaqasana,	জ্যাকানা,	জ্যাকসন,	
mukhomandaler,	মুখমন্ডলের,	মুখমণ্ডলের,	
kram,	ক্রম,	ক্রম,	
durbhagya,	দুর্ভাগ্য,	দূর্ভাগ্য,	
rockibul,	রকিবুল,	রকিবুল,	
phising,	ফিসিং,	ফিসিং,	
satarkakari,	সতর্ককারী,	সতর্ককারী,	
sikara,	সিকারা,	শিকার,	
gobeshana,	গোবেষন,	গবেষনা,	
amarjito,	আমার্জিত,	অমার্জিত,	
dhrubaker,	ধ্রুবাকের,	ধ্রুবকের,	
saqara,	সাকারা,	সাকার,	
akpashe,	আকপাশে,	একপাশে,	
motke,	মোটকে,	মতকে,	
horiddar,	হরিদ্দার,	হরিদ্বার,	
tawnship,	টাউনশিপ,	টাউনশিপ,	
minilosar,	মিনিলোসার,	মিনিলোসার,	
aarke,	আরকে,	আরকে,	
bohoodin,	বহদুন,	বহুদিন,	
nazad,	নাজাদ,	নজদ,	
bitertrate,	বাইটারট্রেট,	বাইটারট্রেট,	
ceramiksh,	সেরামিক্স,	সিরামিকস,	
shakar,	শাকার,	সকার,	
tigre,	তিগ্রে,	টাইগার,	
jwar,	জ্বার,	জ্বর,	
chintamani,	চিন্তমানি,	চিন্তামনি,	
bondhukey,	বন্ধুকে,	বন্ধুকে,	
dianes,	ডায়ানেস,	ডিএনএস,	
krusher,	ক্রুশের,	ক্রুশের,	
debeting,	ডেবেটিং,	ডিবেটিং,	
eesosiyeetasa,	ইসসয়িটেস,	এসোসিয়েটস,	
charpanch,	চারপাঞ্চ,	চারপাঁচ,	
mele,	মেলে,	মাইল,	
keui,	কেউ,	কেউই,	
choritrotakeo,	চরিত্রটাকেও,	চরিত্রটাকেও,	
dekaner,	দেকানের,	দেকানের,	
pathanirdeshona,	পাঠানির্দেশনা,	পথনির্দেশনা,	
sainyader,	সৈন্যাদের,	সৈন্যদের,	
fasi,	ফাসি,	ফাঁসী,	
jaanar,	যানার,	জানার,	
existing,	এক্সিস্টিং,	এক্সিসটিং,	
riazuddin,	রিয়াজদ্দিন,	রিয়াজউদ্দীন,	
segulo,	সেগুলো,	সেগুলো,	
ganochin,	গণচিন,	গণচীন,	
directarate,	ডিরেক্টরেট,	ডিরেক্টরেট,	
edmiral,	এদমিরাল,	এডমিরাল,	
omanisa,	ওমানিসা,	অমানিশা,	
deputy,	ডিপুটি,	ডেপুটি,	
bossonte,	বসন্তে,	বসন্তে,	
pathanatak,	পাঠানাটক,	পথনাটক,	
zonsa,	জোসসা,	জোন্স,	
jounatar,	যৌনাার,	যৌনতার,	
dhyana,	ধ্যান,	ধ্যান,	
modelgulo,	মডেলগুলো,	মডেলগুলো,	
olpo,	ওলপো,	অল্প,	
atmobonchito,	আত্মবঞ্চিত,	আত্মবঞ্চিত,	
porirshoder,	পরির্ধদের,	পরির্ষদের,	
khalid,	খালিদ,	খালিদ,	
gurmukh,	গুরমুখ,	গুরমুখ,	
sarsa,	সারসা,	সোর্স,	
akmato,	আকমাতো,	একমত,	
grambaaseeder,	গ্রামবাসীদের,	গ্রামবাসীদের,	
kobutorer,	কবুতরের,	কবুতরের,	
uparjon,	উপার্জন,	উপার্জন,	
kandy,	কান্ডি,	ক্যান্ডি,	
muhurtati,	মুহুর্তটি,	মুহুর্তটি,	
breq,	ব্রেক,	ব্রেক,	
cloring,	ক্লোরিং,	ক্লোরিং,	
obhaarbhiu,	ওভারভু,	ওভারভিউ,	
israelbahini,	ইসরায়েলবিহীন,	ইস্রায়েলবাহিনী,	
kabutorer,	কবুটরের,	কবুতরের,	
liseensee,	লিসিন্স,	লাইসেন্স,	
holdim,	হোল্ডিম,	হোল্ডিং,	
saras,	সারাস,	সরস,	
nopdnodir,	নপটড্ডির,	নদনদীর,	
karmojog,	কর্মযোগ,	কর্মযোগ,	
bulano,	বুলানো,	বুলান,	
biswashi,	বিশ্বাশী,	বিশ্বাসই,	
corymb,	করিম্ব,	করিম,	
mohit,	মোহিত,	মুহিত,	
rokkhonabekkhoner,	রক্ষণাকেক্ষণের,	রক্ষণাবেক্ষণের,	
rachonakal,	রচনাকাল,	রচনাকাল,	
proshtutkarok,	প্রস্তুতকারক,	প্রস্তুতকারক,	
jor,	জর,	জ্বর,	
dhila,	ধীলা,	ঢিলা,	
manushe,	মানুশে,	মানুষে,	
hugheke,	হুঘেকে,	হিউজকে,	
khalidke,	খালিদকে,	খালিদকে,	
shikhra,	শিখরা,	শিখরা,	
nischitobhave,	নিশ্চিতভাবে,	নিশ্চিতভাবে,	
simantarkkhibahinir,	সীমান্ত্রকবিহানিনীর,	সীমান্তরক্ষীবাহিনীর,	
drissogulo,	দৃশ্যগুলো,	দৃশ্যগুলো,	
bowie,	বোয়েই,	বওই,	
pratishthanik,	প্রতিষ্ঠানিক,	প্রাতিষ্ঠানিক,	
bhittimul,	ভিত্তিমূল,	ভিত্তিমূল,	
daakteekite,	ডাকটিকিতে,	ডাকটিকিটে,	
tachnach,	টাচনাচ,	তছনছ,	
tanshree,	তানশরি,	তানশ্রী,	
taalaal,	তালাল,	তালাল,	
mane,	মানে,	মানে,	
engrezder,	এংরেজদের,	ইংরেজদের,	
vange,	ভ্যাঙ্গে,	ভাঙ্গে,	
prarthitao,	প্রার্থীতাও,	প্রার্থীতাও,	
blacq,	ব্ল্যাক,	ব্ল্যাক,	
gabinius,	গাবিনিয়াস,	গাবিনিআস,	
choukato,	চৌকাতো,	চৌকাত,	
elaakati,	এলাকাটি,	এলাকাটি,	
shipley,	শিপলি,	শিপলে,	
hughkey,	হাঘকে,	হিউজকে,	
beatleser,	বিটলেসের,	বিটলসের,	
gorrer,	গোরের,	গোরের,	
jens,	জেন্স,	জিন্স,	
shift,	শিফট,	শিফট,	
katiusha,	কাতিউশা,	কাতিউশা,	
nachar,	নাচার,	নাচার,	
daqten,	ডাকতেন,	ডাকতেন,	
batom,	বাতম,	বাটম,	
eexpreession,	এক্সপ্রিশশন,	এক্সপ্রেশন,	
dipankar,	দীপানকর,	দিপঙ্কর,	
thakeni,	থাকেনি,	থাকেনি,	
parijaner,	পারিজানের,	পরিজনের,	
protinito,	প্রতিনিত,	প্রতিনিত,	
horippur,	হরিপপুর,	হরিপুর,	
peterke,	পেটারকে,	পিটারকে,	
quary,	কোয়ারী,	কোয়েরি,	
scholastic,	স্কোলাস্টিক,	স্কলাস্টিক,	
onurbar,	অনুর্বার,	অনুর্বর,	
mekong,	মেকং,	মেকং,	
weenis,	বইনিস,	ভেনিস,	
kormobuddhite,	কর্মবুদ্ধিতে,	কর্মবুদ্ধিতে,	
lyataa,	ল্যাটা,	ল্যাটা,	
saabyastha,	সব্যস্থ,	সাব্যস্থ,	
byabosthar,	ব্যবস্থার,	ব্যবস্থার,	
volivoler,	ভলিভোলের,	ভলিভলের,	
pleena,	প্লেন,	প্লেন,	
janoganonar,	জনগণাননার,	জনগণনার,	
rajtantra,	রাজতন্ত্র,	রাজতন্ত্র,	
graambaaseer,	গ্রামবাসীর,	গ্রামবাসীর,	
bhagnekeo,	ভাগনেকেও,	ভাগ্নেকেও,	
premo,	প্রেমো,	প্রিমো,	
tatey,	টাতে,	তাতে,	
podotyagsongkranto,	পদত্যাগসংক্রান্ত,	পদত্যাগসংক্রান্ত,	
pariyech,	পাড়য়েছ,	পরিয়েছ,	
laaisens,	লাইসেন্স,	লাইসেন্স,	
debete,	দেবেতে,	ডিবেট,	
bipajjanak,	বিপজজানাক,	বিপজ্জনক,	
karima,	করিমা,	করিম,	
akhandata,	আখণ্ডটা,	অখণ্ডতা,	
modele,	মডেলে,	মডেলে,	
panthar,	পান্থার,	পন্থার,	
danakana,	দননকা,	ডানকান,	
booroon,	বুরুন,	বোরন,	
vejjanno,	বেজ্জন্য,	ভেজানো,	
baaik,	বাইক,	বাইক,	
shahabike,	শাহাবীকে,	সাহাবীকে,	
chorchita,	চর্চিতা,	চর্চিত,	
sumoo,	সুমুও,	সুমো,	
soleel,	সললেল,	সলিল,	
laishensha,	লাইশেষনা,	লাইসেন্স,	
saifai,	সাইফাই,	সাইফাই,	
adhyatmik,	অধ্যাতমিক,	আধ্যাত্মিক,	
chalaabi,	চালাবী,	চালাবে,	
milayatane,	মিলায়াতানে,	মিলায়তনে,	
achintopurer,	অচিন্তপুরের,	অচিন্তপুরের,	
ostad,	ওস্তাদ,	ওস্তাদ,	
average,	আভারেজ,	এভারেজ,	
ekatitto,	একাতিত্ব,	একাতিত্ব,	
dalnata,	দলনাটা,	ডালনাটা,	
munshiji,	মুন্িজি,	মুনশীজি,	
sheekar,	শিকার,	শিকার,	
tookror,	টুকরর,	টুকরোর,	
khali,	খালি,	খালি,	
niphelheim,	নিফেলহিয়েম,	নিফেলহেইম,	
holuder,	হলুদের,	হলুদের,	
bosonte,	বসন্তে,	বসন্তে,	
uporoshtho,	উপরস্থ,	উপরস্থ,	
bayshorkarikarone,	বায়শরকারিকরণে,	বেসরকারিকরণ,	
armeenian,	আর্মিনিয়ান,	আর্মেনিয়ান,	
elakatikay,	এলাকাটিকা,	এলাকাটিকে,	
prokolpow,	প্রকল্পও,	প্রকল্পও,	
binee,	বিনে,	বেনি,	
boshoborti,	বশবর্তী,	বশবর্তী,	
digrir,	দিগ্রির,	ডিগ্রির,	
jamjomat,	জামজামাত,	জমজমাট,	
nirikhe,	নিরিখে,	নিরিখ,	
ghotolen,	ঘটলেন,	ঘটলেন,	
urey,	উরে,	ইউরি,	
konflict,	কনফ্লিক্ট,	কনফ্লিক্ট,	
avidur,	আভিদুর,	আভিদুর,	
lettere,	লেট্রে,	লেটারে,	
gabhaskaar,	গাভাসকার,	গাভাস্কার,	
vagini,	ভাগিনি,	ভগিনী,	
nilfamarir,	নীলফামারীর,	নীলফামারীর,	
orbi,	ওরবি,	ওরবি,	
tata,	টাটা,	তাতা,	
chapchap,	চাপচাপ,	চাপচাপ,	
suchonakal,	সূচোাকাল,	সূচনাকাল,	
eshtoniya,	এস্টনীয়,	এস্তোনিয়া,	
munim,	মুনিম,	মুনিম,	
ujobekeestan,	উজবেকিস্তান,	উজবেকিস্তান,	
bhramarotsab,	ভ্রমমরাত্সব,	ভ্রমরোৎসব,	
aasirbaad,	আসীরবাদ,	আশির্বাদ,	
mangolic,	ম্যানগোলিক,	মাঙ্গলিক,	
bishaashke,	বিষাশকে,	বিশ্বাসকে,	
shilpikuler,	শিল্পীকুলের,	শিল্পীকুলের,	
asamanyo,	অসমান্য,	অসামান্য,	
maktum,	মাক্তুম,	মাকতুম,	
pharn,	ফার্ন,	ফার্ন,	
shikshagata,	শিক্ষাগত,	শিক্ষাগত,	
chire,	চিরে,	চিরে,	
kkhur,	খুকর,	ক্ষুর,	
superheroo,	সুপারহিরিও,	সুপারহিরো,	
kantojir,	কান্তজীর,	কান্তজির,	
societykey,	সোসিযটিকে,	সোসাইটিকে,	
restuarant,	রেস্টুরেন্ট,	রেষ্টুরেন্ট,	
maley,	মালে,	মালে,	
beetloser,	বিটলোসের,	বিটলসের,	
carzar,	কারজার,	চার্জার,	
masjidtir,	মাসজিদটির,	মসজিদটির,	
oedipus,	ওড়িপুস,	ইডিপাস,	
dii,	ডিআই,	দিই,	
reetesh,	রিটেশ,	রিতেশ,	
shekarone,	শেকারনে,	সেকারণে,	
perry,	পেররি,	পেরি,	
chetanagato,	চেতনাগত,	চেতনাগত,	
mandondo,	মানদণ্ড,	মানদণ্ড,	
oxite,	অক্সটিতে,	অক্সাইট,	
shuchonakal,	শুচোাকাল,	সূচনাকাল,	
faskari,	ফাসকারী,	ফাঁসকারী,	
shalook,	শালুক,	শালুক,	
pleeta,	প্লিট,	প্লেট,	
obosore,	অবসরে,	অবসরে,	
anusthane,	অনুষ্ঠানে,	অনুষ্ঠানে,	
coons,	কুন্স,	কুনস,	
saptahokal,	সপ্তাহকাল,	সপ্তাহকাল,	
purborekorde,	পূর্বরেকর্ডে,	পূর্বরেকর্ডে,	
anichchi,	অনিচ্ছি,	আনিচ্ছি,	
dhormokorme,	ধর্মকর্মে,	ধর্মকর্মে,	
suraaropeeto,	সুরারোপিত,	সুরারোপিত,	
sangosrobomukto,	সংস্রবরমুক্ত,	সংস্রবমুক্ত,	
jeshh,	জেশ,	জেস,	
srabosty,	স্রাবস্টি,	শ্রাবস্তী,	
spredashiita,	স্প্রেডিশিত,	স্প্রেডশীট,	
umb,	ইউমবি,	ইউএমবি,	
rajtantrey,	রাজতন্ত্রে,	রাজতন্ত্রে,	
holding,	হোল্ডিং,	হোল্ডিং,	
vishnuu,	ভিষ্ণু,	বিষ্ণু,	
muradpur,	মুরাদপুর,	মুরাদপুর,	
america,	আমেরিকা,	আমেরিকা,	
adhunikkaley,	আধুনিকলাকে,	আধুনিককালে,	
amittrakkhor,	অমিত্রাক্ষর,	অমিত্রাক্ষর,	
sthapona,	স্থাপনা,	স্থাপনা,	
pachak,	পাচাক,	পাচক,	
steen,	স্তিন,	স্টেন,	
bolechile,	বলেছিলে,	বলেছিলে,	
ispredseet,	ইস্প্রেডসিট,	স্প্রেডশীট,	
suhasini,	সুহাসিনী,	সুহাসিনী,	
tokeo,	টকেও,	টোকেও,	
philipiner,	ফিলিপাইনের,	ফিলিপাইনের,	
site,	সিতে,	সিটে,	
niroja,	নিরোজা,	নিরোজা,	
matthews,	ম্যাথিওস,	ম্যাথিউস,	
olympicer,	অলিম্পিসের,	অলিম্পিকের,	
expreshshion,	এক্সপ্রেশন,	এক্সপ্রেশন,	
prokolpogulor,	প্রকল্পগুলোর,	প্রকল্পগুলোর,	
rifleksa,	রিফলেক্সা,	রিফ্লেক্স,	
punorabortonte,	পুনরাবর্তন্তে,	পুনরাবর্তন্তে,	
bandhan,	বন্ধন,	বাঁধন,	
deeares,	দিয়েরস,	ডিআরএস,	
besur,	বেসুর,	বেসুর,	
khuliechilam,	খুলিয়াছিলাম,	খুলিয়েছিলাম,	
vodqa,	ভোডকা,	ভদকা,	
kaamij,	কামিজ,	কামিজ,	
autopromotioner,	অটোপ্রমিশনের,	অটোপ্রমোশনের,	
chorban,	চোরবান,	চর্বন,	
bisheshshyer,	বিশেষ্ব্যের,	বিশেষ্যের,	
istoone,	ইস্তউন,	স্টোন,	
amanisha,	আমানিশা,	অমানিশা,	
chetanagoto,	চেতনাগত,	চেতনাগত,	
zoubankal,	যৌবনকাল,	যৌবনকাল,	
qraima,	ক্রেইমা,	ক্রাইম,	
modhyekar,	মধ্যেকর,	মধ্যেকার,	
karir,	কারির,	কারীর,	
temone,	তেমনে,	তেমনই,	
obosan,	অবসান,	অবসান,	
mukhmondole,	মুখমন্ডলে,	মুখমণ্ডলে,	
samajikotar,	সমাজিকতার,	সামাজিকতার,	
borlen,	বরলেন,	বরলেন,	
thechar,	থেচার,	থ্যাচার,	
dajjha,	দাজঝা,	দাহ্য,	
shattoki,	শত্তকি,	সাত্যকি,	
arshie,	আরশী,	আরসিএ,	
turkamena,	তুরককমেনা,	তুর্কমেন,	
basab,	বাসাব,	বাসাব,	
amorendro,	আমরেন্দ্র,	অমরেন্দ্র,	
noditei,	নদীতেই,	নদীতেই,	
bibechyo,	বিবেচ্য,	বিবেচ্য,	
aembed,	এমবেড,	এম্বেড,	
dagmukta,	দাগমুক্ত,	দাগমুক্ত,	
thabai,	থাবাই,	থাবাই,	
roktokhoron,	রক্তখরণ,	রক্তক্ষরণের,	
uparzoner,	উপার্জনের,	উপার্জনের,	
sayanaida,	সায়নাদ,	সায়ানাইড,	
mohajot,	মহাযত,	মহাজোট,	
mandape,	মান্ডাপে,	মন্ডপে,	
jontrangshogulor,	যন্ত্রাংশগুলোর,	যন্ত্রাংশগুলোর,	
nanir,	নানির,	নানীর,	
vezano,	ভেজানো,	ভেজানো,	
teoyana,	তেওয়ান,	তাইওয়ান,	
onshogrohoner,	অনশগ্রহণের,	অংশগ্রহনের,	
graambashee,	গ্রামবাশী,	গ্রামবাসী,	
freelancerra,	ফ্রিল্যান্সরা,	ফ্রিল্যান্সাররা,	
falak,	ফালাক,	ফলক,	
talaal,	তালাল,	তালাল,	
ghoor,	ঘর,	ঘুর,	
dijijer,	ডিজিজের,	ডিজিজের,	
aholya,	আহল্যা,	অহল্যা,	
keu,	কেউ,	কেউ,	
antarctika,	অন্তর্কটিকা,	অ্যান্টার্কটিকা,	
bisshaskey,	বিশ্বাসকে,	বিশ্বাসকে,	
trutimatra,	ত্রুটিমাত্র,	ত্রুটিমাত্র,	
bhandti,	ভান্ডটি,	ভাণ্ডটি,	
eesa,	ইইএসএ,	আইএএস,	
gamdan,	গামদান,	গামদান,	
deaubande,	দেউবান্ডে,	দেওবন্দে,	
landin,	ল্যান্ডিন,	ল্যান্ডিং,	
akar,	আকার,	একার,	
asociatis,	অ্যাসোসিটিস,	এসোসিয়েটস,	
temanti,	তেমন্তি,	তেমনটি,	
lutharen,	লুথারেন,	লুথেরান,	
sqirt,	স্কিইট,	স্কার্ট,	
dharavassokar,	ধারাভাসককর,	ধারাভাষ্যকার,	
jounotar,	যৌনতার,	যৌনতার,	
shikkharrthirao,	শিক্ষার্থীরীরাও,	শিক্ষার্থীরাও,	
pratista,	প্রতিষ্ট,	প্রতিষ্টা,	
salafeta,	সালাফেটা,	সালফেট,	
aatto,	আট্তো,	আত্ম,	
sachetanvabe,	সচেতনভাবে,	সচেতনভাবে,	
sanghar,	সঙ্ঘর,	সংহার,	
korimpur,	করিমপুর,	করিমপুর,	
bidghootey,	বিদ্ঘুতে,	বিদঘুটে,	
kadam,	কাদম,	কদম,	
shikkharthirao,	শিক্ষার্থীরাও,	শিক্ষার্থীরাও,	
chittronatyokar,	চিত্তনাত্রকার,	চিত্রনাট্যকার,	
nibirbhabe,	নিবৃহভাবে,	নিবিরভাবে,	
idipasha,	ইডিপাশা,	ইডিপাস,	
gondhe,	গন্ধে,	গন্ধে,	
review,	রিভিউজ,	রিভিউও,	
pacbar,	পাকবার,	পাঁচবার,	
prokar,	প্রকার,	প্রকার,	
alimpiqa,	আলিমপিকা,	অলিম্পিক,	
kei,	কেই,	কেই,	
jarmaniteo,	জার্মানীতেও,	জার্মানিতেও,	
shloker,	শ্লোকের,	শ্লোকের,	
bolvodro,	বলবদ্র,	বলভদ্র,	
kailashrao,	কৈলশ্রও,	কৈলাশরাও,	
gasthii,	গাস্থিই,	গোষ্ঠীই,	
tochhnochh,	টচ্ছন,	তছনছ,	
murad,	মুরাদ,	মুরাদ,	
bosontokke,	বসন্তককে,	বসন্তকে,	
aalkatraa,	আলকাত্রা,	আলকাতরা,	
panda,	পান্ডা,	পান্ডে,	
foloshrutite,	ফলশ্রুতিতে,	ফলশ্রুতিতে,	
hisabagyan,	হিসাবজ্ঞান,	হিসাবজ্ঞান,	
soori,	সোয়রি,	সুরি,	
shamshere,	শমশেরে,	শমসের,	
azaan,	আজান,	আজান,	
magar,	মাগার,	মাগার,	
vugoley,	ভাগোলে,	ভূগোলে,	
apad,	আপাদ,	আপদ,	
shapad,	শাপাদ,	শ্বাপদ,	
yaq,	যাক,	ইয়াক,	
daap,	ডাপ,	ড্যাপ,	
bade,	বাদ,	বাদে,	
nagorikke,	নাগরিককে,	নাগরিককে,	
pothon,	পথন,	পঠন,	
ispredsheet,	ইস্প্রেডশিট,	স্প্রেডশীট,	
footbalarer,	ফুটবলারের,	ফুটবলারের,	
shahidputra,	শহিদপুত্র,	শহীদপুত্র,	
aarmstrong,	আর্মস্ট্রং,	আর্মস্ট্রং,	
edmeeral,	এদমিরাল,	এডমিরাল,	
shikare,	শিকারে,	শিকারে,	
sobrakamer,	সব্রাকামের,	সবরকমের,	
kortona,	কর্তনা,	করতনা,	
sthaponagulor,	স্থাপনাগুলোর,	স্থাপনাগুলোর,	
directorete,	ডিরেক্টরেট,	ডিরেক্টরেট,	
obdi,	ওব্দী,	অব্দি,	
chalochchitraeei,	চলচ্চিত্রই,	চলচ্চিত্রেই,	
somabeshti,	সমাবেশটি,	সমাবেশটি,	
barbadoj,	বারবাজদ,	বার্বাডোজ,	
orhan,	অরহান,	ওরহান,	
shuperheiro,	শুপারহিরোর,	সুপারহিরো,	
heepatitis,	হিপাটাইটিস,	হেপাটাইটিস,	
shootar,	সূতার,	শ্যুটার,	
morodeho,	মরদেহ,	মরদেহ,	
windo,	উইন্ডো,	উইন্ডো,	
nyata,	ন্যাট,	ম্যাট,	
bhushito,	ভূষিত,	ভূষিত,	
boudher,	বৌধের,	বৌদ্ধের,	
stanahenja,	স্তনাহেঞ্জা,	স্টোনহেঞ্জ,	
smarak,	স্মারক,	স্মারক,	
dhadhiye,	ধধধিয়ে,	ধাধিয়ে,	
poste,	পোস্টে,	পোষ্টে,	
romjaner,	রোমজানের,	রমযানের,	
hitaishi,	হিতাইশি,	হিতৈষী,	
keuoi,	কেওয়,	কেউই,	
nutunotto,	নুতুনত্ব,	নতুনত্ব,	
matorom,	মাতোরম,	মাতরম,	
asabhya,	অসভ্য,	অসভ্য,	
beshakbar,	বেশকবার,	বেশকবার,	
turkeyder,	তুরকেদের,	তুর্কিদের,	
victor,	ভিক্টর,	ভিক্টর,	
sushposhtolikhito,	সুষ্পষ্টলিশিত,	সুষ্পষ্টলিখিত,	
baikalyo,	বৈকল্য,	বৈকল্য,	
sithilota,	সিথিলতা,	শিথিলতা,	
chilahatee,	চিলাহাটি,	চিলাহাটি,	
braqe,	ব্র্যাকে,	ব্রেক,	
kushumba,	কুশুম্বা,	কুশুম্বা,	
fanse,	ফ্যান্স,	ফাঁসে,	
remacry,	রিম্যাক্রি,	রেমাক্রী,	
laesensh,	লাযাসেস,	লাইসেন্স,	
meshmeshya,	মেশমেশ্যা,	মেশহমেশহিইয়া,	
gore,	গোরে,	গোর,	
protishtan,	প্রতিষ্টান,	প্রতিষ্টান,	
macbeth,	ম্যাকবেথ,	ম্যাকবেথ,	
shasankarta,	শাসনকার্তা,	শাসনকর্তা,	
talgachh,	তালগাছ,	তালগাছ,	
khoka,	খোকা,	খোকা,	
hingsar,	হিংসার,	হিংসার,	
swasthohinotay,	স্বাস্থ্যহীনতায়,	স্বাস্থ্যহীনতায়,	
chuti,	চুটি,	ছুটি,	
upobasher,	উপবাশের,	উপবাসের,	
footbalarra,	ফুটবলরা,	ফুটবলাররা,	
lyaanding,	ল্যান্ডিং,	ল্যান্ডিং,	
brixfield,	ব্রিক্সফিল্ড,	ব্রিক্সফিল্ড,	
abdi,	আব্দী,	অব্দি,	
jinsa,	জিনসা,	জিন্স,	
fastag,	ফস্তাগ,	ফ্যাসট্যাগ,	
rakkhandurga,	রক্ষণদূর্গ,	রক্ষণদুর্গ,	
protul,	প্রতুল,	প্রতুল,	
byatari,	ব্যাটারী,	ব্যাটারী,	
chalochchitreei,	চলচ্চিত্রই,	চলচ্চিত্রেই,	
santaa,	সান্তা,	সান্তা,	
pronoti,	প্রণতি,	প্রণতি,	
karmasampadon,	কর্মসম্পদান,	কর্মসম্পাদন,	
abheedhanik,	অভিধানিক,	অভিধানিক,	
abheedhaaneeck,	অবিধানিক,	অভিধানিক,	
ghetu,	ঘেটু,	ঘেটু,	
grauth,	গ্রাথ,	গ্রোথ,	
jocqey,	জককে,	জকি,	
toxoid,	টক্সোড,	টক্সয়েড,	
path,	পাথ,	পাথ,	
ooipokar,	ঐপপকার,	উইপোকার,	
sommotite,	সম্মতিতে,	সম্মতিতে,	
hool,	হুল,	হুল,	
joones,	জনসে,	জোন্স,	
vandar,	ভান্ডার,	ভাণ্ডার,	
niknayman,	নিক্নাম্মান,	নিকনেইমান,	
abhijitda,	অভিজিৎদা,	অভিজিতদা,	
trenda,	ট্রেন্ড,	ট্রেন্ড,	
byaboharkariyi,	ব্যবহারকারীই,	ব্যবহারকারীই,	
atak,	আটাক,	আটক,	
venush,	ভেনুশ,	ভেনাস,	
bisnukey,	বিস্কুইকে,	বিষ্ণুকে,	
prokolpogulikei,	প্রকল্পগুলিকেই,	প্রকল্পগুলিকেই,	
kisti,	কিস্তি,	কিস্তি,	
patrol,	প্যাটরল,	পেট্রোল,	
yuro,	য়ুরো,	ইউরো,	
dhanche,	ধানচে,	ধাঁচে,	
protijogiitamulok,	প্রতিযোগিতামূলক,	প্রতিযোগীতামূলক,	
gaj,	গ্যাজ,	গেজ,	
horas,	হোরাস,	হোরাস,	
hillse,	হিলসে,	হিলসে,	
teoner,	তেওনের,	টিওনার,	
juakhelar,	যুয়াখালের,	জুয়াখেলার,	
choopi,	চুপি,	চুপি,	
ponjikar,	পঞ্জিকার,	পঞ্জিকার,	
vangley,	ভ্যাংলি,	ভাঙলে,	
krush,	ক্রুশ,	ক্রুশ,	
jibnagore,	জীবনাগরে,	জীবননগর,	
ajeeboner,	আজিবনের,	আজীবনের,	
chikitshar,	চিকিত্সার,	চিকিত্সার,	
uporitale,	উপরিতালে,	উপরিতলে,	
pathkrom,	পাঠকরম,	পাঠক্রম,	
juktorashtreo,	যুক্তরাষ্ট্রেও,	যুক্তরাষ্ট্রেও,	
durgotsabe,	দুর্গোৎসবে,	দুর্গোৎসবে,	
bhenicer,	ভেনিসের,	ভেনিসের,	
nagorikra,	নাগরিকরা,	নাগরিকেরা,	
phood,	ফুড,	ফুড,	
lahano,	লাহানো,	লাহানো,	
hooldim,	হুল্ডিং,	হোল্ডিং,	
ul,	ইউএল,	উল,	
chhooteete,	ছোটিতে,	ছুটিতে,	
hastamathun,	হস্তমাঠুন,	হস্তমথুন,	
dharmee,	ধর্মী,	ধর্মী,	
teennis,	টেনেস,	টেনিস,	
brittakarey,	বৃত্তকারে,	বৃত্তাকারে,	
sohinsotar,	সোহিনসতার,	সহিংসতার,	
munjur,	মুঞ্জুর,	মুনজুর,	
wagadada,	ওয়াগাদা,	বাগদাদ,	
bharotiyotar,	ভারতীয়তার,	ভারতীয়তার,	
salmaner,	সালমানের,	সালমানের,	
michir,	মিছির,	মিচির,	
mataram,	মাতারাম,	মাতরম,	
konistho,	কনিষ্ঠ,	কনিষ্ঠ,	
patjata,	পাটজাতা,	পাটজাত,	
koordider,	কোর্িদের,	কুর্দিদের,	
disposes,	ডিস্পোজেস,	ডিসপোজেস,	
proshadhoner,	প্রশাধনের,	প্রসাধনের,	
swostir,	স্বস্তির,	স্বস্তির,	
jibanto,	জীবনত্ব,	জীবন্ত,	
foxer,	ফক্সার,	ফক্সের,	
graambasider,	গ্রামবাসীদের,	গ্রামবাসীদের,	
balabhadra,	বালাভা্র,	বলভদ্র,	
elakatir,	এলাকাটির,	এলাকাটির,	
porobortii,	পরবর্তী,	পরর্বতী,	
desiseyer,	ডেসিসেয়ার,	ডিজিজের,	
slatgulor,	স্ল্যাটগুলোর,	স্ল্যাটগুলোর,	
vool,	ভোল,	উল,	
bisheshshyo,	বিশেষ্য,	বিশেষ্য,	
iuro,	ইউরু,	ইউরো,	
jamaanor,	জামানোর,	জমানোর,	
sahojlovyotar,	সহযোগ্যসল্তার,	সহজলভ্যতার,	
grotha,	গ্রোথা,	গ্রোথ,	
jesh,	জেশ,	জেস,	
kormoi,	কর্মই,	কর্মই,	
janmat,	জানমত,	জন্মাত,	
chhayi,	ছায়ি,	ছাই,	
jommu,	জম্মু,	জম্মু,	
sayatana,	সায়তান,	শয়তান,	
mausumer,	মৌসুমের,	মৌসুমের,	
muradke,	মুরাডকে,	মুরাদকে,	
dharmantor,	ধর্মান্তর,	ধর্মান্তর,	
orbit,	অরবিট,	অরবিট,	
deejeejer,	দিজেজের,	ডিজিজের,	
parisankhanbid,	পরিসংখ্যাবিদ,	পরিসংখ্যানবিদ,	
ronangane,	রোনাঙ্গনে,	রণাঙ্গনে,	
bonnypran,	বন্নীর্রাণ,	বন্যপ্রাণ,	
bhabarlaler,	ভাবারলালের,	ভবরলালের,	
lekhaksattwar,	লেখকসত্ত্বর,	লেখকসত্ত্বার,	
hughes,	হিঘেস,	হিউজেস,	
ingreziteo,	ইংরেজিতেও,	ইংরেজিতেও,	
venisey,	ভেনিসে,	ভেনিসে,	
akeeb,	আকিব,	আকিব,	
suraaropito,	সুরারোপিত,	সুরারোপিত,	
daybhager,	দায়াভের,	দায়ভাগের,	
chongar,	চঙ্গার,	চোঙ্গার,	
seo,	সেও,	সেও,	
licensin,	লাইসেন্সিন,	লাইসেন্সিং,	
chandil,	চান্দিল,	চান্ডিল,	
shomser,	শম্সের,	সমশের,	
airish,	আইরিশ,	আইরিস,	
khilaphat,	খিলাফাত,	খিলাফত,	
tistar,	তিস্তার,	তিস্তার,	
aziboner,	আজিবনের,	আজীবনের,	
akkharkey,	অক্ষরকে,	অক্ষরকে,	
beauby,	বিউবি,	বিউবি,	
khelaphate,	খেলাফাতে,	খেলাফতে,	
pinogbagke,	পিনোগবাগকে,	পিনগবাগকে,	
marketin,	মার্কেটিন,	মার্কেটিং,	
satarka,	সতরকা,	সতর্ক,	
anagarikra,	অনাগারিকরা,	অনাগরিকরা,	
sombhobonao,	সম্ভবনাও,	সম্ভবনাও,	
female,	ফেমালে,	ফিমেল,	
homsher,	হোমশের,	হোমসের,	
sikkhakromer,	শিক্ষাক্রমের,	শিক্ষাক্রমের,	
detik,	ডেটিক,	দেতিক,	
battery,	ব্যাটারি,	ব্যাটারী,	
korimkey,	করিমকে,	করিমকে,	
oswastikor,	অস্বাস্তিকর,	অস্বস্তিকর,	
auttacharer,	অটথাচারের,	অত্যাচারের,	
mukhamandoler,	মুখামান্ডলের,	মুখমণ্ডলের,	
danab,	দানাব,	দানব,	
kraanti,	ক্রান্তি,	ক্রান্তি,	
sarjur,	সররজুর,	সরযূর,	
uddhritto,	উদ্ধৃত্ত,	উদ্ধৃত,	
pitiler,	পিতিলের,	পিটিলের,	
nirbaho,	নির্বাহ,	নির্বাহ,	
feroza,	ফেরোজা,	ফিরোজা,	
oncholeo,	অঁচলেও,	অঞ্চলেও,	
spashtotai,	স্পষ্টতাই,	স্পষ্টতই,	
probhura,	প্রভুরা,	প্রভুরা,	
adorso,	আদরসো,	আর্দশ,	
sukumaree,	সুকুমারী,	সুকুমারী,	
reejideencee,	রিজিলিন্স,	রেসিডেন্স,	
anchalo,	আঁচালো,	অঞ্চলও,	
zerusalem,	জেরুসালেম,	জেরুজালেম,	
nischitobhabe,	নিশ্চিতভাবে,	নিশ্চিতভাবে,	
seramiks,	সেরামিক্স,	সিরামিকস,	
dhaanche,	ধানচে,	ধাঁচে,	
tiger,	টিগের,	টাইগার,	
ponchashjon,	পঞ্চাশজন,	পঞ্চাশজন,	
kiibord,	কিবার্ড,	কীবোর্ড,	
pustir,	পুস্তির,	পুষ্টির,	
baarnis,	বারনিস,	বার্নিশ,	
jiland,	জিল্যান্ড,	জিল্যান্ড,	
distibutor,	ডিস্টিবুটোর,	ডিস্টিবিউটারের,	
dajhyo,	দাঝ্য,	দাহ্য,	
gingbhalobasen,	গিনভালোবেসেন,	গিংভালোবাসেন,	
andra,	আন্দ্রা,	আন্ড্রা,	
amanisa,	আমানিসা,	অমানিশা,	
munot,	মুনোট,	মুনোট,	
zeebonto,	জীবন্ত,	জীবন্ত,	
motabolombira,	মতাবলম্বীরা,	মতাবলম্বীরা,	
hafsa,	হাফসা,	হাফসা,	
delibhara,	ডেলীভরা,	ডেলিভার,	
ray,	রায়,	রায়,	
gabeshonar,	গবেষণার,	গবেষনার,	
surakarder,	সুরকর্দের,	সুরকারদের,	
attorkite,	আ্যাটরটিকে,	অতর্কিতে,	
vvimsenn,	ভিভিএমএনএস,	ভীমসেন,	
aflatoxin,	আফ্লাটক্সিন,	আ্যফ্ল্যাটক্সিন,	
kale,	কলে,	কালে,	
jonoikaa,	জনোকায়া,	জনৈকা,	
husni,	হুসনি,	হুসনি,	
khudhartara,	ক্ষুধারতারা,	ক্ষুধার্তরা,	
orthobochorke,	অর্থবছরকে,	অর্থবছরকে,	
norpholk,	নরফোলক,	নরফোক,	
kotibondhe,	কটিবন্ধে,	কটিবন্ধে,	
poriikkhateo,	পরীক্ষাতেও,	পরীক্ষাতেও,	
capsule,	ক্যাপসুলে,	ক্যাপ্সুল,	
taatey,	তাতে,	তাতে,	
tenishe,	তেনিশে,	টেনিসে,	
siitei,	শিতেই,	শীতেই,	
rubidium,	রুবিডিয়াম,	রুবিডিয়াম,	
parka,	পারকা,	পার্ক,	
suraropito,	সুরারোপিত,	সুরারোপিত,	
paira,	পায়ারা,	পাইরা,	
sharthe,	শার্থে,	স্বার্থে,	
firozaa,	ফিরোজা,	ফিরোজা,	
elbamtite,	এলবামটিতে,	এলবামটিতে,	
nirdesika,	নির্দেসিকা,	নির্দেশিকা,	
ddebet,	ড্ডিবেট,	ডিবেট,	
fasir,	ফাসির,	ফাসীর,	
cathalic,	ক্যাথালিক,	ক্যাথলিক,	
dhanijomite,	ধানিজয়তিতে,	ধানিজমিতে,	
bhejaano,	ভেজানো,	ভেজানো,	
durarohini,	দুরারোহিনী,	দুরারোহিণী,	
abadamoner,	আবাদামনের,	অবদমনের,	
jolaatonko,	জলাাতনকো,	জলাতঙ্ক,	
nakkal,	নকককল,	নক্কল,	
bhujangta,	ভুজাংটা,	ভুজঙ্গটা,	
reshmirekha,	রেশমিরেখা,	রেশমীরেখা,	
esoosiyetasa,	এসুসিয়েটস,	এসোসিয়েটস,	
waal,	ওয়াল,	উল,	
jolrang,	জলরাং,	জলরঙ,	
himsrot,	হিমস্রোট,	হিমস্রোত,	
torunderke,	তরুনদেরকে,	তরুণদেরকে,	
shahjapur,	শাহজাপুর,	শাহজাপুর,	
carlos,	কার্লোস,	কার্লোস,	
aalaa,	আলা,	আলা,	
neck,	নেক,	নেক,	
bbosonto,	ব্যবস্ত,	বসন্ত,	
pader,	পাদের,	প্যাডের,	
yanqee,	যানকি,	ইয়াংকি,	
huk,	হুক,	হুক,	
satyaky,	সত্যকি,	সাত্যকি,	
gonesher,	গনেশের,	গণেশের,	
puroheetder,	পুরোহিতদের,	পুরোহিতদের,	
beila,	বেইলা,	বেইলা,	
dapadpi,	দাপদপী,	দাপাদপি,	
phokser,	ফক্সের,	ফক্সের,	
madhabike,	মাধবীকে,	মাধবীকে,	
monchosthol,	মঞ্চস্থল,	মঞ্চস্থল,	
hondooras,	হন্দুরাস,	হন্ডুরাস,	
pacchi,	পাচচি,	পাচ্ছি,	
cxt,	সিসিসিটি,	সিএক্সটি,	
nanabornobishishto,	নানাবর্ণবিশিষ্ট,	নানাবর্ণবিশিষ্ট,	
dweepgoolotey,	দ্বীপগলগুলোতে,	দ্বীপগুলোতে,	
tarkareer,	তারকারীর,	তরকারীর,	
khitkar,	খিটকার,	ক্ষিতকর,	
carloos,	কার্লাস,	কার্লোস,	
freekeh,	ফ্রিকেহ,	ফ্রিকেহ,	
palashir,	পলাশির,	পলাশীর,	
deefinision,	ডিফিনিশন,	ডেফিনেশন,	
seguloi,	সেগুলোই,	সেগুলোই,	
lirikti,	লিরিকটি,	লিরিকটি,	
kramp,	ক্রাম্প,	ক্র্যাম্প,	
balokarak,	বালকারাক,	বলকারক,	
generalissimo,	জেনারেলিসমিও,	জেনারেলিসিমো,	
gaphiloti,	গাফিলোটি,	গাফিলতি,	
ashok,	আসক,	আশোক,	
sangbadmadhyamgulote,	সংবাদমাধ্যমগুলোতে,	সংবাদমাধ্যমগুলোতে,	
bhittitei,	ভিত্তিতেই,	ভিত্তিতেই,	
neker,	নেকের,	নেকের,	
chaka,	চাকা,	চাকা,	
sobchey,	সব্চে,	সবচে,	
basermick,	বেসারমিক,	বেসারমিক,	
mukhoshdharir,	মুখোষধারীর,	মুখোশধারীর,	
jorury,	জরুরি,	জরূরী,	
calabe,	ক্যালাবে,	চালাবে,	
gajetted,	গ্যাজেটেড,	গেজেটেড,	
nick,	নিক,	নিক্,	
ovarview,	ওভারভিউ,	ওভারভিউ,	
paolasthi,	পাওলাস্থী,	পাওলাসথি,	
graambaaseeder,	গ্রামবাসীদের,	গ্রামবাসীদের,	
sectore,	সেক্টরে,	সেক্টরে,	
fatakasto,	ফাতাকাস্ত,	ফাটাকেষ্ট,	
qonfliqt,	কনফ্লিক্ট,	কনফ্লিক্ট,	
ghumachche,	ঘুমাচ্ছে,	ঘুমাচ্ছে,	
deliver,	ডেলিভার,	ডেলিভার,	
cinemapremider,	সিনেমাপ্রেমীদের,	সিনেমাপ্রেমীদের,	
bizito,	বিজিত,	বিজিত,	
nogore,	নগরে,	নগরে,	
humner,	হামনার,	হামনার,	
purohitra,	পুরোহিত্র,	পুরোহিতরা,	
primoo,	প্রাইমো,	প্রিমো,	
siropa,	সিরোপা,	শিরোপা,	
shtona,	শ্তনা,	স্টোন,	
ingrejra,	ইংরেজরা,	ইংরেজরা,	
kalenga,	কলেঙ্গা,	কালেঙ্গা,	
mosharroph,	মশারপর্ফ,	মশাররফ,	
korijachilen,	করিযাছিলেন,	করিযাছিলেন,	
sepha,	সেফা,	শেফ,	
ponera,	পনেরা,	পনের,	
dhalur,	ধলুর,	ঢালুর,	
birishiritey,	বিরিশিরিতে,	বিরিশিরিতে,	
kichudinpar,	কিছুদিনপর,	কিছুদিনপর,	
shajano,	শাজানো,	সাজানো,	
sima,	সিমা,	সীমা,	
miley,	মিলে,	মিলে,	
hoteltee,	হোটেলটি,	হোটেলটি,	
khuizza,	খুইজ্জা,	খুইজ্জা,	
bhalobaas,	ভালোবাস,	ভালোবাসা,	
narbur,	নারবুর,	নরবুর,	
bahati,	বাহাটি,	বাহাতি,	
graambaaseeo,	গ্রামবাসিও,	গ্রামবাসীও,	
zarniz,	জারনিজ,	জারনিজ,	
nojder,	নজদের,	নজদের,	
phiqsa,	ফিক্সা,	ফিক্স,	
jemy,	জেযামি,	জেমি,	
dito,	দিতো,	দিতো,	
probeshkari,	প্রবেশকারী,	প্রবেশকারী,	
mile,	মিলে,	মিলে,	
firoza,	ফিরোজা,	ফিরোজা,	
sethai,	সেথাই,	সেথাই,	
karaa,	কারা,	কারো,	
sahapathike,	সহপাঠিকে,	সহপাঠীকে,	
prashikkhane,	প্রশিক্ষণে,	প্রশিক্ষণে,	
argho,	অর্ঘ,	অর্ঘ্য,	
protisthan,	প্রতিষ্ঠান,	প্রতিষ্টান,	
bikargrosto,	বিকারগ্রস্ত,	বিকারগ্রস্ত,	
muhaiminer,	মুহাইমিনের,	মুহাইমিনের,	
bishshaasho,	বিশ্বাস,	বিশ্বাসও,	
akhhunno,	আখুন্ন,	অক্ষুণ্ণ,	
samaveshke,	সমাভেষকে,	সমাবেশকে,	
ghamta,	ঘামটা,	ঘোমটা,	
rudrasagar,	রুদ্রসাগরের,	রুদ্রসাগরের,	
dalip,	দালিপ,	দালিপ,	
bhiktara,	ভিক্তারা,	ভিক্টর,	
bedanta,	বেদান্ত,	বেদান্ত,	
fevarite,	ফেভারিতে,	ফেভারিট,	
nanilalke,	নানিলালকে,	ননীলালকে,	
khiladirao,	খিলাদিরাও,	খিলাড়িরাও,	
suparahiro,	সুপারহীরও,	সুপারহিরো,	
cheentaikaree,	চিন্তাইকারী,	ছিনতাইকারী,	
annorup,	আন্নরূপ,	অন্যরূপ,	
gronthoti,	গ্রন্থতি,	গ্রন্থটি,	
oikhan,	ঐখান,	ঐখান,	
dhandu,	ধন্দু,	ধন্দু,	
dupleks,	ডুপ্লেক্স,	ডুপ্লে,	
black,	ব্ল্যাক,	ব্ল্যাক,	
ghotleyo,	ঘটলেও,	ঘটলেও,	
tanu,	তানু,	তনু,	
gaandaas,	গান্দাস,	জ্ঞানদাস,	
ucchosito,	উচ্চসিত,	উচ্ছসিত,	
bhenkates,	ভেঙকাতেস,	ভেঙ্কটেশ,	
dormetori,	ডরমমটরি,	ডরমিটরি,	
folleni,	ফলেনি,	ফলেনি,	
dharavahiker,	ধারাভাহিকের,	ধারাবাহিকের,	
difinision,	ডিফিশনিন,	ডেফিনেশন,	
meloonborrone,	মেলুনবর্ণনে,	মেলবোর্নে,	
khelechen,	খেলেছেন,	খেলেছেন,	
paripakey,	পরিপাকে,	পরিপাকে,	
johor,	জহর,	জহর,	
mehsus,	মেহসুস,	মেহসুস,	
shabkam,	শাক্কাম,	শবকাম,	
monzeele,	মনজিলে,	মঞ্জিলে,	
elakaasoho,	এলাকাসহ,	এলাকাসহ,	
kachhakaachhi,	কাছাকাছি,	কাছাকাছি,	
nehle,	নেহলে,	নেহলে,	
grootha,	গ্রুথা,	গ্রোথ,	
fakhrul,	ফখরুল,	ফাখরুল,	
harja,	হার্জা,	হার্জ,	
chalochchitraeer,	চলচ্চিত্রীর,	চলচ্চিত্রের,	
milea,	মিলেয়া,	মাইলে,	
debdebier,	দেবদেবীরে,	দেবদেবীর,	
kottar,	কোট্তার,	কট্টর,	
votarer,	ভোটারের,	ভোটারের,	
heze,	হেজে,	হেজ,	
duryogamoyee,	দুর্যোগাময়ী,	দুর্যোগময়ী,	
wilderske,	উইল্ডার্সকে,	উইল্ডার্সকে,	
hariner,	হরিণের,	হরিণের,	
jaunotar,	যৌনতার,	যৌনতার,	
parjotaker,	পার্যতাকের,	পর্যটকের,	
chitlar,	চিতলার,	চিতলার,	
shunani,	শুনানি,	শুনানী,	
rakhtokkharoner,	রাখতক্ষণারের,	রক্তক্ষরণের,	
andamana,	আন্দামানা,	আন্দামান,	
varma,	ভারমা,	ভার্মা,	
azin,	আজিন,	আজিন,	
sanghatakder,	সংহতাকাদের,	সংঘটকদের,	
pisach,	পিসাচ,	পিশাচ,	
harasta,	হারস্ত,	হারাস্তা,	
chalachchitrei,	চলচ্চিত্রেই,	চলচ্চিত্রেই,	
nishad,	নিষাদ,	নিষাদ,	
songbadmadhyomer,	সংবাদমাধ্যমের,	সংবাদমাধ্যমের,	
sooya,	সুয়া,	সোয়া,	
somosto,	সমষ্ত,	সমস্ত,	
sobaiderke,	সোবাইদেরকে,	সবাইদেরকে,	
blogarra,	ব্লগাররা,	ব্লগাররা,	
eoki,	ইওকি,	এওকি,	
nadnadeer,	নদন্দাদির,	নদনদীর,	
mitrota,	মিত্রটা,	মিত্রতা,	
koordira,	কোরদিরা,	কুর্দিরা,	
hurricane,	হ্যুরিকানে,	হ্যারিকেন,	
shibraj,	শিবরাজ,	শিবরাজ,	
bibecchyo,	বিবেচ্ছ,	বিবেচ্য,	
ganonanatto,	গণনানন্ত,	গণনাট্য,	
nationalser,	নেটননেলসের,	ন্যাশনালসের,	
nisader,	নিসাদের,	নিষাদের,	
akreetokarjo,	আক্রিতকার্য,	অকৃতকার্য,	
dhyanastha,	ধ্যানস্থ,	ধ্যানস্থ,	
mardud,	মারদুদ,	মরদুদ,	
dep,	ডেপ,	ডেপ,	
daaoon,	দাওনন,	ডাউন,	
dinifitian,	দিনিফিইিয়ান,	ডেফিনেশন,	
vagni,	ভাগনি,	ভগ্নী,	
nabayug,	নবায়ুগ,	নবযুগ,	
chirkut,	চিরকুট,	চিরকুট,	
soinyora,	সৈন্যরা,	সৈন্যরা,	
madhabi,	মাধবী,	মাধবী,	
sipa,	সিপা,	শিপ,	
parkasa,	পারকাশা,	পার্কস,	
bisnuke,	বিস্ুুকে,	বিষ্ণুকে,	
lutherana,	লুথেরানা,	লুথেরান,	
jothartho,	যথার্থ,	যথার্থ,	
jhonkar,	ঝোঁকার,	ঝঙ্কার,	
byathapather,	ব্যথাপথের,	ব্যথাপথের,	
elakaatite,	এলাকাটিতে,	এলাকাটিকে,	
ghatla,	ঘাটলা,	ঘটল,	
khaschandpur,	খাশচাঁদপুর,	খাসচাঁদপুর,	
sursur,	সুরসুর,	সুরসুর,	
suiti,	সুইটি,	সুইটি,	
karim,	কারিম,	করিম,	
akkhunno,	আক্ষুন্ন,	অক্ষুণ্ণ,	
taposgoner,	তাপসংবনের,	তাপসগণের,	
booponer,	বুপনের,	বপনের,	
khamotagulor,	ক্ষমতাগুলোর,	ক্ষমতাগুলোর,	
favorite,	ফ্যাভরিতে,	ফেভারিট,	
hetimganje,	হেটিমগঞ্জে,	হেতিমগঞ্জে,	
as,	এসএস,	অস,	
paste,	পাস্টে,	পেষ্ট,	
soorsa,	সুরসা,	সোর্স,	
poriskoron,	পরিস্করণ,	পরিষ্করণ,	
streegon,	স্ত্রীগণ,	স্ত্রীগণ,	
internship,	ইন্টারনেপি,	ইন্টার্নশিপ,	
rakhete,	রাখেতে,	রাখেতে,	
poketchorder,	পকেটচোর্ডের,	পকেটচরদের,	
militaryr,	মিলিটারির,	মিলিটারির,	
machkabar,	মাককাবার,	মাচকাবার,	
segular,	সেগুলার,	সেগুলোর,	
angkita,	আংকিটা,	অঙ্কিতা,	
dankaan,	ডানকান,	ডানকান,	
templet,	টেম্পলেট,	টেম্পলেট,	
artilary,	আর্টিলারী,	আর্টিলারি,	
ongshogrohoner,	অংশগ্রহণের,	অংশগ্রহনের,	
chopol,	চপল,	চপল,	
iksaprishana,	এক্সপ্রীসন,	এক্সপ্রেশন,	
chhutir,	ছুটির,	ছুটির,	
pothnirdeshona,	পথ্নীর্দেশনা,	পথনির্দেশনা,	
ganokantha,	গণকোঁঠা,	গণকণ্ঠ,	
senabahineeow,	সেনাবাহীনীয়,	সেনাবাহিনীও,	
karmosansthan,	কর্মসনস্থান,	কর্মসংস্থান,	
jhamala,	ঝামালা,	ঝামালা,	
toroonra,	তরুনরা,	তরুণরা,	
dishani,	দিশানী,	দিশানি,	
nothiboddho,	নথীবদ্ধ,	নথিবদ্ধ,	
carbus,	কারবাস,	কারবাস,	
lotharan,	লোথারান,	লুথেরান,	
tukroke,	টুকররকে,	টুকরোকে,	
hajeerhatt,	হাজিরহাট,	হাজিরহাট,	
sikkhagata,	শিক্ষাগত,	শিক্ষাগত,	
orthoneeti,	অর্থনীতি,	অর্থনীতির,	
machgulo,	মাছগুলো,	মাছগুলো,	
moresbai,	মোরসসেবাই,	মোরেসবাই,	
shrabasti,	শ্রাবস্তি,	শ্রাবস্তী,	
atmira,	আত্মিরা,	আত্মীরা,	
chaiten,	চাইতেন,	চাইতেন,	
laiseensee,	লাইসইন্স,	লাইসেন্স,	
dibet,	দিবেত,	ডিবেট,	
koreempoor,	করিমপুর,	করিমপুর,	
bishasey,	বিষাসে,	বিশ্বাসে,	
sawam,	সাওয়াম,	সাওম,	
gardeen,	গার্ডিন,	গার্ডেন,	
maailey,	মাইলে,	মাইলে,	
byan,	বিয়ান,	ব্যাং,	
stander,	স্ট্যাণ্ডের,	স্ট্যাণ্ডের,	
krimlin,	ক্রিমলিন,	ক্রিমলিন,	
fokskon,	ফক্সকন,	ফক্সকন,	
jhijhi,	ঝিঝি,	ঝিঝি,	
manab,	মানব,	মানব,	
shahanara,	শাহানারা,	শাহানারা,	
bhenasha,	ভেনাশা,	ভেনাস,	
vushi,	ভুশি,	ভুষি,	
sumitrar,	সুমিত্রার,	সুমিত্রার,	
graambasio,	গ্রামবাসিও,	গ্রামবাসীও,	
drissotir,	দৃশ্যটির,	দৃশ্যটির,	
zaire,	জাইরে,	জাইরে,	
tomader,	তোমাদের,	তোমাদের,	
daktikit,	ডাক্তিকিট,	ডাকটিকিট,	
uddharkarmirai,	উদ্ধারকার্মীরাই,	উদ্ধারকর্মীরাই,	
modhumotii,	মধুমতিই,	মধুমতী,	
procharona,	প্রচারণা,	প্রচারণা,	
ishter,	ইস্টার,	ইস্টের,	
daaun,	ডাউন,	ডাউন,	
parshwer,	পার্শ্বের,	পার্শ্বের,	
azijer,	আজিজের,	আজিজের,	
shansthagulo,	শান্তাগুলো,	সংস্থাগুলো,	
borkhastokritora,	বরখাস্তকৃতরা,	বরখাস্তকৃতরা,	
transapharma,	ট্রান্সফোর্মা,	ট্রান্সফর্ম,	
ghatleo,	ঘাটলেও,	ঘটলেও,	
cholchhe,	চলছে,	চলছে,	
vesselli,	ভেসেলি,	ভেসেলি,	
fitarsaho,	ফিতারসহ,	ফিতরসহ,	
larson,	লারসন,	লারসন,	
durgatsob,	দুর্গাতসমব,	দুর্গোৎসব,	
addabaj,	আদ্দাবাজ,	আড্ডাবাজ,	
bharatey,	ভারাতে,	ভারতে,	
firozapure,	ফিরোজাপুরে,	ফিরোজাপুরে,	
nirikho,	নিরিখো,	নিরিখ,	
agora,	আগোরা,	আগোরা,	
durlabhatwang,	দুর্লভত্যবং,	দুর্লভত্বং,	
monohputo,	মনোপপুত,	মনঃপুত,	
laishenshim,	লাইশেনশিম,	লাইসেন্সিং,	
chikitsar,	চিকিতসার,	চিকিত্সার,	
batikromee,	বাটিক্রমী,	ব্যতিক্রমী,	
plator,	প্ল্যাটর,	প্লেটোর,	
moushum,	মৌশুম,	মৌসুম,	
jotharthovabey,	যথার্থভাবে,	যথার্থভাবে,	
talgach,	তালগাছ,	তালগাছ,	
panchasjan,	পঞ্চাসজন,	পঞ্চাশজন,	
shudhui,	শুধুই,	শুধুই,	
mase,	মাস,	মাসে,	
dadar,	দাদার,	দাদার,	
bishhnu,	বিষ্ণু,	বিষ্ণু,	
dokaangoolote,	দোকানগুলোতে,	দোকানগুলোতে,	
carlo,	কারলো,	কার্লো,	
rakkhanbhag,	রক্ষণভঙ্গ,	রক্ষণভাগ,	
bouddho,	বৌদ্ধ,	বৌদ্ধ,	
bijepi,	বিজেপি,	বিজেপি,	
batikromi,	বাটিক্রমী,	ব্যতিক্রমী,	
syfy,	সিফি,	সাইফাই,	
shoori,	শূরী,	সুরি,	
shudhir,	শুধির,	শুধীর,	
naagaalyand,	নওগাল্যান্দ,	নাগাল্যান্ড,	
karecho,	করেছো,	করেছো,	
ghoshito,	ঘোষিত,	ঘোষিত,	
gagee,	গাগী,	গেজ,	
esasiyetasa,	এসাসিয়েটা,	এসোসিয়েটস,	
shukraanoo,	শুকরানৌও,	শুক্রানু,	
modelkey,	মডেলকে,	মডেলকে,	
vedanta,	ভেদান্ত,	বেদান্ত,	
duhsthanostho,	দুঃস্থানস্থ,	দুঃস্থানস্থ,	
poddhotiteyi,	পদ্ধটিতেই,	পদ্ধতিতেই,	
madhuree,	মধুরি,	মাধুরী,	
raunanganey,	রানাঙ্গনে,	রণাঙ্গনে,	
commissionvogider,	কমিশনভিউজনদের,	কমিশনভোগীদের,	
licencer,	লাইসেন্সের,	লাইসেন্সের,	
basakey,	বাসাকে,	বাসাকে,	
taroni,	তারনী,	তরণী,	
sikha,	সিখা,	শিখ,	
bhabanipur,	ভবানীপুর,	ভবানীপুর,	
seebiai,	সেবিয়াই,	সিবিআই,	
mooney,	মুনে,	মুনে,	
ekshoti,	একশোটি,	একশোটি,	
motkey,	মটকে,	মতকে,	
ship,	শিপ,	শিপ,	
mitrer,	মিত্রের,	মিত্রের,	
lajik,	লাজিক,	লজিক,	
firalem,	ফিরালেম,	ফিরালেম,	
oyebjin,	ওয়েবজিন,	ওয়েবজিন,	
renoo,	রেনুউ,	রেনো,	
kuhelika,	কুহেলিকা,	কুহেলিকা,	
patochitra,	পাটোচিত্র,	পটচিত্র,	
ancholgoolote,	আঁচলগুলোতে,	অঞ্চলগুলোতে,	
faltu,	ফাল্টু,	ফালতু,	
ranangane,	রনাঙ্গনে,	রণাঙ্গনে,	
osthisondhi,	অস্থিসন্ধী,	অস্থিসন্ধি,	
byaboharkari,	ব্যবহারকারী,	ব্যবহারকারী,	
suisharke,	শুইশারকে,	সুইশারকে,	
doorotaumo,	দূরতামো,	দূরতম,	
notey,	নোটে,	নোটে,	
japanostho,	যাপানস্থ,	জাপানস্থ,	
jubokti,	যুবক্তি,	যুবকটি,	
bishwasho,	বিশ্বাসও,	বিশ্বাসও,	
srivatsalakshanang,	শ্রীবৎসালক্ষতং,	শ্রীবৎসলক্ষণং,	
atorkitey,	আটরটিকে,	অতর্কিতে,	
teemothi,	তেমোথি,	টিমোথি,	
obosorer,	অবসরের,	অবসরের,	
confliqt,	কনফ্লিকট,	কনফ্লিক্ট,	
rajshri,	রাজশ্রী,	রাজশ্রী,	
baugey,	বাগে,	বাগে,	
anchalei,	আঁচালেই,	অঞ্চলেই,	
zerusalem,	জেরুসালেম,	জেরুসালেম,	
nirgomon,	নির্গমন,	নির্গমন,	
sharoker,	শ্রকের,	স্মারকের,	
jalbe,	জলবে,	জ্বলবে,	
daaktikit,	ডাকটিকিট,	ডাকটিকিট,	
collaborators,	কলাবরেটর্স,	কলাবরেটরস,	
baganoto,	বাগানত,	বাগানত,	
charban,	চারবান,	চর্বন,	
shilbar,	শিলবার,	সিলভার,	
zozyota,	যজ্যতা,	যোজ্যতা,	
headquartus,	হেডকার্টাউস,	হেডকোয়ার্টাস,	
kuronir,	কুরনীর,	কুরনীর,	
halding,	হ্যালিং,	হোল্ডিং,	
hydrological,	হাইড্রোলজিক্যাল,	হাইড্রোলজিক্যাল,	
hojurer,	হজুরের,	হজুরের,	
ostheesandhi,	অস্থিসন্ধি,	অস্থিসন্ধি,	
aatmobishwasi,	আত্মবিশ্বাসী,	আত্মবিশ্বাসী,	
rohosyoti,	রহস্যটি,	রহস্যটি,	
ched,	চেদ,	ছেদ,	
arthonitir,	অর্থনীতির,	অর্থনীতির,	
ivil,	আইভিল,	ইভিল,	
jahara,	জাহারা,	যাহরা,	
orthanitike,	অর্থানিতিকে,	অর্থনীতিকে,	
gujob,	গুজব,	গুজব,	
rupert,	রুপার্ট,	রুপার্ট,	
chhedon,	ছেদন,	ছেদন,	
makhno,	মাকনো,	মাখনো,	
rohasyati,	রোহস্যটি,	রহস্যটি,	
mosjidtir,	মসজিদটির,	মসজিদটির,	
dholeshwari,	ধোলেশ্বরী,	ধলেশ্বরী,	
ispredsiit,	ইস্প্রেডশিট,	স্প্রেডশীট,	
ummool,	উম্মুল,	উম্মুল,	
bornanukrome,	বর্ণানুক্রমে,	বর্নানুক্রমে,	
asantosh,	অসন্তোষ,	অসন্তোষ,	
mesenjjar,	মেসেনজাজার,	মেসেঞ্জার,	
indrakanan,	ইন্দ্রকান,	ইন্দ্রকানন,	
srichoitonnodeb,	শ্রীচৈতন্বদেব,	শ্রীচৈতন্যদেব,	
khargosher,	খার্ঘশের,	খরগোসের,	
shikkhadikkhay,	শিক্ষাদিক্ষায়,	শিক্ষাদিক্ষায়,	
sotorkobhabey,	সতর্কভাবে,	সতর্কভাবে,	
khonjena,	খোঁজেনা,	খোঁজেনা,	
laaisensh,	লাইসেন্স,	লাইসেন্স,	
shasankorta,	শাসনকর্তা,	শাসনকর্তা,	
semai,	সেমাই,	সেমাই,	
yuroo,	য়ুরো,	ইউরো,	
tottorat,	তত্ত্বরত,	তওরাত,	
keyu,	কেয়ু,	কেউ,	
guzon,	গুজন,	গুজব,	
hariken,	হরিকেন,	হ্যারিকেন,	
ganoporibahoner,	গণপরিবহণের,	গণপরিবহনের,	
babona,	বাবোনা,	বাবনা,	
foreks,	ফরেক্স,	ফরেক্স,	
deputee,	ডিপুটে,	ডেপুটি,	
mausumeo,	মৌসুমেও,	মৌসুমেও,	
armeeniyana,	আর্মিনীয়ান,	আর্মেনিয়ান,	
nuhas,	নুহাস,	নুহাশ,	
rajtantro,	রাজতন্ত্র,	রাজতন্ত্র,	
francine,	ফ্রান্সইন,	ফ্রান্সিন,	
nariderke,	নারীদেরকে,	নারিদেরকে,	
antercticker,	অ্যান্টারকেটিকের,	অ্যান্টার্কটিকের,	
nodimatrik,	নদীমার্তিক,	নদীমাতৃক,	
logic,	লুগিক,	লজিক,	
janamukhi,	জানামুখী,	জনমুখী,	
pharmesigulote,	ফার্মেসিগুলোতে,	ফার্মেসীগুলোতে,	
bajpa,	বজতা,	বাজপা,	
terlarang,	টার্লারাং,	তেরলারং,	
chalchhe,	চালছে,	চলছে,	
chhadite,	ছাদিতে,	ছড়িতে,	
pachattar,	পাচাত্টর,	পাচাত্তার,	
vetrillocuism,	ভেট্রিলোক্িমিজ,	ভেট্রিলোকুইজম,	
fastara,	ফস্তারা,	ফস্টার,	
naabyota,	নব্যটা,	নাব্যতা,	
chamski,	চ্যাম্সকি,	চমস্কি,	
rakshanbhag,	রক্ষণভাগ,	রক্ষণভাগ,	
saralya,	সালাল্যা,	সারল্য,	
bhagno,	ভাগনো,	ভগ্ন,	
krishibigyani,	কৃষিবিজ্ঞানী,	কৃষিবিজ্ঞানী,	
bhimsenkei,	ভীমসেনকেই,	ভীমসেনকেই,	
cheef,	চিফ,	শেফ,	
makong,	মাকং,	মেকং,	
shasyadi,	শাস্যাদি,	শস্যাদি,	
rijoor,	রিজোর,	রিজুর,	
ameettrakkhor,	অমিত্বাক্ষর,	অমিত্রাক্ষর,	
dantahin,	দন্তাহীন,	দন্তহীন,	
chinto,	চিন্ত,	চিনতো,	
ashankai,	আশঙ্কাই,	আশঙ্কাই,	
alraji,	আলরাজি,	আলরাজী,	
tigmanshu,	তিগমানশু,	তিগ্মাংশু,	
niemond,	নিম্ম্ড,	নিমন্ড,	
bishesyo,	বিশেষ্য,	বিশেষ্য,	
saurce,	সার্স,	সোর্স,	
tep,	টেপ,	ট্যাপ,	
sangkulaan,	সংকুলন,	সংকুলান,	
nepchooner,	নেপচুনের,	নেপচুনের,	
oitijjo,	ঐতিহ্য,	ঐতিহ্য,	
with,	উইথ,	ভিত,	
qanasarabheshana,	কননাসেশরভষণ,	কনসারভেশন,	
nartana,	নারানা,	নর্টন,	
sexperter,	সেক্সপার্টার,	সেক্সপার্টের,	
bike,	বিকে,	বাইক,	
shhashtra,	শাষ্ট্র,	শাস্ত্র,	
gitikobita,	গীতিকবিটা,	গীতিকবিতা,	
nutoner,	নিউটনের,	নূতনের,	
domone,	ডোমোন,	দমনে,	
hepatitis,	হেপাটাইটিস,	হেপাটাইটিস,	
dufresne,	ডাফ্রেন,	ডুফরেস্ন,	
parkin,	পারকিন,	পার্কিং,	
kekru,	কেকরু,	কেকরু,	
phutanta,	ফুটান্ট,	ফুটন্ত,	
prajanankal,	প্রজাননকাল,	প্রজননকাল,	
rakim,	রাকিম,	রাকিম,	
habshi,	হাবশি,	হাবশী,	
edic,	এডিক,	এডিক,	
bashoborty,	বাশবর্তী,	বশবর্তী,	
amburi,	অম্বুরি,	আম্বুরি,	
dhangsantup,	ধ্বংসন্তূপ,	ধ্বংসন্তুপ,	
bhoolapuka,	ভৌলতুকা,	ভোলাপুক,	
shubhag,	শুভাগ,	শুভাগ,	
byabaharkariderke,	ব্যবহারকারীদেরকে,	ব্যবহারকারীদেরকে,	
kadakhonchar,	কাদাখোঁচার,	কাদাখোঁচার,	
sarollo,	সারললো,	সারল্য,	
kanasarabhesana,	কননাসেভাসন,	কনসারভেশন,	
ponthaar,	পন্থার,	পন্থার,	
bijito,	বিজিত,	বিজিত,	
dada,	দাদা,	দাদা,	
hoil,	হইল,	হইল,	
mekon,	মেকন,	মেকং,	
tuleche,	তুলেছে,	তুলেছে,	
dakteekiter,	ডাক্তিকিটের,	ডাকটিকিটের,	
zeland,	জেলান্দ,	জিল্যান্ড,	
fake,	ফাকে,	ফাকে,	
elgoridom,	এলগোরিদোম,	এলগরিদম,	
deool,	দেওল,	দেউল,	
laiseensim,	লাইসননিজম,	লাইসেন্সিং,	
sazanor,	সাজানোর,	সাজানোর,	
sambhabonao,	সম্ভাবনাও,	সম্ভবনাও,	
prakalpatike,	প্রকল্পতিকে,	প্রকল্পটিকে,	
asthishondhi,	আস্থিশন্ধী,	অস্থিসন্ধি,	
nirmol,	নির্মল,	নির্মল,	
rajtontro,	রাজতন্ত্র,	রাজতন্ত্র,	
alumni,	আলুমনি,	অ্যালমনি,	
chanoo,	চানু,	চানু,	
aasar,	আসার,	আসর,	
plato,	প্ল্যাটো,	প্লেটো,	
ronodeep,	রনদাপ,	রণদীপ,	
kharar,	খারার,	খরার,	
saarbharti,	সারভার্তি,	সার্ভারটি,	
vins,	ভিন্স,	ভিন্স,	
shchalastic,	শ্যালাস্টিক,	স্কলাস্টিক,	
definition,	ডিফিশনশন,	ডেফিনেশন,	
saainyo,	সাইন্য,	সৈন্য,	
daltyagi,	দল্তগী,	দলত্যাগী,	
chaudhurio,	চৌধুরিও,	চৌধুরীও,	
mesenjarer,	মেসেনজারের,	মেসেঞ্জারের,	
gaujano,	গৌজানো,	গজানো,	
uqeliptas,	উকেলিপ্তাস,	ইউক্যালিপ্টাস,	
obharbhiu,	অভারভু,	ওভারভিউ,	
peri,	পেরি,	পেরি,	
soomitrar,	সুমিত্রার,	সুমিত্রার,	
balatkar,	বালাটকর,	বলাৎকার,	
ganosochetonota,	গণসচেতনাটা,	গণসচেতনতা,	
joubankal,	যৌবনকাল,	যৌবনকাল,	
dumaa,	দুমা,	দুমা,	
bairey,	বাইরে,	বাইরে,	
dhauto,	ধাতো,	ধৌত,	
jathartho,	যথার্থ,	যথার্থ,	
mexicoteo,	মেক্সিকেটেও,	মেক্সিকোতেও,	
fishing,	ফিশিং,	ফিসিং,	
edaningkale,	এডানিংকালে,	ইদানীংকালে,	
ghomtaa,	ঘোমটা,	ঘোমটা,	
boudhher,	বৌধের,	বৌদ্ধের,	
palestine,	প্যালেস্টাইন,	প্যালেস্টাইনে,	
pranidero,	প্রাণীদেরও,	প্রানীদেরও,	
greenald,	গ্রিনাল্ড,	গ্রিনল্ড,	
uzobekeestaan,	উজবেকিস্তান,	উজবেকিস্তান,	
chikitsanirbhar,	চিকিতসাহির্ভর,	চিকিৎসানির্ভর,	
bapio,	বাপিও,	বাপিও,	
lobbytey,	লবিটে,	লবিতে,	
tukrowti,	টুকরোযুতি,	টুকরোটি,	
nariderke,	নারীদেরকে,	নারীদেরকে,	
bharpur,	ভারপুর,	ভরপুর,	
musolmanera,	মুসলমানেরা,	মুসলমানেরা,	
raia,	রাইয়া,	রায়,	
qaro,	কারো,	কারো,	
vimsen,	ভিমসেন,	ভীমসেন,	
madhobi,	মাধবী,	মাধবী,	
bayii,	বায়ি,	বাঈ,	
fibergulote,	ফাইবারগুলোতে,	ফাইবারগুলোতে,	
kheshar,	খেশার,	খেশার,	
udbhaboney,	উদ্ভাবনে,	উদ্ভাবনে,	
krisenta,	ক্রিসেন্ট,	ক্রিসেন্ট,	
kul,	কুল,	কুল,	
canservatian,	ক্যানারভেটিয়ান,	কনসারভেশন,	
dharabahikotitey,	ধারাবাহিকতিতে,	ধারাবাহিকটিতে,	
somonwitobhabey,	সমন্নিতভাবে,	সমন্বিতভাবে,	
debate,	দেবাতে,	ডিবেট,	
zakharovar,	যাখারোভার,	জাখারোভার,	
catholicbad,	ক্যাথলিবাড,	ক্যাথলিকবাদ,	
pratijogira,	প্রতিযোগীরা,	প্রতিযোগীরা,	
bhardwaj,	ভাদ্বজাজ,	ভরদ্বাজ,	
prasadhoner,	প্রাসধধনের,	প্রসাধনের,	
noiteek,	নৈতিক,	নৈতিক,	
militarite,	মিলিটারিতে,	মিলিটারিতে,	
phaltu,	ফাল্টু,	ফালতু,	
grontho,	গ্রন্থ,	গ্রন্থ,	
nili,	নীলী,	নিলি,	
torabganj,	তোরবগঞ্জ,	তোরাবগঞ্জ,	
chhintayikari,	ছিন্তায়কারী,	ছিনতাইকারী,	
grambaashi,	গ্রামবাশী,	গ্রামবাসী,	
grahoksebai,	গ্রাহকসেবাই,	গ্রাহকসেবায়,	
chenza,	চেনজা,	চেঞ্জ,	
bonbhumi,	বনভুমি,	বনভূমি,	
jaaygata,	জায়গাটা,	জায়গাটা,	
naubom,	নওমম,	নবম,	
difinisian,	ডিফিনিসিয়ান,	ডেফিনেশন,	
kaalaam,	কালাম,	কালাম,	
soommo,	সুমমো,	সুমো,	
graambaasheeo,	গ্রামবাশীও,	গ্রামবাসীও,	
badhamuktovabe,	বাধামুতকাববে,	বাধামুক্তভাবে,	
bhabotarini,	ভাবতীরিণী,	ভবতারিণী,	
chalochchitrogulor,	চালচচিত্রগুলোর,	চলচ্চিত্রগুলোর,	
bhebechili,	ভেবেছিলি,	ভেবেছিলি,	
fatkabazare,	ফাতকাবাজারে,	ফাটকাবাজারে,	
meropenemer,	মেরোপেনেমের,	মেরোপেনেমের,	
shekarmani,	শেকরমানী,	শেকরমানি,	
agaldar,	আগালদার,	আগলদার,	
phareeksa,	ফররিস্কা,	ফরেক্স,	
nagorikkey,	নাগরিককে,	নাগরিককে,	
srk,	সিরক,	শাহরুখ,	
lebina,	লেবিনা,	লেবিনা,	
relance,	রিলেন্স,	রিলায়েন্স,	
dhanak,	ধানা,	ধানক,	
stana,	স্তানা,	স্টোন,	
prabhritite,	প্রভৃতিতে,	প্রভৃতিতে,	
nirarthak,	নিরার্থক,	নিরর্থক,	
neemeette,	নিমিত্বে,	নিমিত্তে,	
dinar,	দিনার,	ডিনার,	
konar,	কোনার,	কণার,	
bonobhumi,	বনভূমি,	বনভূমি,	
fanding,	ফ্যানিং,	ফান্ডিং,	
paab,	পাব,	পাব,	
ganohotyake,	গণহত্যাকে,	গণহত্যাকে,	
ratishilatai,	রতিশীলতাই,	রতিশীলতায়,	
prakalpagulor,	প্রকল্পগুলোর,	প্রকল্পগুলোর,	
nirmolota,	নির্মলতা,	নির্মলতা,	
sucre,	সাক্রে,	সাকার,	
prapokkey,	প্রাপক্যকে,	প্রাপককে,	
anutpadanshil,	অনুৎপলদদশীশ,	অনুৎপাদনশীল,	
qor,	কোর,	কর,	
kazianis,	কাজিয়ানিস,	কাজানিস,	
hepatetisa,	হেপাটেইটস,	হেপাটাইটিস,	
janosamaj,	জনসমাজ,	জনসমাজ,	
tonoo,	তোনু,	তনু,	
atwabishvashi,	আত্ববিশ্বাসী,	আত্মবিশ্বাসী,	
mugdha,	মুগধা,	মুগ্ধ,	
philo,	ফালো,	ফিলো,	
taunsheep,	টাউনশপ,	টাউনশিপ,	
taxikeo,	ট্যাক্সিকেও,	ট্যাক্সিকেও,	
sobrakomer,	সব্রাকমের,	সবরকমের,	
brittakar,	বৃত্তকার,	বৃত্তাকার,	
institutione,	ইনস্টিটিশনে,	ইনস্টিটিউশনে,	
upobashii,	উপবাশী,	উপবাসী,	
navaratri,	নবরত্রী,	নবরাত্রি,	
rodney,	রডনি,	রেডনি,	
oboshore,	অবশরে,	অবসরে,	
armshtronj,	আর্মস্ট্রাজ,	আর্মস্ট্রং,	
alpo,	অলপো,	অল্প,	
rata,	রাতা,	রত,	
capshule,	ক্যাপশুলে,	ক্যাপসুল,	
suri,	সুরী,	সুরি,	
sakshatkarer,	সাক্ষাৎকারের,	সাক্ষাৎকারের,	
rajyotiro,	রাজ্যটিরও,	রাজ্যটিরও,	
thailandsaho,	থাইলানদাসহ,	থাইল্যান্ডসহ,	
ekbai,	একবাই,	একবাই,	
ishton,	ইস্তন,	স্টোন,	
alankorana,	আলনকারণ,	অলঙ্করণ,	
baarbadoj,	বারবাজদ,	বার্বাডোজ,	
mirina,	মিরিনা,	মিরিনা,	
tateo,	টাতেও,	তাতেও,	
jaatti,	যাত্তি,	জাতটি,	
proteemar,	প্রতিমার,	প্রতিমার,	
dikpal,	দিকপাল,	দিকপাল,	
mousumeo,	মৌসুমেও,	মৌসুমেও,	
hundai,	হুন্দাই,	হুন্দাই,	
lubitz,	লুবিৎজ,	লুবিৎজ,	
drishyer,	দৃশ্যের,	দৃশ্যের,	
deputi,	ডেপুটি,	ডেপুটি,	
vaibon,	ভাইবন,	ভাইবোন,	
doorotomo,	দূরতম,	দূরতম,	
rajotwo,	রাজত্ব,	রাজত্ব,	
katui,	কাটুই,	কাতুই,	
boiragirhat,	বৈরাগীরহাট,	বৈরাগিরহাট,	
baju,	বাজু,	বাজু,	
annimated,	অ্যানিমেটেড,	এনিমেটেড,	
abheedhanic,	অভিধানিক,	অভিধানিক,	
dipon,	ডিপন,	দীপন,	
chandrima,	চন্দ্রিমা,	চন্দ্রিমা,	
plaiin,	প্লেইন,	প্লেন,	
deenes,	দীনেস,	দীনেশ,	
dovaar,	ডোভার,	ডোভার,	
charger,	চার্গের,	চার্জার,	
soolke,	সুলকে,	শুল্কে,	
geja,	গেজা,	গেজ,	
iub,	আইবিউ,	আইইউবি,	
chakrapani,	চক্রপাণি,	চক্রপানী,	
onker,	অঙ্কার,	ওঙ্কার,	
rushod,	রুশোড,	রুশদ,	
gaddaphii,	গদ্দাপিই,	গাদ্দাফী,	
prithibir,	পৃথিবীর,	পৃথবীর,	
ikboler,	ইকবলের,	ইকবলের,	
fotanor,	ফোটানোর,	ফোটানোর,	
loombinee,	লুম্বিন,	লুম্বিনী,	
mankisundar,	মানকিসুন্দর,	মানকিসুন্দর,	
bitlaser,	বিটলাসের,	বিটলসের,	
humira,	হুমিরা,	হুমিরা,	
shainyader,	শৈন্যদের,	সৈন্যদের,	
kogake,	কোগাকে,	কোগাকে,	
miitar,	মিতার,	মিত্র,	
aakkas,	আক্কাস,	আককাস,	
jaistho,	জাইস্থ,	জ্যৈষ্ঠ,	
asamonjasyopurno,	অসামঞ্জ্যবস্পূর্ণ,	অসামঞ্জস্যপূর্ণ,	
deares,	ডিয়ারস,	ডিআরএস,	
aansareer,	আনসারীর,	আনসারীর,	
kayed,	কায়েদ,	কায়েদ,	
marketing,	মার্কেটিং,	মার্কেটিং,	
nirbachokder,	নির্বাচকদের,	নির্বাচকদের,	
salmanul,	সালমানুল,	সালমানুল,	
damodar,	দামোদার,	দামদর,	
literacy,	লিটারেসি,	লিটারেসি,	
bhugol,	ভূগোল,	ভূগোল,	
ekjoge,	একযোগে,	একযোগে,	
seeramiks,	সিরামিক্স,	সিরামিকস,	
probondhobhittik,	প্রবন্ধভিত্তিক,	প্রবন্ধভিত্তিক,	
hansasya,	হাসসায়,	হংসস্য,	
choudhursoho,	চৌধুরসহ,	চৌধুরসহ,	
bhangle,	ভাঙলগে,	ভাঙলে,	
joumana,	যৌমানা,	জুমানা,	
madhoboir,	মাধবৈর,	মাধবীর,	
bosturoi,	বস্তুরই,	বস্তুরই,	
charukala,	চারুকালা,	চারুকলা,	
forma,	ফোরাম,	ফর্মা,	
oindrila,	ঐন্দ্রিলা,	ঐন্দ্রিলা,	
soomita,	সুমিতা,	সুমিতা,	
protistha,	প্রতিষ্ঠা,	প্রতিষ্টা,	
peshto,	পেষ্ট,	পেষ্ট,	
myari,	ম্যারী,	ম্যারি,	
sangbadmadhyome,	সংবাদমাধ্যমে,	সংবাদমাধ্যমে,	
baet,	বিইট,	বাইট,	
srisri,	শ্রীশরী,	শ্রীশ্রী,	
qarlosa,	কারলোসা,	কার্লোস,	
prarthonakokkher,	প্রার্থনাকক্ষের,	প্রার্থনাকক্ষের,	
asommoti,	অসম্মতি,	অসম্মতি,	
nabbata,	নব্বটা,	নাব্যতা,	
breel,	ব্রিল,	ব্রিল,	
thyachar,	থ্যাচর,	থ্যাচার,	
bonshi,	বনশি,	বংশী,	
remakri,	রিমকক্রী,	রেমাক্রী,	
mahasava,	মহাসব,	মহাসভা,	
jamarate,	জামারাতে,	জামারাতে,	
dhache,	ধাছে,	ধাঁচে,	
hupile,	হুপিলে,	হুপিলে,	
reflex,	রিফ্লেক্স,	রিফ্লেক্স,	
madrasa,	মাদরাসা,	মাদ্রাসা,	
udvaboney,	উদ্ভাবনে,	উদ্ভাবনে,	
ahong,	আহং,	অহং,	
dhaleshwari,	ধলেশ্বরী,	ধলেশ্বরী,	
infarmatian,	ইনফরমেশন,	ইনফরমেশন,	
firoze,	ফিরোজে,	ফিরোজ,	
suparharo,	সুপারহারো,	সুপারহিরো,	
jeebonnogor,	জীবনযোগর,	জীবননগর,	
samashtike,	সমশ্টিকে,	সমষ্টিকে,	
direectoratee,	ডিরেক্টরেট,	ডিরেক্টরেট,	
bibader,	বিবাদের,	বিবাদের,	
vault,	ভেল্ট,	ভল্ট,	
diibug,	দিবুগ,	ডিবাগ,	
dolphiny,	ডলফিনি,	ডলফিনি,	
dwibidho,	দ্বিবিধ,	দ্বিবিধ,	
kirke,	কিরকে,	কিরকে,	
naobihar,	নওবিহার,	নৌবিহার,	
turista,	তুরুস্তা,	টুরিস্ট,	
oojbekistan,	ওজবেকিস্তান,	উজবেকিস্তান,	
furio,	ফুরিও,	ফুরিও,	
laaishenshh,	লৈইশেঁশ,	লাইসেন্স,	
chirontan,	চিরন্তান,	চিরন্তন,	
popke,	পপকে,	পোপকে,	
cheekitsar,	চিকিৎসার,	চিকিত্সার,	
seoul,	সিউল,	সোল,	
bojata,	বোজাটা,	বোজাটা,	
somraat,	সমরাত,	সম্রাট,	
brittakare,	বৃত্তকারে,	বৃত্তাকারে,	
dharabahiktite,	ধারাবাহিকটিতে,	ধারাবাহিকটিতে,	
byboshthar,	ব্যবস্থার,	ব্যাবস্থার,	
kumbhalnar,	কুম্ভনলার,	কুম্ভালনার,	
durtomo,	দুর্তম,	দূরতম,	
byabostho,	ব্যবস্থ,	ব্যাবস্থা,	
salsa,	সালসা,	সালসা,	
ramantic,	র্যামান্টিক,	রোমান্টিক,	
pakhtunistan,	পাখতুন্নিৎসান,	পাখতুনিস্তান,	
labonaktatar,	লবণাক্ততার,	লবণাক্ততার,	
bhaibon,	ভাইবন,	ভাইবোন,	
faase,	ফাসে,	ফাঁসে,	
chalachchitrotike,	চালাচ্চিত্রটিকে,	চলচ্চিত্রটিকে,	
katbe,	কাটবে,	কাটবে,	
debdebyr,	দেবদেবীর,	দেবদেবীর,	
byabaharkareederke,	ব্যবহারকারীদেরকে,	ব্যবহারকারীদেরকে,	
asaktibandhan,	আসক্তিবন্ধন,	আসক্তিবন্ধন,	
khagen,	খাগেন,	খগেন,	
utshahomulok,	উৎসাহমূলক,	উৎসাহমূলক,	
spredashita,	স্প্রেদিশিটা,	স্প্রেডশীট,	
gunje,	গুঞ্জে,	গুঁজে,	
bohorompurer,	বহরমপুরের,	বহরমপুরের,	
sqalarashipa,	স্কলারশিপ,	স্কলারশিপ,	
prosadhoner,	প্রসাধনের,	প্রসাধনের,	
ramnathbabur,	রামনাথবাবুর,	রামনাথবাবুর,	
seconder,	সেকন্ডের,	সেকেন্ডের,	
nirgaman,	নির্গমমান,	নির্গমন,	
kolkarkhana,	কোককারখানা,	কলকারখানা,	
andon,	আন্দন,	আন্দোন,	
sanstha,	সান্্থ,	সংস্থা,	
blasterke,	ব্লাস্টারকে,	ব্লাস্টারকে,	
udbhabaney,	উদ্ভাবনে,	উদ্ভাবনে,	
canflikt,	ক্যানফ্লিকট,	কনফ্লিক্ট,	
parq,	পার্ক,	পার্ক,	
cholechi,	চলেছি,	চলেছি,	
abarte,	আবর্তে,	আবর্তে,	
kuthibarike,	কুঠিবারীকে,	কুঠিবাড়ীকে,	
saatzoner,	সাতজনের,	সাতজনের,	
veemsen,	ভিমসেন,	ভীমসেন,	
markeetim,	মার্কিটিং,	মার্কেটিং,	
habsi,	হাবসি,	হাবশী,	
chalochchitrei,	চলচ্চিত্রেই,	চলচ্চিত্রেই,	
daacktickete,	ড্যাকটিকেট,	ডাকটিকিটে,	
hitokor,	হিতোকর,	হিতকর,	
polashir,	পলাশির,	পলাশীর,	
alkatra,	আলকাত্র,	আলকাতরা,	
rabo,	রাবো,	রব,	
jansha,	জানশা,	জন্স,	
messengerer,	মেসেনজারের,	মেসেঞ্জারের,	
lopjonito,	লোপজনিত,	লোপজনিত,	
brahmanera,	ব্রহহ্মণেরা,	ব্রাহ্মণেরা,	
capsul,	ক্যাপসুল,	ক্যাপসুল,	
gobeshokgon,	গবেষকগণ,	গবেষকগণ,	
sathik,	সাথিক,	সঠিক,	
batistambhatike,	বাতিস্তম্ভূতিকে,	বাতিস্তম্ভটিকে,	
afzol,	আফজোল,	আফজল,	
aro,	আরো,	আরও,	
digree,	দিগ্রি,	ডিগ্রি,	
russad,	রুসাদ,	রুশদ,	
nimitte,	নিমিত্বে,	নিমিত্তে,	
pratiyogita,	প্রতিযোগীতা,	প্রতিযোগীতা,	
pillai,	পিল্লাই,	পিল্লাই,	
asovya,	আসোভা,	অসভ্য,	
rubala,	রুবালা,	রুবল,	
ceramicsh,	সেরামিক্চ,	সিরামিকস,	
byke,	বিইইকে,	বাইক,	
taunasipa,	টাউনাসিপা,	টাউনশিপ,	
granada,	গ্র্যানাড,	গ্র্যানাডা,	
bishnu,	বিষ্ণু,	বিষ্ণু,	
eeksapreeshana,	ইক্সপ্রিয়শন,	এক্সপ্রেশন,	
elaakaati,	এলাকাটি,	এলাকাটি,	
firti,	ফিরটি,	ফিরতি,	
harbore,	হারবোর,	হারবারে,	
timathi,	তিমাথি,	টিমোথি,	
prakare,	প্রকারে,	প্রকারে,	
poschimey,	পশ্চিমে,	পশ্চিমে,	
angshogrohon,	অংশগ্রহণ,	অংশগ্রহন,	
dorgah,	দোরগাহ,	দরগাহ,	
drishyogulotey,	দৃশ্যগুলোতে,	দৃশ্যগুলোতে,	
moshjidke,	মশহিদকে,	মসজিদকে,	
shomostigoto,	শমস্তিগত,	সমষ্টিগত,	
mohammadi,	মোহাম্মাদি,	মুহাম্মদী,	
setike,	সেতিকে,	সেটিকে,	
aaeerese,	আইনেসে,	আইরেসে,	
lokhindorer,	লোখিন্দরের,	লখিন্দরের,	
parther,	পার্থের,	পার্থের,	
bbiswashi,	বিব্বিসা,	বিশ্বাসই,	
shresthoshcho,	শ্রেষ্ঠস্চ,	শ্রেষ্ঠশ্চ,	
dakope,	ডাকোপ,	দাকোপ,	
bandhubhaabaapanna,	বন্ধুোবাজ্পান,	বন্ধুভাবাপন্ন,	
rayyaleti,	রায়য়েলতি,	রয়্যালটি,	
balithubar,	বালিথিবার,	বালিথুবার,	
rahshahi,	রহসহহি,	রাহশাহী,	
rca,	আরসিএ,	আরসিএ,	
neerbachoker,	নির্বাচকের,	নির্বাচকের,	
meshintao,	মেশিনতাও,	মেশিনটাও,	
annanere,	আন্নানেরে,	অন্যানেরে,	
rananganey,	রনাঙ্গাে,	রণাঙ্গনে,	
mast,	মাস্ট,	মাস্ত,	
volapuk,	ভোলাপুক,	ভোলাপুক,	
mercedes,	মার্সেডস,	মার্সেডেস,	
noitik,	নৈটিক,	নৈতিক,	
mail,	মেল,	মাইল,	
sikarder,	সিকারদের,	শিকারদের,	
shikkhartheerao,	শিক্ষার্থীরাও,	শিক্ষার্থীরাও,	
ogovir,	ওগভভির,	অগভীর,	
bagicha,	বাগিচা,	বাগিচা,	
oblivion,	অবলিভিশন,	অবলিভিয়ন,	
banglota,	বাংলোটা,	বাংলোটা,	
uindos,	উইন্ডোস,	উইন্ডোস,	
monjurul,	মনজুরুল,	মনজুরুল,	
jumlalancer,	জুলাল্যান্সের,	জুমলাল্যান্সার,	
fuss,	ফুস,	ফাস,	
siraju,	সিরাজু,	সিরাজু,	
elaakaa,	এলাকা,	এলাকা,	
bulan,	বুলান,	বুলান,	
byaboharkarike,	ব্যবহারকারীকে,	ব্যবহারকারীকে,	
tooku,	টুকু,	টুকু,	
hosto,	হোস্টো,	হস্ত,	
gandogol,	গন্ডগোল,	গন্ডগোল,	
temonvabe,	তেমনভাবে,	তেমনভাবে,	
duiekdiner,	দুই়েকদিনের,	দুইএকদিনের,	
chakradhare,	চক্রধারে,	চক্রধরে,	
sokkhomotabriddhi,	সক্ষতমবৃদ্ধি,	সক্ষমতাবৃদ্ধি,	
jaubankal,	যৌবনকাল,	যৌবনকাল,	
protishta,	প্রতিষ্টা,	প্রতিষ্টা,	
nagorikra,	নাগরিকরা,	নাগরিকরা,	
janar,	জানার,	জানার,	
bhandar,	ভান্ডার,	ভাণ্ডার,	
toufiq,	তৌফিক,	তৌফিক,	
bachai,	বাচাই,	বাছাই,	
taronee,	তররণী,	তরণী,	
bongshokey,	বংশকে,	বংশকে,	
irish,	এরিশ,	আইরিস,	
shatan,	শতন,	শয়তান,	
ramchander,	রামচন্দর,	রামচন্দরের,	
change,	চাঙ্গে,	চেঞ্জ,	
edaning,	এডিনিং,	ইদানিং,	
postay,	পোস্টাই,	পোস্টে,	
aieesha,	আইশা,	আইএএস,	
banshite,	বাঁশিতে,	বাঁশিতে,	
ramonar,	রামনার,	রমনার,	
scoore,	স্কোর,	স্কোর,	
nirapattamulok,	নিরাপত্তমূলক,	নিরাপত্তামূলক,	
mukhomandoler,	মুখমান্ডলের,	মুখমণ্ডলের,	
windos,	উইন্ডোস,	উইন্ডোস,	
futote,	ফুটোতে,	ফুটোতে,	
hukar,	হুকার,	হুকার,	
pray,	প্রেই,	প্রায়,	
baieq,	বাইক,	বাইক,	
metropalitana,	মেট্রোপালিটানা,	মেট্রোপলিটন,	
biplabeer,	বিপ্লাবীর,	বিপ্লবীর,	
harbare,	হাবারে,	হারবারে,	
rakhtokkharone,	রাখতক্ষরাণে,	রক্তক্ষরণে,	
biplobi,	বিপ্লবি,	বিপ্লবী,	
chat,	চাট,	চ্যাট,	
jontropatigulite,	যন্ত্রপটিগুলিতে,	যন্ত্রপাতিগুলিতে,	
mulor,	মুলোর,	মুলোর,	
satarkatar,	সতর্কটার,	সতর্কতার,	
dokan,	দোকান,	দোকান,	
bodhirota,	বধিরতা,	বধিরতা,	
ganaporibahaner,	গণপরিবাহনের,	গণপরিবহনের,	
rajyabhogi,	রাজ্যভোগী,	রাজ্যভোগী,	
abdan,	আবদান,	আব্দান,	
kheylechen,	খেয়েলছেন,	খেলেছেন,	
girilal,	গিরিলাল,	গিরিলাল,	
difinishian,	ডিফিনিশিয়ান,	ডেফিনেশন,	
jibonnogor,	জীবনযোগর,	জীবননগর,	
rajtontre,	রাজতন্ত্রে,	রাজতন্ত্রে,	
somonnitobhabe,	সমন্নিতভাবে,	সমন্বিতভাবে,	
palbongser,	পালবংসের,	পালবংশের,	
hyaloyin,	হ্যালোইন,	হ্যালোইন,	
poderthobid,	পদের্থবিদ,	পদার্থবিদ,	
nodiiteyi,	নডীতেই,	নদীতেই,	
songkolonti,	সংকলন্তি,	সংকলনটি,	
kooshumba,	কুশুম্বা,	কুশুম্বা,	
aziza,	আজিজা,	আজিজা,	
zommu,	জম্মু,	জম্মু,	
poschime,	পশ্চিমে,	পশ্চিমে,	
oxforde,	অক্সফোর্ডে,	অক্সফোর্ডে,	
chintakarma,	চিন্তকর্মা,	চিন্তাকর্ম,	
bonorajite,	বনরাজিতে,	বনরাজিতে,	
atarkitey,	আটারকিতে,	অতর্কিতে,	
pujito,	পুজিত,	পুজিত,	
sommoteer,	সম্মতির,	সম্মতির,	
abhidhanick,	অভিচানিক,	অভিধানিক,	
bedantodhormo,	বেদান্তধর্ম,	বেদান্তধর্ম,	
beshirbhaagei,	বেশীরভাগেই,	বেশিরভাগেই,	
ponero,	পনেরও,	পনের,	
chyeta,	চ্যান,	চ্যাট,	
oncoleo,	অনকলেও,	অঞ্চলেও,	
tinhazar,	তিনহাজার,	তিনহাজার,	
teentir,	টেনটির,	তিনটির,	
sumi,	সুমি,	সুমি,	
roy,	রয়ে,	রায়,	
poscime,	পশ্চিমে,	পশ্চিমে,	
leaders,	লিডার্স,	লিডার্স,	
hattey,	হ্যাটে,	হাঁটতে,	
hosne,	হোসে,	হোসনে,	
treend,	ট্রিন্ড,	ট্রেন্ড,	
seekkhokbrindo,	শিক্ষকবৃন্দ,	শিক্ষকবৃন্দ,	
laga,	লাগা,	লগ,	
swatantrata,	স্বাতন্ত্রটা,	স্বতন্ত্রতা,	
karadandey,	কারাদান্দে,	কারাদণ্ডে,	
aamor,	আমর,	আমর,	
huqa,	হুকা,	হুক,	
tiuning,	টিউনিং,	টিউনিং,	
chhotogolper,	ছোটগল্পের,	ছোটগল্পের,	
peerry,	পেররি,	পেরি,	
sonaktokaran,	সনাক্তকরণ,	সনাক্তকরণ,	
shikshakbrindo,	শিক্ষাকবৃন্দ,	শিক্ষকবৃন্দ,	
ateetkaale,	অতীতকালে,	অতীতকালে,	
qaferder,	কাফেরদের,	কাফেরদের,	
raagei,	রাগেই,	রাগেই,	
scuvi,	স্কাউি,	স্কুভি,	
uddhrita,	উদ্ধৃত,	উদ্ধৃত,	
hari,	হারি,	হরি,	
amontronkarider,	আমন্ত্রণকারীদের,	আমন্ত্রণকারীদের,	
stona,	স্তনা,	স্টোন,	
rasunkunchi,	রসুনকুঁচি,	রসুনকুঁচি,	
taunship,	টাউনশপ,	টাউনশিপ,	
sarboshokteeman,	সর্বশক্তিমান,	সর্বশক্তিমান,	
dobhara,	ডোভারা,	ডোভার,	
dekhso,	দেখসো,	দেখসো,	
sanghitar,	সংহিতার,	সংহিতার,	
bolbo,	বলবো,	বলবো,	
overholing,	ওভারহলিং,	ওভারহোলিং,	
bhutbhut,	ভূতভুট,	ভুটভুট,	
siramikasa,	সিরামিকাসা,	সিরামিকস,	
eshiyetika,	এসিয়েতিকা,	এশিয়াটিক,	
shukrabab,	শুক্রবাব,	শুক্রবাব,	
atighataner,	অতিঘাতনের,	অতিঘটনের,	
chokhwala,	চোখালা,	চোখওয়ালা,	
wictor,	উইস্টর,	ভিক্টর,	
amiya,	আমিয়া,	অমিয়,	
rahi,	রহি,	রাহী,	
liceensee,	লাইসাইন্স,	লাইসেন্স,	
jerusaleme,	জেরুসালেমে,	জেরুসালেমে,	
bhuushito,	ভূভিত,	ভূষিত,	
umedpoor,	উমেদপুর,	উমেদপুর,	
nirbahey,	নির্বাহে,	নির্বাহে,	
nagorikota,	নাগরিকতা,	নাগরিকতা,	
said,	সাইদ,	সাইদ,	
sorting,	সর্টিং,	সর্টিং,	
maudelder,	মাউদেলদের,	মডেলদের,	
madraser,	মাদ্রাসের,	মাদ্রাজের,	
cn,	সিএন,	সিএন,	
abheedhaaneek,	অভিধানিক,	অভিধানিক,	
paikgachha,	পাইকগাছা,	পাইকগাছা,	
thaii,	থাইই,	থাই,	
haridware,	হরিদ্বারে,	হরিদ্বারে,	
upobaasee,	উপবাসী,	উপবাসী,	
indra,	ইন্ড্রা,	ইন্দ্র,	
nothivuktir,	নথিভুক্তির,	নথিভুক্তির,	
phutbolarder,	ফুটবলারদের,	ফুটবলারদের,	
gazipur,	গাজীপুর,	গাজিপুর,	
janghu,	জাঙঘু,	জঙ্ঘু,	
metropolitan,	মেট্রোপলিটান,	মেট্রোপলিটন,	
shikkhakram,	শিক্ষাক্রম,	শিক্ষাক্রম,	
arthanitike,	অর্থনীতিকে,	অর্থনীতিকে,	
inapharameshana,	ইনাফারমেশন,	ইনফরমেশন,	
sahojatprobritti,	সহযাগ্্রতিস্রীত্তি,	সহজাতপ্রবৃত্তি,	
baibasthaar,	বৈবস্থার,	ব্যবস্থার,	
durgatsober,	দুর্গাতসবের,	দুর্গোৎসবে,	
laaishheshh,	লৈইশেস,	লাইসেন্স,	
irana,	ইরানা,	ইরান,	
madhobeer,	মাধবীর,	মাধবীর,	
shhepha,	শেফা,	শেফ,	
puding,	পুডিং,	পুডিং,	
jamkaalo,	জাকালাও,	জমকালো,	
shumo,	শুমো,	সুমো,	
vittimul,	ভিত্তিমূল,	ভিত্তিমূল,	
teliha,	তেলিহা,	তেলিহা,	
gannaprakasham,	গন্নপ্রকোষম,	গন্নাপ্রকাশম,	
societyke,	সোসিয়াটিকে,	সোসাইটিকে,	
plack,	প্ল্যাক,	প্ল্যাক,	
hena,	হেনা,	হেনা,	
konoroop,	কোনরূপ,	কোনরূপ,	
simaa,	সিমা,	সীমা,	
jamjamat,	জামজামাত,	জমজমাট,	
gajano,	গাজানো,	গজানো,	
lendal,	লেন্ডাল,	লেন্ডল,	
mandarbani,	মনন্দারবাণী,	মন্দারবাণী,	
niketaner,	নিকেতানের,	নিকেতনের,	
kaleo,	কালেও,	কালেও,	
kinsa,	কিনসা,	কিংস,	
totokson,	টোটোকসন,	ততক্ষন,	
bosoben,	বসবেন,	বসবেন,	
satarkabhabey,	সতর্কভাবে,	সতর্কভাবে,	
uchchotara,	উচ্চতারা,	উচ্চতর,	
eupheike,	ইউফেইকে,	ইউফেইকে,	
fostar,	ফস্তার,	ফস্টার,	
nothibhukteer,	নথিভুত্তির,	নথিভুক্তির,	
registrikrito,	রেজিস্ট্রিকৃত,	রেজিস্ট্রীকৃত,	
bagdadii,	বাগদাদী,	বাগদাদী,	
oitijjha,	ঐতিহজা,	ঐতিহ্য,	
injiniyarim,	ইঞ্জিনিয়ারিজ,	ইঞ্জিনিয়ারিং,	
kraim,	ক্রেইম,	ক্রাইম,	
nagarikera,	নাগরিকেরা,	নাগরিকেরা,	
shchalastik,	শ্যালাস্তিক,	স্কলাস্টিক,	
elakasoho,	এলাকাসহ,	এলাকাসহ,	
panchadadu,	পঞ্চদাদু,	পঞ্চাদাদু,	
protijogi,	প্রতিযোগী,	প্রতিযোগী,	
lyaataa,	ল্যাটা,	ল্যাটা,	
distance,	ডিসট্যান্স,	ডিসট্যান্স,	
ateetkale,	অতীতকালে,	অতীতকালে,	
uttor,	উত্তর,	উওর,	
dwijenbabuder,	দ্বিজেনবাবুদের,	দ্বিজেনবাবুদের,	
procharjontrogulo,	প্রচারযন্ত্রগুলো,	প্রচারযন্ত্রগুলো,	
bejiye,	বেজিয়ে,	বেজিয়ে,	
nodiitei,	নড়িতেই,	নদীতেই,	
senabahinio,	সেনাবাহিনীও,	সেনাবাহিনীও,	
sosoa,	সসোয়া,	শশা,	
phutonta,	ফুটোন্টা,	ফুটন্ত,	
bsnleu,	বিএসএনএিএললি,	বিএসএনএলইইউ,	
bibadey,	বিবাদে,	বিবাদে,	
nikate,	নিকাতে,	নিকটে,	
protizogii,	প্রতিযোগী,	প্রতিযোগী,	
qaferderkey,	কাফেরদেরকে,	কাফেরদেরকে,	
kani,	কানি,	কানি,	
dombhoke,	দম্ভকে,	দম্ভকে,	
cuti,	কিউটি,	কিউটি,	
bisnoo,	বিসোনু,	বিষ্ণু,	
jotinkey,	জটিনকে,	যতীনকে,	
tookrokey,	টুক্রকে,	টুকরোকে,	
rotheen,	রথহিন,	রথীন,	
asif,	আসিফ,	আসিফ,	
ganjana,	গাঞ্জনা,	গঞ্জনা,	
pratisthasaho,	প্রতিষ্ঠাসহ,	প্রতিষ্ঠাসহ,	
siddhantei,	সিদ্ধান্তেই,	সিদ্ধান্তেই,	
nathivookto,	নথিভুক্ত,	নথিভুক্ত,	
shten,	স্টেন,	স্টেন,	
ayumi,	আয়ুমি,	আয়ুমি,	
kathmandu,	কাঠমণ্ডু,	কাঠমান্ডু,	
cholochchitraeeo,	চলচ্চিত্রীও,	চলচ্চিত্রেও,	
zerusalemer,	জুরুসালেমের,	জেরুজালেমের,	
fimela,	ফাইমেলা,	ফিমেল,	
laaisheesh,	লইশস,	লাইসেন্স,	
chasee,	চাসি,	চেস,	
miraqela,	মিরাকেলা,	মিরাকেল,	
sthapanar,	স্থাপনার,	স্থাপনার,	
ciima,	সিমা,	সীমা,	
zubokra,	যুবকরা,	যুবকরা,	
bhenise,	ভেনিসে,	ভেনিসে,	
meghachchanno,	মেঘচচ্ছন্ন,	মেঘাচ্ছন্ন,	
chalachchitra,	চলচ্চিত্র,	চলচ্চিত্র,	
byaktigotovabeo,	ব্যক্তিতগতভাবেও,	ব্যাক্তিগতভাবেও,	
ancholgoolir,	আঁচলগুলির,	অঞ্চলগুলির,	
subade,	সুবাদে,	সুবাদে,	
haripur,	হরিপুর,	হরিপুর,	
bahjya,	বাহজযযা,	বাহ্য,	
probhur,	প্রভুর,	প্রভুর,	
hank,	হাঁক,	হাঙ্ক,	
eporzonto,	এপরজন্ত,	এপর্যন্ত,	
obdee,	ওব্দি,	অব্দি,	
kaale,	কালে,	কালে,	
akatwa,	আকাতব,	একাত্ব,	
kormopontha,	কর্মপন্থা,	কর্মপন্থা,	
plainey,	প্লেইনে,	প্লেনে,	
mumtaj,	মুমতাজ,	মুমতাজ,	
hossne,	হোসনে,	হোসনে,	
shikhaboudi,	শিখাবৌদি,	শিখাবৌদি,	
vogno,	ভগ্ন,	ভগ্ন,	
promothesh,	প্রমথেষ,	প্রমথেশ,	
deenesh,	দীনেশ,	দীনেশ,	
nederlande,	নেডারল্যাণ্ডে,	নেদারল্যান্ডে,	
aaps,	এপিএস,	এএপিএস,	
grambasheeo,	গ্রামবাশীও,	গ্রামবাসীও,	
dhhaloor,	ঢালোর,	ঢালুর,	
bhromonkaale,	ভ্রমণকালে,	ভ্রমণকালে,	
cloudbook,	ক্লাউববুক,	ক্লাউডবুক,	
saranor,	সারানোর,	সরানোর,	
chadake,	চড়াকে,	চড়াকে,	
graambasi,	গ্রামবাসী,	গ্রামবাসী,	
licensedhari,	লাইসেন্সধারী,	লাইসেন্সধারী,	
mugdal,	মুগদাল,	মুগডাল,	
gonjona,	গন্জনা,	গঞ্জনা,	
bardhitansh,	বার্ধিতান,	বর্ধিতাংশ,	
supreetira,	সুপ্রিটিরা,	সুপ্রীতিরা,	
sachetonvabe,	সচেতনভাবে,	সচেতনভাবে,	
falasrutite,	ফালসস্রুটিতে,	ফলশ্রুতিতে,	
neermol,	নির্মল,	নির্মল,	
swadhinotatukui,	স্বাধীনতাটুকুই,	স্বাধীনতাটুকুই,	
meshenjar,	মেশেনজার,	মেসেঞ্জার,	
bbiswasho,	বিব্বিসাভ,	বিশ্বাসও,	
kanshater,	কাঁ্শাটের,	কানসাটের,	
dera,	দেরা,	ডেরা,	
marri,	মারি,	ম্যারি,	
harysoner,	হারিসনের,	হ্যারিসনের,	
abhidhaaneeck,	অভিচানিক,	অভিধানিক,	
flirt,	ফ্লির্ট,	ফ্লার্ট,	
anchalsaho,	আঞচালসহ,	অঞ্চলসহ,	
sarbhaarti,	সরভার্তি,	সার্ভারটি,	
omkar,	ওমকার,	ওঙ্কার,	
poriharsoho,	পরিহারসহ,	পরিহারসহ,	
lesense,	লেসেন্স,	লাইসেন্স,	
obhijojan,	অভিযোজন,	অভিযোজন,	
panchbar,	পাঁচবার,	পাঁচবার,	
attacharito,	অট্টাচারিত,	অত্যাচারিত,	
dhaleshorii,	ধলেশরেই,	ধলেশ্বরী,	
jothon,	যথন,	যথন,	
deebug,	দিবুগ,	ডিবাগ,	
sift,	সিফটট,	শিফট,	
hoonayin,	হুনায়িন,	হুনাইন,	
jonmobhumitir,	জন্মভূমিটির,	জন্মভূমিটির,	
chaudhurider,	চৌধুরীদের,	চৌধুরীদের,	
dighol,	দিঘল,	দীঘল,	
platform,	প্ল্যাটফর্ম,	প্লাটফর্ম,	
contemporary,	কনটেমপারির,	কন্টেম্পোরারি,	
omeettrakkhor,	অমিত্রাক্ষর,	অমিত্রাক্ষর,	
nutan,	নুতান,	নূতন,	
soundorjotakei,	সৌন্দর্যটাকেই,	সৌন্দর্যটাকেই,	
granthatyke,	গ্রন্থাটিকে,	গ্রন্থটিকে,	
bbiswashke,	বিবিষ্বাসকে,	বিশ্বাসকে,	
sthapanatir,	স্থাপানাটির,	স্থাপনাটির,	
oncholshomuher,	অংচলসমূহের,	অঞ্চলসমূহের,	
alonkaran,	আলনকারান,	অলঙ্করণ,	
udbodhani,	উদ্বোধনী,	উদ্বোধনী,	
shikshagato,	শিক্ষাগত,	শিক্ষাগত,	
romnar,	রোমনার,	রমনার,	
bosano,	বসানো,	বসানো,	
gajiipur,	গাজিপুর,	গাজীপুর,	
rashedul,	রাশেদুল,	রাশিদুল,	
skolarsip,	স্কলারসিপ,	স্কলারশিপ,	
koota,	কূতা,	কোটা,	
olympik,	অলিম্পিক,	অলিম্পিক,	
pet,	পেট,	পেত,	
pushtee,	পুষ্টি,	পুষ্টি,	
afrazuler,	আফরাজুলের,	আফরাজুলের,	
modyer,	মদ্যের,	মদ্যের,	
bojhey,	বোঝে,	বোঝে,	
niutrino,	নিউট্রিনো,	নিউট্রিনো,	
atmiyasulabh,	আত্মীয়সমূলভ,	আত্মীয়সুলভ,	
ekhate,	এখাতে,	একহাতে,	
awatar,	আওয়াতার,	অবতার,	
pleto,	প্লেটো,	প্লেটো,	
jhanjra,	ঝঞ্জার,	ঝাঁজরা,	
bakhyateet,	বাযাখ্যাটি,	ব্যাখ্যাতীত,	
chakundite,	চাকুন্দিতে,	চাকুন্দিতে,	
drissoteer,	দৃশস্িতের,	দৃশ্যটির,	
wishnu,	উইষ্ণু,	বিষ্ণু,	
shatokeo,	শতকেও,	শতকেও,	
eigulor,	এইগুলোর,	এইগুলোর,	
godamjato,	গোদাজমতো,	গুদামজাত,	
caroline,	ক্যারোলিনে,	ক্যরোলিন,	
premoronge,	প্রেমরঙ্গে,	প্রেমরঙে,	
ekok,	একক,	একক,	
turky,	টার্কি,	তুর্কি,	
dorun,	ডোরুন,	দরুণ,	
jund,	জুন্ড,	জুন্দ,	
garora,	গ্রোরা,	গারোরা,	
narsaari,	নার্সারি,	নার্সারি,	
setikey,	সেতিকে,	সেটিকে,	
siqhar,	সিখার,	শিকার,	
karecho,	করেছো,	করেছ,	
seekkharthirao,	শিক্ষার্থীরাও,	শিক্ষার্থীরাও,	
seshardhe,	শেশার্ধে,	শেষার্ধে,	
protyokkhovabey,	প্রত্যক্ষবাবে,	প্রত্যক্ষভাবে,	
nirbahi,	নির্বাহী,	নির্বাহি,	
gondogol,	গণ্ডগলল,	গন্ডগোল,	
parqim,	পারকিম,	পার্কিং,	
gandhariir,	গান্ধারীর,	গান্ধারীর,	
ghotleo,	ঘটলেও,	ঘটলেও,	
pujit,	পুজিত,	পুজিত,	
uthe,	উঠে,	উঠে,	
chilahaati,	চিলাহাটি,	চিলাহাটি,	
futonta,	ফুটোন্টা,	ফুটন্ত,	
elakai,	এলাকাই,	এলাকাই,	
heena,	হিনা,	হেনা,	
mukhyo,	মুখ্য,	মুখ্য,	
chhutee,	ছুটি,	ছুটি,	
planeti,	প্লানেটি,	প্লেনটি,	
uddhritir,	উদ্ধৃতির,	উদ্ধৃতির,	
udyem,	উদ্মেম,	উদ্যেম,	
romarder,	রোমারদের,	রোমারদের,	
vobanipur,	ভবানীপুর,	ভবানীপুর,	
chikkingsasoho,	চিক্কিংসহসহ,	চিকিংসাসহ,	
roopdaan,	রূপদান,	রুপদান,	
gananatyo,	গণনাত্ম,	গণনাট্য,	
chereche,	চেরেছে,	ছেড়েছে,	
pabo,	পাবো,	পাব,	
pyore,	প্যোরে,	পিওর,	
khappar,	খপ্পর,	খপ্পর,	
phiksa,	ফিক্সা,	ফিক্স,	
spredshiit,	স্প্রেডশিট,	স্প্রেডশীট,	
koro,	কোরো,	করো,	
bosontoke,	বসন্তকে,	বসন্তকে,	
jacksonke,	জ্যাকসনকে,	জ্যাকসনকে,	
amar,	আমার,	আমর,	
shangsthatikey,	সাংসথ্টিকেই,	সংস্থাটিকে,	
poscater,	পশ্চাটের,	পশ্চাতের,	
aosafur,	আওসাফুর,	আওশাফুর,	
konagoolo,	কোনোগুলো,	কণাগুলো,	
goodamjato,	গুড়াজমাত,	গুদামজাত,	
mozlis,	মজলিস,	মজলিশ,	
ekatto,	একাত্ত,	একাত্ব,	
onupater,	অনুপাতের,	অনুপাতের,	
sangbadmadhyame,	সংবাদমাধ্যমে,	সংবাদমাধ্যমে,	
shoriph,	শরীফ,	শরিফ,	
rachanakal,	রচনাকাল,	রচনাকাল,	
baipass,	বাইপাস,	বাইপাস,	
ganochien,	গণছিন,	গণচীন,	
bulichev,	বুলিশেছ,	বুলিচেভ,	
ghoorchen,	ঘররছেন,	ঘুরেছেন,	
ganaparibahan,	গণপরিবহন,	গণপরিবহন,	
brekethru,	ব্রেকেঠরু,	ব্রেকথ্রু,	
protibedokrao,	প্রতিবেদকরাও,	প্রতিবেদকরাও,	
shroddhabihin,	শ্রদ্ধাভিহীন,	শ্রদ্ধাবিহীন,	
jonosomaj,	জনসমাজ,	জনসমাজ,	
apolokbhabe,	অপকলভাবে,	অপলকভাবে,	
shommotite,	সম্মতিতে,	সম্মতিতে,	
sondhisthaponer,	সন্ধিস্থাপনের,	সন্ধিস্থাপনের,	
paramartha,	পরমার্থ,	পরমার্থ,	
eucalyptus,	ইউক্যাল্পটাস,	ইউক্যালিপ্টাস,	
jyaqa,	জ্যাক,	জ্যাক,	
jyesthaa,	জ্যেষ্ঠা,	জ্যেষ্ঠা,	
diniphition,	ডিনিফিশন,	ডেফিনেশন,	
ramzaner,	রামজনের,	রমযানের,	
cheekitshar,	চিকিৎসার,	চিকিত্সার,	
uindoos,	উইন্দুস,	উইন্ডোস,	
bishnoo,	বিষ্ণু,	বিষ্ণু,	
nazad,	নাজাদ,	নাজাদ,	
musalmanderke,	মুসলমানদেরকে,	মুসলমানদেরকে,	
artherer,	আর্থারের,	আর্থারের,	
oncholshomuh,	অংচলসমূহ,	অঞ্চলসমূহ,	
kantajir,	কন্টাজির,	কান্তজির,	
daktickete,	ডাক্তিকতে,	ডাকটিকিটে,	
osommotite,	অসম্মতিতে,	অসম্মতি,	
ardasho,	আর্দাশো,	আর্দশ,	
nirobota,	নিরোবতা,	নিরবতা,	
prothar,	প্রথার,	প্রথার,	
nimnosakkharkari,	নিম্নসাক্ষরকারী,	নিম্নস্বাক্ষরকারী,	
sportstar,	স্পোর্টস্টার,	স্পোর্টসস্টার,	
gaichhe,	গাইছে,	গাইছে,	
aakabar,	আকাবার,	আকাবার,	
gaziipur,	গাজিপুর,	গাজীপুর,	
ved,	ভেড,	বেদ,	
timoothi,	টিমুথি,	টিমোথি,	
heelser,	হিলসের,	হিলসের,	
engrejer,	এংরেজের,	ইংরেজের,	
mangoleek,	ম্যানগোলিক,	মাঙ্গলিক,	
pratijogitamulak,	প্রতিযোগিতামূলক,	প্রতিযোগীতামূলক,	
laps,	ল্যাপস,	ল্যাপস,	
osamarik,	ওসামারিক,	অসামরিক,	
binakar,	বিনাকার,	বিনাকার,	
babare,	বাবারে,	বাবারে,	
venus,	ভেনুস,	ভেনাস,	
vabnakey,	ভাবনাকে,	ভাবনাকে,	
sbaajan,	স্বজন,	স্বজন,	
achintyabhedaved,	অচিন্ত্যভেদেবে,	অচিন্ত্যভেদাভেদ,	
toler,	টলার,	তালের,	
madelim,	মাডেলিম,	মডেলিং,	
fiksing,	ফিকসিং,	ফিক্সিং,	
nirvachaker,	নির্ভাচাকের,	নির্বাচকের,	
unchiyechilo,	উঁচিলেছিল,	উঁচিয়েছিল,	
ashor,	আসর,	আসর,	
ashonkai,	আশঙ্কাই,	আশঙ্কাই,	
bujhechhila,	বুঝেছিলা,	বুঝেছিল,	
rajnoitik,	রাজনৈতিক,	রাজনৈতীক,	
ahalyar,	আহল্যার,	অহল্যার,	
dreeshtiheen,	দৃষ্টিহীন,	দৃষ্টিহীন,	
madaspushto,	মাদসসুষ্ট,	মদদপুষ্ট,	
lampot,	ল্যাম্পট,	লম্পট,	
muradkey,	মুরাডকে,	মুরাদকে,	
koomarir,	কুমারীর,	কুমারীর,	
scholastik,	স্কলাস্তিক,	স্কলাস্টিক,	
kadapaker,	কাড়াপাকের,	কড়াপাকের,	
hights,	হাইটস,	হাইটস,	
alexandar,	আলেক্সান্ডার,	আলেকজান্ডার,	
taranee,	তারান,	তরণী,	
karmazog,	কর্মজগ,	কর্মযোগ,	
tikto,	তিক্ত,	তিক্ত,	
prrajanankaal,	প্রজাানকানাল,	প্রজননকাল,	
bii,	বিআই,	বি,	
baman,	বামান,	বামন,	
sampadoner,	সম্পাদনের,	সম্পাদনের,	
sangitanusthane,	সঙ্গীতনুষ্ঠানে,	সঙ্গীতানুষ্ঠানে,	
summer,	সামার,	সামার,	
uposhthit,	উপশ্থিত,	উপস্থিত,	
rokibul,	রোকিবুল,	রকিবুল,	
metrikoleshana,	মেট্রিকোশেছানা,	মেট্রিকোলেশন,	
onucheeder,	অনুচীদের,	অনুচ্ছেদের,	
roopmatro,	রূপমাত্র,	রূপমাত্র,	
dong,	ডংং,	ডং,	
moshzidtike,	মশ্িদদিতকে,	মসজিদটিকে,	
silabhara,	সিলাভারা,	সিলভার,	
vabuk,	ভাবুক,	ভাবুক,	
hajirhat,	হাজিরহাট,	হাজিরহাট,	
souripurang,	সৌরীপুরং,	সৌরিপুরং,	
chaloke,	চালোকে,	চালকে,	
raiialati,	রাই়ালালিটি,	রয়্যালটি,	
melborrone,	মেলবোর্নে,	মেলবোর্নে,	
siddhantoo,	সিদ্ধান্তু,	সিদ্ধান্তও,	
adhyattikota,	অধ্যাত্মিকতা,	আধ্যাত্মিকতা,	
bisshasyi,	বিশ্বাসই,	বিশ্বাসই,	
korle,	করলে,	করলে,	
kod,	কোড,	কোড,	
samyuktha,	সামুযক্ষ,	সামিউক্তা,	
shamuker,	শামুকের,	শামুকের,	
install,	ইন্্টল,	ইন্সটল,	
dwipke,	দ্বীপকে,	দ্বীপকে,	
onkush,	অঙ্কুষ,	অংকুশ,	
siima,	সিমা,	সীমা,	
iling,	ইলিং,	ইলিং,	
sikkharrtheerao,	শিক্ষার্থীরাও,	শিক্ষার্থীরাও,	
prosadhaner,	প্রসাধানের,	প্রসাধনের,	
chopal,	চোপাল,	চপল,	
graminphonor,	গ্রামিনপোহনের,	গ্রামীণফোনর,	
bodhir,	বধির,	বধির,	
gronther,	গ্রন্থের,	গ্রন্থের,	
swastir,	স্বস্তির,	স্বস্তির,	
bodhukeo,	বোধুকেও,	বধুকেও,	
kanshat,	কাঁশট,	কানসাট,	
erythrian,	এরিথ্রিয়ান,	এরিথ্রিয়ান,	
monjooshree,	মন্ুষ্রী,	মঞ্জুশ্রী,	
balatarin,	বালাতারিন,	বালাতারিয়ান,	
protijogiider,	প্রতিযোগীদের,	প্রতিযোগীদের,	
sangaskritipreme,	সংস্কৃতিপ্রেমে,	সংস্কৃতিপ্রেমে,	
durgatsabe,	দুর্গতসাবে,	দুর্গোৎসবে,	
opohoron,	অপহরণ,	অপহরন,	
beam,	বিইএম,	বিম,	
phiksim,	ফিকসিম,	ফিক্সিং,	
barnis,	বারনিস,	বার্নিশ,	
kiandi,	কিয়ান্দি,	ক্যান্ডি,	
societytey,	সোিটিই়ে,	সোসাইটিতে,	
sadeep,	সাদিপ,	সদীপ,	
emarjensi,	এমরজেন্সি,	এমার্জেন্সি,	
porishongkhanbid,	পরিষংখাযানিড,	পরিসংখ্যানবিদ,	
taffsherer,	তাফশারের,	তাফসীরের,	
teta,	টেট,	টেটা,	
bisshasi,	বিশ্বাসী,	বিশ্বাসী,	
cholochchitrake,	চলচ্চিত্রকে,	চলচ্চিত্রকে,	
elaakaate,	এলাকাটে,	এলাকাতে,	
taholo,	তাহলো,	তাহলো,	
habathu,	হাবাথু,	হাবাথু,	
anandamahale,	আনন্দমহলে,	আনন্দমহলে,	
hakone,	হাকনে,	হাকোনে,	
maradeha,	মারেহা,	মরদেহ,	
teter,	টেটের,	টেটের,	
byatikrami,	ব্যতিক্রমী,	ব্যতিক্রমী,	
maudelgulo,	মাউদেলগুলো,	মডেলগুলো,	
transhapharma,	ট্রান্সফোর্ম,	ট্রান্সফর্ম,	
subader,	সুবাদের,	সুবাদে,	
indro,	ইন্দ্রো,	ইন্দ্র,	
protijogitamulok,	প্রতিযোগিতামূলক,	প্রতিযোগীতামূলক,	
marmaraa,	মারমারা,	মারমারা,	
mitroder,	মিত্রদের,	মিত্রদের,	
bipti,	বিপ্তি,	বিপ্তি,	
kinto,	কিন্টো,	কিনত,	
dijmarescu,	ডিজরামেক্সু,	দিজমার্সাকু,	
mononiitoder,	মনোনীতদের,	মনোনীতদের,	
poddhotitei,	পদ্ধটিতেই,	পদ্ধতিতেই,	
bifol,	বিফল,	বিফল,	
zubokder,	যুবকদের,	যুবকদের,	
somratra,	সম্রাত্র,	সম্রাটরা,	
bondi,	বন্ডী,	বন্দী,	
starker,	স্টারকের,	স্টার্কের,	
kaansaat,	কানসাত,	কানসাট,	
tarunra,	তরুণরা,	তরুণরা,	
temonbhabe,	তেমনভাবে,	তেমনভাবে,	
kholdhular,	খোলধুলার,	খোলধূলার,	
aabarte,	আবর্তে,	আবর্তে,	
aakkaash,	আক্কাশ,	আককাস,	
unitgulo,	ইউনিটগুলো,	ইউনিটগুলো,	
conflikt,	কনফ্লিকট,	কনফ্লিক্ট,	
bangobandhu,	বঙ্গবন্ধু,	বঙ্গবন্ধু,	
homeser,	হোমসের,	হোমসের,	
osamanno,	ওসামান্য,	অসামান্য,	
udvabani,	উদ্ভাবাণী,	উদ্ভাবনী,	
cheento,	চিনতো,	চিনতো,	
parikhar,	পরিখর,	পরিখার,	
sedikei,	সেদিকেই,	সেদিকেই,	
drishyogulote,	দৃশ্যগুলোতে,	দৃশ্যগুলোতে,	
scholarsip,	স্কলারসিপ,	স্কলারশিপ,	
milekhanek,	মিলেখানেক,	মাইলখানেক,	
dakshinangsho,	দক্ষিণাংস,	দক্ষিণাংশ,	
uter,	উউটের,	উটের,	
ernad,	এরনাদ,	এরনাড,	
riphleksa,	রিফলকেসা,	রিফ্লেক্স,	
hul,	হুল,	হুল,	
bethikata,	বেথিকাটা,	বেঠিকতা,	
ministara,	মিনিস্টার,	মিনিস্টার,	
hizriite,	হিজরিতে,	হিজরীতে,	
hert,	হার্ট,	হার্ট,	
sharifpur,	শরীফপুর,	শরিফপুর,	
qredita,	ক্রেডিটা,	ক্রেডিট,	
onchalgulir,	অংচল্লুলির,	অঞ্চলগুলির,	
heawy,	হেউভি,	হেভি,	
thailand,	থাইল্যান্ড,	থাইল্যান্ড,	
peeth,	পিথ,	পীঠ,	
nabyata,	নব্যতা,	নাব্যতা,	
rahee,	রহহি,	রাহি,	
utotoro,	উততর,	উততর,	
dologuloo,	দলগুলো,	দলগুলোও,	
alsaar,	আলসার,	আলসার,	
eokee,	ইওকি,	এওকি,	
kruser,	ক্রুসের,	ক্রুশের,	
oichchheek,	ঐচ্চিক,	ঐচ্ছিক,	
oitijhyotike,	ঐতিহ্যটিকে,	ঐতিহ্যটিকে,	
nutaner,	নুটানের,	নূতনের,	
bishashke,	বিষাশকে,	বিশ্বাসকে,	
khanonkaj,	খননকাজ,	খননকাজ,	
samajikatar,	সমাজিকাতার,	সামাজিকতার,	
nek,	নেক,	নেক,	
euqalyptus,	ইউক্লাপটাস,	ইউক্যালিপ্টাস,	
shem,	শেম,	সেম,	
patigoniter,	পাটিগণিতের,	পাটিগণিতের,	
dienes,	ডায়েন্স,	ডিএনএস,	
rohasyer,	রহস্যের,	রহস্যের,	
spancer,	স্প্যান্সের,	স্পেন্সার,	
liedtke,	লিয়েডটেকে,	লইডটক,	
gara,	গারা,	গোর,	
arekdol,	আরেকদল,	আরেকদল,	
bojhaao,	বোঝাও,	বোঝাও,	
megacaldera,	মেগাকালাদেরা,	মেগাক্যাল্ডেরা,	
tricksguli,	ট্রিকস্যুলি,	ট্রিকসগুলি,	
heavy,	হেভি,	হেভি,	
shuri,	শুরী,	সুরি,	
groth,	গ্রোথ,	গ্রোথ,	
purohitder,	পুরোহিতদের,	পুরোহিতদের,	
abhiyojan,	অভিযয়ন,	অভিযোজন,	
bangladesh,	বাংলাদেশ,	বঙ্গালাদেস,	
nischitvabe,	নিশ্চিতভাবে,	নিশ্চিতভাবে,	
samajeek,	সমাজীক,	সামাজিক,	
kyatagorir,	ক্যাটাগরির,	ক্যাটাগরির,	
elakaai,	এলাকাই,	এলাকাই,	
jamseder,	জ্যামসেডের,	জামসেদের,	
times,	টাইমস,	টাইমস্,	
mojdur,	মজদুর,	মজদুর,	
dharabahikvabe,	ধারাবাহিকভাবে,	ধারাবাহিকভাবে,	
maudelti,	মাউদেলটি,	মডেলটি,	
remacri,	রিম্যাক্রি,	রেমাক্রী,	
chomski,	চম্সকি,	চমস্কি,	
wedanta,	ওয়াদান্ত,	বেদান্ত,	
dheke,	ধেকে,	ঢেকে,	
okkhorke,	অক্ষরকে,	অক্ষরকে,	
touraat,	তৌরাত,	তওরাত,	
sallallahu,	সাল্লাল্লাহু,	সল্লাল্লাহু,	
chapal,	চাপাল,	চপল,	
byabaharkareer,	ব্যবহারকারীর,	ব্যবহারকারীর,	
pyaleshtainer,	প্যালেস্টেশনের,	প্যালেস্টাইনের,	
saifullahil,	সাইফুল্লাহিল,	সাইফুল্লাহিল,	
juboke,	যুবকে,	যুবকে,	
toptoshele,	তপ্তশেলে,	তপ্তশেলে,	
whole,	ভহলে,	হোল,	
emerjency,	এমার্জেন্সি,	এমার্জেন্সি,	
dhamshrenite,	ধামশ্রেণীতে,	ধামশ্রেণীতে,	
pleta,	প্লেটা,	প্লেটো,	
marry,	মারি,	ম্যারি,	
mastarsa,	মস্তরসা,	মাস্টার্স,	
jamanataswarup,	জামনতাস্বরূপ,	জামানতস্বরূপ,	
bachhaikrito,	বাছাইকৃত,	বাছাইকৃত,	
jhumjhumita,	ঝুমঝুমিতা,	ঝুমঝুমিটা,	
siddhanto,	সিদ্ধান্ত,	সিদ্ধান্তও,	
kalirkhal,	কালিরখাল,	কালিরখাল,	
hunine,	হুনিনে,	হুনাইন,	
kaia,	কাইয়া,	কায়া,	
monzushree,	মন্ুইশ্রী,	মঞ্জুশ্রী,	
breakthrough,	ব্রেক্ষুর্থ,	ব্রেকথ্রু,	
jakso,	জাকসো,	যক্ষ,	
bishshasho,	বিশ্বাস,	বিশ্বাসও,	
porjotoker,	পর্যটকের,	পর্যটকের,	
edipass,	এডিপাস,	ইডিপাস,	
sookkho,	সুক্ষ,	সুক্ষ্ম,	
mookhomandoler,	মুখামণ্ডলের,	মুখমণ্ডলের,	
turisht,	ট্রিশ্ট,	টুরিস্ট,	
kormyi,	কর্মই,	কর্মই,	
mashtarsha,	মাষ্টার্স,	মাস্টার্স,	
langhaner,	লঙ্ঘনের,	লংঘনের,	
dayitta,	দায়িত্ত,	দায়িত্ব,	
maarmaader,	মারমাদের,	মারমাদের,	
pettern,	পেটার্ন,	প্যাটার্ন,	
saom,	সিওম,	সাওম,	
kusumeshu,	কুসুমেশু,	কুসুমেষু,	
parqa,	পারকা,	পার্ক,	
abhidhaaner,	অভিধানের,	অভিধানের,	
taigara,	টাইগারা,	টাইগার,	
steena,	স্টিনা,	স্টেন,	
dacope,	ডাকোপ,	দাকোপ,	
moorali,	মুরালি,	মুরলী,	
shahoshikatar,	শাহসিকাতার,	সাহসিকতার,	
mulbhitti,	মুলভিত্তি,	মূলভিত্তি,	
dubureer,	ডুবুরির,	ডুবুরির,	
progresh,	প্রগ্রেশ,	প্রগ্রেস,	
saalsa,	সালসা,	সালসা,	
upobasee,	উপবাসী,	উপবাসী,	
cholochchitro,	চলচ্চিত্র,	চলচ্চিত্র,	
khaaneker,	খানেকের,	খানেকের,	
chalake,	চালাকে,	চালকে,	
enamela,	এনামেলা,	এনামেল,	
gazetted,	গ্যাজেটেড,	গেজেটেড,	
mette,	মেট্টে,	ম্যাট,	
vince,	ভিন্স,	ভিন্স,	
sthapanagulor,	স্থাপানাগুলোর,	স্থাপনাগুলোর,	
dobhaar,	দোভার,	ডোভার,	
ajeem,	আজিম,	আজিম,	
mookhomaundoler,	মুখামুল্নদের,	মুখমণ্ডলের,	
masjidsaha,	মসজিদসহ,	মসজিদসহ,	
asbab,	আসবাব,	আসবাব,	
tukrote,	টুকরতে,	টুকরোতে,	
phakay,	ফাকায়,	ফাকে,	
gaichey,	গাইছে,	গাইছে,	
jakatke,	জাকাতকে,	যাকাতকে,	
inziniyarsa,	ইঞ্জিনিয়ারস,	ইঞ্জিনিয়ার্স,	
bondiira,	বন্দিরার,	বন্দীরা,	
gandhikey,	গান্ধিকে,	গান্ধীকে,	
odeb,	ওডেব,	ওদেব,	
sobche,	সব্চে,	সবচে,	
bm,	বিএম,	বিএম,	
directorate,	ডিরেক্টরেট,	ডিরেক্টরেট,	
shringa,	শ্রিংগা,	শৃঙ্গ,	
bouddha,	বৌদ্ধ,	বৌদ্ধ,	
taufik,	তাফিক,	তৌফিক,	
shilpojaat,	শিল্পজাত,	শিল্পজাত,	
salchak,	সালচক,	সালচাক,	
plasse,	প্লাস,	প্লাসে,	
potka,	পটকা,	পটকা,	
codee,	কোড,	কোডে,	
joki,	জকি,	জকি,	
batikromshalee,	বাটিক্রমশালী,	ব্যতিক্রমধর্মী,	
uthaney,	উঠানে,	উঠানে,	
armshtrong,	আর্মস্ট্রং,	আর্মস্ট্রং,	
nisshongotake,	নিঃশংপতাকে,	নিঃসঙ্গতাকে,	
tasminer,	তাসমিনের,	তাসমিনের,	
nabatarange,	নবতরঙ্গে,	নবতরঙ্গে,	
middleton,	মিডলটন,	মিডলটন,	
ghatiti,	ঘাটিটি,	ঘাঁটিটি,	
prakar,	প্রকার,	প্রকার,	
dephinishion,	ডেফিশনশন,	ডেফিনেশন,	
torunra,	তরুনরা,	তরুণরা,	
barder,	বার্ডার,	বার্ডের,	
pragreesa,	প্রজ্রীসা,	প্রগ্রেস,	
bo,	বো,	বু,	
bhogno,	ভগ্ন,	ভগ্ন,	
giitikobitar,	গীতিটিকবাটার,	গীতিকবিতার,	
daebug,	দ্যাবুগ,	ডিবাগ,	
prijon,	প্রিজন,	প্রিজন,	
gazeetteed,	গাজীতদ,	গেজেটেড,	
eura,	ইউরা,	ইউরো,	
mahbunur,	মাহবুনুর,	মাহবুনুর,	
emargency,	এমারজেন্সী,	এমার্জেন্সি,	
disni,	ডিসনি,	ডিজনী,	
billaho,	বিল্লাহ,	বিল্লাহ,	
ekroop,	একরূপ,	একরূপ,	
liaodong,	লিয়াজোডং,	লিয়াওদং,	
pare,	পায়ার,	পাড়ে,	
shikshakrom,	শিক্ষাক্রম,	শিক্ষাক্রম,	
manoharpur,	মনোহরপুর,	মনোহরপুর,	
akheli,	আখেলি,	আখেলী,	
godabari,	গোদাবারী,	গোদাবরী,	
gandagol,	গন্ডাগোল,	গন্ডগোল,	
munsi,	মুন্সি,	মুন্সী,	
provritike,	প্রভৃতিকে,	প্রভৃতিকে,	
hitlere,	হিটলারে,	হিটলারে,	
chakurijibirao,	চাকুরিজীবিরাও,	চাকুরীজীবীরাও,	
samratder,	সামরাতদের,	সম্রাটদের,	
nichupattir,	নিচুপত্তির,	নিচুপট্টির,	
devolapar,	দেবোলাপার,	ডেভলপার,	
jeebnagore,	জীবনাগরে,	জীবননগর,	
nodnodeer,	নদন্দীর,	নদনদীর,	
shiropar,	শিরোপার,	শিরোপার,	
krom,	কোরম,	ক্রম,	
tookrote,	টুক্রতে,	টুকরোতে,	
cooda,	কোডা,	কোডা,	
asaciates,	অ্যাসাসিয়েটস,	এসোসিয়েটস,	
shotodha,	শতধা,	শতধা,	
shansthaner,	শান্্্থনের,	সংস্থানের,	
bamon,	বামোন,	বামন,	
serup,	সেরুপ,	সেরূপ,	
deil,	দিল,	ডেইল,	
kirti,	কীর্তি,	কীর্তি,	
dormitory,	ডরমিটরি,	ডরমিটরি,	
rajnikant,	রাজনীকান্ত,	রাজনীকান্ত,	
govindarajan,	গোবিন্দরাজন,	গোবিন্দরাজন,	
porizoner,	পরিজনের,	পরিজনের,	
landing,	ল্যান্ডিং,	ল্যান্ডিং,	
utsahi,	উৎসাহি,	উৎসাহী,	
glanio,	গ্লানিও,	গ্লানিও,	
dharavahikbhabe,	ধারাভাহিকভাবে,	ধারাবাহিকভাবে,	
pretti,	প্রেট্টি,	প্রিটি,	
jeelyaand,	জিলিয়ান্দ,	জিল্যান্ড,	
chowdhuryke,	চৌধুর্কে,	চৌধুরীকে,	
nikela,	নিকেলা,	নিকেল,	
kurdira,	কুর্দিরা,	কুর্দিরা,	
arifin,	আরিফিন,	আরিফিন,	
orgho,	অর্ঘ,	অর্ঘ্য,	
jitpur,	জিতপুর,	জিতপুরের,	
borendroke,	বরেন্দ্রকে,	বরেন্দ্রকে,	
taateo,	টাতেও,	তাতেও,	
osomorthito,	অসমর্থিত,	অসমর্থিত,	
kharavel,	খারাভেল,	খারবেল,	
emiratas,	এমিরাতাস,	এমিরেটাস,	
upbasher,	উপবাশের,	উপবাসের,	
gemske,	জেমস্কে,	জেমসকে,	
gasthi,	গাস্থি,	গোষ্ঠী,	
bonvumitey,	বনভূমিতে,	বনভূমিতে,	
bosantake,	বসন্তকে,	বসন্তকে,	
sangkoolan,	সাংকুলান,	সংকুলান,	
chatrorai,	চাত্ররাই,	ছাত্ররাই,	
saamaanya,	সামান্যা,	সামান্য,	
pretty,	প্রেটটি,	প্রিটি,	
landey,	ল্যান্ডে,	ল্যান্ডে,	
utsahamulak,	উৎসাহমূলক,	উৎসাহমূলক,	
lutheerana,	লুথিরানা,	লুথেরান,	
poripake,	পরিপাকে,	পরিপাকে,	
aizulke,	আইজুলকে,	আইজুলকে,	
masjidti,	মাসজিদটি,	মসজিদটি,	
kayech,	কয়েছ,	কায়েছ,	
degree,	ডিগ্রি,	ডিগ্রি,	
kaande,	কান্ডে,	কাণ্ডে,	
aarik,	আরিক,	আরিক,	
boikalyo,	বৈকাল্য,	বৈকল্য,	
dubaate,	ডুবাতে,	ডুবাতে,	
boner,	বনের,	বনের,	
antarbhutto,	অন্তর্ভুত্ত,	অন্তর্ভুক্ত,	
manir,	মানির,	মনির,	
mosjidsoho,	মসজিদ্বসহ,	মসজিদসহ,	
vittiteo,	ভিত্তিতেও,	ভিত্তিতেও,	
rohosyo,	রহস্য,	রহস্য,	
minister,	মিনিস্টের,	মিনিস্টার,	
zesa,	জেসা,	জেস,	
torkarir,	তর্কারীর,	তরকারীর,	
treebhuj,	ত্রিভুজ,	ত্রিভূজ,	
mulvitti,	মুলভিট্তি,	মূলভিত্তি,	
dakten,	ডাকতেন,	ডাকতেন,	
uponeeshod,	উপনিশদ,	উপনিষদ,	
elahabade,	এলাহাবাদে,	এলাহাবাদে,	
horeepur,	হরিপুর,	হরিপুর,	
dibya,	দিব্যা,	দিব্যা,	
postac,	পোস্টাক,	পোস্টকে,	
bhimsen,	ভীমসেন,	ভীমসেন,	
duburir,	ডুবুরির,	ডুবুরির,	
ovidhanik,	অভিধানিক,	অভিধানিক,	
ghoomato,	ঘুমাতো,	ঘুমাতো,	
madhumati,	মধুমতি,	মধুমতী,	
parisankhanvid,	পরিসংখ্যান্বিদ,	পরিসংখ্যানবিদ,	
foxcon,	ফক্সকন,	ফক্সকন,	
dembakreeti,	দেম্বাকৃতি,	ডিম্বাকৃতি,	
maadla,	মাদা,	মাদলা,	
chhanada,	ছানাদা,	ছানাদা,	
bhupal,	ভুপাল,	ভূপাল,	
arsie,	আরসি,	আরসিএ,	
jaandrel,	যাঁদ্রেল,	জাঁদরেল,	
booksar,	বুকসার,	বুক্সার,	
oncholke,	অঁচলকে,	অঞ্চলকে,	
upobaashee,	উপবাশী,	উপবাসী,	
gandhiir,	গান্ধির,	গান্ধীর,	
orbeet,	অরবিত,	অরবিট,	
monur,	মনুর,	মনুর,	
hypar,	হাইপার,	হাইপার,	
towraat,	টোর়ারত,	তওরাত,	
orunima,	ওরুনিমা,	অরুণিমা,	
residensa,	রেসিডেনসসা,	রেসিডেন্স,	
pradoshik,	প্রাদোশিক,	প্রাদশিক,	
naraphoka,	নারাখোকা,	নরফোক,	
fatakesto,	ফাতাকেস্তো,	ফাটাকেষ্ট,	
shamijir,	শামীজীর,	স্বামীজীর,	
ajij,	আজিজ,	আজিজ,	
query,	কোয়েরী,	কোয়েরি,	
chhadura,	ছদুরা,	ছাদুরা,	
myathiou,	ম্যাথুও,	ম্যাথিউ,	
machsoho,	মাচসহ,	মাছসহ,	
veniser,	ভেনিসের,	ভেনিসের,	
plate,	প্লেট,	প্লেটে,	
tarkale,	তারকালে,	তারকালে,	
golimodhye,	গলিমধ্যে,	গলিমধ্যে,	
sadadyarao,	সদদ্যারাও,	সদদ্যরাও,	
bohudeen,	বহুদীন,	বহুদিন,	
anyorup,	অন্যরূপ,	অন্যরূপ,	
avetar,	আভেটার,	অবতার,	
engreziteo,	এংরেজিতেও,	ইংরেজিতেও,	
nikote,	নিকোতে,	নিকটে,	
grambaseer,	গ্রামবাসীর,	গ্রামবাসীর,	
bhalobasar,	ভালোবাসার,	ভালোবাসার,	
marpit,	মারপিট,	মারপিট,	
shommotir,	সম্মতির,	সম্মতির,	
eevil,	ইভিল,	ইভিল,	
madeling,	ম্যাডেলিং,	মডেলিং,	
sahachke,	সাহাচকে,	সাহাচকে,	
kayartara,	কায়ারতারা,	কোয়ার্টার,	
provur,	প্রভুর,	প্রভুর,	
kutubuddinke,	কুতুবুদ্দিনকে,	কুতুবুদ্দিনকে,	
tecnokret,	টেকনোক্রেট,	টেকনোক্র্যাট,	
baait,	বাইত,	বাইট,	
shourshe,	সৌরশে,	সোর্স,	
prity,	প্রিটি,	প্রিটি,	
caramiks,	ক্যারামিক্স,	সিরামিকস,	
jahangirbad,	জাহাঙ্গীরবাদ,	জাহাঙ্গীরবাদ,	
seniar,	সেনিয়ার,	সিনিয়র,	
feemalee,	ফিমালে,	ফিমেল,	
aachhis,	আছিস,	আছিস,	
deqe,	ডেকে,	ডেকে,	
noditir,	নদীটির,	নদীটির,	
bbosben,	ব্যবসবেন,	বসবেন,	
sahocorje,	সাঁচর্যে,	সাহচর্যে,	
yak,	যাক,	ইয়াক,	
scorey,	স্কোরে,	স্কোরে,	
brindaboney,	বৃন্দাবনে,	বৃন্দাবনে,	
prachando,	প্রচাণ্ড,	প্রচণ্ড,	
kaley,	কলে,	কালে,	
sahozlabhbhatar,	সহজ্লভভাতার,	সহজলভ্যতার,	
jonee,	জনী,	জনি,	
gyada,	গ্যাদ,	গ্যাদা,	
sanaktokaran,	সনাক্তকরণ,	সনাক্তকরণ,	
somoodrotote,	সমদদরতে,	সমুদ্রতটে,	
phartha,	ফার্থা,	ফার্থ,	
darjiling,	দার্জিলিং,	দার্জিলিং,	
longhan,	লঙ্ঘন,	লংঘন,	
hizrite,	হিজরিতে,	হিজরীতে,	
nabotom,	নাবতম,	নবতম,	
brail,	ব্রেইল,	ব্রেইল,	
armori,	আরমোরি,	আরমোরি,	
prokolpotike,	প্রকল্পটিকে,	প্রকল্পটিকে,	
crime,	ক্রাইম,	ক্রাইম,	
gyandas,	জ্ঞানদাস,	জ্ঞানদাস,	
iraner,	ইরানের,	ইরানের,	
samanyai,	সামান্যই,	সামান্যই,	
abhirupbabuke,	অভিরুপবাবুকে,	অভিরূপবাবুকে,	
besooro,	বেসুরো,	বেসুর,	
kakhnoba,	কাকসোবা,	কখনওবা,	
rajnaiteek,	রাজনৈতিক,	রাজনৈতীক,	
licenshe,	লাইসেন্স,	লাইসেন্স,	
ekekrokom,	একেক্রকম,	একেকরকম,	
katateo,	কাটাতেও,	কাটাতেও,	
spreadshiit,	স্প্রেডশিট,	স্প্রেডশীট,	
senabahinikey,	সেনাবাহিনীকে,	সেনাবাহিনীকে,	
mithener,	মিথেনের,	মিথেনের,	
dhhaabi,	ঢাবি,	ঢাবি,	
poripaker,	পরিপাকের,	পরিপাকের,	
juddhahato,	যুদ্ধাহাট,	যুদ্ধাহত,	
registaner,	রেজিস্টানের,	রেগিস্তানের,	
becha,	বেচা,	বেচা,	
chalachchitrer,	চলচ্চিত্রের,	চলচ্চিত্রের,	
shoreefer,	শরীফের,	শরিফের,	
trabuco,	ট্রাবুকো,	ট্র্যাবুকো,	
debholopar,	দেভলতার,	ডেভলপার,	
jati,	জাতি,	যাতি,	
dharabahikbhabe,	ধারাবাহিকভাবে,	ধারাবাহিকভাবে,	
bishwaashshke,	বিশ্বাসশকে,	বিশ্বাসকে,	
porinoti,	পরিণতি,	পরিণতি,	
maritimer,	মারিটিমের,	মেরিটাইমের,	
pnouchute,	পৌঁছুতে,	পৌঁছুতে,	
somoibo,	সময়েবো,	সমৈব,	
mukhabandha,	মুখাবন্ধ,	মুখবন্ধ,	
ankanshilpe,	আন্কাশশিল্পে,	অঙ্কনশিল্পে,	
sylvi,	সিলভি,	সিলভি,	
chiroharit,	চিরোহারিত,	চিরহরিৎ,	
baarnish,	বার্নিশ,	বার্নিশ,	
sponsorshipe,	স্পন্সরশিপে,	স্পন্সরশীপে,	
siddhante,	সিদ্ধান্তে,	সিদ্ধান্তে,	
darji,	দার্জি,	দরজি,	
diznee,	দিজনী,	ডিজনী,	
lisense,	লিসেন্সে,	লাইসেন্স,	
juktorastrer,	যুক্তরাস্ত্রের,	যুক্তরাষ্ট্রের,	
venice,	ভেনিস,	ভেনিস,	
stagecraft,	স্টাগক্রাক্ট,	স্টেজক্রাফট,	
mukhbondho,	মুখবন্ধ,	মুখবন্ধ,	
sarboporee,	সর্বপরী,	সর্বোপরী,	
qonflict,	কনফ্লিক্ট,	কনফ্লিক্ট,	
talaa,	তালা,	তালা,	
noitikota,	নৈতিকতা,	নৈতিকতা,	
byaptikaler,	ব্যাপ্তিকালের,	ব্যাপ্তিকালের,	
orrgho,	অর্ঘ,	অর্ঘ্য,	
antorbhuktimulak,	আন্তর্ভুক্তিমূলক,	অন্তর্ভুক্তিমূলক,	
matrirup,	মাতৃরূপ,	মাতৃরূপ,	
poripakey,	পরিপাকে,	পরিপাকে,	
deefinition,	ডিফিশন,	ডেফিনেশন,	
choudry,	চৌদ্রী,	চৌধুরী,	
paner,	পানের,	পানের,	
dibug,	দিবুগ,	ডিবাগ,	
chowdhurir,	চৌধুরীর,	চৌধুরীর,	
ovinetar,	অভিনেতার,	অভিনেতার,	
parikha,	পরিখখা,	পরিখার,	
jerusalemer,	জেরুসালেমের,	জেরুজালেমের,	
akkelpure,	আক্কেলপুরে,	আক্কেলপুরে,	
nirbaaho,	নির্বাহ,	নির্বাহ,	
dabarer,	দাবারের,	দাবারের,	
byaboharkarir,	ব্যবহারকারীর,	ব্যবহারকারীর,	
mahibur,	মাহিবুরের,	মহিবুর,	
engrejra,	এংরেজরা,	ইংরেজরা,	
hosney,	হোসেই,	হোসনে,	
ganoporibahon,	গণপরিবহণ,	গণপরিবহন,	
show,	শু,	শো,	
parabortee,	পারাবর্তী,	পরর্বতী,	
sorano,	সোরানো,	সরানো,	
otyacharer,	অত্যাচারের,	অত্যাচারের,	
mukhya,	মুখ্যা,	মুখ্য,	
sheetke,	শীতকে,	শীতকে,	
tantubayer,	তান্তুবায়ের,	তন্তুবায়ের,	
shektore,	শেক্তরে,	সেক্টরে,	
rushad,	রুশাদ,	রুশদ,	
taims,	টেইমস,	টাইমস্,	
bojhe,	বোঝে,	বোঝে,	
ghotaibe,	ঘটাবিে,	ঘটাইবে,	
seekkhaou,	শিক্ষাউ,	শিক্ষাও,	
poste,	পোস্টে,	পোস্টে,	
sombhobonaao,	সম্ভবনাও,	সম্ভবনাও,	
shcholastic,	শ্কোলসস্টিক,	স্কলাস্টিক,	
lambaate,	লাম্বাতে,	লম্বাটে,	
antarctica,	অন্ার্ট্যাকটি,	অ্যান্টার্কটিকা,	
oitijhya,	ঐতিহ্যা,	ঐতিহ্য,	
abhidhaanic,	অভিধানিক,	অভিধানিক,	
harza,	হারজজা,	হার্জ,	
bornolikhon,	বর্ণলীখন,	বর্ণলিখন,	
orthisoho,	অর্থিসহ,	অর্থিসহ,	
jolbe,	জলবে,	জ্বলবে,	
laat,	লাত,	লাট,	
bossoben,	বসবেন,	বসবেন,	
sangram,	সংগ্রাম,	সঙ্গ্রাম,	
blacker,	ব্ল্যাকার,	ব্ল্যাকের,	
madhnagar,	মাধনগর,	মাধনগরের,	
satarkokari,	সতর্ককারী,	সতর্ককারী,	
harris,	হ্যারিস,	হ্যারিস,	
neemitte,	নিমিত্বে,	নিমিত্তে,	
habol,	হাবোল,	হাবোল,	
camerapersoner,	ক্যামেরাপারসনের,	ক্যামেরাপার্সনের,	
poorohitder,	পওরোহিতদের,	পুরোহিতদের,	
gostigulo,	গোষ্টিগুলো,	গোষ্ঠীগুলো,	
swajan,	স্বজন,	স্বজন,	
dakter,	ডাক্টের,	ডাকতের,	
sikkhokder,	শিক্ষকদের,	শিক্ষকদের,	
ralf,	রালফ,	রালফ,	
mayily,	মেয়লি,	মাইলি,	
houzgulite,	হাউজগুলিতে,	হাউজগুলিতে,	
tapdei,	তাপদেই,	তাপড়েই,	
shangkulaan,	শংকুলান,	সংকুলান,	
golghare,	গোলঘরে,	গোলঘরে,	
welaqama,	ওয়ালাকামা,	ওয়েলকাম,	
bosante,	বসন্যে,	বসন্তে,	
neelkamal,	নিলকমাল,	নীলকমল,	
palkee,	পালকি,	পাল্কি,	
ancholsaha,	আঞচচলসহ,	অঞ্চলসহ,	
kodorer,	কদরের,	কদরের,	
laishensh,	লইশেঁশ,	লাইসেন্স,	
horipur,	হরিপুর,	হরিপুর,	
shasonkarta,	শাসনকার্ত,	শাসনকর্তা,	
raagee,	রাগী,	রাগী,	
firth,	ফিরথ,	ফার্থ,	
jotota,	যততা,	যতোটা,	
hugeke,	হুগেকে,	হিউজকে,	
rajendracholer,	রাজেন্দ্রাচের,	রাজেন্দ্রচোলের,	
kalki,	কালকি,	কালকি,	
badargaji,	বদরগাজি,	বদরগাজী,	
sahittopritite,	সাহিত্যপ্রীতিতে,	সাহিত্যপ্রীতিতে,	
gaaddafee,	গড়দাফি,	গাদ্দাফী,	
sikarer,	সিকারের,	শিকারের,	
flexta,	ফ্লেক্সটা,	ফ্লেক্সটা,	
neerbahi,	নিরবাহি,	নির্বাহি,	
shahurgulor,	শহুরগুলোর,	শহুরগুলোর,	
deepan,	দীপান,	দীপন,	
ancholtike,	আঁচকল্িকে,	অঞ্চলটিকে,	
vittio,	ভিত্তিও,	ভিত্তিও,	
grushko,	গ্রাশ্ক,	গ্রুশকো,	
skolastik,	স্কলাস্তিক,	স্কলাস্টিক,	
alaul,	আলাউল,	আলাওল,	
uponeesoder,	উপনিবদের,	উপনিষদের,	
panchashjon,	পঞ্চাশজন,	পঞ্চাশজন,	
danata,	দানাটা,	ডোনাট,	
gatibege,	গাতিবেগে,	গতিবেগে,	
drissogoolote,	দ্রিস্গগুলোতে,	দৃশ্যগুলোতে,	
ukeliptas,	উকেলিপ্তাস,	ইউক্যালিপ্টাস,	
shaater,	সাতের,	শ্যুটার,	
bedey,	বেদে,	বেদে,	
dristiheen,	দৃষ্টিহীন,	দৃষ্টিহীন,	
jerushalema,	জেরুশালামা,	জেরুসালেম,	
bipradas,	বিপ্রদাস,	বিপ্রদাস,	
jomoker,	জমকের,	জমকের,	
ajeejer,	আজীজের,	আজিজের,	
dhani,	ধনী,	ধানি,	
augustine,	আগাস্তিন,	অগাস্টিন,	
abodamaner,	অবদামানের,	অবদমনের,	
harbur,	হারবুর,	হারবার,	
sten,	স্টেন,	স্টেন,	
marmader,	মারমাদের,	মারমাদের,	
samanwitovabe,	সামান্বতিভাবে,	সমন্বিতভাবে,	
tennis,	টেনিস,	টেনিস,	
songrahak,	সংগ্রাহক,	সংগ্রাহক,	
muchlima,	মুছলিমা,	মুছলিমা,	
biplabee,	বিপ্লাবী,	বিপ্লবী,	
otyacharito,	অত্যাচিরিত,	অত্যাচারিত,	
nichols,	নিকোলস,	নিকলস,	
karpeter,	কারপেটের,	কার্পেটের,	
chhutochhooti,	ছুটোছুটি,	ছুটোছুটি,	
orthonitir,	অর্থনীতির,	অর্থনীতির,	
baharamporer,	বহরমর্পরের,	বহরমপুরের,	
saoum,	সাওম,	সাওম,	
hazat,	হাজাত,	হজত,	
dadapur,	দাদাপুর,	দাদাপুর,	
dabliudabliui,	ডাব্লিউদ্দেবুই,	ডাব্লিউডাব্লিউই,	
deelibhara,	দীলীভরা,	ডেলিভার,	
brookoleen,	ব্রুকলিন,	ব্রুকলিন,	
bhaandar,	ভান্দার,	ভাণ্ডার,	
eukalyptus,	ইউক্লাপটাস,	ইউক্যালিপ্টাস,	
myat,	ম্যাট,	ম্যাট,	
poorohitra,	পওরোহিত্রা,	পুরোহিতরা,	
sulfatee,	সুলফাতে,	সালফেট,	
bhogni,	ভগ্নী,	ভগ্নী,	
makame,	মাকামে,	মাকামে,	
taler,	তালের,	তালের,	
qirq,	কির্ক,	কার্ক,	
skirt,	স্কিইট,	স্কার্ট,	
dibate,	দিবাতে,	ডিবেট,	
khoakshir,	খোয়াকশির,	খোয়াক্ষীর,	
direqtareta,	ডিরেক্টরেটা,	ডিরেক্টরেট,	
thanvi,	থানভি,	থানভী,	
aanaan,	আনান,	আনান,	
romantik,	রোমান্তিক,	রোমান্টিক,	
choshon,	চোষ,	চোষণ,	
chaalkee,	চালকি,	চালকে,	
foolkopi,	ফুলকোপি,	ফুলকপি,	
ipl,	আইপিএল,	আইপিএল,	
yura,	য়রর,	ইউরো,	
baptics,	ব্যাপটিকস,	ব্যাপটিকস,	
bandra,	বন্দ্রা,	বন্দীরা,	
pratool,	প্রাটুল,	প্রতুল,	
krisenter,	ক্রিসেন্টের,	ক্রিসেন্টের,	
pravritir,	প্রভৃতির,	প্রভৃতির,	
cholochchitra,	চলচ্চিত্র,	চলচ্চিত্র,	
ganakantha,	গণকা্থ,	গণকণ্ঠ,	
ghomta,	ঘোমটা,	ঘোমটা,	
donat,	ডোনাত,	ডোনাট,	
probolshoktio,	প্রবলশক্তিও,	প্রবলশক্তিও,	
kaferder,	কাফেরদের,	কাফেরদের,	
somraatder,	সম্রাটদের,	সম্রাটদের,	
shnaipara,	শ্নেইপর,	স্নাইপার,	
ragei,	রাগেই,	রাগেই,	
basaalt,	বাসাল্ট,	ব্যাসল্ট,	
senior,	সেনিওর,	সিনিয়র,	
ashamorthito,	আশামর্থিত,	অসমর্থিত,	
korkotkraantee,	করককপ্রান্ত,	কর্কটক্রান্তি,	
boikolyo,	বৈকল্য,	বৈকল্য,	
chalai,	চালাই,	চালাবে,	
sealvi,	সিলভি,	সিলভি,	
ayantarqatiqa,	অযন্তরকাটিকা,	অ্যান্টার্কটিকা,	
lyaandeeng,	ল্যান্ডিং,	ল্যান্ডিং,	
nilkuthir,	নীলকুঠির,	নীলকুঠির,	
mutar,	মুতার,	মুতার,	
songasthaner,	সঙ্গা্থানের,	সংস্থানের,	
sqalastiqa,	স্কলস্তিকা,	স্কলাস্টিক,	
langhangulir,	লঙ্ঘনগুলির,	লঙ্ঘনগুলির,	
bamni,	বামনি,	বামনী,	
ashociatesh,	অশযাসিয়েট,	এসোসিয়েটস,	
lungiti,	লুংগিটি,	লুঙ্গিটি,	
patengar,	পাটেঙ্গার,	পতেঙ্গার,	
majlishpur,	মজলিশপুর,	মজলিশপুর,	
harees,	হারিস,	হ্যারিস,	
kathmandute,	কাঠমান্ুুতে,	কাঠমান্ডুতে,	
postar,	পোস্টার,	পোস্টের,	
suparichito,	সুপারিচিত,	সুপরিচিত,	
qyapasula,	ক্যাপসুলা,	ক্যাপসুল,	
murader,	মুরাদের,	মুরাদের,	
gej,	গেজ,	গেজ,	
ase,	আসে,	আসে,	
mentither,	মেন্তিহের,	মেনটিথের,	
evaner,	ইভানের,	ইভানের,	
farid,	ফারদ,	ফরিদ,	
guha,	গুহা,	গোহ,	
antorvukta,	আন্তর্ভুক্ত,	অন্তর্ভুক্ত,	
swairacharibirodhi,	স্বৈরাচারবিরোধী,	স্বৈরাচারীবিরোধী,	
quata,	কুয়াতা,	কোটা,	
notti,	নট্টি,	নোটটি,	
bopoon,	বোপুন,	বপন,	
krechi,	ক্রেচি,	করেছি,	
vushito,	ভূষিত,	ভূষিত,	
giitikobita,	গীতিকিবোটি,	গীতিকবিতা,	
nirbachakder,	নির্বাচকদের,	নির্বাচকদের,	
johny,	জোননি,	জনি,	
vitti,	ভিত্তি,	ভিত্তিই,	
rojapalaner,	রোজাপালানের,	রোজাপালনের,	
shakankti,	শককান্তি,	শকাঙ্কটি,	
mahakabi,	মহাকাবী,	মহাকবি,	
teenisa,	তেনিসা,	টেনিস,	
taitela,	টাইতেলা,	টাইটেল,	
sonaicha,	শোনাইচা,	সোনাইচা,	
yukeliptash,	যুকেলিপ্তাস,	ইউক্যালিপ্টাস,	
hosbaleke,	হোসবালেকে,	হোসবালেকে,	
hijritey,	হিজ্রিতে,	হিজরীতে,	
corsin,	কর্িন,	করসিন,	
himchi,	হিমচি,	হিমচি,	
quota,	কোওটা,	কোটা,	
shasonamoleri,	শাসনামলির,	শাসনামলেরই,	
chupani,	চুপানী,	চুপানি,	
kk,	কেকে,	কেকে,	
karmakarke,	কর্মকারকে,	কর্মকারকে,	
nirmankaaj,	নির্মাণকজ,	নির্মাণকাজ,	
shikhbe,	শিখবে,	শিখবে,	
jegulur,	যেগুলুর,	যেগুলুর,	
bikargrasta,	বিকা্গারস্ত,	বিকারগ্রস্ত,	
nirmankarmisaha,	নির্মাণকর্মীসহ,	নির্মাণকর্মীসহ,	
nathivukta,	নথিভুক্ত,	নথিভুক্ত,	
armstronz,	আর্মস্ট্রাজ,	আর্মস্ট্রং,	
refleks,	রিফ্লেক্স,	রিফ্লেক্স,	
chhuteer,	ছুটির,	ছুটির,	
shpredshiit,	স্প্রেডশিট,	স্প্রেডশীট,	
cheess,	চিস,	চেস,	
bhadaka,	ভাদাকা,	ভদকা,	
gate,	গাতে,	গ্যেটে,	
mekapgulo,	মেকাপগুলো,	মেকআপগুলো,	
pulivendla,	পুলিভেন্ডলা,	পুলিভেন্ডলা,	
homshke,	হোমশকে,	হোমসকে,	
fol,	ফলল,	ফল,	
daqop,	ডাকো,	দাকোপ,	
gandhike,	গান্ধিকে,	গান্ধীকে,	
durgotshob,	দুর্গোৎভব,	দুর্গোৎসব,	
musalmani,	মুসলমানি,	মুসলমানই,	
anchalgulir,	আঞচচলগুলির,	অঞ্চলগুলির,	
sudrishya,	সুদৃশ্য,	সুদৃশ্য,	
saseza,	সাসেজা,	সসেজ,	
mohajote,	মহাযতে,	মহাজোট,	
lyandim,	ল্যান্ডিং,	ল্যান্ডিং,	
militarir,	মিলিটারির,	মিলিটারির,	
survative,	সারভেটিভ,	সারভেটিভ,	
sithilotar,	সিথিলতার,	শিথিলতার,	
manob,	মানব,	মানব,	
dara,	দারা,	দারা,	
kanader,	কানাদের,	কণাদের,	
aairees,	আইইরিস,	আইরিস,	
dhwajbhango,	ধ্বাজভঙ্গ,	ধ্বজভঙ্গ,	
aakaabar,	আকাবার,	আকাবার,	
muktijuddhojato,	মুক্তিযুদ্ধোজত,	মুক্তিযুদ্ধজাত,	
jatata,	জাটাটা,	যতোটা,	
nosihote,	নসীহতে,	নসিহতে,	
songkulan,	সংকুলান,	সংকুলান,	
gotirodh,	গতিরোধ,	গতিরোধ,	
samaptir,	সমাপ্তির,	সমাপ্তির,	
ashirbadatri,	আশির্বদাত্রী,	আশীর্বাদাত্রী,	
bisshonath,	বিশ্বনাথ,	বিশ্বনাথ,	
ekirokom,	একিরকম,	একইরকম,	
lishenshe,	লিশেন্সে,	লাইসেন্স,	
ishahak,	ইশাহাক,	ইসাহাক,	
sahozlabhbhotar,	সহজ্লাভভতার,	সহজলভ্যতার,	
planea,	প্ল্যানি,	প্লেনে,	
lettar,	লেট্টার,	লেটার,	
stoonahenja,	স্তোনেহনাজা,	স্টোনহেঞ্জ,	
tongaa,	টোঙ্গা,	টোঙ্গা,	
arthurer,	আর্থুরের,	আর্থারের,	
bhittiti,	ভিত্তিটি,	ভিত্তিটি,	
shatoke,	শতকে,	শতকে,	
boiporiityen,	বৈপরিয়ত্যেন,	বৈপরীত্যেন,	
matis,	মাতিস,	ম্যাটিস,	
nothivukto,	নথিভুক্ত,	নথিভুক্ত,	
jewellery,	জেয়েলারি,	জুয়েলারির,	
shho,	শো,	শো,	
saramukhe,	সারামুখে,	সারামুখে,	
probhuder,	প্রভুদের,	প্রভুদের,	
projanankal,	প্রজানাকাল,	প্রজননকাল,	
enginiiring,	ইঞ্জিনিয়ারিং,	ইঞ্জিনিয়ারিং,	
somraatra,	সোমরাত্র,	সম্রাটরা,	
mulyabriddhikale,	মূল্যবৃদ্ধিকালে,	মূল্যবৃদ্ধিকালে,	
meghacchonno,	মেঘচ্ছঁন,	মেঘাচ্ছন্ন,	
oshtader,	অষ্টাদের,	ওস্তাদের,	
sweety,	স্বীতি,	সুইটি,	
jacksoner,	জ্যাকসনের,	জ্যাকসনের,	
pachchi,	পাচ্ছি,	পাচ্ছি,	
prothakey,	প্রথাকে,	প্রথাকে,	
konisttha,	কনিংস্থা,	কনিষ্ঠ,	
olympic,	অলিম্পিক,	অলিম্পিক,	
aashtikotaa,	আশ্টিকতাও,	আস্তিকতা,	
shlok,	শ্লোক,	শ্লোক,	
rajan,	রাজান,	রাজন,	
encidablu,	এনসিডাবুল,	এনসিডাব্লু,	
orthanitir,	অর্থানিতির,	অর্থনীতির,	
themeke,	থেমেকে,	থিমকে,	
gejetade,	গেজেটাদে,	গেজেটেড,	
matt,	ম্যাট,	ম্যাট,	
rudroke,	রুদ্রকে,	রুদ্রকে,	
shiter,	শিটের,	শীতের,	
latsaheb,	লততাাহেব,	লাটসাহেব,	
alaol,	আলাল,	আলাওল,	
title,	টিটলে,	টাইটেল,	
sharif,	শরীফ,	শরিফ,	
protizogiita,	প্রতিযোগীতা,	প্রতিযোগীতা,	
elakaate,	এলাকাতে,	এলাকাতে,	
manatmulak,	মানাতমূলক,	মানতমূলক,	
neemeetto,	নিমিত্ব,	নিমিত্ত,	
natshi,	নাতশি,	নাত্সি,	
dipti,	দিপ্তি,	ডেপুটি,	
ooporoshtho,	অপরস্থ,	উপরস্থ,	
protectionism,	প্রটটকশনিজম,	প্রোটেকশনিজম,	
bodna,	বোনা,	বদনা,	
dokaangulotey,	দোকানগুলোতে,	দোকানগুলোতে,	
mukhomandal,	মুখমান্দল,	মুখমণ্ডল,	
arg,	আর্গ,	আর্গ,	
aborto,	আবর্ত,	আবর্ত,	
kkomandar,	ক্কোমান্ডার,	কমাণ্ডার,	
shikara,	শিকারা,	শিকার,	
bhorkendra,	ভরকেন্দ্র,	ভরকেন্দ্র,	
pratisthanik,	প্রতিস্থানিক,	প্রাতিষ্ঠানিক,	
pooshteer,	পুষ্টির,	পুষ্টির,	
jomjamat,	জমজমাত,	জমজমাট,	
digreeke,	দিগ্রিকে,	ডিগ্রিকে,	
balaruma,	বালারুমা,	বলরুম,	
oncholsomuho,	অংশলমসহ,	অঞ্চলসমূহ,	
gonohotyakey,	গণহত্যাকে,	গণহত্যাকে,	
norfolk,	নরফক,	নরফোক,	
pouchute,	পৌছুতে,	পৌঁছুতে,	
magrey,	ম্যাগ্রে,	ম্যাগ্রে,	
chalochchitro,	চালচচিত্র,	চলচ্চিত্র,	
joisttho,	জয়স্থ,	জ্যৈষ্ঠ,	
uponishad,	উপনিশাদ,	উপনিষদ,	
poribahokotto,	পরিবাহকত্ব,	পরিবাহকত্ব,	
bboponer,	ব্বপনের,	বপনের,	
porbotmala,	পর্বতমালা,	পর্বতমালা,	
prodiiper,	প্রদিপের,	প্রদীপের,	
musabbirul,	মুসাব্বিরুল,	মুসাব্বিরুল,	
sures,	সুরেস,	সুরেশ,	
sausage,	সৌভাগে,	সসেজ,	
supparak,	সুপরাক,	সুপ্পারক,	
flux,	ফ্লাক্স,	ফ্লাস্ক,	
parinati,	পরিণাটি,	পরিণতি,	
avisongson,	অভিসংসন,	অভিশংসন,	
sardar,	সারদার,	সরদার,	
saazano,	সাজানো,	সাজানো,	
providere,	প্রভিদেরে,	প্রভাইডারে,	
shrichaitanyadev,	শ্রীচৈতান্দযবে,	শ্রীচৈতন্যদেব,	
ponchaashjon,	পঞ্চাশজন,	পঞ্চাশজন,	
varote,	ভারোতে,	ভারতে,	
oitijje,	ঐতিহ্যে,	ঐতিহ্যে,	
snehban,	স্নেহবান,	স্নেহবান,	
safin,	সাফিন,	সাফিন,	
nothivukta,	নথিভুক্ত,	নথিভুক্ত,	
sahittekder,	সাহিত্যেকদের,	সাহিত্যেকদের,	
saver,	সাভার,	সেভার,	
churger,	চার্গের,	চার্জের,	
felto,	ফেলতো,	ফেলত,	
udor,	উদোর,	উদর,	
ovidhaner,	অভিধানের,	অভিধানের,	
agomone,	আগোমোন,	আগমনে,	
mukhobondho,	মুখবন্ধ,	মুখবন্ধ,	
phox,	ফক্স,	ফক্স,	
ansarir,	আনসারীর,	আনসারীর,	
nagorikderkey,	নাগরিকদেরকে,	নাগরিকদেরকে,	
dojo,	দজজ,	ডোজো,	
informetion,	ইনফরমেশন,	ইনফরমেশন,	
nobotomo,	নবতম,	নবতম,	
ajibooner,	আজিবুনের,	আজীবনের,	
chinito,	চিনিত,	চিনতো,	
shamshernagar,	শমশেরনগর,	শমশেরনগর,	
songasthatike,	সঙ্গাষ্ঠীতিকে,	সংস্থাটিকে,	
superheiroo,	সুপারহিরিও,	সুপারহিরো,	
scholarship,	স্কলারশিপ,	স্কলারশিপ,	
kalkarkhana,	কলকারখানা,	কলকারখানা,	
jetam,	জেতাম,	যেতাম,	
brojomohun,	ব্রজোমহুন,	ব্রোজোমোহন,	
jatinke,	জাতিনকে,	যতীনকে,	
shaddhi,	শাদহি,	সাধ্বী,	
moddhyoshtho,	মধ্যস্থ,	মধ্যস্থ,	
mumtazer,	মুমতাজের,	মুমতাজের,	
dharavahik,	ধারাভাহিক,	ধারাবাহিক,	
tikta,	টিকটা,	তিক্ত,	
votar,	ভোটার,	ভোটার,	
telakucha,	তেলাকুচা,	তেলাকুচা,	
anisa,	আনিসা,	আনিস,	
shhow,	শো,	শো,	
unchuporjayer,	উঁচুপর্যায়ের,	উঁচুপর্যায়ের,	
ramolino,	র্মোলিনো,	রামোলিনো,	
lagche,	লাগছে,	লাগছে,	
brake,	ব্র্যাকে,	ব্রেক,	
shkalarashhipa,	স্কল্পরোষিত,	স্কলারশিপ,	
oisamoyer,	ঐসাময়ের,	ঐসময়ের,	
torutoler,	তরুতলের,	তরুতলের,	
ghumachhe,	ঘুমাচে,	ঘুমাচ্ছে,	
moonshi,	মুনশি,	মুন্সি,	
idyi,	আইডি,	আইডিই,	
eduardo,	এডুর়ার্ড,	এডুয়ার্দো,	
video,	ভিদেও,	ভিডিয়োও,	
hafej,	হাফেজ,	হাফেয,	
teemothy,	টেমথি,	টিমোথি,	
ujobekeestaner,	উজবেকিস্তানের,	উজবেকিস্তানের,	
jeher,	জেহের,	জেহের,	
naneer,	নানীর,	নানীর,	
aranyani,	অরণ্যনী,	অরণ্যানী,	
peethey,	পিঠে,	পীঠে,	
torkareer,	তর্কারীর,	তরকারীর,	
shingping,	শিংপিং,	শিংপিং,	
aaziz,	আজিজ,	আজিজ,	
mercial,	মার্সিয়াল,	মার্শিয়াল,	
prasadhoni,	প্রাাধনি,	প্রসাধনী,	
shniper,	শ্নিপের,	স্নাইপার,	
bajhyo,	বাঝ্য,	বাহ্য,	
gafeeloti,	গাফিলোটি,	গাফিলতি,	
chalochchitreer,	চলচ্চিত্রীর,	চলচ্চিত্রের,	
kajangale,	কাজঙ্গলে,	কজঙ্গলে,	
serveray,	সার্ভারে,	সার্ভারে,	
korimer,	করিমের,	করিমের,	
geejeeteeda,	গিজেটিদা,	গেজেটেড,	
awrbit,	আয়ারববিট,	অরবিট,	
pyetarna,	প্যারেন্ন,	প্যাটার্ন,	
kormoke,	কর্মকে,	কর্মকে,	
elakayi,	এলাকায়ি,	এলাকাই,	
rajdhani,	রাজধানী,	রাজধানি,	
cholochchitrer,	চলচ্চিত্রের,	চলচ্চিত্রের,	
chhuti,	ছুটি,	ছুটি,	
ekoghore,	একঘরে,	একঘরে,	
shikh,	শিখ,	শিখ,	
shanno,	শান্ন,	সান্নো,	
zibonnogor,	জীবনযোগর,	জীবননগর,	
conservetion,	কনজারভেশন,	কনসারভেশন,	
tahalo,	তাহালো,	তাহলো,	
digri,	দিগ্রি,	ডিগ্রি,	
monir,	মনির,	মনির,	
indrani,	ইন্দ্রাণী,	ইন্দ্রাণী,	
maner,	মানের,	মানে,	
khanabale,	খানাবালে,	খানাবলে,	
shiulijhra,	শিউলিঝরা,	শিউলিঝরা,	
byomkes,	ব্যামকোস,	ব্যোমকেশ,	
aamontrito,	আমন্ত্রিত,	আমন্ত্রিত,	
muchi,	মুচি,	মুচি,	
danaqana,	দননকা,	ডানকান,	
kanar,	কানার,	কণার,	
daakticketer,	ডাক্টিকেটের,	ডাকটিকিটের,	
ghoomachhilo,	ঘৌমাচিলো,	ঘুমাচ্ছিল,	
bibhinno,	বিভিন্ন,	বিভন্ন,	
drabyatah,	দ্রা্যতা,	দ্রব্যতঃ,	
kaathhmaandute,	কাঠমন্দুতে,	কাঠমান্ডুতে,	
akram,	আকরাম,	আকরাম,	
mojlish,	মজলিশ,	মজলিশ,	
rajotta,	রাজট্বা,	রাজত্ব,	
gotihin,	গতিহীন,	গতিহীন,	
courtcaser,	কোর্টক্সের,	কোর্টকেসের,	
recondishon,	রেকানডিশন,	রিকন্ডিশন,	
pratijogider,	প্রািযোগীদের,	প্রতিযোগীদের,	
kaferderke,	কাফেরদেরকে,	কাফেরদেরকে,	
ghurte,	ঘূরতে,	ঘুরতে,	
bihar,	বিহার,	বিহার,	
echhti,	এছটি,	এছটি,	
maladabha,	মালাদাভ,	মলদোভা,	
supplenza,	সাপেন্জ,	সাপলেঞ্জা,	
thandabhabe,	ঠান্ডাভাবে,	ঠাণ্ডাভাবে,	
kichutei,	কিছুতেই,	কিছুতেই,	
torabgonj,	তরববঞ্জ,	তোরাবগঞ্জ,	
deobonde,	দেওবন্দে,	দেওবন্দে,	
prosadhoni,	প্রসাধনী,	প্রসাধনী,	
kade,	কাদে,	কোড,	
pratisthanikvabe,	প্রতিস্থানিকভাবে,	প্রাতিষ্ঠানিকভাবে,	
kobulennechha,	কবুলেনছেছা,	কবুলেন্নেছা,	
deraa,	দেরা,	ডেরা,	
bharotchilo,	ভারতচিল,	ভারতছিল,	
kommandar,	কোমান্দার,	কমাণ্ডার,	
kormokarke,	কর্মকারকে,	কর্মকারকে,	
cheerokoomari,	চেরকুমারী,	চিরকুমারী,	
aajeej,	আজিজ,	আজিজ,	
louhojato,	লৌহজাত,	লৌহজাত,	
nabatamo,	নবতামো,	নবতম,	
ganesh,	গনেশ,	গণেশ,	
cholochchitratike,	চলচ্চিত্রটিকে,	চলচ্চিত্রটিকে,	
beshyasdone,	বেশ্যাসদনে,	বেশ্যাসদনে,	
teman,	তেমান,	তেমন,	
pakistanira,	পাকিস্তানিরা,	পাকিস্তানীরা,	
fansi,	ফানসি,	ফাঁসী,	
sumita,	সুমিতা,	সুমিতা,	
mandanda,	মনন্দদ,	মানদণ্ড,	
aporishodhito,	অপরিষদিত,	অপরিশোধিত,	
nottee,	নত্তি,	নোটটি,	
eekbalke,	ইকবলকে,	ইকবালকে,	
tennys,	টেনিস,	টেনিস,	
turbiner,	টারবিনের,	টারবাইনের,	
yucalyptus,	য়ুকালিপটাস,	ইউক্যালিপ্টাস,	
jipiusamriddha,	জিপিউরসমৃদ্ধ,	জিপিউসমৃদ্ধ,	
sompadonkaree,	সম্পাদককারী,	সম্পাদনকারী,	
station,	স্টেশন,	ষ্টেশন,	
monzooshree,	মন্ুভ্রী,	মঞ্জুশ্রী,	
shommoteer,	সম্মতির,	সম্মতির,	
nibondhocheler,	নিবন্ধচেলের,	নিবন্ধছেলের,	
shorifer,	শরীফের,	শরিফের,	
aviyojan,	অভিযোজন,	অভিযোজন,	
jaruri,	জারুরি,	জরূরী,	
heteler,	হেটেলের,	হেটেলের,	
manushgulor,	মানুষগুলোর,	মানুষগুলোর,	
ansareer,	আনসারীর,	আনসারীর,	
zerusaleme,	জুরুসালেমে,	জেরুসালেমে,	
jyesttha,	জ্যেষ্ঠা,	জ্যেষ্ঠা,	
khalidkay,	খালিদকায়,	খালিদকে,	
abanishankar,	অবনিশঙ্কর,	অবনিশংকর,	
moushumei,	মৌশুমেই,	মৌসুমেই,	
anubhutimalar,	অনুভূতিমূলার,	অনুভূতিমালার,	
chhaikalo,	ছাইকালো,	ছাইকালো,	
simons,	সিমনস,	সিমন্স,	
townshhip,	টাউনশিপ,	টাউনশিপ,	
shrabastee,	শ্রাবস্তী,	শ্রাবস্তী,	
paroner,	পারণের,	পারণের,	
ashanka,	আশানকা,	আশংকা,	
sausagee,	সৌভাগী,	সসেজ,	
doobate,	দুবাতে,	ডুবাতে,	
naitikatavodh,	নৈতিকতাবাধ,	নৈতিকতাবোধ,	
bokul,	বকুল,	বকুল,	
itastata,	ইটস্তাটা,	ইতস্তত,	
bodhirta,	বোধিরটা,	বধিরতা,	
michhilti,	মিছিলটি,	মিছিলটি,	
onchalti,	অংচলটি,	অঞ্চলটি,	
masjidsaho,	মাজদিসসহ,	মসজিদসহ,	
ghurechen,	ঘুরেছেন,	ঘুরেছেন,	
arasie,	আরাসি,	আরসিএ,	
residence,	রেসিডেন্স,	রেসিডেন্স,	
bhangchur,	ভাংচুর,	ভাংচুর,	
chilona,	চিলোনা,	ছিলনা,	
bikretara,	বিক্রেতারা,	বিক্রেতারা,	
mmadhuri,	ম্যামধধারী,	মাধুরী,	
tukroti,	টুকরতি,	টুকরোটি,	
edseler,	এডসেলের,	এডসেলের,	
maunchostho,	মঞ্চস্থ,	মঞ্চস্থ,	
meloonborroner,	মেলুনবর্ণনের,	মেলবোর্নের,	
huka,	হুকা,	হুক,	
drissoke,	দৃশকে,	দৃশ্যকে,	
utpotti,	উৎপট্টি,	উতপত্তি,	
asamorik,	আসামরিক,	অসামরিক,	
bhogiroth,	ভগিরোথ,	ভগীরথ,	
plate,	প্লেট,	প্লেট,	
dai,	ডেই,	দিই,	
bokahoke,	বকাহকে,	বকাহকে,	
ebhara,	এভারা,	এভার,	
gobeshakgon,	গবেষাকগণ,	গবেষকগণ,	
heart,	হার্ট,	হার্ট,	
icelands,	আইসেল্যান্ডস,	আইসল্যান্ডসহ,	
sinaake,	সিনাকে,	সিনাকে,	
soommita,	সুমিি,	সুমিতা,	
backflipe,	ব্যাকফ্ল্পে,	ব্যাকফ্লিপে,	
sompadon,	সম্পাদন,	সম্পাদন,	
crucer,	ক্রুকের,	ক্রুশের,	
acrolect,	অক্রোলেক্ট,	অ্যাক্রোলেক্ট,	
tinage,	টিনাজ,	টিনেজ,	
ramantika,	রমণতিকা,	রোমান্টিক,	
shishu,	শিশু,	শিশু,	
dhojovongo,	ধ্বজংসহ,	ধ্বজভঙ্গ,	
bhumija,	ভূমিজা,	ভূমিজ,	
bouddher,	বৌদ্ধের,	বৌদ্ধের,	
doula,	দৌলা,	দৌলা,	
bolatkar,	বলাটকর,	বলাৎকার,	
chhutochhuti,	ছুটোছুটি,	ছুটোছুটি,	
bandi,	বন্দী,	বন্দী,	
vaphara,	ভাফারা,	বাফার,	
dhanyi,	ধন্যী,	ধন্যি,	
mukharji,	মুখর্জি,	মুখার্জী,	
duple,	ডুপলে,	ডুপ্লে,	
shasheja,	শাষেজা,	সসেজ,	
aaireshe,	আয়েরেশে,	আইরেসে,	
prasadhani,	প্রসাধনি,	প্রসাধনী,	
manohputa,	মনোহপুতা,	মনঃপুত,	
jokkher,	যক্ষের,	যক্ষের,	
bim,	বিআইএম,	বিম,	
kartona,	কারতোনা,	করতনা,	
welcome,	ওয়ালকম,	ওয়েলকাম,	
spredasita,	স্প্রেডাসিটা,	স্প্রেডশীট,	
valobasen,	ভালোবাসেন,	ভালোবাসেন,	
tophaat,	তোফাত,	তফাৎ,	
cholocchitrer,	চলচ্চিত্রের,	চলচ্চিত্রের,	
mozdoor,	মজদুর,	মজদুর,	
gavaskar,	গাভাসকার,	গাভাস্কার,	
majdur,	মজদুর,	মজদুর,	
plak,	প্লাক,	প্ল্যাক,	
bonsho,	বংশ,	বংশ,	
bisheshya,	বিশেষ্যা,	বিশেষ্য,	
chahidapotrer,	চাহিদাপত্রের,	চাহিদাপত্রের,	
shudden,	শুদ্দেন,	সাডেন,	
bupher,	বুফার,	বাফার,	
taderek,	তাদেরেক,	তাদেরেক,	
saraiki,	সারাইকি,	সরাইকি,	
vaticaner,	ভ্যাটিকানের,	ভ্যাটিকানের,	
veenis,	ভেনিস,	ভেনিস,	
taap,	টাঁপ,	ট্যাপ,	
salphat,	সালফাট,	সালফেট,	
patishapta,	পািশপটপ,	পাটিসাপটা,	
panchashjan,	পঞ্চাশজান,	পঞ্চাশজন,	
palteche,	পালতেছে,	পাল্টেছে,	
byaktikegreptar,	ব্যক্তিফেতপ্রতের,	ব্যক্তিকেগ্রেপ্তার,	
karore,	কারোর,	কারোর,	
ukeliptash,	উকেলিপ্তাশ,	ইউক্যালিপ্টাস,	
vobani,	ভবানী,	ভবানী,	
padee,	পাদে,	পাড়ে,	
chandanara,	চন্দনারা,	চন্দনারা,	
bohudin,	বহুদিন,	বহুদিন,	
ixprission,	এক্সপ্রিশন,	এক্সপ্রেশন,	
bane,	বনে,	বনে,	
choson,	চসন,	চোষণ,	
hertj,	হার্টজ,	হার্জ,	
dosha,	দশা,	দোসা,	
haitasha,	হাইতাশা,	হাইটস,	
asovarno,	অসোভার্ন,	অসবর্ণ,	
saqara,	সাকারা,	সকার,	
nathibhuktir,	নথিভুক্তির,	নথিভুক্তির,	
hijri,	হিজরি,	হিজরী,	
bhabanir,	ভবনীর,	ভবানীর,	
chhooti,	ছুটি,	ছুটি,	
ahmed,	আহমেদ,	আহামদ,	
goshthiti,	গোষ্ঠিতি,	গোষ্ঠীটি,	
rejidens,	রেজিডেনস,	রেসিডেন্স,	
stoic,	স্টোইক,	স্টোয়িক,	
besirvagei,	বেসিরভাগেই,	বেশিরভাগেই,	
siit,	শিত,	শীত,	
nyeta,	নায়াট,	ম্যাট,	
omarader,	ওমারাদের,	ওমারাদের,	
bhaisaho,	ভৈইসহ,	ভাইসহ,	
kyathlik,	ক্যাচলিক,	ক্যাথলিক,	
manbe,	মানবে,	মানবে,	
korley,	করলে,	করলে,	
heerani,	হিরানী,	হিরানি,	
mokhmoley,	মোখমলে,	মখমলে,	
teunar,	টেউনার,	টিউনার,	
ardasha,	আর্দশ,	আর্দশ,	
eenameela,	ইনামিলা,	এনামেল,	
mitrata,	মিত্রাটা,	মিত্রতা,	
highcomissione,	হাইকোিমসনে,	হাইকমিশনে,	
maila,	মেলা,	মাইল,	
ghuznavi,	ঘুজনাভি,	গজনভি,	
ponchaasjon,	পঞ্চাসজন,	পঞ্চাশজন,	
behrampurer,	বেহরামপুরের,	বহরমপুরের,	
karuna,	করুনা,	করুণা,	
chalachchitroi,	চলচ্চিত্রই,	চলচ্চিত্রই,	
photanor,	ফোটানোর,	ফোটানোর,	
shoreefpur,	শরীফপুর,	শরিফপুর,	
kathghera,	কাঠেঘরা,	কাঠঘেরা,	
sadeena,	সাদেন,	সাডেন,	
dibi,	দিবি,	দিবি,	
duio,	দুয়ো,	দুইও,	
hames,	হ্যামেস,	হোমস,	
durotamo,	দূরতামো,	দূরতম,	
vaabnake,	ভাবনাকে,	ভাবনাকে,	
samratra,	সামরত্র,	সম্রাটরা,	
tolemy,	টোলেমি,	টলেমির,	
jeshtha,	জেশথা,	জ্যেষ্ঠা,	
doneta,	ডোনেটা,	ডোনাট,	
kormokarer,	কর্মকারের,	কর্মকারের,	
conflict,	কনফ্লিক্ট,	কনফ্লিক্ট,	
standards,	স্ট্যান্ডার্ডসহ,	স্টান্ডার্ডস,	
nirmalata,	নির্মলতা,	নির্মলতা,	
kindom,	কিন্দম,	কিংডম,	
emarjenshi,	এমরজেনশি,	এমার্জেন্সি,	
harishankar,	হরিশঙ্কর,	হরিশংকর,	
goonoman,	গুণামন,	গুণমান,	
antorvuktimulak,	আন্তর্ুুক্তিগালক,	অন্তর্ভুক্তিমূলক,	
angsogrohone,	অংসগ্রহণে,	অংশগ্রহনের,	
chet,	চেট,	চ্যাট,	
rajpur,	রাজপুর,	রাজপুর,	
bhenom,	ভেনম,	ভেনম,	
ishtone,	ইস্তনে,	স্টোন,	
udbhaboni,	উদ্ভাবনী,	উদ্ভাবনী,	
shucharita,	শুচারিত,	সুচরিতা,	
sahinsatar,	সহিনসাতার,	সহিংসতার,	
epiela,	এপিলা,	আইপিএল,	
mirakela,	মিরাকেল,	মিরাকেল,	
khorsed,	খোর্সড,	খোরশেদ,	
tetela,	টেটেলা,	টাইটেল,	
jonesh,	জনেশ,	জোন্স,	
purbanchaler,	পূর্বাঞ্চলের,	পূর্বাঞ্চলের,	
paadee,	পাদে,	পাড়ে,	
aansaareer,	আনসারীর,	আনসারীর,	
kortam,	কর্তাম,	করতাম,	
manjushree,	মঞ্জুশ্রী,	মঞ্জুশ্রী,	
aqram,	আকরাম,	আকরাম,	
sookumari,	সুকুমারী,	সুকুমারী,	
shekender,	শেকেন্দের,	সেকেন্ডের,	
dipgulote,	ডিপগুলোতে,	দ্বীপগুলোতে,	
seqtara,	সেকটারা,	সেক্টর,	
soketgulor,	সকেটগুলোর,	সকেটগুলোর,	
lakshmir,	লক্ষ্মীর,	লক্ষ্মীর,	
suiza,	সুইজা,	সুইজা,	
romancha,	রোমাঞ্চ,	রোমাঞ্চ,	
adhunikkale,	আধুনিককালে,	আধুনিককালে,	
akten,	আকতেন,	অকটেন,	
shtonehenge,	শ্তনেঘে,	স্টোনহেঞ্জ,	
kash,	কাশ,	কাস,	
robot,	রোবোট,	রোবোট,	
aakaabaar,	আকাবার,	আকাবার,	
sikkhakbrinda,	শিক্ষাবকৃন্দ,	শিক্ষকবৃন্দ,	
pancbaar,	প্যান্সবার,	পাঁচবার,	
balakarak,	বালাকারাক,	বলকারক,	
milton,	মিলটন,	মিলটন,	
kompeeto,	কমিপিটো,	কম্পিত,	
spenser,	স্পেন্সের,	স্পেন্সার,	
vabaponno,	ভাবাপন্ন,	ভাবাপন্ন,	
toroonraa,	তরুনরা,	তরুণরা,	
popaike,	পপাইকে,	পপাইকে,	
foks,	ফকস,	ফক্স,	
accountdharira,	অ্যাকাউন্টধারীরা,	একাউন্টধারীরা,	
horidwar,	হরিদ্বার,	হরিদ্বার,	
bhenus,	ভেনুস,	ভেনাস,	
bonke,	বনকে,	বনকে,	
ingrezeeteo,	ইংরেজিতেও,	ইংরেজিতেও,	
shitei,	শিটেই,	শীতেই,	
deciliter,	ডিসিলিটের,	ডেসিলিটার,	
mukhomondoler,	মুখমণ্ডলের,	মুখমণ্ডলের,	
prokalpagulo,	প্রকালপাগুলো,	প্রকল্পগুলো,	
jotsna,	জোটসনা,	জ্যোৎস্না,	
duuma,	ডুমা,	দুমা,	
toki,	তোকি,	তকি,	
baipash,	বাইপাশ,	বাইপাস,	
deep,	দীপ,	দীপ,	
reshidensha,	রেশিদেনশা,	রেসিডেন্স,	
naabbota,	নাব্যতা,	নাব্যতা,	
manjushri,	মঞ্জুষ্রি,	মঞ্জুশ্রী,	
shangkalonti,	সংকলন্তী,	সংকলনটি,	
ikbaaler,	ইকবালের,	ইকবালের,	
ganosachetanata,	গণসচেনতা,	গণসচেতনতা,	
durgotsab,	দুর্গোৎসব,	দুর্গোৎসব,	
barack,	বারাক,	বারাক,	
tahorir,	তাহরীর,	তাহরীর,	
gronthao,	গ্রন্থাও,	গ্রন্থও,	
antarvuktimulak,	অন্তর্ভুক্তিমূলক,	অন্তর্ভুক্তিমূলক,	
gratha,	গ্রাথা,	গ্রোথ,	
rajbandi,	রাজবন্দী,	রাজবন্দী,	
bisheshyo,	বিশেষ্য,	বিশেষ্য,	
gaje,	গাজে,	গেজ,	
benojir,	বেনোজির,	বেনজীর,	
railliner,	রেললিনের,	রেললাইনের,	
wrighter,	ঋর্ঘটের,	রাইটের,	
sthaponagulo,	স্থাপনাগুলো,	স্থাপনাগুলো,	
qarpeta,	কারপেটা,	কার্পেট,	
ghumunoi,	ঘুমুনোই,	ঘুমুনোই,	
jhalkanite,	ঝালকানিতে,	ঝলকানীতে,	
haris,	হারিস,	হ্যারিস,	
sikkharthirao,	শিক্ষার্থীরাও,	শিক্ষার্থীরাও,	
uddhrito,	উদ্ধৃত,	উদ্ধৃত,	
thare,	থারে,	থরে,	
zoojyota,	যোজ্যতা,	যোজ্যতা,	
aniyantrita,	অনিয়ন্ত্রিত,	অনিয়ন্ত্রিত,	
bhyaatikaner,	ভ্যাটিকানের,	ভ্যাটিকানের,	
vortuki,	ভর্তুকি,	ভর্তুকি,	
shangsthaner,	সাংস্থানের,	সংস্থানের,	
naajii,	নাজী,	নাত্সি,	
probeshan,	প্রবেশন,	প্রবেশন,	
shrabosty,	শ্রাবস্তি,	শ্রাবস্তী,	
vorkendra,	ভরকেন্দ্রের,	ভরকেন্দ্র,	
croak,	ক্রোক,	ক্রোক,	
adhikartai,	অধিকারটাই,	অধিকর্তাই,	
casper,	ক্যাসপার,	ক্যাসপার,	
ghenshei,	ঘেঁশেই,	ঘেঁষেই,	
amiretus,	আমিরেতুস,	এমিরেটাস,	
sheshardhe,	শেষার্ধে,	শেষার্ধে,	
surke,	সুরকে,	সুরকে,	
selim,	সেলিম,	সেলিম,	
yatharthabhabe,	যথার্থভাবে,	যথার্থভাবে,	
sheepha,	শীফা,	শেফ,	
shringey,	শ্রিংগে,	শৃঙ্গে,	
deilee,	দেইলি,	ডেইলি,	
lidars,	লিডার্স,	লিডার্স,	
cantan,	ক্যান্টান,	ক্যান্টন,	
suchanakal,	সুচানাকাল,	সূচনাকাল,	
jatotaa,	জাতোতা,	যতোটা,	
mulyayonsapekkhe,	মূল্যয়েন্পক্ষে,	মূল্যায়নসাপেক্ষে,	
showtey,	শুটে,	শোতে,	
shef,	শেফ,	শেফ,	
mah,	মাহ,	মাহে,	
shringge,	শ্রিংগে,	শৃঙ্গে,	
hilser,	হিলসের,	হিলসের,	
krus,	ক্রুস,	ক্রুশ,	
tecno,	টেকনো,	টেকনো,	
konroop,	কননরূপ,	কোনরূপ,	
klaud,	ক্লাউড,	ক্লাউড,	
kourabe,	কৌরাবে,	কৌরবে,	
bhotomulyoke,	ভোটমূল্যকে,	ভোটমূল্যকে,	
nibeditar,	নিবেদিতার,	নিবেদিতার,	
kingsh,	কিংশ,	কিংস,	
pranibigyani,	প্রাণীবিজ্ঞানী,	প্রাণীবিজ্ঞানী,	
choddo,	চদ্ড,	চোদ্দো,	
sabrakamer,	সব্রকমের,	সবরকমের,	
ghaghat,	ঘাঘাট,	ঘাঘট,	
veenish,	ভিনিশ,	ভেনিস,	
ekghare,	একঘরে,	একঘরে,	
hoteltite,	হোটেলটিতে,	হোটেলটিতে,	
gronthowo,	গ্রন্থস,	গ্রন্থও,	
narsinghomgulor,	নার্সিংহগুলোর,	নার্সিংহোমগুলোর,	
artore,	আরতোরে,	আর্টরে,	
aashanka,	আশঙ্কা,	আশংকা,	
impaction,	ইম্্যাপশন,	ইমপ্যাকশন,	
elaaka,	এলাকা,	এলাকা,	
nirabota,	নিরাবতা,	নিরবতা,	
shektor,	শেক্তর,	সেক্টর,	
chirantan,	চিরান্তন,	চিরন্তন,	
jaanachhe,	যানাচে,	জানাচ্ছে,	
hastantar,	হস্তান্তর,	হস্তান্তর,	
aamoode,	আমুদে,	আমুদে,	
domonmulok,	ডোমন্মুলক,	দমনমূলক,	
marodeho,	মারোদহ,	মরদেহ,	
shithilata,	শিথিলতা,	শিথিলতা,	
ritesh,	রিটেশ,	রিতেশ,	
prosadhani,	প্রসাধানি,	প্রসাধনী,	
kyatgarite,	ক্যাটগারিতে,	ক্যাটগারিতে,	
rubidiyaam,	রুবিদিয়াম,	রুবিডিয়াম,	
dip,	ডিপ,	দীপ,	
gejeted,	জেজেটেড,	গেজেটেড,	
chotogolper,	চটটগল্পের,	ছোটগল্পের,	
kleentoner,	ক্লিন্তনের,	ক্লিনটনের,	
kathla,	কথলা,	কাঠলা,	
agomoney,	অগোমোনি,	আগমনে,	
moshahidur,	মশাহিদুর,	মোশাহিদুর,	
erajyobasi,	এরজ্যাবাসী,	এরাজ্যবাসী,	
fongli,	ফংলি,	ফংলি,	
grambaashio,	গ্রামবাশীও,	গ্রামবাসীও,	
besirbhaagi,	বেসিরভাগী,	বেশিরভাগই,	
somsher,	সম্শের,	সমশের,	
chiraharit,	চিরাহারিত,	চিরহরিৎ,	
khude,	খুদে,	ক্ষুদে,	
vromonkaley,	ভ্রমণকালে,	ভ্রমণকালে,	
ispreedshiit,	ইস্প্রিদশিত,	স্প্রেডশীট,	
guzober,	গুজোবের,	গুজবের,	
concerter,	কনসার্টার,	কানসাটের,	
tyapa,	ত্যাপা,	ট্যাপ,	
madhoori,	মধুরি,	মাধুরী,	
malinga,	মালিঙ্গা,	মালিংগা,	
xpose,	ক্সকসে,	এক্সপোজ,	
transformaarer,	ট্রান্সফর্মারের,	ট্রান্সফরমারের,	
tintir,	তিনটির,	তিনটির,	
helloin,	হেলওয়েন,	হ্যালোইন,	
planey,	প্ল্যানে,	প্লেনে,	
toching,	টচচিং,	টোচিং,	
dhonni,	ধন্নি,	ধন্যি,	
quartar,	কোয়ার্ার,	কোয়ার্টার,	
kagbeni,	কাগবেনি,	কাগবেনি,	
bisshas,	বিশ্বাস,	বিশ্বাস,	
nirgoon,	নিরগুণ,	নির্গুণ,	
byapoktor,	ব্যাপক্তর,	ব্যাপকতর,	
cheenja,	চিনজা,	চেঞ্জ,	
soteciety,	সোটেসিটি,	সোসাইটিতে,	
nothibhukto,	নথিভুক্ত,	নথিভুক্ত,	
madrasake,	মাদ্রাসাকে,	মাদ্রাসাকে,	
bastubad,	বস্তুবাদ,	বস্তুবাদ,	
pravura,	প্রবুরা,	প্রভুরা,	
suporichita,	সুপরিচিতি,	সুপরিচিত,	
khabarsoho,	খাবারসহ,	খাবারসহ,	
sommotitey,	সম্মতিতে,	সম্মতিতে,	
akai,	আকাই,	একাই,	
sambatsarkal,	সম্বতসরকাল,	সম্বৎসরকাল,	
sahab,	সাহাব,	সাহাব,	
bosben,	বসবেন,	বসবেন,	
baasaate,	বাসাতে,	বাসাতে,	
chhatrodiger,	ছাত্রদিগের,	ছাত্রদিগের,	
chaaktir,	চাক্তির,	চাকতির,	
manibhaijaner,	মণিভাজনের,	মণিভাইজানের,	
mozdur,	মজদুর,	মজদুর,	
proshtotto,	প্রশ্তত্ব,	প্রস্ত্তত,	
dimbacriti,	ডিম্বাক্রিটি,	ডিম্বাকৃতি,	
moomtaj,	মুমতাজ,	মুমতাজ,	
chargar,	চার্গার,	চার্জার,	
turbine,	টারবিন,	টারবাইন,	
kamla,	কামলা,	কামলা,	
karaponner,	কারাপণ্যের,	কারাপণ্যের,	
ceramiker,	সেরামিকের,	সিরামিকের,	
choudhurike,	চৌধুরীকে,	চৌধুরীকে,	
jini,	জিনি,	যিনি,	
sumeeta,	সুমিতা,	সুমিতা,	
khudrokar,	ক্ষুদ্রকার,	ক্ষুদ্রকার,	
soheensotar,	সহহেনসতার,	সহিংসতার,	
rinobodh,	ঋণবোধ,	ঋণবোধ,	
ebham,	এভাম,	ইভিএম,	
steeit,	স্টিট,	স্টেইট,	
taufiq,	তাফিক,	তৌফিক,	
goteehin,	গতিহীন,	গতিহীন,	
logotype,	লোগেপিতে,	লোগোটাইপ,	
remission,	রিমিসন,	রিমিশন,	
horash,	হোরাশ,	হোরাস,	
dorneca,	ডর্নেকা,	ডরনেকা,	
spredsheet,	স্প্রেডশিট,	স্প্রেডশীট,	
prangulo,	প্রাণগুলো,	প্রানগুলো,	
mathieu,	মাথিউ,	ম্যাথিউ,	
baibosthar,	বৈবস্থার,	ব্যবস্থার,	
cheerontan,	চেরোন্তান,	চিরন্তন,	
agamane,	আগামানে,	আগমনে,	
satjaner,	সাতজানের,	সাতজনের,	
laesens,	লেইসেন্স,	লাইসেন্স,	
promodwara,	প্রমোদবরা,	প্রমদ্বারা,	
barrageke,	ব্যারাজেকে,	ব্যারেজকে,	
thailandshoho,	থাইলান্ডসহ,	থাইল্যান্ডসহ,	
sangharshik,	সংঘর্ষিক,	সাংঘর্ষিক,	
dharmadasbabu,	ধর্মদাসবাবু,	ধর্মদাসবাবু,	
ghumacchilo,	ঘুমাচ্ছিল,	ঘুমাচ্ছিল,	
batsmanei,	ব্যাটসমেনেই,	ব্যাটসম্যানই,	
fooloo,	ফুলু,	পোলো,	
lat,	ল্ত,	লাট,	
suhayeler,	সুহায়েলের,	সুহায়েলের,	
prachirer,	প্রাচীরের,	প্রাচিরের,	
vaisoho,	ভাইসহ,	ভাইসহ,	
europia,	ইউরোপিয়া,	ইউরোপিয়া,	
arke,	আরকে,	আরকে,	
cs,	সিএস,	সিএস,	
sahooseekotar,	সহহুকতির,	সাহসিকতার,	
bhikkharthe,	ভিক্ষার্থে,	ভিক্ষার্থে,	
rupantarer,	রূপান্তরের,	রুপান্তরের,	
biswashi,	বিশ্বাশী,	বিশ্বাসী,	
pratiyogitar,	প্রতিযোগিতার,	প্রতিযোগীতার,	
degreeo,	ডিগ্রিও,	ডিগ্রিও,	
nadike,	নাদিকে,	নদীকে,	
rahee,	রহহি,	রাহী,	
yathaarthabhaabe,	যথাার্থভাবে,	যথার্থভাবে,	
transform,	ট্রান্সফর্ম,	ট্রান্সফর্ম,	
zeeland,	জিল্যান্ড,	জিল্যান্ড,	
bhramapraban,	ভ্রমপ্রবণ,	ভ্রমপ্রবণ,	
bhaangchur,	ভাংচুর,	ভাংচুর,	
titarer,	টিতারের,	তিতারের,	
browser,	ব্রজসের,	ব্রাউজার,	
chai,	চেই,	ছাই,	
tuni,	তুনি,	টুনি,	
nothibhukta,	নথিভুক্ত,	নথিভুক্ত,	
bagdad,	বাগদাদ,	বাগদাদে,	
ekbakke,	একবাককে,	একবাক্যে,	
morathee,	মরাঠী,	মরাঠি,	
uthhaane,	উঠানে,	উঠানে,	
shector,	শেক্টর,	সেক্টর,	
purbancoler,	পূর্বানকোলের,	পূর্বাঞ্চলের,	
nomo,	নমমো,	নমো,	
valobase,	ভালোবাসে,	ভালোবাসে,	
ongkush,	অংকুশ,	অংকুশ,	
yaak,	যাক,	ইয়াক,	
fulkapi,	ফুলকাপি,	ফুলকপি,	
poroborti,	পরবর্তী,	পরর্বতী,	
shite,	শিটে,	শীতে,	
mishal,	মিশাল,	মিশাল,	
gloria,	গ্লোরিয়া,	গ্লোরিয়া,	
alaoler,	আলালের,	আলাওলের,	
sangbadmadhyomgulote,	সংবাদমাধ্যমগুলোতে,	সংবাদমাধ্যমগুলোতে,	
nirvachokder,	নির্ভাচকদের,	নির্বাচকদের,	
chheher,	ছেহের,	ছেহের,	
torunosomriddho,	তরুণসমৃদ্ধ,	তরুণসমৃদ্ধ,	
shrimoti,	শ্রীমতি,	শ্রীমতি,	
jerusalema,	জেরুসালেমা,	জেরুসালেম,	
manush,	মানুশ,	মানুষ,	
alexanderke,	আলেক্সাান্ডারকে,	আলেকজান্ডারকে,	
siddhanter,	সিদ্ধান্তের,	সিদ্ধান্তের,	
arashie,	আরাশীয়,	আরসিএ,	
badaghat,	বাদাঘাট,	বাদাঘাট,	
adbhanced,	অ্যাডভান্ডে,	অ্যাডভান্সড,	
hijrite,	হিজরিতে,	হিজরীতে,	
faaj,	ফাজ,	ফাজ,	
samoshtigato,	সামষ্টিগত,	সমষ্টিগত,	
monchostho,	মঞ্চস্থ,	মঞ্চস্থ,	
goolen,	গুলেন,	গুলেন,	
magical,	ম্যাজিক্যাল,	ম্যাজিকাল,	
mathews,	ম্যাথেবস,	ম্যাথিউস,	
bahubar,	বহুবার,	বহুবার,	
assaciates,	অ্যাসাসিয়েটস,	এসোসিয়েটস,	
jatinkey,	জাতিনকে,	যতীনকে,	
salapheeta,	সালাফিত,	সালফেট,	
aswasteekor,	অস্বাস্তিকর,	অস্বস্তিকর,	
kaalki,	কালকি,	কালকি,	
damakalkarmirao,	দমকলকর্মীরাও,	দমকলকর্মীরাও,	
rudiger,	রুদিগের,	রুদিগের,	
saria,	সারিয়া,	সরিয়া,	
boshoborty,	বশবর্তি,	বশবর্তী,	
parking,	পারকিং,	পার্কিং,	
abeganuvutir,	আবেগানুভূতির,	আবেগানুভূতির,	
kuresher,	কুরেশের,	কুরেশের,	
bhromoner,	ভ্রমণের,	ভ্রমণের,	
manushera,	মানুষেরা,	মানুষেরা,	
kode,	কোড,	কোড,	
byabosthar,	ব্যবস্থার,	ব্যাবস্থার,	
bhabatarini,	ভবতররিণী,	ভবতারিণী,	
shulfate,	শুলফাতে,	সালফেট,	
sohojlovyotar,	সহজ্লবহতয়তার,	সহজলভ্যতার,	
korush,	করুশ,	ক্রুশ,	
lagchhe,	লাগছে,	লাগছে,	
kaash,	কাশ,	কাস,	
manabmaner,	মানবমানের,	মানবমনের,	
rezidence,	রিজিডেন্সে,	রেসিডেন্স,	
sarder,	সারদের,	সরদার,	
nischoy,	নিশ্চয়,	নিশ্চয়,	
byaboharkarie,	ব্যবহারকারী,	ব্যবহারকারীই,	
erokomer,	এরকমের,	এরকমের,	
horiddare,	হরিদ্দারে,	হরিদ্বারে,	
codeti,	কোডেটি,	কোডটি,	
tolemyr,	টোলেমির,	টলেমির,	
weelcomee,	বাইলকমি,	ওয়েলকাম,	
juktarashtrasaha,	যুক্তরাষ্টারসহ,	যুক্তরাষ্ট্রসহ,	
kanuner,	কানুনের,	কানুনের,	
beem,	বীইএম,	বিম,	
labonaaktotaar,	লাবণাক্ততার,	লবণাক্ততার,	
addata,	আদ্দাতা,	আড্ডাটা,	
chrystal,	ক্রিস্টাল,	ক্রাইস্টাল,	
hindutirtha,	হিন্দুতীর্থ,	হিন্দুতীর্থ,	
fud,	ফুড,	ফুড,	
bidyadanke,	বিদ্যাদানকে,	বিদ্যাদানকে,	
bbiswash,	বিব্বাসভাস,	বিশ্বাস,	
safiha,	সাফিহা,	সাফিহা,	
koyekbare,	কয়েকবারে,	কয়েকবারে,	
laagche,	লাগছে,	লাগছে,	
parishram,	পরিশ্রম,	পরিশ্রম,	
madhukori,	মধুকরী,	মাধুকরী,	
shfingtar,	সিফিটটার,	স্ফিংটার,	
bondishalatei,	বন্দিশালাতেই,	বন্দিশালাতেই,	
siddhantoke,	সিদ্ধান্তকে,	সিদ্ধান্তকে,	
groundta,	গ্রুন্ডটা,	গ্রাউন্ডটা,	
qulim,	কুলিম,	কুলিং,	
kaalengaa,	কালেঙ্গা,	কালেঙ্গা,	
dokanei,	দোকানেই,	দোকানেই,	
jalarong,	জালারাং,	জলরঙ,	
manushsoho,	মানুষসহ,	মানুষসহ,	
proteemake,	প্রতিমাকে,	প্রতিমাকে,	
akpaase,	আকপাসে,	একপাশে,	
colgirl,	কলারিল,	কলগার্ল,	
khoor,	খুর,	ক্ষুর,	
keyboarder,	কেববর্ডের,	কীবোর্ডের,	
jins,	জিন্স,	জিন্স,	
teestar,	তেস্টার,	তিস্তার,	
crashlands,	ক্র্যাশল্যান্ডস,	ক্র্যাশল্যান্ডস,	
uparjoner,	উপার্জনের,	উপার্জনের,	
anyarup,	অন্যাূপ,	অন্যরূপ,	
marathi,	মারাঠি,	মরাঠি,	
lendl,	লেন্ডল,	লেন্ডল,	
cholochchitrai,	চলচ্চিত্রই,	চলচ্চিত্রই,	
enjineers,	এঞজাইনির্স,	ইঞ্জিনিয়ার্স,	
abhidhaner,	অভিধানের,	অভিধানের,	
sontoshpur,	সন্তোশপুর,	সন্তোষপুর,	
chakti,	চাকতি,	চাকতি,	
assexe,	অ্যাসেক্সে,	অ্যাসেক্সে,	
oncolsoho,	অনকললসহ,	অঞ্চলসহ,	
uporitoler,	উপরিতলের,	উপরিতলের,	
jolrong,	জলরোং,	জলরঙ,	
byabaharkaree,	ব্যবহারকারী,	ব্যবহারকারী,	
prokolpoti,	প্রকল্পটি,	প্রকল্পটি,	
stonehenje,	স্তোনেহাজে,	স্টোনহেঞ্জ,	
azimpur,	আজিমপুর,	আজিমপুর,	
ranangone,	রানাঙ্গনে,	রণাঙ্গনে,	
lutharan,	লুথারান,	লুথেরান,	
thaanobhi,	থানোভি,	থানভী,	
chalachchitroke,	চালাচ্চিত্রকে,	চলচ্চিত্রকে,	
manober,	মানবের,	মানবের,	
dooburira,	ডুবুরিরা,	ডুবুরিরা,	
elaakate,	এলাকাটে,	এলাকাতে,	
bite,	বিতে,	বাইট,	
sangsakti,	সাংসক্তি,	সংসক্তি,	
ajuhat,	অজুহাত,	অজুহাত,	
kalakushalir,	কলাকুশলীর,	কলাকুশলীর,	
helly,	হেল্লি,	হিলি,	
phund,	ফান্ড,	ফান্ড,	
adhyatmikata,	অধ্যাতমিকতা,	আধ্যাত্মিকতা,	
nibobondhonkrito,	নিববন্ধনকৃত,	নিববন্ধনকৃত,	
hooq,	হুক,	হুক,	
shariba,	শারিবা,	শরিবা,	
gopalrao,	গোপালরাও,	গোপালরাও,	
oxfordey,	অক্সফোর্ডে,	অক্সফোর্ডে,	
dai,	ডেই,	ডে,	
samany,	সামানি,	সামান্য,	
gandhiio,	গান্ধিয়ো,	গান্ধীও,	
abikaul,	অবিকাল,	অবিকল,	
pluck,	প্লাক,	প্ল্যাক,	
chhuteete,	ছুটিতে,	ছুটিতে,	
oncoltike,	অনলকলিটকে,	অঞ্চলটিকে,	
daraider,	দারাইদের,	দরাইদের,	
kaaferder,	কাফেরদের,	কাফেরদের,	
akhando,	আখণ্ড,	অখন্ড,	
ultrasonography,	আল্ট্রোপোফানর্রী,	আলট্রাসনোগ্রাফিও,	
koyeeri,	কয়েই,	কোয়েরি,	
sthapanagulo,	স্থাপানাগুলো,	স্থাপনাগুলো,	
gonona,	গননানা,	গননা,	
kurdider,	কুর্দীদের,	কুর্দিদের,	
teenej,	তেনেজ,	টিনেজ,	
horidbar,	হরিদ্বার,	হরিদ্বার,	
baaiq,	বাইক,	বাইক,	
chalochchitraeeo,	চালচচিত্রীও,	চলচ্চিত্রেও,	
nirvaha,	নির্ভা,	নির্বাহ,	
ghoshanapatratio,	ঘোষণাপত্রীিও,	ঘোষণাপত্রটিও,	
avinetar,	অভিনেতার,	অভিনেতার,	
sahajlabhbhotar,	সহজলভভততার,	সহজলভ্যতার,	
gobeshonar,	গবেষণার,	গবেষনার,	
doorger,	ডররার,	দুর্গের,	
lakkhero,	লক্ষেরও,	লক্ষেরও,	
dooburir,	ডুবুরির,	ডুবুরির,	
hol,	হোল,	হোল,	
hood,	হুড,	হুড,	
kaloniir,	কালোনীর,	কালনীর,	
byepass,	ব্যাসেপস,	বাইপাস,	
nodimaatrik,	নদীমারিত্বিক,	নদীমাতৃক,	
akkheperi,	আক্ষেপেরই,	আক্ষেপেরই,	
elakatite,	এলাকাটিতে,	এলাকাটিকে,	
aditisaha,	আদিতিসহ,	অদিতিসহ,	
atmabishvashi,	আত্মবিশ্বাসী,	আত্মবিশ্বাসী,	
ponchasjon,	পঞ্চাসজন,	পঞ্চাশজন,	
pooshti,	পুষ্টি,	পুষ্টি,	
dokkhinangsho,	দক্ষিণাংশ,	দক্ষিণাংশ,	
chikittsar,	চিকিতসসারের,	চিকিত্সার,	
bondira,	বন্দিরা,	বন্দীরা,	
mawdeel,	মাউদিল,	মডেল,	
iqbalke,	ইকবলকে,	ইকবালকে,	
biprodas,	বিপ্রদাস,	বিপ্রদাস,	
daaradaa,	দারাদা,	দারদা,	
juboksoho,	যুবসকহ,	যুবকসহ,	
land,	ল্যান্ড,	ল্যান্ড,	
ekbakye,	একবাক্যে,	একবাক্যে,	
alpakichudin,	অল্পকিলিখুন,	অল্পকিছুদিন,	
alpa,	আলপা,	অল্প,	
abosan,	অবসান,	অবসান,	
armashtram,	আর্মস্থ্রম,	আর্মস্ট্রং,	
manushti,	মানুষটি,	মানুষটি,	
deh,	দেহ,	দেহ্,	
kaathhaamaandu,	কাঠমম্্দু,	কাঠমান্ডু,	
podarthobidder,	পদার্থবিদ্যের,	পদার্থবিদদের,	
teamothy,	টিমোথি,	টিমোথি,	
prakalpoguli,	প্রকল্পগুলি,	প্রকল্পগুলি,	
torkarite,	তর্কারিতে,	তরকারিতে,	
sutir,	সুটির,	সুতির,	
shrabostee,	শ্রাবস্তী,	শ্রাবস্তী,	
bikromei,	বিক্রমেই,	বিক্রমেই,	
shandra,	শান্দ্রা,	শান্দ্রার,	
songbadmadhyame,	সংবাদমাধ্যমে,	সংবাদমাধ্যমে,	
ddheela,	ঢিলা,	ঢিলা,	
bishwaashshoi,	বিশ্বাসশই,	বিশ্বাসই,	
catholicder,	ক্যাথলিকদের,	ক্যাথলিকদের,	
byaboharkareer,	ব্যবহারকারীর,	ব্যবহারকারীর,	
ragee,	রাগী,	রাগী,	
karmokarke,	কর্মকারকে,	কর্মকারকে,	
chal,	চাল,	চাল,	
highcommissionay,	হাইসমিজসমেন্সা,	হাইকমিশনে,	
pyatarne,	প্যাটার্নে,	প্যাটার্নে,	
manobikotao,	মানবিকতাও,	মানবিকতাও,	
ramachandranke,	রামাচন্দ্রনকে,	রামাচন্দ্রনকে,	
neshadrabyer,	নেশাদ্রব্যের,	নেশাদ্রব্যের,	
langhoner,	ল্যাংহনের,	লংঘনের,	
bojhao,	বোঝাও,	বোঝাও,	
mythological,	মিথলজিক্যাল,	মাইথলজিকাল,	
dipke,	ডিপকে,	দ্বীপকে,	
konnoder,	কন্যদের,	কন্যদের,	
ashamarthita,	আশামার্থিত,	অসমর্থিত,	
aholyar,	আহল্যার,	অহল্যার,	
daltagi,	ডালতাগি,	দলত্যাগী,	
kushakhali,	কুশখখালী,	কুশাখালি,	
konruup,	কননুরূপ,	কোনরূপ,	
pinglateo,	পিংলাতেও,	পিংলাতেও,	
oiteejye,	ঐতিহ্যে,	ঐতিহ্যে,	
kuldip,	কুল্ডিপ,	কুলদীপ,	
mukhomandaley,	মুখমন্ডলে,	মুখমণ্ডলে,	
vaider,	ভাইদের,	ভাইদের,	
anchalgoolir,	আঞ্চলগুলির,	অঞ্চলগুলির,	
doloo,	দললু,	ডলু,	
shilver,	শিলভের,	সিলভার,	
ajuhath,	অজুহাত,	অজুহাত,	
maailkhanek,	মাইলখানেক,	মাইলখানেক,	
qara,	কারা,	কর,	
venkates,	ভেঙ্কাটেস,	ভেঙ্কটেশ,	
abti,	আবতি,	আবতি,	
ujbekistaner,	উজ্বেসিস্তানের,	উজবেকিস্তানের,	
sossar,	সোসার,	সকার,	
kaatbey,	কাটবে,	কাটবে,	
kanasarabheeshana,	কননাসাভরষণ,	কনসারভেশন,	
ohalyar,	ওহালয়ার,	অহল্যার,	
laicenshe,	লাইকেন্সে,	লাইসেন্স,	
oporishodhito,	অপরিধিিত,	অপরিশোধিত,	
purple,	পারপ্লে,	পার্পেল,	
mmadhukkori,	ম্যামুধকক্তরী,	মাধুকরী,	
turkii,	তুরকি,	তুর্কি,	
udbodhaney,	উদ্বোধনে,	উদ্বোধনে,	
mitro,	মিত্রো,	মিত্র,	
jansa,	জানসা,	জন্স,	
plusey,	প্লাসে,	প্লাসে,	
nirikh,	নিরিখ,	নিরিখ,	
shit,	শিট,	শীত,	
jani,	জানি,	জনি,	
jones,	জোনেস,	জোন্স,	
songasthatir,	সঙ্গাষ্ঠিতির,	সংস্থাটির,	
jaadrel,	জাদরেল,	জাঁদরেল,	
neelfamarir,	নিলপরমীর,	নীলফামারীর,	
kidambi,	কিদাম্বী,	কিদম্বি,	
venuser,	ভেনুসের,	ভেনাসের,	
windows,	উইন্ডোস,	উইন্ডোস,	
bandhano,	বাঁধনো,	বাঁধানো,	
deefinishion,	ডিফিনিশন,	ডেফিনেশন,	
tiunara,	টিউনারা,	টিউনার,	
farna,	ফার্না,	ফার্ন,	
megh,	মেঘ,	মেঘ,	
nirbaahe,	নিরবাহে,	নির্বাহে,	
prothati,	প্রথাটি,	প্রথাটি,	
ceramicer,	সেরামিসের,	সিরামিকের,	
bangalore,	বাঙ্গালোরে,	ব্যাঙ্গালুরে,	
dalee,	দালী,	ডালে,	
rekhapat,	রেখাপাত,	রেখাপাত,	
dakkhinkare,	দক্ষিণকারে,	দক্ষিণকরে,	
hevy,	হেভি,	হেভি,	
masjidke,	মাসজিদকে,	মসজিদকে,	
neerbahe,	নেরবাহে,	নির্বাহে,	
redcrosser,	রেডক্রোসের,	রেডক্রসের,	
nathivookteer,	নথিভুক্তির,	নথিভুক্তির,	
karam,	কারম,	কেরাম,	
chhooteer,	ছূটির,	ছুটির,	
pack,	পাক,	প্ল্যাক,	
muktilav,	মুক্তিলাভ,	মুক্তিলাভ,	
shilpajata,	শিল্পাজাতা,	শিল্পজাত,	
bhabaaponno,	ভাবাপন্ন,	ভাবাপন্ন,	
uporitaley,	উপরিতালে,	উপরিতলে,	
probhritike,	প্রভৃতিকে,	প্রভৃতিকে,	
sarbhare,	সারভারে,	সার্ভারে,	
bhabaponno,	ভাবাপন্ন,	ভাবাপন্ন,	
karadando,	কারাদন্দ,	কারাদণ্ড,	
muhuriganj,	মুহুরীগঞ্জ,	মুহুরীগঞ্জ,	
bapokotor,	বাপকতর,	ব্যাপকতর,	
aireshe,	আইরেশে,	আইরেসে,	
laatimer,	লাটিমের,	লাটিমের,	
dinara,	দিনারা,	ডিনার,	
satarkabhabe,	সতর্কভাবে,	সতর্কভাবে,	
jontrototto,	যন্ত্রত্্ত,	যন্ত্রতত্ত্ব,	
shurugulo,	শুরুগুলো,	শুরুগুলো,	
rilayensa,	রিলায়েন্স,	রিলায়েন্স,	
dhos,	ধোস,	ধস,	
oncholtee,	অংচল্ি,	অঞ্চলটি,	
bonvumi,	বনভূমি,	বনভূমি,	
mag,	মাগ,	এমএজি,	
sarajibonbyapi,	সারাজীবনব্যবপু,	সারাজীবনব্যাপী,	
amor,	আমোর,	আমর,	
chhootochhuti,	ছূটচুটি,	ছুটোছুটি,	
chaanoo,	চানুও,	চানু,	
vabook,	ভাবুক,	ভাবুক,	
utpatti,	উৎপাত্তি,	উতপত্তি,	
oswasteekor,	অস্বস্তিকর,	অস্বস্তিকর,	
dormroome,	ডরমুরমে,	ডর্মরুমে,	
kampita,	কমমপিতা,	কম্পিত,	
totokhon,	ততখন,	ততক্ষন,	
toranganj,	তোরাঙ্জন,	তোরাবগঞ্জ,	
argead,	আর্জড,	আর্জিদ,	
swartho,	স্বার্থ,	স্বার্থ,	
goora,	গোউরা,	গোর,	
antarctica,	অন্ার্ট্যাকটি,	অ্যান্টার্কটিকার,	
abosare,	অবসারে,	অবসরে,	
serology,	সেরোলজি,	সেরোলজি,	
vogiroth,	ভগিরোথ,	ভগীরথ,	
ruby,	রাবি,	রুবী,	
uporzon,	উপর্জন,	উপার্জন,	
zohns,	জোনস,	জন্স,	
niketon,	নিকেটন,	নিকেতন,	
siddharther,	সিদ্ধার্থের,	সিদ্ধার্থের,	
queri,	কেয়েরী,	কোয়েরি,	
rayyalati,	রায়য়লতী,	রয়্যালটি,	
bollov,	বল্লভ,	বল্লভ,	
mmehonoti,	ম্যামেহনিটি,	মেহনতি,	
suparichiti,	সুপারিচিতি,	সুপরিচিতি,	
doltyagi,	দলত্যাগী,	দলত্যাগী,	
rajbondir,	রাজবন্দির,	রাজবন্দীর,	
maail,	মেল,	মাইল,	
joubanbatee,	যৌবনবাটি,	যৌবনবতী,	
palbongsher,	পালবংশের,	পালবংশের,	
lendol,	লেন্ডল,	লেন্ডল,	
debdebie,	দেবদেবী,	দেবদেবী,	
minishtarer,	মিনিষ্টারের,	মিনিস্টারের,	
torikher,	তরিখের,	তরিখের,	
bhowanipur,	ভোওনিপুর,	ভবানীপুর,	
spreedashita,	স্প্রীদশিত,	স্প্রেডশীট,	
gujab,	গুজাব,	গুজব,	
biphal,	বিফাল,	বিফল,	
jackey,	জ্যাকে,	জকি,	
dhangsachchi,	ধ্বংশাচ্চি,	ধ্বংসাচ্ছি,	
bonnopran,	বন্নপ্রাণ,	বন্যপ্রাণ,	
qrisenta,	ক্রিসেন্টা,	ক্রিসেন্ট,	
peeri,	পীরি,	পেরি,	
ap,	এপি,	আপ,	
jonomukhi,	জনমুখী,	জনমুখী,	
nachiketa,	নচিকেতা,	নচিকেতা,	
prime,	প্রাইম,	প্রাইম,	
anhu,	আনহু,	আনহু,	
soundarja,	সৌন্দর্যা,	সৌর্ন্দয্য,	
byabaharkarike,	ব্যবহারকারীকে,	ব্যবহারকারীকে,	
greep,	গ্রীপ,	গ্রিপ,	
moreecha,	মরিচা,	মরিচা,	
grambaasheeo,	গ্রামবাশীও,	গ্রামবাসীও,	
brindabane,	বৃন্দাবানে,	বৃন্দাবনে,	
songkoloney,	সংকলনে,	সংকলনে,	
reliance,	রিলিয়েন্স,	রিলায়েন্স,	
nothivookta,	নথিভুক্ত,	নথিভুক্ত,	
tirmijii,	তিরমিজি,	তিরমিজি,	
audioguloke,	অডিওগুলোকে,	অডিওগুলোকে,	
cocaine,	কোকেইন,	কোকেইন,	
koruna,	কোরুনা,	করুণা,	
aairish,	আই়িরিস,	আইরিস,	
safiin,	সাফিন,	সাফিন,	
madhuri,	মধুরি,	মাধুরী,	
sampadon,	সম্পাদন,	সম্পাদন,	
sheets,	সিটস,	শীটস,	
dolu,	দললু,	ডলু,	
smarok,	স্মারক,	স্মারক,	
baibosthaar,	বৈযবস্থায়ার,	ব্যবস্থার,	
kings,	কিংস,	কিংস,	
aagera,	আগেরা,	আগোরা,	
dewaben,	দেওয়াবেন,	দেওয়াবেন,	
agomonke,	আগমনকে,	আগমনকে,	
ghoomachhe,	ঘৌমাচে,	ঘুমাচ্ছে,	
bojiye,	বজিয়ে,	বজিয়ে,	
kiuti,	কুটি,	কিউটি,	
bee,	বিই,	বি,	
creshcent,	ক্রেচসেন্ট,	ক্রিসেন্ট,	
jhimochchilo,	ঝিমোচ্ছিল,	ঝিমোচ্ছিলো,	
gyandaas,	জ্ঞানদাস,	জ্ঞানদাস,	
carlosh,	কার্লোশ,	কার্লোস,	
pracharanamulak,	প্রচারণামূলক,	প্রচারণামূলক,	
licencedhari,	লাইসেন্সাধিরী,	লাইসেন্সধারী,	
bongsho,	বংশ,	বংশ,	
bidhirnityang,	বিধির্নিত্বাাং,	বিধির্নিত্যং,	
mimgulor,	মিমগুলোর,	মিমগুলোর,	
kloud,	ক্লাউড,	ক্লাউড,	
graambaashio,	গ্রামবাশীও,	গ্রামবাসীও,	
anusvara,	অনুস্বর,	অনুস্বার,	
rajashri,	রাজশ্রী,	রাজশ্রী,	
mujuru,	মুজুরু,	মুজুরু,	
dakticket,	ডাক্তিকট,	ডাকটিকিট,	
bostubad,	বস্তুবাদ,	বস্তুবাদ,	
ghumachchila,	ঘুমাচ্ছিলা,	ঘুমাচ্ছিল,	
kada,	কাদ,	কোডা,	
dola,	দোলা,	দলা,	
daaktikite,	ডাকটিকিতে,	ডাকটিকিটে,	
cinematographar,	সিনেমাটোগ্রাফর,	সিনেমাটোগ্রাফার,	
mandope,	মাণদোপে,	মন্ডপে,	
sector,	সেক্টর,	সেক্টর,	
neshnos,	নেশননস,	নেশনস,	
sqolastiq,	স্কোলাস্তিক,	স্কলাস্টিক,	
chokrantosoho,	চক্রান্তসহ,	চক্রান্তসহ,	
naper,	নাপের,	ন্যাপের,	
chitronattakar,	চিত্রনাট্টাকার,	চিত্রনাট্যকার,	
vugorvey,	ভাগরভে,	ভূগর্ভে,	
qlauda,	ক্লাউড,	ক্লাউড,	
ekspression,	এক্সপ্রেশন,	এক্সপ্রেশন,	
sangasthagulo,	সংস্থগুলো,	সংস্থাগুলো,	
roopdan,	রূপদান,	রুপদান,	
narishwar,	নারীশ্বর,	নারীশ্বরের,	
chemjong,	চেমজং,	চেমজং,	
prottokkhovabe,	প্রত্যক্ষভাবে,	প্রত্যক্ষভাবে,	
ekla,	একলা,	একলা,	
bbiseshyer,	ব্বিসেশ্যের,	বিশেষ্যের,	
shringgo,	শ্রিংগো,	শৃঙ্গ,	
lagto,	লাগটো,	লাগতো,	
comoros,	কমোরোস,	কোমোরোস,	
arthonitite,	অর্থনীতিতে,	অর্থনীতিতে,	
vobobibhuti,	ভববিভূতি,	ভববিভূতি,	
dei,	দেই,	দিই,	
priseflex,	প্রিফেক্সেল্স,	প্রাইজফ্লেক্স,	
nobotom,	নবতম,	নবতম,	
pichte,	পিচতে,	পিছতে,	
grambaasi,	গ্রামবাসী,	গ্রামবাসী,	
chouhate,	চৌহাটে,	চৌহাটে,	
hamburgey,	হামবুর্জে,	হামবুর্গে,	
daayitto,	দায়িত্ব,	দায়িত্ব,	
gabhaaskar,	গাভাস্কার,	গাভাস্কার,	
bunot,	বুনো,	বুনট,	
naazee,	নাজী,	নাত্সি,	
sanaktakaran,	সনক্তকরণ,	সনাক্তকরণ,	
difinishion,	ডিফিশনশন,	ডেফিনেশন,	
toufik,	তৌফিক,	তৌফিক,	
niharkantibabu,	নীহারকান্তিবাবু,	নিহারকান্তিবাবু,	
chaudhuriyo,	চৌধুরিয়,	চৌধুরীও,	
siqh,	সিখ,	শিখ,	
mumtajer,	মুমতাজের,	মুমতাজের,	
karlei,	কারলেই,	করলেই,	
pharanyeta,	ফররনেত্তা,	ফরম্যাট,	
neshnosh,	নেশনোস,	নেশনস,	
rohinibabu,	রোহিনীবাবু,	রোহিনীবাবু,	
nirmolotaa,	নির্মলতা,	নির্মলতা,	
sollallhu,	সোল্লালুহু,	সল্লাল্লাহু,	
melbourner,	মেলবোর্নের,	মেলবোর্নের,	
ajijer,	অজিজের,	আজিজের,	
itostatah,	ইতস্তাতাহ,	ইতস্ততঃ,	
chalachchitro,	চালাচ্চিত্র,	চলচ্চিত্র,	
gaddaafee,	গড়দাফি,	গাদ্দাফী,	
basturoi,	বাস্তুরই,	বস্তুরই,	
chhon,	ছন,	ছোঁ,	
shoodhooi,	সূধই,	শুধুই,	
akkaas,	আক্কাস,	আককাস,	
everestey,	এভারেস্টে,	এভারেস্টে,	
beekaargrasta,	বীকার্গরস্ত,	বিকারগ্রস্ত,	
machhti,	মাছটি,	মাছটি,	
neutrinoo,	নিউট্রিনিও,	নিউট্রিনো,	
shikshakbrinda,	শিক্ষাকবৃন্দ,	শিক্ষকবৃন্দ,	
jeten,	জেতেন,	জেতেন,	
innahu,	ইন্নাহু,	ইন্নাহু,	
qyantana,	ক্যান্তনা,	ক্যান্টন,	
antennal,	আনযান্েনাল,	অ্যান্টেনাল,	
bhyatikaner,	ভ্যাটিকানের,	ভ্যাটিকানের,	
mailkhanek,	মাইলখানেক,	মাইলখানেক,	
rinattak,	ঋণত্তক,	ঋনাত্মক,	
mumtaz,	মুমতাজ,	মুমতাজ,	
raghubar,	রঘুবার,	রঘুবীর,	
gorjon,	গর্জন,	গর্জন,	
shaahaabiike,	সাহাবাইকে,	সাহাবীকে,	
komanera,	কমানেরা,	কমানেরা,	
tigmanshu,	তিগমানশু,	তিগমংশু,	
atibiplabi,	অতিবিপ্লবী,	অতিবিপ্লবি,	
rashider,	রাশিদের,	রশিদের,	
birmuktijoddhagan,	বির্মুক্তিযোদ্ধং,	বীরমুক্তিযোদ্ধাগণ,	
hisaber,	হিসাবের,	হিসাবের,	
ghotol,	ঘটল,	ঘটল,	
champa,	চম্পা,	চাঁপা,	
brekthrough,	ব্রেক্ঠরুঘ,	ব্রেকথ্রু,	
wodka,	ওয়াডকা,	ভদকা,	
janagononar,	জনগোননার,	জনগণনার,	
samajik,	সমাজিক,	সামাজিক,	
sheshdinti,	শেষদিনটি,	শেষদিনটি,	
esprito,	এস্পৃত,	এস্পিরিটো,	
purushika,	পুরুষিকা,	পুরুষিকা,	
basaake,	বাসাকে,	বাসাকে,	
sorsa,	সোর্সা,	সোর্স,	
drishi,	দৃষি,	দৃশ্যই,	
thyachara,	থ্যাচারা,	থ্যাচার,	
cholchhee,	চলছি,	চলছে,	
nirgamon,	নির্গমন,	নির্গমন,	
tokee,	টকি,	তকি,	
dala,	দালা,	দলা,	
parswer,	পারস্বের,	পার্শ্বের,	
gudamjat,	গুদামজাত,	গুদামজাত,	
sthitiko,	স্থিতিকও,	স্থিতিকো,	
kanthar,	কাঁ্ঠার,	কাঁথার,	
dharmiyabhabei,	ধর্মীয়ভাবেই,	ধর্মীয়ভাবেই,	
jeebanjapon,	জীবনজ্নপ,	জীবনযাপন,	
soource,	সুমার,	সোর্স,	
aprasangikbhabei,	অপ্রসঙ্গিকভাবেই,	অপ্রাসঙ্গিকভাবেই,	
shatodha,	শতোধা,	শতধা,	
bage,	বাগে,	বাগে,	
inafarameshana,	ইনাফারেশন,	ইনফরমেশন,	
elakatay,	এলাকাটা,	এলাকাতে,	
sip,	সিপ,	শিপ,	
chirkoot,	চিরকুট,	চিরকুট,	
santoshpore,	সন্তোশপরে,	সন্তোষপুর,	
niurolaji,	নিউলোজা,	নিউরোলজি,	
shhikara,	শিকারা,	শিকার,	
hock,	হক,	হুক,	
hadisti,	হাদিস্তি,	হাদিসটি,	
nazranar,	নাজরানার,	নাজরানার,	
phuda,	ফুড়া,	ফুড,	
saarbhaarti,	সারভার্তি,	সার্ভারটি,	
cena,	সিনা,	সিনা,	
cbi,	সিবিআই,	সিবিআই,	
aalkaatra,	আলকাত্র,	আলকাতরা,	
niropekkho,	নিরপেক্ষ,	নিরপেক্ষ,	
ajibon,	আজিবন,	আজীবন,	
kinsha,	কিন্স,	কিংস,	
pyor,	পিওয়ার,	পিওর,	
eshtonia,	এস্টোনিয়া,	এস্তোনিয়া,	
atwobishvashi,	আত্ববিশ্বাষী,	আত্মবিশ্বাসী,	
shardotsobei,	শার্দোৎসবেই,	শারদোৎসবেই,	
sinakey,	সিনাকে,	সিনাকে,	
ashiatic,	আসিয়াটিক,	এশিয়াটিক,	
municipal,	মুনিসিপাল,	মিউনিসিপ্যাল,	
perri,	পেরি,	পেরি,	
raiji,	রাইজি,	রাইজি,	
naazi,	নাজী,	নাত্সি,	
akhandota,	আখণ্ডতা,	অখণ্ডতা,	
peengna,	পেনং,	পিংনা,	
karmoi,	কারময়,	কর্মই,	
miraclee,	মিরাকলি,	মিরাকেল,	
fising,	ফিসিং,	ফিসিং,	
si,	সি,	এসআই,	
nirbahe,	নিরবাহে,	নির্বাহে,	
dushtogone,	দুস্টগণে,	দুষ্টগণে,	
bujhtepari,	বুঝতেপারী,	বুঝতেপারি,	
kareer,	কারীর,	কারীর,	
ghamtaa,	ঘামটা,	ঘোমটা,	
footballerra,	ফুটবলাররা,	ফুটবলাররা,	
upbrazillian,	উপ্রব্জিলিয়ান,	আপব্রাজিলিয়ান,	
maaktoome,	মাক্তুমে,	মাকতুম,	
noteti,	নোটেটি,	নোটটি,	
nathivukteer,	নথিভুক্তির,	নথিভুক্তির,	
addhattikotar,	আদ্ধাত্তিকতার,	আধ্যাত্মিকতার,	
sofie,	সোফি,	সোফি,	
ssahocorze,	শাইকরর্জে,	সাহচর্যে,	
proboleme,	প্রবলেমে,	প্রবলেমে,	
krema,	ক্রেমা,	ক্রাইম,	
proshikkhane,	প্রশিক্ষণে,	প্রশিক্ষণে,	
kamti,	কামটি,	কমতি,	
masto,	মাস্টো,	মাস্ত,	
punosthaner,	পুনস্থানের,	পুনঃস্থানের,	
dorgaaho,	দরগাহো,	দরগাহ,	
judge,	জুডগে,	জাজ,	
palta,	পাল্টা,	পালটা,	
sohokari,	সহকারী,	সহকারী,	
ekoirokom,	একরকম,	একইরকম,	
buddhitii,	বুদ্ধিটিই,	বুদ্ধিটিই,	
osthishondhi,	অস্থিসন্ধি,	অস্থিসন্ধি,	
phormat,	ফরমমাত,	ফরম্যাট,	
protijogii,	প্রতিযোগী,	প্রতিযোগী,	
kosambir,	কোসাম্বীর,	কোসাম্বীর,	
patininda,	পািনিন্দ,	পতিনিন্দ,	
ooipoka,	ঐপপকা,	উইপোকা,	
soinyo,	সৈন্য,	সৈন্য,	
bhageri,	ভাগেরী,	ভাগেরই,	
sanaktokaron,	সনাক্তকরণ,	সনাক্তকরণ,	
proo,	প্রুও,	প্রো,	
buth,	বুথ,	বুথ,	
shishupalgarh,	শিশুপলগরছ,	শিশুপালগড়ে,	
rakkhanvag,	রক্ষণভঙ্গ,	রক্ষণভাগ,	
meridiane,	মেরিডিয়ানে,	মেরিডিয়ানে,	
evereste,	এভারেস্তে,	এভারেস্টে,	
geographics,	জিওগ্রাফিক্স,	জিওগ্রাফিকস,	
jonoshongjog,	জনসঙ্গ,	জনসংযোগ,	
piulir,	পিলির,	পিউলির,	
blyaka,	ব্লায়কা,	ব্ল্যাক,	
mahafezkhanar,	মহাফেক্ননার,	মহাফেজখানার,	
bajite,	বাজিতে,	বাজিতে,	
satan,	সাতান,	শয়তান,	
ahalya,	আহল্যা,	অহল্যা,	
ji,	জিআ,	জি,	
bone,	বনে,	বনে,	
musallati,	মুসললতী,	মুসল্লাটি,	
baire,	বাইরে,	বাইরে,	
laaz,	লাজ,	লাজ,	
graambaashee,	গ্রামবাশী,	গ্রামবাসী,	
kuttake,	কুট্টাকে,	কুত্তাকে,	
oncholgulir,	অংচলগুলির,	অঞ্চলগুলির,	
gandharir,	গান্ধারীর,	গান্ধারীর,	
samle,	স্যামলে,	সামলে,	
rahimed,	রহিমদ,	রহিমেদ,	
jandrel,	জাঁদ্রেল,	জাঁদরেল,	
osoborno,	অসবর্ণ,	অসবর্ণ,	
protiakromonei,	প্রতিয়াক্রমের,	প্রতিআক্রমণেই,	
eporjonto,	এপরজন্ত,	এপর্যন্ত,	
niropekshtar,	নিরোপাক্ষেতার,	নিরপেক্ষতার,	
fand,	ফ্যান্ড,	ফান্ড,	
bikretaara,	বিক্রেতারা,	বিক্রেতারা,	
bangulzai,	বানগুলজাই,	বঙ্গুলিজাই,	
noiteekotar,	নৈতিকতার,	নৈতিকতার,	
senabahineekey,	সেনাবাহিনীকে,	সেনাবাহিনীকে,	
swadesh,	স্বদেশ,	স্বদেশ,	
sharansthal,	শরণস্থল,	শরণস্থল,	
nowel,	নোয়াল,	নভেল,	
milekhaanek,	মিলেখানেক,	মাইলখানেক,	
abheedhaneek,	অভিধানিক,	অভিধানিক,	
maryir,	মার্যির,	ম্যারির,	
turkyder,	টার্কিডের,	তুর্কিদের,	
daakten,	ডাঁকেত,	ডাকতেন,	
mukherjee,	মুখের্জি,	মুখার্জী,	
