goonoman,	গনোমান,	গুণমান,	
thailandsaho,	থাইলান্ডাহহ,	থাইল্যান্ডসহ,	
jacksonke,	জ্যাকশনকে,	জ্যাকসনকে,	
roopdaan,	রূপডান,	রুপদান,	
ekoirokom,	একৈরকম,	একইরকম,	
sanaktakaran,	সনক্তকরণ,	সনাক্তকরণ,	
edmiral,	এডমিরাল,	এডমিরাল,	
bisshaskey,	বিশস্্কে,	বিশ্বাসকে,	
provur,	প্রভুর,	প্রভুর,	
farhetin,	ফারহেটিন,	ফারহেতিন,	
spredshiit,	স্প্রেডশটিট,	স্প্রেডশীট,	
anyarup,	অন্যরূপ,	অন্যরূপ,	
vodqa,	ভোদ্ডা,	ভদকা,	
mumtazer,	মুমতাজের,	মুমতাজের,	
protijogiider,	প্রতিযোগীদের,	প্রতিযোগীদের,	
deefinishion,	ডিফিশিন,	ডেফিনেশন,	
sudrissho,	সুদৃশ্ব,	সুদৃশ্য,	
phutonta,	ফুটনটা,	ফুটন্ত,	
harbur,	হারবুর,	হারবার,	
siramikasa,	সিরামিকাসা,	সিরামিকস,	
fatakesto,	ফাতাকেস্ত,	ফাটাকেষ্ট,	
iksaprishana,	ইক্ষপ্রিণা,	এক্সপ্রেশন,	
nodnodeer,	নদনদির,	নদনদীর,	
lidars,	লিডারস,	লিডার্স,	
romnar,	রোমনার,	রমনার,	
prasadhoner,	প্রাসাধনের,	প্রসাধনের,	
onkush,	অংকুশ,	অংকুশ,	
cheess,	চেস,	চেস,	
elaakaati,	এলাকাতি,	এলাকাটি,	
kada,	কাদা,	কোডা,	
neemitte,	নিমিত্তে,	নিমিত্তে,	
goshthiti,	গোষ্ঠীটি,	গোষ্ঠীটি,	
taunship,	তৌনশিপ,	টাউনশিপ,	
dharavassokar,	ধারাবসকার,	ধারাভাষ্যকার,	
sollallhu,	সোল্লাল্ু,	সল্লাল্লাহু,	
grambaaseeder,	গ্রামবাসীদের,	গ্রামবাসীদের,	
doobate,	দৌবাতে,	ডুবাতে,	
bade,	বাদে,	বাদে,	
jerusaleme,	জেরুসালেমে,	জেরুসালেমে,	
rejidens,	রেজিডেন্স,	রেসিডেন্স,	
elakaatite,	এলাকাটিতে,	এলাকাটিকে,	
bandi,	বান্দি,	বন্দী,	
ap,	এপিও,	আপ,	
amanisha,	আমানীশা,	অমানিশা,	
kachhakaachhi,	কাচাকাছি,	কাছাকাছি,	
registaner,	রেজিস্টানের,	রেগিস্তানের,	
laicenshe,	লাইশেন্সে,	লাইসেন্স,	
diibug,	দিইবুগ,	ডিবাগ,	
saria,	সারিয়া,	সরিয়া,	
shitei,	শীতেই,	শীতেই,	
nimnosakkharkari,	নিম্নসক্ষারকারী,	নিম্নস্বাক্ষরকারী,	
graambaaseeder,	গ্রামবাসীদের,	গ্রামবাসীদের,	
bbiseshyer,	বিবেশিয়ের,	বিশেষ্যের,	
informetion,	ইনফর্মেশন,	ইনফরমেশন,	
orbeet,	অর্বীত,	অরবিট,	
emiratas,	এমিরাতাস,	এমিরেটাস,	
bhalobasar,	ভালোবাসার,	ভালোবাসার,	
mangolic,	ম্যাঙ্গোলিক,	মাঙ্গলিক,	
raiji,	রাইজি,	রাইজি,	
kinsa,	কিন্সা,	কিংস,	
kortona,	কর্তনা,	করতনা,	
osomorthito,	অসমর্থিত,	অসমর্থিত,	
bondira,	বন্দীরা,	বন্দীরা,	
bikromei,	বিক্রমেই,	বিক্রমেই,	
licencer,	লাইসেন্সের,	লাইসেন্সের,	
muchi,	মুচি,	মুচি,	
bashoborty,	বাশবর্তি,	বশবর্তী,	
swasthohinotay,	স্বাস্থহীনতয়া,	স্বাস্থ্যহীনতায়,	
rohasyati,	রোহস্যাতি,	রহস্যটি,	
angibhutovabe,	অঙ্গীতভাবে,	অঙ্গীভূতভাবে,	
faltu,	ফালটু,	ফালতু,	
gandogol,	গণ্ডগোল,	গন্ডগোল,	
arthonitir,	অর্থনীতির,	অর্থনীতির,	
niharkantibabu,	নিহারকান্তিবাবু,	নিহারকান্তিবাবু,	
existing,	এক্সিস্টিং,	এক্সিসটিং,	
ekoghore,	একঘরে,	একঘরে,	
towraat,	তোউরাত,	তওরাত,	
brittakare,	বৃত্তকারে,	বৃত্তাকারে,	
sazanor,	সাজানোর,	সাজানোর,	
tatey,	টাযাটে,	তাতে,	
spenser,	স্পেন্সের,	স্পেন্সার,	
jonoshongjog,	জনশঙ্যোগ,	জনসংযোগ,	
mozlis,	মোজলিস,	মজলিশ,	
erokomer,	এরোকেমের,	এরকমের,	
munshiji,	মুনশিজি,	মুনশীজি,	
jothartho,	যথার্থ,	যথার্থ,	
pleto,	প্লেটো,	প্লেটো,	
kinsha,	কিনশা,	কিংস,	
booroon,	বুরুন,	বোরন,	
toching,	টচিং,	টোচিং,	
byke,	ব্যাকে,	বাইক,	
aaps,	এআপিএস,	এএপিএস,	
alankorana,	আলাঙ্কোণা,	অলঙ্করণ,	
change,	চাঙ্গে,	চেঞ্জ,	
survative,	সারভাটটটটভ,	সারভেটিভ,	
touraat,	তৌরাত,	তওরাত,	
romantik,	রোমানটিক,	রোমান্টিক,	
prakalpatike,	প্রকলপতিকে,	প্রকল্পটিকে,	
platform,	প্ল্যাটফর্ম,	প্লাটফর্ম,	
mukhomandaler,	মুখমণ্ডলের,	মুখমণ্ডলের,	
khamotagulor,	ক্ষমতাগুলোর,	ক্ষমতাগুলোর,	
fasir,	ফাসির,	ফাসীর,	
nirmankaaj,	নির্মণকাজ,	নির্মাণকাজ,	
jibnagore,	জীবনাগোরে,	জীবননগর,	
ancholtike,	অঞ্চলটিকে,	অঞ্চলটিকে,	
seekkhaou,	সিক্ষাউ,	শিক্ষাও,	
gannaprakasham,	গণ্্পপ্রকশম,	গন্নাপ্রকাশম,	
dala,	দালা,	দলা,	
adorso,	আদরসো,	আর্দশ,	
fishing,	ফিশিং,	ফিসিং,	
sachetanvabe,	সচেতনাভবে,	সচেতনভাবে,	
rohosyo,	রহস্য,	রহস্য,	
grambaseer,	গ্রামবাসার,	গ্রামবাসীর,	
cooda,	কোড,	কোডা,	
alaoler,	অ্যালাওলার,	আলাওলের,	
andon,	আন্দন,	আন্দোন,	
ishton,	ইশ্টন,	স্টোন,	
kaash,	কাশ,	কাস,	
salmaner,	সালমানের,	সালমানের,	
brekthrough,	ব্রেক্রুঘো,	ব্রেকথ্রু,	
manush,	মনুষ,	মানুষ,	
aporishodhito,	অপরিশোধিত,	অপরিশোধিত,	
karaponner,	কারাপন্নের,	কারাপণ্যের,	
vaticaner,	ভ্যাটিকানের,	ভ্যাটিকানের,	
lungiti,	লুঙ্গীতি,	লুঙ্গিটি,	
lampot,	ল্যাম্পট,	লম্পট,	
chhadite,	ছাদিতে,	ছড়িতে,	
koota,	কোটা,	কোটা,	
liceensee,	লিইসন্সি,	লাইসেন্স,	
ekok,	এককক,	একক,	
dorgaaho,	দরগাহ,	দরগাহ,	
muhuriganj,	মুহুরীগঞ্জ,	মুহুরীগঞ্জ,	
sachetonvabe,	সাচেতনভাবে,	সচেতনভাবে,	
antorvukta,	অন্তর্ভূক্ত,	অন্তর্ভুক্ত,	
ganoporibahoner,	গণপরিবাহনের,	গণপরিবহনের,	
musallati,	মুসাল্লাটি,	মুসল্লাটি,	
basakey,	বাসাকে,	বাসাকে,	
utshahomulok,	উৎসাহমূলক,	উৎসাহমূলক,	
olympicer,	অলিম্পিসের,	অলিম্পিকের,	
bunot,	বুনটট,	বুনট,	
jani,	জানি,	জনি,	
rohosyoti,	রহস্যটি,	রহস্যটি,	
sheshdinti,	শেষদিন্তি,	শেষদিনটি,	
koruna,	কোরুনা,	করুণা,	
juddhahato,	যুদ্ধাহাত,	যুদ্ধাহত,	
matthews,	ম্যাটহাউস,	ম্যাথিউস,	
vobanipur,	ভবানীপুর,	ভবানীপুর,	
geja,	গেজা,	গেজ,	
kheylechen,	খেয়েলছেন,	খেলেছেন,	
militarite,	মিলিতারিতে,	মিলিটারিতে,	
parqim,	পার্কিম,	পার্কিং,	
shithilata,	শীথিলতা,	শিথিলতা,	
akeeb,	আকেব,	আকিব,	
goolen,	গুলেন,	গুলেন,	
ratishilatai,	রতিশীলতাই,	রতিশীলতায়,	
aaireshe,	আইরেশে,	আইরেসে,	
bhangle,	ভ্ংলে,	ভাঙলে,	
elakaai,	এলাকাই,	এলাকাই,	
harishankar,	হরিশঙ্কার,	হরিশংকর,	
tasminer,	তাসমিনের,	তাসমিনের,	
beila,	বেইলা,	বেইলা,	
pratool,	প্রতৌল,	প্রতুল,	
sumoo,	সুমুও,	সুমো,	
sector,	সেক্টর,	সেক্টর,	
tenishe,	টেনিশে,	টেনিসে,	
grauth,	গ্রাথ,	গ্রোথ,	
holding,	হোল্ডিং,	হোল্ডিং,	
masjidti,	মাসজিদটি,	মসজিদটি,	
phiksa,	ফিকসা,	ফিক্স,	
gazeetteed,	গ্যাজেটিদ,	গেজেটেড,	
homeser,	হোমেসের,	হোমসের,	
patishapta,	পাতিষাপ্ত,	পাটিসাপটা,	
lirikti,	লিরিকটি,	লিরিকটি,	
mathews,	ম্যাথভাস,	ম্যাথিউস,	
bhittimul,	ভিত্তিমূল,	ভিত্তিমূল,	
bhabarlaler,	ভবর্ললের,	ভবরলালের,	
neelfamarir,	নেলফামারীর,	নীলফামারীর,	
bhenicer,	ভেনিসের,	ভেনিসের,	
kaaferder,	কাফেরদের,	কাফেরদের,	
title,	টিটলে,	টাইটেল,	
tahalo,	তাহালো,	তাহলো,	
tricksguli,	ট্রিকসগুলি,	ট্রিকসগুলি,	
miley,	মিলে,	মিলে,	
phartha,	ফার্থা,	ফার্থ,	
uddhritir,	উদ্ধৃতির,	উদ্ধৃতির,	
niemond,	নিইমোন্ড,	নিমন্ড,	
soommo,	সুম্মো,	সুমো,	
udbodhani,	উদ্বধানী,	উদ্বোধনী,	
bhikkharthe,	ভীক্ষার্থে,	ভিক্ষার্থে,	
pathanatak,	পাথানাটাক,	পথনাটক,	
asamorik,	অসমরিক,	অসামরিক,	
shamuker,	শমুকের,	শামুকের,	
pujit,	পুজিত,	পুজিত,	
jarmaniteo,	জরমমনিতেও,	জার্মানিতেও,	
darji,	দারজি,	দরজি,	
nabbata,	নব্বতা,	নাব্যতা,	
saralya,	সরল্লা,	সারল্য,	
maail,	মাইল,	মাইল,	
rinattak,	ঋণত্বক,	ঋনাত্মক,	
jommu,	জম্মু,	জম্মু,	
phutanta,	ফুতান্ত,	ফুটন্ত,	
hooldim,	হুল্ডিম,	হোল্ডিং,	
arifin,	আরিফিন,	আরিফিন,	
oxite,	অক্সিতে,	অক্সাইট,	
harbore,	হারবোর,	হারবারে,	
padee,	পাদে,	পাড়ে,	
thare,	থারে,	থরে,	
wodka,	ওয়াডকা,	ভদকা,	
sarbhaarti,	সর্ভার্তি,	সার্ভারটি,	
biplabeer,	বিপ্লাবার,	বিপ্লবীর,	
ishter,	ইশ্টের,	ইস্টের,	
chaalaabi,	চালাবি,	চালাবে,	
pachattar,	পাচাত্তর,	পাচাত্তার,	
bishwaashshoi,	বিশ্বাষ্ই,	বিশ্বাসই,	
ganjana,	গানজানা,	গঞ্জনা,	
salphat,	সালফত,	সালফেট,	
shahurgulor,	শহহুরগুলোর,	শহুরগুলোর,	
korimkey,	করিমকে,	করিমকে,	
siqh,	সিঃহ,	শিখ,	
phiqsa,	ফিকসা,	ফিক্স,	
dakshinangsho,	দক্ষিণাংশ,	দক্ষিণাংশ,	
kayech,	কায়েছ,	কায়েছ,	
saurce,	সার্স,	সোর্স,	
jatinke,	জাতিনকে,	যতীনকে,	
beshakbar,	বেশকবার,	বেশকবার,	
bulano,	বুলানো,	বুলান,	
ghotaibe,	ঘোটাইবে,	ঘটাইবে,	
batsmanei,	ব্যাটম্যানেই,	ব্যাটসম্যানই,	
proshtotto,	প্রশ্তত্ত,	প্রস্ত্তত,	
bolechile,	বলেছিলে,	বলেছিলে,	
avetar,	আভেতার,	অবতার,	
nakkal,	নক্কাল,	নক্কল,	
boudhher,	বৌধ্রের,	বৌদ্ধের,	
swadesh,	স্বদেশ,	স্বদেশ,	
ahong,	আহং,	অহং,	
jakso,	জাকসো,	যক্ষ,	
aansareer,	আনসারির,	আনসারীর,	
toler,	টোলের,	তালের,	
plusey,	প্লুসে,	প্লাসে,	
marmaraa,	মারমারা,	মারমারা,	
bharotiyotar,	ভারতীয়তার,	ভারতীয়তার,	
windo,	উইইন্ডো,	উইন্ডো,	
nagarikera,	নাগারীকেরা,	নাগরিকেরা,	
sausagee,	সৌসগী,	সসেজ,	
cn,	সিএন,	সিএন,	
inziniyarsa,	ইনজিনিরার্স,	ইঞ্জিনিয়ার্স,	
oiteejye,	ঐতিয্যে,	ঐতিহ্যে,	
poripaker,	পরিপাকের,	পরিপাকের,	
atibiplabi,	অতিবিপ্লবাী,	অতিবিপ্লবি,	
vushi,	ভুশী,	ভুষি,	
ganonanatto,	গণনানত্ত,	গণনাট্য,	
jens,	জেনস,	জিন্স,	
bedanta,	বেদান্তা,	বেদান্ত,	
chittronatyokar,	চিত্তরণাত্যকার,	চিত্রনাট্যকার,	
nirabota,	নিরাবতা,	নিরবতা,	
shangkulaan,	শংকুলান,	সংকুলান,	
nirvachaker,	নির্ভাচাকের,	নির্বাচকের,	
sikkhakbrinda,	শিক্ষাকবৃন্দ,	শিক্ষকবৃন্দ,	
ogovir,	অগভির,	অগভীর,	
nothivookta,	নথিভুক্ত,	নথিভুক্ত,	
barder,	বার্ডের,	বার্ডের,	
pothnirdeshona,	পথ্নির্দেশনা,	পথনির্দেশনা,	
pratista,	প্রতিস্তা,	প্রতিষ্টা,	
karim,	কারিম,	করিম,	
rajtantro,	রাজতান্ত্র,	রাজতন্ত্র,	
beauby,	বিউবি,	বিউবি,	
satarkabhabey,	সতরকাভাবে,	সতর্কভাবে,	
chhooteer,	ছুটির,	ছুটির,	
corsin,	করসিন,	করসিন,	
arshie,	আর্শী,	আরসিএ,	
moshzidtike,	মশ্জদিতে,	মসজিদটিকে,	
moddhyoshtho,	মদ্ধশ্্থ,	মধ্যস্থ,	
rakshanbhag,	রক্ষণভাগ,	রক্ষণভাগ,	
onshogrohoner,	অন্শগ্রহণের,	অংশগ্রহনের,	
tateo,	তাতেও,	তাতেও,	
pacchi,	পাচ্চি,	পাচ্ছি,	
talgach,	তালগাছ,	তালগাছ,	
harees,	হ্যারেস,	হ্যারিস,	
palashir,	পালাশির,	পলাশীর,	
aakkaash,	আক্কাশ,	আককাস,	
jaatti,	যাত্তি,	জাতটি,	
helloin,	হেলোয়েন,	হ্যালোইন,	
byaboharkarir,	ব্যবহারকারীর,	ব্যবহারকারীর,	
suiza,	সুইজা,	সুইজা,	
habshi,	হাবশি,	হাবশী,	
somabeshti,	সমাবেশটি,	সমাবেশটি,	
jonoikaa,	জনৈকা,	জনৈকা,	
meshintao,	মেশিনটাও,	মেশিনটাও,	
vezano,	ভেজানো,	ভেজানো,	
brindabane,	বৃন্দাবানে,	বৃন্দাবনে,	
biprodas,	বিপ্রোদাস,	বিপ্রদাস,	
baikalyo,	বাইকাল্য,	বৈকল্য,	
santoshpore,	সান্তশ্রে,	সন্তোষপুর,	
nirmolotaa,	নির্মলতা,	নির্মলতা,	
magar,	মাগার,	মাগার,	
dajhyo,	দাঝ্য,	দাহ্য,	
makame,	মাকামে,	মাকামে,	
shresthoshcho,	শ্ষেষ্টশ্চ,	শ্রেষ্ঠশ্চ,	
pothon,	পথন,	পঠন,	
sheetke,	শীতকে,	শীতকে,	
rakim,	রকিম,	রাকিম,	
shurugulo,	শুরুগুলো,	শুরুগুলো,	
pratiyogita,	প্রতিযোগীতা,	প্রতিযোগীতা,	
aabarte,	আবার্তে,	আবর্তে,	
protijogiitamulok,	প্রতিযোগতিমূলক,	প্রতিযোগীতামূলক,	
directorete,	ডাইরেক্টরোতে,	ডিরেক্টরেট,	
purborekorde,	পূর্বরেকদের,	পূর্বরেকর্ডে,	
pitiler,	পিতিলের,	পিটিলের,	
uparjoner,	উপার্যনের,	উপার্জনের,	
chilona,	চিলোনা,	ছিলনা,	
cholochchitratike,	চলচ্চিত্রাতিকে,	চলচ্চিত্রটিকে,	
debate,	দেবাতে,	ডিবেট,	
chakurijibirao,	চাকুরিজিবারও,	চাকুরীজীবীরাও,	
somonnitobhabe,	সোমননিতভাবে,	সমন্বিতভাবে,	
bonvumitey,	বনভুমিতে,	বনভূমিতে,	
gujob,	গুজব,	গুজব,	
rata,	রাতা,	রত,	
bheenisa,	ভীনিসা,	ভেনিস,	
songkolonti,	সংকল্নটি,	সংকলনটি,	
saramukhe,	সরমুখে,	সারামুখে,	
sudrishya,	সুদ্রিশ্য,	সুদৃশ্য,	
venus,	ভেনাস,	ভেনাস,	
angsogrohone,	অংসগ্রহণে,	অংশগ্রহনের,	
alumni,	আলুমনি,	অ্যালমনি,	
jyesttha,	জেয়েট্থা,	জ্যেষ্ঠা,	
bboponer,	ব্বপনের,	বপনের,	
shhepha,	সেফা,	শেফ,	
edipass,	এডিপাস,	ইডিপাস,	
suchonakal,	সূচনাকল,	সূচনাকাল,	
porinoti,	পরিণটি,	পরিণতি,	
debeting,	ডেবেটিং,	ডিবেটিং,	
confliqt,	কনফ্লিক্ট,	কনফ্লিক্ট,	
titarer,	তিতারের,	তিতারের,	
neerbahe,	নিরবাহে,	নির্বাহে,	
dosha,	দোশা,	দোসা,	
tomader,	টোমাদের,	তোমাদের,	
beatleser,	বেটলেসের,	বিটলসের,	
bhramarotsab,	ভ্রামারসোব,	ভ্রমরোৎসব,	
purbancoler,	পার্বাঙ্কলের,	পূর্বাঞ্চলের,	
chamski,	চ্যামস্কি,	চমস্কি,	
uddhrito,	উদৃথিত,	উদ্ধৃত,	
orunima,	ওরুনিমা,	অরুণিমা,	
protizogii,	প্রতিযোগী,	প্রতিযোগী,	
siddhantei,	সিদ্ধান্তেই,	সিদ্ধান্তেই,	
freelancerra,	ফ্রিলান্সারররা,	ফ্রিল্যান্সাররা,	
diznee,	ডিজন,	ডিজনী,	
pranibigyani,	প্রাণিবিজ্ঞানী,	প্রাণীবিজ্ঞানী,	
shekarmani,	শেকারমানি,	শেকরমানি,	
jeher,	জেহের,	জেহের,	
aatmobishwasi,	আত্মবিশ্বাসী,	আত্মবিশ্বাসী,	
sedikei,	সেদিকেই,	সেদিকেই,	
cholchhee,	চলছী,	চলছে,	
scoore,	স্কোরে,	স্কোর,	
nilfamarir,	নীলফামারির,	নীলফামারীর,	
perri,	পেরি,	পেরি,	
supplenza,	সাপ্লেনজা,	সাপলেঞ্জা,	
daacktickete,	ডাক্টিকেতে,	ডাকটিকিটে,	
karecho,	কারেছো,	করেছো,	
mousumeo,	মৌসুমেও,	মৌসুমেও,	
palbongser,	পালবংসের,	পালবংশের,	
kaia,	কাইয়া,	কায়া,	
bajite,	বাজিতে,	বাজিতে,	
khalid,	খালিদ,	খালিদ,	
shoreefpur,	শরীফপুর,	শরিফপুর,	
desiseyer,	ডেসিসেয়ের,	ডিজিজের,	
lokhindorer,	লখিন্দরের,	লখিন্দরের,	
choopi,	চুপি,	চুপি,	
smarok,	স্মারক,	স্মারক,	
jwar,	জ্বার,	জ্বর,	
ddebet,	ড্বেবেট,	ডিবেট,	
siraju,	সিরাজু,	সিরাজু,	
shtonehenge,	স্টোনেহেঙ্গে,	স্টোনহেঞ্জ,	
sutir,	সুতির,	সুতির,	
drishyogulote,	দৃশ্যগুলোতে,	দৃশ্যগুলোতে,	
maudelder,	মাউডেলদের,	মডেলদের,	
kaalaam,	কালাম,	কালাম,	
postar,	পোস্টার,	পোস্টের,	
asovya,	অসোভিয়া,	অসভ্য,	
sardar,	সার্দার,	সরদার,	
baganoto,	বাগানোতো,	বাগানত,	
ancholsaha,	আঞ্চলসহ,	অঞ্চলসহ,	
neker,	নেকের,	নেকের,	
meloonborrone,	মেলোনবোর্রেন,	মেলবোর্নে,	
parisankhanbid,	পরিসংখ্বিদ,	পরিসংখ্যানবিদ,	
swastir,	স্বস্তির,	স্বস্তির,	
remacri,	রেমাল্কারি,	রেমাক্রী,	
mast,	মাস্ট,	মাস্ত,	
gaichey,	গাইছে,	গাইছে,	
francine,	ফ্রান্সাইন,	ফ্রান্সিন,	
poschime,	পশ্চিমে,	পশ্চিমে,	
shlok,	শ্লোক,	শ্লোক,	
spredasita,	স্প্রেদাসিতা,	স্প্রেডশীট,	
chatrorai,	চাত্ররাই,	ছাত্ররাই,	
kkhur,	ক্রুর,	ক্ষুর,	
zarniz,	জার্িজ,	জারনিজ,	
mankisundar,	মন্কিসুন্দর,	মানকিসুন্দর,	
udbhaboni,	উদ্ভাবনী,	উদ্ভাবনী,	
blasterke,	ব্লাস্টারকে,	ব্লাস্টারকে,	
suparahiro,	সুপারহীরও,	সুপারহিরো,	
souripurang,	সৌরীপূরং,	সৌরিপুরং,	
shchalastik,	স্চালস্তিক,	স্কলাস্টিক,	
shomostigoto,	শমস্তিগত,	সমষ্টিগত,	
satarkokari,	সতারককারী,	সতর্ককারী,	
rashedul,	রাশেদুল,	রাশিদুল,	
cloring,	ক্লোরিং,	ক্লোরিং,	
danakana,	ডানাকানা,	ডানকান,	
husni,	হুস্নি,	হুসনি,	
khoakshir,	খো়াকশির,	খোয়াক্ষীর,	
shingping,	শিংপংং,	শিংপিং,	
holuder,	হোলুদের,	হলুদের,	
bane,	বানে,	বনে,	
bosontoke,	বসন্তকে,	বসন্তকে,	
agamane,	আগামানে,	আগমনে,	
fake,	ফেকে,	ফাকে,	
degreeo,	ডিগ্রিও,	ডিগ্রিও,	
langhangulir,	লাঙ্ঘালগুলির,	লঙ্ঘনগুলির,	
bhromoner,	ভ্রমণের,	ভ্রমণের,	
shpredshiit,	স্পারডটিট,	স্প্রেডশীট,	
townshhip,	টৌশিিপ,	টাউনশিপ,	
sarsa,	সারসা,	সোর্স,	
greep,	গ্রিপ,	গ্রিপ,	
keyu,	কেয়ু,	কেউ,	
yucalyptus,	যুয়ালিক্্পুস,	ইউক্যালিপ্টাস,	
hoondayi,	হুন্দায়ি,	হুন্দাই,	
balakarak,	বালাকার,	বলকারক,	
jatata,	জাটাটা,	যতোটা,	
madhnagar,	মধনগর,	মাধনগরের,	
scholastik,	স্কোলস্তিক,	স্কলাস্টিক,	
bhowanipur,	ভোপনীপুর,	ভবানীপুর,	
blacq,	ব্ল্যাক,	ব্ল্যাক,	
adhyattikota,	আধ্যাত্তিকতা,	আধ্যাত্মিকতা,	
windos,	উইন্ডোস,	উইন্ডোস,	
samajikotar,	সমাজিকতার,	সামাজিকতার,	
mukhmondole,	মুখমণ্ডলে,	মুখমণ্ডলে,	
bizito,	বিজিত,	বিজিত,	
breq,	ব্রেক,	ব্রেক,	
sangosrobomukto,	সংস্রবমুক্ত,	সংস্রবমুক্ত,	
ship,	শিপ,	শিপ,	
prakare,	প্রারের,	প্রকারে,	
taatey,	টাতে,	তাতে,	
bayshorkarikarone,	বযশশকরীকরণে,	বেসরকারিকরণ,	
protistha,	প্রতিষ্ঠা,	প্রতিষ্টা,	
hood,	হুড,	হুড,	
raunanganey,	রাউঙ্গানে,	রণাঙ্গনে,	
rupert,	রিপার্ট,	রুপার্ট,	
shasyadi,	শাস্যাদি,	শস্যাদি,	
jatotaa,	জাতোটা,	যতোটা,	
arashie,	আরাশী,	আরসিএ,	
orrgho,	অর্ঘ,	অর্ঘ্য,	
palbongsher,	পালবংশের,	পালবংশের,	
disni,	ডিসিনি,	ডিজনী,	
parisankhanvid,	পরিসংখ্নিদ,	পরিসংখ্যানবিদ,	
neemeette,	নেমিত্বে,	নিমিত্তে,	
antarvuktimulak,	আন্তর্ভুতিমক,	অন্তর্ভুক্তিমূলক,	
choudhurike,	চৌধুরিকে,	চৌধুরীকে,	
bhabaaponno,	ভাবাপন্ন,	ভাবাপন্ন,	
kalirkhal,	কালিরখাল,	কালিরখাল,	
ardasho,	আর্দাসো,	আর্দশ,	
cheekitsar,	চিকিৎসার,	চিকিত্সার,	
ceramicsh,	সেরিমিক্স,	সিরামিকস,	
amiretus,	অমিরেটাস,	এমিরেটাস,	
chikittsar,	চিকিতসার,	চিকিত্সার,	
valobasen,	ভালোবাসেন,	ভালোবাসেন,	
ganochien,	গ্যানোয়েন,	গণচীন,	
swadhinotatukui,	স্বাধীনতাুকুই,	স্বাধীনতাটুকুই,	
karmoi,	কারমোই,	কর্মই,	
faskari,	ফাসকারি,	ফাঁসকারী,	
anusvara,	অনুসভারা,	অনুস্বার,	
comoros,	কমোরোস,	কোমোরোস,	
kaatbey,	কাটবে,	কাটবে,	
phuda,	ফুডা,	ফুড,	
gate,	গ্যাট,	গ্যেটে,	
reflex,	রেফ্লেক্স,	রিফ্লেক্স,	
karmake,	কারমাকে,	কর্মকে,	
akhandota,	আখান্দতা,	অখণ্ডতা,	
amittrakkhor,	অমিত্রাক্ষর,	অমিত্রাক্ষর,	
chakti,	চাকটি,	চাকতি,	
abhijitda,	অভিজিতদা,	অভিজিতদা,	
anektai,	আনেকটাই,	অনেকটাই,	
jounotar,	যৌনতার,	যৌনতার,	
sobrakomer,	সব্রাকোমের,	সবরকমের,	
vittio,	ভিত্তিও,	ভিত্তিও,	
manjushree,	মঞ্জুশ্রী,	মঞ্জুশ্রী,	
proteemar,	প্রতিমার,	প্রতিমার,	
dologuloo,	দলগুলোও,	দলগুলোও,	
soorsa,	সুরসা,	সোর্স,	
ekbakye,	একবাক্যে,	একবাক্যে,	
muchlima,	মুচলিমা,	মুছলিমা,	
hights,	হাইটস,	হাইটস,	
jamanataswarup,	জমনাতাস্বরূপ,	জামানতস্বরূপ,	
mahbunur,	মাহবুনুর,	মাহবুনুর,	
rajnoitik,	রাজনৈতিক,	রাজনৈতীক,	
chaanoo,	চানু,	চানু,	
bohudin,	বহুদিন,	বহুদিন,	
shikhra,	শিখরা,	শিখরা,	
bhotomulyoke,	ভটমূল্যকে,	ভোটমূল্যকে,	
byaktigotovabeo,	ব্যক্তিগতভাবেও,	ব্যাক্তিগতভাবেও,	
paab,	পাব,	পাব,	
ajeejer,	আজিজের,	আজিজের,	
kartona,	কার্তনা,	করতনা,	
bahati,	বাহাটি,	বাহাতি,	
dhormoprobortokder,	ধর্মপ্রবর্তকদের,	ধর্মপ্রবর্তকদের,	
vandar,	ভান্ডার,	ভাণ্ডার,	
zommu,	জম্ু,	জম্মু,	
ebham,	এভাম,	ইভিএম,	
borendroke,	বরেন্দ্রকে,	বরেন্দ্রকে,	
guha,	গুহা,	গোহ,	
sthaponagulor,	স্থাপনাগুলোর,	স্থাপনাগুলোর,	
dakter,	ডাক্টার,	ডাকতের,	
torkarite,	তর্কারিতে,	তরকারিতে,	
shef,	শেফ,	শেফ,	
ghatleo,	ঘাতলেও,	ঘটলেও,	
feemalee,	ফেমালী,	ফিমেল,	
ghotolen,	ঘটলেন,	ঘটলেন,	
vins,	ভিনস,	ভিন্স,	
konorup,	কোনরূপ,	কোনরূপ,	
vool,	ভুল,	উল,	
nyata,	ন্যাটা,	ম্যাট,	
suparichito,	সুপারিচিত,	সুপরিচিত,	
uporitale,	উপরিতালে,	উপরিতলে,	
aosafur,	আওসাফুর,	আওশাফুর,	
ghumachchila,	ঘুমাচ্ছিলা,	ঘুমাচ্ছিল,	
sohinsotar,	সহিনসতার,	সহিংসতার,	
shahidputra,	শহিদপুত্র,	শহীদপুত্র,	
shuri,	শুরী,	সুরি,	
proshikkhane,	প্রশিক্ষাণে,	প্রশিক্ষণে,	
musalmani,	মুসলমানি,	মুসলমানই,	
somraatra,	সম্রাত্র,	সম্রাটরা,	
sainyader,	সৈন্যাদের,	সৈন্যদের,	
seeramiks,	সেরামিক্স,	সিরামিকস,	
noditei,	নদীতেই,	নদীতেই,	
grooth,	গ্রোথ,	গ্রোথ,	
daltyagi,	দাল্ত্যাগী,	দলত্যাগী,	
anchalgoolir,	অঞ্চলগুলির,	অঞ্চলগুলির,	
mitro,	মিত্রো,	মিত্র,	
boudher,	বৌধের,	বৌদ্ধের,	
votarer,	ভোটারের,	ভোটারের,	
nachar,	নাচার,	নাচার,	
karmojog,	কারমোোগ,	কর্মযোগ,	
ankanshilpe,	অঁকালশিল্পে,	অঙ্কনশিল্পে,	
kagbeni,	কাগবেনি,	কাগবেনি,	
bhenkates,	ভেঙ্কাটেস,	ভেঙ্কটেশ,	
crashlands,	ক্রাশল্যান্ডস,	ক্র্যাশল্যান্ডস,	
thabai,	থাবাই,	থাবাই,	
sayatana,	সায়াতানা,	শয়তান,	
aakkas,	আক্কাস,	আককাস,	
progresh,	প্রগ্রেশ,	প্রগ্রেস,	
catholicbad,	ক্যাথোলিক্যাড,	ক্যাথলিকবাদ,	
dweepgoolotey,	ড্বিগপুলেট,	দ্বীপগুলোতে,	
neshadrabyer,	নেশাদ্রব্যের,	নেশাদ্রব্যের,	
vobobibhuti,	ভববিভূতি,	ভববিভূতি,	
jandrel,	জান্ড্রেল,	জাঁদরেল,	
hojurer,	হজুরের,	হজুরের,	
parkin,	পারকিন,	পার্কিং,	
uposhthit,	উপস্থিত,	উপস্থিত,	
jibanto,	জীবান্ত,	জীবন্ত,	
kloud,	ক্লাউড,	ক্লাউড,	
dipankar,	দিপানকর,	দিপঙ্কর,	
hydrological,	হাইড্রোলিক্যাল,	হাইড্রোলজিক্যাল,	
samratder,	সম্রাদদের,	সম্রাটদের,	
churger,	চুর্গের,	চার্জের,	
kanader,	কানাদের,	কণাদের,	
banglota,	বাংলোটা,	বাংলোটা,	
chalochchitraeer,	চালচ্চিত্রার,	চলচ্চিত্রের,	
saazano,	সাজানো,	সাজানো,	
bishshasho,	বিশ্বাষ,	বিশ্বাসও,	
somonwitobhabey,	সোমন্মিভাবে,	সমন্বিতভাবে,	
tochhnochh,	তচ্ছন,	তছনছ,	
kabutorer,	কাবুতরের,	কবুতরের,	
arekdol,	আরেকডল,	আরেকদল,	
paadee,	পাড়ি,	পাড়ে,	
harza,	হারজা,	হার্জ,	
grushko,	গ্রুস্কো,	গ্রুশকো,	
deefinition,	ডিফিনিশন,	ডেফিনেশন,	
tikta,	টিকটা,	তিক্ত,	
aamontrito,	আমন্ত্রিত,	আমন্ত্রিত,	
teman,	টেমান,	তেমন,	
soinyo,	সৈন্য,	সৈন্য,	
prakalpoguli,	প্রকলপপুলি,	প্রকল্পগুলি,	
shikara,	শিকারা,	শিকার,	
batikromi,	বাতিক্রমী,	ব্যতিক্রমী,	
romancha,	রোমাঞ্চ,	রোমাঞ্চ,	
uddhrita,	উদ্ধৃত,	উদ্ধৃত,	
kanar,	কানার,	কণার,	
pleta,	প্লেটা,	প্লেটো,	
distance,	ডিসট্যান্স,	ডিসট্যান্স,	
panthar,	পান্থার,	পন্থার,	
eshtonia,	এস্তনিয়া,	এস্তোনিয়া,	
monchostho,	মন্চস্থ,	মঞ্চস্থ,	
purohitra,	পুরহিত্রা,	পুরোহিতরা,	
stagecraft,	স্টেগেটক্রাফ,	স্টেজক্রাফট,	
osommotite,	অসম্ততিতে,	অসম্মতি,	
vaibon,	ভাইবন,	ভাইবোন,	
janamukhi,	জানামুখী,	জনমুখী,	
palkee,	পালকে,	পাল্কি,	
achintopurer,	অচিন্তপুরের,	অচিন্তপুরের,	
utpotti,	উৎপত্তি,	উতপত্তি,	
upbrazillian,	আপ্রেজিলিয়ান,	আপব্রাজিলিয়ান,	
fuss,	ফুস,	ফাস,	
pretty,	প্রেটি,	প্রিটি,	
debdebyr,	ডেবডেবারির,	দেবদেবীর,	
durgatsober,	দুর্গতস্ববের,	দুর্গোৎসবে,	
shukrabab,	শুক্রবাব,	শুক্রবাব,	
chowdhuryke,	চৌধুরকে,	চৌধুরীকে,	
duburir,	দুবুরির,	ডুবুরির,	
milekhaanek,	মিলেখানেক,	মাইলখানেক,	
grambaasi,	গ্রামবাসী,	গ্রামবাসী,	
logic,	লোগিক,	লজিক,	
bujhtepari,	বুঝেতপারী,	বুঝতেপারি,	
review,	রেভিয়াব,	রিভিউও,	
humner,	হামনার,	হামনার,	
idyi,	ইদ্ি,	আইডিই,	
gagee,	গ্যাগী,	গেজ,	
tiunara,	তিউনারা,	টিউনার,	
dubaate,	দুবাতে,	ডুবাতে,	
prarthonakokkher,	প্রার্থনাক্ষের,	প্রার্থনাকক্ষের,	
bongsho,	বংশ,	বংশ,	
heepatitis,	হেপাটিটিস,	হেপাটাইটিস,	
dadapur,	দাদাপুর,	দাদাপুর,	
sompadonkaree,	সম্পাদনকারী,	সম্পাদনকারী,	
oedipus,	ওড়েপুস,	ইডিপাস,	
dokan,	দোকান,	দোকান,	
karlei,	কারলেই,	করলেই,	
bosantake,	বসনাতাকে,	বসন্তকে,	
leaders,	লিডার্স,	লিডার্স,	
siddhantoo,	সিদ্ধান্তও,	সিদ্ধান্তও,	
protijogi,	প্রতিযোগী,	প্রতিযোগী,	
gandhikey,	গান্ধিকে,	গান্ধীকে,	
foxer,	ফক্সার,	ফক্সের,	
abhidhaanick,	অভিচানিক,	অভিধানিক,	
vedanta,	ভেদান্তা,	বেদান্ত,	
bondi,	বন্দি,	বন্দী,	
dhaanche,	ধাঁছে,	ধাঁচে,	
shhashtra,	সাস্ত্রা,	শাস্ত্র,	
sotorkobhabey,	সতর্কভাবে,	সতর্কভাবে,	
kalenga,	কালেঙ্গা,	কালেঙ্গা,	
jansa,	জানসা,	জন্স,	
porishongkhanbid,	পরিশ্খবানবিদ,	পরিসংখ্যানবিদ,	
ongkush,	অংকুশ,	অংকুশ,	
songkulan,	সংকুলান,	সংকুলান,	
noitik,	নৈটিক,	নৈতিক,	
amorendro,	অমরেন্দ্রে,	অমরেন্দ্র,	
paner,	পানের,	পানের,	
baibasthaar,	বৈবস্থার,	ব্যবস্থার,	
noiteekotar,	নৈতিকতার,	নৈতিকতার,	
champa,	চাম্পা,	চাঁপা,	
ekshoti,	একশোটি,	একশোটি,	
protyokkhovabey,	প্রত্যক্ষবাযে,	প্রত্যক্ষভাবে,	
eevil,	ইভিল,	ইভিল,	
akatwa,	আকাত্ব,	একাত্ব,	
hoil,	হইল,	হইল,	
suparharo,	সুপারহারো,	সুপারহিরো,	
satyaky,	সাত্যাকি,	সাত্যকি,	
pathkrom,	পাঠকর্ম,	পাঠক্রম,	
probeshan,	প্রবেশন,	প্রবেশন,	
tarkareer,	তারকারীর,	তরকারীর,	
juboksoho,	যুবকসহ,	যুবকসহ,	
markeetim,	মার্কিটিম,	মার্কেটিং,	
tirmijii,	তীর্মিজি,	তিরমিজি,	
panchashjon,	পাঞ্চাশজন,	পঞ্চাশজন,	
zeland,	জেল্যান্ড,	জিল্যান্ড,	
selim,	সেলিম,	সেলিম,	
nyeta,	ন্যাটা,	ম্যাট,	
turbiner,	টারবিনের,	টারবাইনের,	
simaa,	সিমা,	সীমা,	
shikkhadikkhay,	শিক্ষাদিক্ষায়,	শিক্ষাদিক্ষায়,	
favorite,	ফ্যাভোরিতে,	ফেভারিট,	
chalaabi,	চালাবি,	চালাবে,	
opohoron,	অপহরণ,	অপহরন,	
pakhtunistan,	পাখতুনীত্নান,	পাখতুনিস্তান,	
nachiketa,	নাচিকেটা,	নচিকেতা,	
fiksing,	ফিকসিং,	ফিক্সিং,	
cholochchitraeeo,	চলচ্চিত্রীও,	চলচ্চিত্রেও,	
nischitobhave,	নিশ্চিতভাবে,	নিশ্চিতভাবে,	
oboshore,	অবশরে,	অবসরে,	
jaadrel,	যাদ্রেল,	জাঁদরেল,	
ghumachhe,	ঘুমাছে,	ঘুমাচ্ছে,	
rastagulikeo,	রাসতাগুলিকেও,	রাস্তাগুলিকেও,	
sadbi,	সাদবি,	সাধ্বী,	
basermick,	ব্যাসেরমিক,	বেসারমিক,	
miraclee,	মিরাক্লি,	মিরাকেল,	
promodwara,	প্রমোদ্বারা,	প্রমদ্বারা,	
bondiira,	বন্দিয়ার,	বন্দীরা,	
lekhaksattwar,	লেখাতস্তবরর,	লেখকসত্ত্বার,	
metropolitan,	মেট্রোপিলিটান,	মেট্রোপলিটন,	
tottorat,	টত্তরাট,	তওরাত,	
hitaishi,	হিতাইশী,	হিতৈষী,	
horas,	হোরাস,	হোরাস,	
nirgamon,	নির্গামোন,	নির্গমন,	
shikshakbrindo,	শিক্ষাকবৃন্দ,	শিক্ষকবৃন্দ,	
kichudinpar,	কিছুদিনপার,	কিছুদিনপর,	
aflatoxin,	আফলাটক্সিন,	আ্যফ্ল্যাটক্সিন,	
vangley,	ভ্যাংলে,	ভাঙলে,	
supreetira,	সুপ্রীতীরা,	সুপ্রীতিরা,	
chenza,	চেনজা,	চেঞ্জ,	
kantojir,	কান্তজির,	কান্তজির,	
primoo,	প্রীমৌ,	প্রিমো,	
chaka,	চাকা,	চাকা,	
shoreefer,	শরিফার,	শরিফের,	
dhadhiye,	ধাধিয়ে,	ধাধিয়ে,	
neelkamal,	নীলকমাল,	নীলকমল,	
elakatay,	এলাকাতায়,	এলাকাতে,	
masto,	মাস্তো,	মাস্ত,	
votar,	ভোটার,	ভোটার,	
matorom,	মাতরোম,	মাতরম,	
anutpadanshil,	অনুৎপদনশীল,	অনুৎপাদনশীল,	
turkamena,	টুর্কামেনা,	তুর্কমেন,	
sahinsatar,	সহিনসতার,	সহিংসতার,	
qarqa,	কার্া,	কার্ক,	
lendol,	লেন্ডল,	লেন্ডল,	
shotodha,	শতধা,	শতধা,	
firti,	ফিরতি,	ফিরতি,	
ashociatesh,	এশোশিয়েটেস,	এসোসিয়েটস,	
shilpikuler,	শিল্পিকুলের,	শিল্পীকুলের,	
nathivukteer,	নথিভূক্তির,	নথিভুক্তির,	
juboke,	যুবককে,	যুবকে,	
saarbhaarti,	সারভার্তি,	সার্ভারটি,	
deputi,	দেপুটি,	ডেপুটি,	
bhittow,	ভিত্তুব,	ভিত্তিও,	
maadla,	মাডলা,	মাদলা,	
ahalya,	আহল্যা,	অহল্যা,	
asommoti,	অসম্মতি,	অসম্মতি,	
ganesh,	গণেশ,	গণেশ,	
dalip,	দালিপ,	দালিপ,	
schilling,	স্কিলিং,	শিলিং,	
bonobhumi,	বনভূমি,	বনভূমি,	
sarajibonbyapi,	সরাজীবন্যবাপী,	সারাজীবনব্যাপী,	
artilary,	আর্টিলারি,	আর্টিলারি,	
flexta,	ফ্লেক্সটা,	ফ্লেক্সটা,	
everage,	এভারেজ,	এভারেজ,	
dewaben,	দেওয়াবেন,	দেওয়াবেন,	
graminphonor,	গ্রামিফন্োর,	গ্রামীণফোনর,	
laat,	ল্যাট,	লাট,	
ameettrakkhor,	অমিত্রক্ষর,	অমিত্রাক্ষর,	
neerbachoker,	নির্বাচকের,	নির্বাচকের,	
ekla,	একলা,	একলা,	
qor,	কোর,	কর,	
laps,	ল্যাপস,	ল্যাপস,	
reliance,	রিলিয়ান্স,	রিলায়েন্স,	
kathghera,	কাঘঘেরা,	কাঠঘেরা,	
pillai,	পিল্লাই,	পিল্লাই,	
annorup,	অন্যরূপ,	অন্যরূপ,	
unchiyechilo,	উঁচিয়েছিল,	উঁচিয়েছিল,	
kailashrao,	কৈলশ্রও,	কৈলাশরাও,	
shikhbe,	শিখবে,	শিখবে,	
steena,	স্টেন,	স্টেন,	
byan,	ব্যান,	ব্যাং,	
grambaasheeo,	গ্রামবাশীও,	গ্রামবাসীও,	
rajpur,	রাজপুর,	রাজপুর,	
harja,	হার্জা,	হার্জ,	
deil,	ডেলল,	ডেইল,	
aro,	আরো,	আরও,	
abti,	আবতি,	আবতি,	
rockibul,	রকিবুল,	রকিবুল,	
laiseensim,	লাইসিনমিম,	লাইসেন্সিং,	
bejiye,	বেজিয়ে,	বেজিয়ে,	
roopmatro,	রুপমাত্র,	রূপমাত্র,	
sofie,	সোফি,	সোফি,	
taitela,	টাইটেল,	টাইটেল,	
protishta,	প্রতিষ্টা,	প্রতিষ্টা,	
cuti,	কুটি,	কিউটি,	
shardotsobei,	শার্দতস্বেই,	শারদোৎসবেই,	
kommandar,	কম্মান্ডার,	কমাণ্ডার,	
prity,	প্রিটি,	প্রিটি,	
bisheshshyer,	বিশেষ্যের,	বিশেষ্যের,	
pleena,	প্লিনা,	প্লেন,	
aaeerese,	আইরেসে,	আইরেসে,	
chirkoot,	চিরকূট,	চিরকুট,	
basaalt,	বাসালট,	ব্যাসল্ট,	
ponthaar,	পন্থার,	পন্থার,	
drissogulote,	দৃরস্গগুলোতে,	দৃশ্যগুলোতে,	
beem,	বিম,	বিম,	
dojo,	দোজো,	ডোজো,	
gorjon,	গর্জন,	গর্জন,	
dabliudabliui,	ডাব্লিউডাউলবলিই,	ডাব্লিউডাব্লিউই,	
reshmirekha,	রেশমিরেখা,	রেশমীরেখা,	
shabkam,	শব্কাম,	শবকাম,	
echhti,	এছটি,	এছটি,	
wictor,	ইইক্টর,	ভিক্টর,	
ekjoge,	একজোগে,	একযোগে,	
upobaashee,	উপবাষী,	উপবাসী,	
ruby,	রুবি,	রুবী,	
roy,	রোয়,	রায়,	
daap,	ডাপ,	ড্যাপ,	
madhuree,	মাধুরী,	মাধুরী,	
fud,	ফুড,	ফুড,	
si,	সিয়া,	এসআই,	
dephinishion,	ডেফিনিশন,	ডেফিনেশন,	
ghurechen,	ঘুরেছেন,	ঘুরেছেন,	
fansi,	ফানসি,	ফাঁসী,	
taigara,	তাইগারা,	টাইগার,	
poschimey,	পশ্চিমে,	পশ্চিমে,	
anisa,	আনিসা,	আনিস,	
anchalo,	আঁচালো,	অঞ্চলও,	
naitikatavodh,	নৈতিকাবোধ,	নৈতিকতাবোধ,	
afzol,	আফজোল,	আফজল,	
uparzoner,	উপরজনের,	উপার্জনের,	
hol,	হলল,	হোল,	
arasie,	আরাসিয়,	আরসিএ,	
bedey,	বেদে,	বেদে,	
moomtaj,	মুমতাজ,	মুমতাজ,	
probondhobhittik,	প্রবণ্ধভিত্তিক,	প্রবন্ধভিত্তিক,	
dong,	ডোং,	ডং,	
directarate,	ডিরেক্টরেট,	ডিরেক্টরেট,	
koyeeri,	কয়েরি,	কোয়েরি,	
sylvi,	সিলভি,	সিলভি,	
deelibhara,	দীলিভারা,	ডেলিভার,	
alpakichudin,	আল্পাকিদুলীন,	অল্পকিছুদিন,	
sexperter,	সেক্সপার্টের,	সেক্সপার্টের,	
nathivookto,	নাথিভুক্ত,	নথিভুক্ত,	
nichols,	নিচলস,	নিকলস,	
popke,	পোপকে,	পোপকে,	
moushumei,	মৌশুমেই,	মৌসুমেই,	
aviyojan,	অভিযোজন,	অভিযোজন,	
bijepi,	বিজেপি,	বিজেপি,	
smarak,	স্মররক,	স্মারক,	
asamanyo,	অসমন্য,	অসামান্য,	
emargency,	এমারজেন্সি,	এমার্জেন্সি,	
upacharjo,	উপাচার্য,	উপাচার্য,	
nathivukta,	নাথিভুক্ত,	নথিভুক্ত,	
bopoon,	বোপুন,	বপন,	
pushtee,	পুষ্টি,	পুষ্টি,	
ashankai,	আশানকাই,	আশঙ্কাই,	
moshjidke,	মশজদেকে,	মসজিদকে,	
durtomo,	দূর্তমো,	দূরতম,	
ponchasjon,	পঞ্চাশজন,	পঞ্চাশজন,	
tahorir,	তাহরীর,	তাহরীর,	
shroddhabihin,	শ্রো্দাবিহীন,	শ্রদ্ধাবিহীন,	
khargosher,	খারগোষের,	খরগোসের,	
tonoo,	টোনো,	তনু,	
mercial,	মার্সিয়াল,	মার্শিয়াল,	
rubidiyaam,	রুবিদিয়াম,	রুবিডিয়াম,	
engrezder,	এনগ্রেজ্ডের,	ইংরেজদের,	
abadamoner,	আবাদামনের,	অবদমনের,	
bupher,	বাফার,	বাফার,	
sahajlabhbhotar,	সহালভভভতার,	সহজলভ্যতার,	
mulvitti,	মূলভিত্তি,	মূলভিত্তি,	
debdebier,	ডেব্ডেবিয়ার,	দেবদেবীর,	
shainyader,	শৈন্যদের,	সৈন্যদের,	
kharar,	খারার,	খরার,	
byaboharkari,	ব্যবহারকারী,	ব্যবহারকারী,	
chalchhe,	চালছে,	চলছে,	
cholochchitra,	চল্চচিত্রা,	চলচ্চিত্র,	
atmabishvashi,	আত্মবিশবাষী,	আত্মবিশ্বাসী,	
mahakabi,	মহাকাবি,	মহাকবি,	
upobashii,	উপবাশীই,	উপবাসী,	
munsi,	মুনসি,	মুন্সী,	
shhow,	শোর,	শো,	
gotihin,	গতিহীন,	গতিহীন,	
shasankorta,	শাসানকর্তা,	শাসনকর্তা,	
pragreesa,	প্রাগ্রিসা,	প্রগ্রেস,	
qredita,	ক্রেডিটা,	ক্রেডিট,	
dii,	ডিয়,	দিই,	
jerushalema,	জেরুশেলামা,	জেরুসালেম,	
mag,	ম্যাগ,	এমএজি,	
hastamathun,	হস্তামুথন,	হস্তমথুন,	
bapio,	বাপিও,	বাপিও,	
balokarak,	বালোকারক,	বলকারক,	
jati,	জাতি,	যাতি,	
fastara,	ফাস্তারা,	ফস্টার,	
madrasi,	মাদরাসি,	মাদ্রাজি,	
saarbharti,	সার্ভরটি,	সার্ভারটি,	
tukroke,	তুকরোকে,	টুকরোকে,	
pack,	প্যাক,	প্ল্যাক,	
jiland,	জিলান্দ,	জিল্যান্ড,	
buth,	বুথ,	বুথ,	
nischitvabe,	নিশ্চিতভাবে,	নিশ্চিতভাবে,	
tuleche,	তুলেছে,	তুলেছে,	
welcome,	ওয়ালকম,	ওয়েলকাম,	
seoul,	সেওয়াল,	সোল,	
rahi,	রাহি,	রাহী,	
bosante,	বসান্তে,	বসন্তে,	
bishwasho,	বিশ্বাষ,	বিশ্বাসও,	
tukroti,	তুক্রটি,	টুকরোটি,	
jontropatigulite,	যন্ত্রপায়ুগুলিতে,	যন্ত্রপাতিগুলিতে,	
nirobota,	নিরোবতা,	নিরবতা,	
drishyer,	দৃশ্যের,	দৃশ্যের,	
kuhelika,	কুহেলিকা,	কুহেলিকা,	
bonke,	বনকে,	বনকে,	
bolbo,	বলবো,	বলবো,	
said,	সাইদ,	সাইদ,	
aatto,	আট্্ো,	আত্ম,	
niutrino,	নিউট্রিনো,	নিউট্রিনো,	
perry,	পেরি,	পেরি,	
oyebjin,	ওয়েবজিন,	ওয়েবজিন,	
umedpoor,	ইউজেদপুর,	উমেদপুর,	
elakatike,	এলাকাটিকে,	এলাকাটিকে,	
atmobonchito,	আত্মবঞ্চিত,	আত্মবঞ্চিত,	
setikey,	সেতিকে,	সেটিকে,	
patengar,	পাটেঙ্গার,	পতেঙ্গার,	
khelechen,	খেলেছেন,	খেলেছেন,	
heavy,	হিভি,	হেভি,	
toxoid,	টক্সোড,	টক্সয়েড,	
esprito,	এসপ্রিত,	এস্পিরিটো,	
ajibooner,	আজুবুনের,	আজীবনের,	
bitertrate,	বিটেরেট্রাট,	বাইটারট্রেট,	
jaunotar,	যৌনতার,	যৌনতার,	
mukhamandoler,	মুখামণ্ডলের,	মুখমণ্ডলের,	
pet,	পেট,	পেত,	
danata,	দানাতা,	ডোনাট,	
sommoteer,	সম্মতির,	সম্মতির,	
hundai,	হুন্দাই,	হুন্দাই,	
cholechi,	চলেছি,	চলেছি,	
joubankal,	যৌবনকাল,	যৌবনকাল,	
angshogrohon,	অংশগ্রহণ,	অংশগ্রহন,	
naraphoka,	নারাফোকা,	নরফোক,	
kinto,	কিন্তো,	কিনত,	
bhorkendra,	ভোরকেন্দ্র,	ভরকেন্দ্র,	
uponishad,	উপনিশাদ,	উপনিষদ,	
atak,	আতাক,	আটক,	
shorifer,	শোরফার,	শরিফের,	
irana,	ইরানা,	ইরান,	
doula,	দৌলা,	দৌলা,	
bidghootey,	বিদঘুতে,	বিদঘুটে,	
commissionvogider,	কমিনসোোডিগের,	কমিশনভোগীদের,	
fol,	ফল,	ফল,	
plack,	প্ল্যাক,	প্ল্যাক,	
mesenjjar,	মেসেঞ্জার,	মেসেঞ্জার,	
bedantodhormo,	বেদান্তধর্ম,	বেদান্তধর্ম,	
dayitta,	দায়িত্তা,	দায়িত্ব,	
spashtotai,	স্পশ্ততাই,	স্পষ্টতই,	
zohns,	জোন্স,	জন্স,	
noteti,	নোেটি,	নোটটি,	
milea,	মিলি,	মাইলে,	
longhan,	লংহান,	লংঘন,	
definition,	ডিফিশনেন,	ডেফিনেশন,	
codeti,	কোডেটি,	কোডটি,	
lopjonito,	লোপজনিত,	লোপজনিত,	
venisey,	ভেনিসে,	ভেনিসে,	
bajpa,	বাজপা,	বাজপা,	
rachonakal,	রচনাকাল,	রচনাকাল,	
bhenasha,	ভেনাশা,	ভেনাস,	
digri,	ডিগ্রি,	ডিগ্রি,	
dhrubaker,	ধ্রুবাকের,	ধ্রুবকের,	
habathu,	হাভাঠু,	হাবাথু,	
dhauto,	ধাতো,	ধৌত,	
mooney,	মুনে,	মুনে,	
niropekkho,	নিরপেক্ষ,	নিরপেক্ষ,	
rajtontro,	রাজতন্ত্র,	রাজতন্ত্র,	
disposes,	ডিসপোসেস,	ডিসপোজেস,	
bitlaser,	বিটলাসের,	বিটলসের,	
teter,	টেটের,	টেটের,	
myathiou,	ম্যাথিউ,	ম্যাথিউ,	
reejideencee,	রিজিডিন্স,	রেসিডেন্স,	
bbiswasho,	বিব্বীশা,	বিশ্বাসও,	
buddhitii,	বুদ্ধিতিই,	বুদ্ধিটিই,	
phareeksa,	ফারককসা,	ফরেক্স,	
dimbacriti,	ডিম্বাকৃতি,	ডিম্বাকৃতি,	
hozot,	হজত,	হজত,	
kichutei,	কিছুতেই,	কিছুতেই,	
shahabike,	শাহাবীকে,	সাহাবীকে,	
katui,	কাটুই,	কাতুই,	
mahibur,	মাহিবুর,	মহিবুর,	
satjaner,	সাতজানের,	সাতজনের,	
rezidence,	রেজিডেন্স,	রেসিডেন্স,	
khuliechilam,	খুলেয়েছিলাম,	খুলিয়েছিলাম,	
olpo,	ওল্পো,	অল্প,	
basab,	বাসাব,	বাসাব,	
prosadhoner,	প্রসাধনের,	প্রসাধনের,	
rena,	রেনা,	রেনো,	
weelcomee,	উয়ালকমম,	ওয়েলকাম,	
trenda,	ট্রেন্ডা,	ট্রেন্ড,	
rajotwo,	রাজত্ব,	রাজত্ব,	
kaamij,	কামিজ,	কামিজ,	
treend,	ট্রিন্ড,	ট্রেন্ড,	
transformaarer,	ট্রান্সফোর্মারের,	ট্রান্সফরমারের,	
sumita,	সুমিতা,	সুমিতা,	
courtcaser,	কার্টক্সের,	কোর্টকেসের,	
mangoleek,	মঙ্গলিক,	মাঙ্গলিক,	
rekhapat,	রেখাপাত,	রেখাপাত,	
sanghitar,	সংঘীতার,	সংহিতার,	
plato,	প্লাটো,	প্লেটো,	
aanaan,	আনান,	আনান,	
tecno,	টেকনো,	টেকনো,	
indro,	ইন্দ্রো,	ইন্দ্র,	
prothati,	প্রথাটি,	প্রথাটি,	
mmadhuri,	ম্মাধুরি,	মাধুরী,	
antarbhutto,	অন্তর্ভূত্ব,	অন্তর্ভুক্ত,	
societykey,	সোসিক্টি,	সোসাইটিকে,	
meghachchanno,	মেঘাচ্ছান্ন,	মেঘাচ্ছন্ন,	
jaanachhe,	যানাচ্ছে,	জানাচ্ছে,	
euqalyptus,	ইউক্লালিপ্টাস,	ইউক্যালিপ্টাস,	
amarika,	আমারিকা,	আমেরিকা,	
mehsus,	মেহসাস,	মেহসুস,	
olympik,	অলিম্পিক,	অলিম্পিক,	
bhaibon,	ভাইবন,	ভাইবোন,	
rajendracholer,	রাজেন্দ্রালছের,	রাজেন্দ্রচোলের,	
skolastik,	স্কোলাস্তিক,	স্কলাস্টিক,	
gajano,	গাজানো,	গজানো,	
andra,	আন্দ্রা,	আন্ড্রা,	
sikara,	সিকারা,	শিকার,	
anchalei,	অঞ্চালেই,	অঞ্চলেই,	
foks,	ফকস,	ফক্স,	
udvabani,	উদভাবনি,	উদ্ভাবনী,	
ceramiksh,	সেরামিক্স,	সিরামিকস,	
aansaareer,	আনসারীর,	আনসারীর,	
mataram,	মাতারাম,	মাতরম,	
akmato,	আকমততো,	একমত,	
footbalarer,	ফুটবলারের,	ফুটবলারের,	
canflikt,	ক্যানফফলিক্ট,	কনফ্লিক্ট,	
jotharthovabey,	যথার্থভাবে,	যথার্থভাবে,	
shaddhi,	শাদ্ধি,	সাধ্বী,	
madrasake,	মাদরাসাকে,	মাদ্রাসাকে,	
bibhinno,	বিভিন্ন,	বিভন্ন,	
byabostho,	ব্যবস্থ,	ব্যাবস্থা,	
bhogni,	ভোগনি,	ভগ্নী,	
gandhariir,	গান্ধারির,	গান্ধারীর,	
suporichita,	সুপরিচিতা,	সুপরিচিত,	
brekethru,	ব্রেকেঠরু,	ব্রেকথ্রু,	
qara,	কারা,	কর,	
larson,	লারসন,	লারসন,	
planeti,	প্লানেটি,	প্লেনটি,	
magical,	ম্যাজিক্যাল,	ম্যাজিকাল,	
vabnakey,	ভাবনাকে,	ভাবনাকে,	
oitijhyotike,	ঐতিহ্যটিকে,	ঐতিহ্যটিকে,	
kanasarabhesana,	কানাভাভেসন,	কনসারভেশন,	
ivil,	ইভিল,	ইভিল,	
kadakhonchar,	কাদাচঞ্চার,	কাদাখোঁচার,	
conflikt,	কনফ্লিক্ট,	কনফ্লিক্ট,	
nibeditar,	নিবেদিতার,	নিবেদিতার,	
vault,	ভাউলট,	ভল্ট,	
bhoutikeshu,	ভৌতিকেশু,	ভৌতিকেষু,	
deep,	ডিপ,	দীপ,	
nodiitei,	নদীতেই,	নদীতেই,	
ukeliptash,	উকেলিপ্লাশ,	ইউক্যালিপ্টাস,	
chyeta,	চ্য়েটা,	চ্যাট,	
teamothy,	টেমোথি,	টিমোথি,	
arthanitike,	অর্থানীতিকে,	অর্থনীতিকে,	
bethikata,	বেঠিকাতা,	বেঠিকতা,	
saseza,	সাসেজা,	সসেজ,	
milayatane,	মিলায়াতানে,	মিলায়তনে,	
temonvabe,	তেমনভাবে,	তেমনভাবে,	
taunasipa,	তৌনসিপা,	টাউনশিপ,	
dekaner,	দেকানের,	দেকানের,	
kanthar,	কান্থার,	কাঁথার,	
elbamtite,	এলবাটমিতে,	এলবামটিতে,	
rakhtokkharoner,	রাখকতকারণের,	রক্তক্ষরণের,	
maladabha,	মালাদা,	মলদোভা,	
shift,	শিফট,	শিফট,	
shrabostee,	শ্রাস্তি,	শ্রাবস্তী,	
byabosthar,	ব্যবস্থার,	ব্যাবস্থার,	
gobeshana,	গোবেশন,	গবেষনা,	
janosamaj,	জনসমাজ,	জনসমাজ,	
uthaney,	উথানে,	উঠানে,	
dokaangulotey,	ডোকানগুলোতে,	দোকানগুলোতে,	
madeling,	ম্যাডেলিং,	মডেলিং,	
abdi,	আব্দি,	অব্দি,	
karu,	কারু,	কারু,	
brittakarey,	বৃত্তকারে,	বৃত্তাকারে,	
chikitsanirbhar,	চিকিৎসানির্ভর,	চিকিৎসানির্ভর,	
sarboporee,	সার্বপরী,	সর্বোপরী,	
feroza,	ফেরোজা,	ফিরোজা,	
daqten,	ডাকটেন,	ডাকতেন,	
turkyder,	টারকাইডের,	তুর্কিদের,	
rajdhani,	রাজধানি,	রাজধানি,	
parqa,	পার্কা,	পার্ক,	
footbalarra,	ফুটবলাররা,	ফুটবলাররা,	
sorano,	সোরানো,	সরানো,	
nutaner,	নুটানের,	নূতনের,	
byabaharkarike,	ব্যবহারকারীকে,	ব্যবহারকারীকে,	
ganochin,	গণোচীন,	গণচীন,	
ansareer,	আনসারীর,	আনসারীর,	
charger,	চার্জের,	চার্জার,	
bouddha,	বৌদ্ধা,	বৌদ্ধ,	
noitikota,	নৈতিকতা,	নৈতিকতা,	
shiqara,	শিকারা,	শিকার,	
sanaktokaron,	সানাকতারণ,	সনাক্তকরণ,	
teoyana,	তেওয়ানা,	তাইওয়ান,	
annanere,	অন্নানেরে,	অন্যানেরে,	
laga,	লাগা,	লগ,	
salapheeta,	সালাফেটা,	সালফেট,	
inapharameshana,	ইনাফারেশন,	ইনফরমেশন,	
pnouchute,	প্ঁছুতে,	পৌঁছুতে,	
nirvachokder,	নির্ভাচকদের,	নির্বাচকদের,	
chalochchitrei,	চালচিত্রের্রেই,	চলচ্চিত্রেই,	
ekirokom,	একিরোম,	একইরকম,	
futonta,	ফুটনটা,	ফুটন্ত,	
deraa,	দেরা,	ডেরা,	
amanisa,	আমানিসা,	অমানিশা,	
enamela,	এনামেলা,	এনামেল,	
veenis,	ভিনিস,	ভেনিস,	
jomoker,	জমকের,	জমকের,	
ingreziteo,	ইনগেরজিতেও,	ইংরেজিতেও,	
elakasoho,	এলাকাসহ,	এলাকাসহ,	
metrikoleshana,	মেত্রিকোলেশন,	মেট্রিকোলেশন,	
shniper,	শ্নিপের,	স্নাইপার,	
raiialati,	রায়ায়লতি,	রয়্যালটি,	
barnis,	বার্নিস,	বার্নিশ,	
flirt,	ফ্লার্ট,	ফ্লার্ট,	
shapad,	শাপাদ,	শ্বাপদ,	
ponchaasjon,	পঞ্চাশজন,	পঞ্চাশজন,	
nagorikderkey,	নাগীরদকেরকে,	নাগরিকদেরকে,	
yuroo,	যুরুও,	ইউরো,	
bisnukey,	বিস্নুকে,	বিষ্ণুকে,	
chhooteete,	ছুটিতে,	ছুটিতে,	
totokson,	টোটকসন,	ততক্ষন,	
tunaita,	টুনাইটা,	টুনাইট,	
besirbhaagi,	বেসিরভাগী,	বেশিরভাগই,	
gaujano,	গাওজানো,	গজানো,	
dantahin,	দানতাহীন,	দন্তহীন,	
baffer,	বেফার,	বাফার,	
parijaner,	পরিজনের,	পরিজনের,	
meshenjar,	মেশেঞ্জার,	মেসেঞ্জার,	
khappar,	খাপপার,	খপ্পর,	
deares,	ডেয়েরেস,	ডিআরএস,	
moushum,	মৌশুম,	মৌসুম,	
krechi,	ক্রেছি,	করেছি,	
langhoner,	লাঙ্ঘনের,	লংঘনের,	
dwibidho,	দ্বিবিধ,	দ্বিবিধ,	
sikarer,	সিকারের,	শিকারের,	
vabuk,	ভাবুক,	ভাবুক,	
patochitra,	পাটচিত্রা,	পটচিত্র,	
labonaktatar,	লববণকাত্তার,	লবণাক্ততার,	
aholya,	আহল্যা,	অহল্যা,	
tokee,	টোক,	তকি,	
kobulennechha,	কবুলেনেনেছা,	কবুলেন্নেছা,	
gejetade,	গেজেতাদে,	গেজেটেড,	
accountdharira,	অ্যাকুন্ড্ধরিরারা,	একাউন্টধারীরা,	
kooshumba,	কৌশুম্বা,	কুশুম্বা,	
drissoteer,	দৃষ্টতির,	দৃশ্যটির,	
parka,	পার্কা,	পার্ক,	
koomarir,	কুমারির,	কুমারীর,	
machkabar,	মাকছাবার,	মাচকাবার,	
bosonte,	বসন্তে,	বসন্তে,	
byaboharkarie,	ব্যবহারকারী,	ব্যবহারকারীই,	
hyaloyin,	হ্যালোইয়ন,	হ্যালোইন,	
dhamshrenite,	ধম্বেন্তিতে,	ধামশ্রেণীতে,	
khabarsoho,	খাবারসহ,	খাবারসহ,	
abheedhanic,	অভেধনিক,	অভিধানিক,	
chalachchitrer,	চালাচ্ছিত্রের,	চলচ্চিত্রের,	
sushposhtolikhito,	সুষ্পোষ্চকিতি,	সুষ্পষ্টলিখিত,	
pyore,	প্যোরে,	পিওর,	
marketing,	মার্কেটিং,	মার্কেটিং,	
ooporoshtho,	অপররষ্থ,	উপরস্থ,	
seo,	সেও,	সেও,	
monzeele,	মঞ্জিলে,	মঞ্জিলে,	
subade,	সুবাদে,	সুবাদে,	
kokeyin,	ককেইনিন,	কোকেইন,	
nanilalke,	নানিলাককে,	ননীলালকে,	
sarbhare,	সারভারে,	সার্ভারে,	
oncoltike,	অন্কলটিকে,	অঞ্চলটিকে,	
jaistho,	যাইস্থ,	জ্যৈষ্ঠ,	
adhyatmikata,	অধ্যাৎমিকতা,	আধ্যাত্মিকতা,	
bhujangta,	ভুজাংটা,	ভুজঙ্গটা,	
kalnir,	কালনির,	কালনীর,	
birmuktijoddhagan,	বির্মুক্তিদোগ্যান,	বীরমুক্তিযোদ্ধাগণ,	
quata,	কোয়াটা,	কোটা,	
karpeter,	কারপেতের,	কার্পেটের,	
kode,	কোডে,	কোড,	
rajnikant,	রাজনিকান্ত,	রাজনীকান্ত,	
tep,	টেপ,	ট্যাপ,	
bhardwaj,	ভর্দ্বাজ,	ভরদ্বাজ,	
ganakantha,	গণকন্ঠা,	গণকণ্ঠ,	
ramantika,	রামনটিকা,	রোমান্টিক,	
rajyabhogi,	রাজ্যভোগী,	রাজ্যভোগী,	
talgachh,	তা্গাছ,	তালগাছ,	
jetam,	জেতাম,	যেতাম,	
taufik,	তাফিক,	তৌফিক,	
akkharkey,	অক্ষরকে,	অক্ষরকে,	
kaande,	কান্ডে,	কাণ্ডে,	
chintakarma,	চিন্তকর্ম,	চিন্তাকর্ম,	
nirbachokder,	নির্বাচকদের,	নির্বাচকদের,	
horash,	হোরাশ,	হোরাস,	
sanghar,	সংঘর,	সংহার,	
kormopontha,	কর্মপন্থা,	কর্মপন্থা,	
hizrite,	হিজরিতে,	হিজরীতে,	
footballerra,	ফুটবলার্ারা,	ফুটবলাররা,	
ghoor,	ঘুর,	ঘুর,	
saifai,	সাইফাই,	সাইফাই,	
nirbaahe,	নিরবাহে,	নির্বাহে,	
chalochchitro,	চালচিত্ত্র,	চলচ্চিত্র,	
lendal,	লেন্ডল,	লেন্ডল,	
juktorashtreo,	যুক্তরাত্রেও,	যুক্তরাষ্ট্রেও,	
muhaiminer,	মুহাইমিনের,	মুহাইমিনের,	
firoza,	ফিরোজা,	ফিরোজা,	
jahara,	জাহারা,	যাহরা,	
ramzaner,	রামজানের,	রমযানের,	
bhupal,	ভূপাল,	ভূপাল,	
eucalyptus,	ইউক্লালিউটাস,	ইউক্যালিপ্টাস,	
baarnis,	বার্নিস,	বার্নিশ,	
ganoparibahaner,	গণপরিবাহনের,	গণপরিবহনের,	
srivatsalakshanang,	শ্রীবাতলকংশকংলং,	শ্রীবৎসলক্ষণং,	
jamjomat,	জামজোমত,	জমজমাট,	
pradoshik,	প্রদোশিক,	প্রাদশিক,	
dolu,	দোলু,	ডলু,	
jotinkey,	জোটিনকে,	যতীনকে,	
nibobondhonkrito,	নিববন্ধনকৃত,	নিববন্ধনকৃত,	
trabuco,	ট্র্যাবো,	ট্র্যাবুকো,	
samashtike,	সমাশটিকে,	সমষ্টিকে,	
obosorer,	অবসরের,	অবসরের,	
shoriph,	শোরিফ,	শরিফ,	
russad,	রুসাদ,	রুশদ,	
shakar,	শাকার,	সকার,	
aniyantrita,	অনিয়ন্ত্রীতা,	অনিয়ন্ত্রিত,	
gyandas,	জ্ঞানদাস,	জ্ঞানদাস,	
alraji,	আলরাজি,	আলরাজী,	
ranangane,	রাঙঙ্গনে,	রণাঙ্গনে,	
dembakreeti,	দেমব্কৃতি,	ডিম্বাকৃতি,	
aairees,	আইরিস,	আইরিস,	
renoo,	রেনো,	রেনো,	
hevy,	হেভি,	হেভি,	
bone,	বনে,	বনে,	
toki,	টোকি,	তকি,	
ghoomato,	ঘোমাতো,	ঘুমাতো,	
ray,	রায়ে,	রায়,	
binakar,	বিনাকার,	বিনাকার,	
deqe,	ডেকে,	ডেকে,	
nirgomon,	নির্গমন,	নির্গমন,	
bite,	বিটে,	বাইট,	
jomjamat,	জোমজামত,	জমজমাট,	
songasthaner,	সংস্থানের,	সংস্থানের,	
agaldar,	আগলদার,	আগলদার,	
dipke,	ডিপকে,	দ্বীপকে,	
shansthagulo,	শাস্থ্সগুলো,	সংস্থাগুলো,	
hughes,	হুঘেস,	হিউজেস,	
grambaashio,	গ্রামবশীও,	গ্রামবাসীও,	
meghacchonno,	মেঘাচ্ছন্ন,	মেঘাচ্ছন্ন,	
khonjena,	খোঁজেনা,	খোঁজেনা,	
toranganj,	তোরঙ্গঞ্জ,	তোরাবগঞ্জ,	
nuhas,	নুহাস,	নুহাশ,	
kidambi,	কিদাম্বি,	কিদম্বি,	
doneta,	ডোনেটা,	ডোনাট,	
phund,	ফান্ড,	ফান্ড,	
nirbaho,	নির্বাহ,	নির্বাহ,	
niroja,	নিরোজা,	নিরোজা,	
mile,	মিলে,	মিলে,	
video,	ভিডেও,	ভিডিয়োও,	
ji,	জিই,	জি,	
bidyadanke,	বিদ্যাদনকে,	বিদ্যাদানকে,	
sondhisthaponer,	সন্ধিষ্ঠাপনের,	সন্ধিস্থাপনের,	
mesenjarer,	মেসেঞ্জারের,	মেসেঞ্জারের,	
taffsherer,	টাফশারের,	তাফসীরের,	
matis,	মাতিস,	ম্যাটিস,	
beshirbhaagei,	বেশীরভাগেই,	বেশিরভাগেই,	
rojapalaner,	রোজাপালানের,	রোজাপালনের,	
obharbhiu,	ওভারভিউ,	ওভারভিউ,	
licencedhari,	লিইসেন্ডারী,	লাইসেন্সধারী,	
zoubankal,	যৌবনকাল,	যৌবনকাল,	
mandope,	ম্যান্ডপে,	মন্ডপে,	
oncholshomuh,	অঞ্চলসমূহ,	অঞ্চলসমূহ,	
mukherjee,	মুখের্যে,	মুখার্জী,	
engreziteo,	এনজ্রেজিতেও,	ইংরেজিতেও,	
bhabanir,	ভবানীর,	ভবানীর,	
songrahak,	সংগ্রাহক,	সংগ্রাহক,	
antercticker,	অন্টার্টিকের,	অ্যান্টার্কটিকের,	
modelgulo,	মোডেলগুলো,	মডেলগুলো,	
raagei,	রাগেই,	রাগেই,	
swarther,	স্বর্থের,	স্বার্থের,	
morodeho,	মরদেহ,	মরদেহ,	
railliner,	রেইলিনের,	রেললাইনের,	
hock,	হক,	হুক,	
phox,	ফোক্স,	ফক্স,	
gyada,	জ্যাদা,	গ্যাদা,	
dhila,	ধিলা,	ঢিলা,	
tistar,	তিস্তার,	তিস্তার,	
akreetokarjo,	আক্রীতকার্য,	অকৃতকার্য,	
vogiroth,	ভগিরোথ,	ভগীরথ,	
dharmiyabhabei,	ধর্মীয়ভাবেই,	ধর্মীয়ভাবেই,	
milekhanek,	মিলেখানেক,	মাইলখানেক,	
sahozlabhbhotar,	সহলোভলভতার,	সহজলভ্যতার,	
fibergulote,	ফিইবারগুলোতে,	ফাইবারগুলোতে,	
dwijenbabuder,	দ্বিজেনবাবুদের,	দ্বিজেনবাবুদের,	
jeshtha,	জেশ্ঠা,	জ্যেষ্ঠা,	
kathmandute,	কাঠমণ্ডুতে,	কাঠমান্ডুতে,	
impaction,	ইমপ্যাকশন,	ইমপ্যাকশন,	
potka,	পটকা,	পটকা,	
prangulo,	প্রানগুলো,	প্রানগুলো,	
sikkhagata,	শিক্ষাগত,	শিক্ষাগত,	
okritokarjo,	ওকৃতরার্য,	অকৃতকার্য,	
jounatar,	যৌনতার,	যৌনতার,	
ashanka,	আশানকা,	আশংকা,	
rachanakal,	রচনাকাল,	রচনাকাল,	
sahojlovyotar,	সহলোব্যতার,	সহজলভ্যতার,	
olympic,	অলিম্পিক,	অলিম্পিক,	
cheerontan,	চিরন্তান,	চিরন্তন,	
sooya,	সুয়া,	সোয়া,	
tigmanshu,	তিগমানশু,	তিগমংশু,	
firoze,	ফিরোজে,	ফিরোজ,	
biplabee,	বিপ্লাবি,	বিপ্লবী,	
doorotomo,	দূরতম,	দূরতম,	
nothivukta,	নথিভুক্ত,	নথিভুক্ত,	
chirkut,	চিরকুট,	চিরকুট,	
gabeshonar,	গাবেশনার,	গবেষনার,	
protijogitamulok,	প্রতিযোগতিমূলক,	প্রতিযোগীতামূলক,	
chirontan,	চিরণতান,	চিরন্তন,	
purple,	পারপলল,	পার্পেল,	
dekhso,	দেখসো,	দেখসো,	
mukhyo,	মুখ্য,	মুখ্য,	
oncholgulir,	অঞ্চলগুলির,	অঞ্চলগুলির,	
dokaanei,	ডোকানেই,	দোকানেই,	
jaaygata,	জয়গতা,	জায়গাটা,	
ala,	আলা,	আলা,	
chire,	চিরে,	চিরে,	
inafarameshana,	ইনারামেশন,	ইনফরমেশন,	
rajan,	রাজান,	রাজন,	
dhhaabi,	ঢাবি,	ঢাবি,	
boiragirhat,	বৈরাগীরত,	বৈরাগিরহাট,	
daaradaa,	দারাদা,	দারদা,	
baipass,	বাইপাস,	বাইপাস,	
mekong,	মেকং,	মেকং,	
sadeena,	সাদিনা,	সাডেন,	
dabarer,	দাবরের,	দাবারের,	
oblivion,	অবলিভনন,	অবলিভিয়ন,	
spredsheet,	স্প্রেডশিট,	স্প্রেডশীট,	
conflict,	কনফ্লিক্ট,	কনফ্লিক্ট,	
kanshat,	কংশাত,	কানসাট,	
dhangsantup,	ধ্বংসস্তূপ,	ধ্বংসন্তুপ,	
mutar,	মুতার,	মুতার,	
vaider,	বাইদের,	ভাইদের,	
gronthowo,	গ্রন্থুও,	গ্রন্থও,	
protiakromonei,	প্রতিয়াক্মমেনেই,	প্রতিআক্রমণেই,	
vittimul,	বিত্তিমূল,	ভিত্তিমূল,	
golghare,	গোলঘরে,	গোলঘরে,	
konar,	কোনার,	কণার,	
proshadhoner,	প্রশাধনের,	প্রসাধনের,	
nagorikkey,	নাগরিককে,	নাগরিককে,	
kruser,	ক্রুসের,	ক্রুশের,	
shilver,	শিলভার,	সিলভার,	
sikkharrtheerao,	শিক্ষার্থীরাও,	শিক্ষার্থীরাও,	
cheerokoomari,	চিরুকুমারী,	চিরকুমারী,	
shten,	স্টেন,	স্টেন,	
majlishpur,	মজজিলপুর,	মজলিশপুর,	
airish,	আইরিস,	আইরিস,	
bihar,	বিহার,	বিহার,	
fitarsaho,	ফিতারসহ,	ফিতরসহ,	
encidablu,	এন্িডাসবুল,	এনসিডাব্লু,	
parq,	পার্ক,	পার্ক,	
taposgoner,	তাপসগণের,	তাপসগণের,	
mythological,	মিইথোজিলাল,	মাইথলজিকাল,	
ujobekeestan,	উজবেক্তন,	উজবেকিস্তান,	
mozdur,	মজদুর,	মজদুর,	
providere,	প্রভীদেরে,	প্রভাইডারে,	
bangladesh,	বাংলাদেশ,	বঙ্গালাদেস,	
totokhon,	ততখন,	ততক্ষন,	
dakope,	ডাকোপে,	দাকোপ,	
prachando,	প্রাচান্ড,	প্রচণ্ড,	
vange,	ভঙঙ্গে,	ভাঙ্গে,	
kod,	কডড,	কোড,	
nabayug,	নাবায়ুগ,	নবযুগ,	
azaan,	আজান,	আজান,	
gejeted,	গেজেটেড,	গেজেটেড,	
udbhaboney,	উদ্ভবনে,	উদ্ভাবনে,	
fulkapi,	ফুলকাপি,	ফুলকপি,	
dormroome,	দর্মুরূমে,	ডর্মরুমে,	
heelser,	হিল্সের,	হিলসের,	
soceitytey,	সোেইটিইট,	সোসাইটিতে,	
peethey,	পিথে,	পীঠে,	
mardud,	মার্দুদ,	মরদুদ,	
sithilota,	সীথিলতা,	শিথিলতা,	
hosne,	হোসনে,	হোসনে,	
bonbhumi,	বনভূমি,	বনভূমি,	
kuthibarike,	কুথিবারীকে,	কুঠিবাড়ীকে,	
dobhara,	দোভারা,	ডোভার,	
bhuushito,	ভূশিত,	ভূষিত,	
vromonkaley,	ভ্রমণকালে,	ভ্রমণকালে,	
utsahamulak,	উৎসমহূলক,	উৎসাহমূলক,	
chintamani,	চিন্তামনি,	চিন্তামনি,	
wedanta,	ওয়াডান্টা,	বেদান্ত,	
benojir,	বেনোজির,	বেনজীর,	
aborto,	আবর্ত,	আবর্ত,	
durotamo,	দুরোতম,	দূরতম,	
vaisoho,	ভাইসোহ,	ভাইসহ,	
zesa,	জেসা,	জেস,	
monohputo,	মনঃপুত,	মনঃপুত,	
granada,	গ্রানাডা,	গ্র্যানাডা,	
prosadhaner,	প্রসাধানের,	প্রসাধনের,	
jipiusamriddha,	জিপিসমমিৃদ্ধ,	জিপিউসমৃদ্ধ,	
horiddar,	হরিদ্দার,	হরিদ্বার,	
difinision,	ডিফিনিশন,	ডেফিনেশন,	
bhimsen,	ভিমসেন,	ভীমসেন,	
glanio,	গ্লানিও,	গ্লানিও,	
karadandey,	কররাদ্ডে,	কারাদণ্ডে,	
abarte,	আবার্তে,	আবর্তে,	
daltagi,	ডালতাগী,	দলত্যাগী,	
brake,	ব্রাকে,	ব্রেক,	
khalidkay,	খলিদকে,	খালিদকে,	
dhanche,	ধাঁছে,	ধাঁচে,	
janghu,	জাংঘু,	জঙ্ঘু,	
cbi,	সিবিআই,	সিবিআই,	
mumtaj,	মুমতাজ,	মুমতাজ,	
patigoniter,	পাতিগনিতের,	পাটিগণিতের,	
sharif,	শারিফ,	শরিফ,	
nopdnodir,	নপনদোরির,	নদনদীর,	
bulan,	বুলান,	বুলান,	
forma,	ফোরমা,	ফর্মা,	
humira,	হুমিরা,	হুমিরা,	
bhyatikaner,	ভ্যাতিকানের,	ভ্যাটিকানের,	
komanera,	কোমানেরা,	কমানেরা,	
bhaandar,	ভান্ডার,	ভাণ্ডার,	
timoothi,	তিমোথি,	টিমোথি,	
upobaasee,	উপবাসী,	উপবাসী,	
khoka,	খোখা,	খোকা,	
chalochchitreei,	চালচ্ছিত্রীই,	চলচ্চিত্রেই,	
adwanced,	অ্যাডসেন্ডেড,	অ্যাডভান্সড,	
mekon,	মেকোন,	মেকং,	
bolvodro,	বলভোদ্রো,	বলভদ্র,	
kormoi,	কর্মই,	কর্মই,	
shoodhooi,	শুধুই,	শুধুই,	
jeelyaand,	জীল্লান্দ,	জিল্যান্ড,	
habol,	হাবল,	হাবোল,	
rupantarer,	রূপান্তরের,	রুপান্তরের,	
madrasa,	মাদরাসা,	মাদ্রাসা,	
baarbadoj,	বার্বাজন,	বার্বাডোজ,	
deejeejer,	দীজের,	ডিজিজের,	
malinga,	মালিঙ্গা,	মালিংগা,	
kale,	কালে,	কালে,	
yatharthabhabe,	যথথারভাবে,	যথার্থভাবে,	
manibhaijaner,	মনিভাইজানের,	মণিভাইজানের,	
ched,	চেদেদ,	ছেদ,	
bishnu,	বিষ্ণু,	বিষ্ণু,	
dhangsachchi,	ধাংসচ্চি,	ধ্বংসাচ্ছি,	
stander,	স্ট্যান্ডার,	স্ট্যাণ্ডের,	
dinifitian,	ডিনিফিটান,	ডেফিনেশন,	
ingrezeeteo,	ইনগ্রেজিতেও,	ইংরেজিতেও,	
hepatitis,	হেপাটিটিস,	হেপাটাইটিস,	
lettere,	লেট্টারে,	লেটারে,	
peeri,	পীরি,	পেরি,	
saranor,	সারানোর,	সরানোর,	
rabo,	রাবো,	রব,	
mathieu,	ম্যাথিও,	ম্যাথিউ,	
dhhaloor,	ঢালুর,	ঢালুর,	
detik,	দেতিক,	দেতিক,	
dijmarescu,	ডিজমারেস্ক,	দিজমার্সাকু,	
nirdesika,	নির্দেসিকা,	নির্দেশিকা,	
nibirbhabe,	নিবীরভাবে,	নিবিরভাবে,	
asociatis,	অসোিয়াটিস,	এসোসিয়েটস,	
fand,	ফ্যান্ড,	ফান্ড,	
harasta,	হারাস্তা,	হারাস্তা,	
nili,	নিলি,	নিলি,	
joumana,	জৌমানা,	জুমানা,	
janmat,	জানমত,	জন্মাত,	
dinara,	দিনারা,	ডিনার,	
rodney,	রডনে,	রেডনি,	
procharona,	প্রচারণা,	প্রচারণা,	
maley,	মালে,	মালে,	
megacaldera,	মেগাকাল্লার,	মেগাক্যাল্ডেরা,	
venice,	ভেনিক,	ভেনিস,	
mukharji,	মুখার্ি,	মুখার্জী,	
kormokarer,	কর্মকারের,	কর্মকারের,	
balatkar,	বালাতকর,	বলাৎকার,	
atorkitey,	আতর্কিতে,	অতর্কিতে,	
muktijuddhojato,	মুক্তিযুদ্ধাত,	মুক্তিযুদ্ধজাত,	
samajeek,	সমাজিক,	সামাজিক,	
sorsa,	সোর্সা,	সোর্স,	
jamseder,	জামেসদের,	জামসেদের,	
somraat,	সোমরাত,	সম্রাট,	
podotyagsongkranto,	পদত্যস্গানক্ত,	পদত্যাগসংক্রান্ত,	
janagononar,	জানাগণনার,	জনগণনার,	
aarmstrong,	আর্মস্ট্রং,	আর্মস্ট্রং,	
kramp,	ক্রাম্প,	ক্র্যাম্প,	
modyer,	মদ্যের,	মদ্যের,	
edic,	এডিক,	এডিক,	
aholyar,	আহল্যার,	অহল্যার,	
ongshogrohoner,	অংশগ্রহণের,	অংশগ্রহনের,	
bikargrosto,	বিকারগ্রস্ত,	বিকারগ্রস্ত,	
daaktikit,	দাক্তিকিট,	ডাকটিকিট,	
sqalastiqa,	স্কালাস্কিকা,	স্কলাস্টিক,	
durgatsabe,	দুর্গতসবে,	দুর্গোৎসবে,	
tarkale,	তারকালে,	তারকালে,	
minister,	মিনিস্টার,	মিনিস্টার,	
eporjonto,	এপর্ন্ত,	এপর্যন্ত,	
soomita,	সমুতা,	সুমিতা,	
mojdur,	মজদুর,	মজদুর,	
braqe,	ব্র্যাকে,	ব্রেক,	
doorotaumo,	দরুতামো,	দূরতম,	
satarkabhabe,	সতরকাভাবে,	সতর্কভাবে,	
cholchhe,	চলেছে,	চলছে,	
madelim,	ম্যাডেলিম,	মডেলিং,	
chopol,	চোপল,	চপল,	
gore,	গোরে,	গোর,	
pray,	প্রেয়,	প্রায়,	
sahachke,	সাহাচকে,	সাহাচকে,	
aajeej,	আজিজ,	আজিজ,	
irish,	ইরিশ,	আইরিস,	
udor,	উদর,	উদর,	
aachhis,	আচিস,	আছিস,	
chandrimaa,	চন্দ্রিমা,	চন্দ্রিমা,	
munot,	মুনোট,	মুনোট,	
katiusha,	কতিউশা,	কাতিউশা,	
korijachilen,	করিজাচিলেন,	করিযাছিলেন,	
shatoke,	শতকে,	শতকে,	
elaakaa,	এলাকাকা,	এলাকা,	
besur,	বেসুর,	বেসুর,	
bhoolapuka,	ভৌলপুকা,	ভোলাপুক,	
daraider,	দারাইদের,	দরাইদের,	
surke,	সুরকে,	সুরকে,	
thyachara,	ঠ্যাচারা,	থ্যাচার,	
sthapanar,	স্থাপনার,	স্থাপনার,	
bollov,	বলোভ,	বল্লভ,	
shekender,	শেকেন্দের,	সেকেন্ডের,	
probolshoktio,	প্রবলশক্তিও,	প্রবলশক্তিও,	
tata,	টাটা,	তাতা,	
narbur,	নারবুর,	নরবুর,	
khanabale,	খানাবালে,	খানাবলে,	
booponer,	বুপনের,	বপনের,	
samany,	সামানি,	সামান্য,	
jhijhi,	ঝিজি,	ঝিঝি,	
kharavel,	খরবেল,	খারবেল,	
shoori,	শূরী,	সুরি,	
dreeshtiheen,	দৃষ্টিহীন,	দৃষ্টিহীন,	
ronodeep,	রণোদেপ,	রণদীপ,	
nathibhuktir,	নাথিভুক্তির,	নথিভুক্তির,	
bosoben,	বসবেন,	বসবেন,	
teta,	টেট,	টেটা,	
literacy,	লিটেরেসি,	লিটারেসি,	
mandape,	মণ্ডপে,	মন্ডপে,	
avisongson,	এভিসনসন,	অভিশংসন,	
avinetar,	অভিনেতার,	অভিনেতার,	
chhootochhuti,	ছোটুচুটি,	ছুটোছুটি,	
augustine,	অগাস্টিন,	অগাস্টিন,	
angkita,	অংকিতা,	অঙ্কিতা,	
chanoo,	চানু,	চানু,	
huqa,	হুকা,	হুক,	
nadnadeer,	নদনাদির,	নদনদীর,	
dharmee,	ধর্মী,	ধর্মী,	
elaakaate,	এলাকাতে,	এলাকাতে,	
kodorer,	কদরের,	কদরের,	
dheke,	ধেকে,	ঢেকে,	
nothivukto,	নথিভুক্ত,	নথিভুক্ত,	
varote,	ভারোতে,	ভারতে,	
chheher,	ছেহের,	ছেহের,	
somsher,	সম্ের,	সমশের,	
ancholsomuho,	আঞ্চলসমূহ,	অঞ্চলসমূহ,	
rashider,	রাশীদের,	রশিদের,	
pravura,	প্রভূরা,	প্রভুরা,	
cheento,	চিন্ত,	চিনতো,	
ponero,	পোনেরো,	পনের,	
bm,	বিএমএম,	বিএম,	
konruup,	কনরুউপ,	কোনরূপ,	
onupater,	অনুপাতের,	অনুপাতের,	
chaiten,	চাইতেন,	চাইতেন,	
fimela,	ফিমেলা,	ফিমেল,	
chikitsar,	চিকিতসার,	চিকিত্সার,	
sift,	সিফট,	শিফট,	
khudhartara,	ক্ষুধারটরা,	ক্ষুধার্তরা,	
shikh,	শিখ,	শিখ,	
arthonitite,	অর্থনীতিতে,	অর্থনীতিতে,	
antarctica,	অ্যান্টার্টিকা,	অ্যান্টার্কটিকার,	
deobonde,	দেওবন্দে,	দেওবন্দে,	
wagadada,	ওয়াগাড়া,	বাগদাদ,	
bossonte,	বস্ন্তে,	বসন্তে,	
grambaashi,	গ্রামবাশী,	গ্রামবাসী,	
motke,	মটকে,	মতকে,	
safin,	সাফিন,	সাফিন,	
dada,	দাদা,	দাদা,	
turkeyder,	টারকেইডের,	তুর্কিদের,	
jhimochchilo,	ঝিমোচ্ছিল,	ঝিমোচ্ছিলো,	
naagaalyand,	নাগাল্যান্দ,	নাগাল্যান্ড,	
durlabhatwang,	দূর্লাববতাবং,	দুর্লভত্বং,	
matrirup,	মাতৃরূপ,	মাতৃরূপ,	
shatodha,	শাতোধা,	শতধা,	
duio,	দুইও,	দুইও,	
dibug,	দীবুগ,	ডিবাগ,	
saom,	সায়াম,	সাওম,	
bibechyo,	বিবেচ্য,	বিবেচ্য,	
saoum,	সাওয়ুম,	সাওম,	
unitgulo,	ইউনিটগুলো,	ইউনিটগুলো,	
procharjontrogulo,	প্রচার্ত্ন্রগুলো,	প্রচারযন্ত্রগুলো,	
somoodrotote,	সমুদ্রততে,	সমুদ্রতটে,	
shattoki,	শত্যকি,	সাত্যকি,	
teenisa,	টিনিস,	টেনিস,	
nirmol,	নির্মল,	নির্মল,	
sahittekder,	সাহিত্যেদের,	সাহিত্যেকদের,	
pariyech,	পরিয়েছ,	পরিয়েছ,	
punorabortonte,	পুনরাবর্তন্তে,	পুনরাবর্তন্তে,	
shrabasti,	শ্রাবস্তি,	শ্রাবস্তী,	
ujobekeestaner,	উজবেক্তানের,	উজবেকিস্তানের,	
sqalarashipa,	স্কলারাশিপা,	স্কলারশিপ,	
dubureer,	দুবুরীর,	ডুবুরির,	
mayily,	মেয়ালি,	মাইলি,	
jeebnagore,	জীবনাগোরে,	জীবননগর,	
uporitoler,	উপরিতলের,	উপরিতলের,	
tukrowti,	টুকরোটি,	টুকরোটি,	
promothesh,	প্রমতেষেষ,	প্রমথেশ,	
kazianis,	কাজিয়ানিস,	কাজানিস,	
groundta,	গ্রান্ডটা,	গ্রাউন্ডটা,	
eoki,	ইওকি,	এওকি,	
antarctika,	অন্টার্টিকা,	অ্যান্টার্কটিকা,	
collaborators,	কলারাটার্টস,	কলাবরেটরস,	
mookhomaundoler,	মখুমণ্ডলের,	মুখমণ্ডলের,	
shasheja,	শাষেজা,	সসেজ,	
satarka,	সতর্কা,	সতর্ক,	
shrichaitanyadev,	শ্রীচৈত্ননেদেব,	শ্রীচৈতন্যদেব,	
durbhagya,	দুর্ভাগ্যা,	দূর্ভাগ্য,	
chal,	চাল,	চাল,	
kathla,	কাঠলা,	কাঠলা,	
deilee,	দীইলে,	ডেইলি,	
dhyana,	ধ্যানা,	ধ্যান,	
kaferder,	কাফারদের,	কাফেরদের,	
panchasjan,	পঞ্চজসজন,	পঞ্চাশজন,	
karam,	কারাম,	কেরাম,	
veniser,	ভেনিসের,	ভেনিসের,	
nirmankarmisaha,	নির্মনককর্মিসহ,	নির্মাণকর্মীসহ,	
baieq,	বাইক,	বাইক,	
keyboarder,	কেয়বোর্ডের,	কীবোর্ডের,	
expreshshion,	এক্সপ্রেশন,	এক্সপ্রেশন,	
shandra,	শান্দ্রা,	শান্দ্রার,	
registrikrito,	রেজিস্ট্রিকৃত,	রেজিস্ট্রীকৃত,	
motkey,	মোককে,	মতকে,	
rudiger,	রুডিগের,	রুদিগের,	
agora,	অগোরা,	আগোরা,	
mekapgulo,	মেকাপগুলো,	মেকআপগুলো,	
durarohini,	দুরারিহীনী,	দুরারোহিণী,	
chhadura,	ছাদুরা,	ছাদুরা,	
chalachchitrei,	চালাচ্ছিত্রেই,	চলচ্চিত্রেই,	
audiotike,	অডিওটিকে,	অডিওটিকে,	
teemothi,	তিমোথি,	টিমোথি,	
ostad,	ওস্তাদ,	ওস্তাদ,	
manushti,	মানুষ্তি,	মানুষটি,	
shipley,	শিপলে,	শিপলে,	
chhutochhooti,	ছুটোছুটি,	ছুটোছুটি,	
shilpajata,	শিল্পাজত,	শিল্পজাত,	
armshtrong,	আর্মোট্রং,	আর্মস্ট্রং,	
nodimaatrik,	নদীমাত্রিক,	নদীমাতৃক,	
alexandar,	আলেক্স্যান্ডার,	আলেকজান্ডার,	
bodhirta,	বোধিরটা,	বধিরতা,	
durgotsab,	দুর্গৎসাব,	দুর্গোৎসব,	
dianes,	ডাইনেস,	ডিএনএস,	
jotsna,	জোটসনা,	জ্যোৎস্না,	
eekbalke,	একবলকে,	ইকবালকে,	
palteche,	পালতেছে,	পাল্টেছে,	
oncholke,	অঞ্চকে,	অঞ্চলকে,	
shubhag,	শুভাগ,	শুভাগ,	
taxikeo,	ট্যাক্সিকেও,	ট্যাক্সিকেও,	
audioguloke,	অডিওগুলোকে,	অডিওগুলোকে,	
ekspression,	এক্সপ্রেশন,	এক্সপ্রেশন,	
ovidhanik,	অভিধানিক,	অভিধানিক,	
elakatikay,	এলাকাতিকা,	এলাকাটিকে,	
planea,	প্লেনে,	প্লেনে,	
mishal,	মিশাল,	মিশাল,	
satarkakari,	সতর্ককারী,	সতর্ককারী,	
suraaropito,	সুরারোপিত,	সুরারোপিত,	
madraser,	মাদরাসের,	মাদ্রাজের,	
patrol,	প্যাটরোল,	পেট্রোল,	
awatar,	অবেতার,	অবতার,	
dara,	দারা,	দারা,	
vimsen,	ভিমসেন,	ভীমসেন,	
chhatrodiger,	ছাত্রদীগের,	ছাত্রদিগের,	
croak,	ক্রোয়াক,	ক্রোক,	
fastag,	ফাস্তাগ,	ফ্যাসট্যাগ,	
chhuteer,	ছুটির,	ছুটির,	
modele,	মডেলে,	মডেলে,	
byepass,	বেআপস,	বাইপাস,	
guzon,	গুজন,	গুজব,	
tiger,	টিগার,	টাইগার,	
korle,	করলে,	করলে,	
philo,	ফিলো,	ফিলো,	
evaner,	ইভানের,	ইভানের,	
tookrote,	টুক্রোট,	টুকরোতে,	
nojder,	নজদের,	নজদের,	
times,	টিমেস,	টাইমস্,	
ghatla,	ঘাটলা,	ঘটল,	
homsher,	হোমের,	হোমসের,	
streegon,	স্ট্রীগন,	স্ত্রীগণ,	
mukhomandoler,	মুখমণ্ডলের,	মুখমণ্ডলের,	
choddo,	চদ্দ,	চোদ্দো,	
korimpur,	করিমপুর,	করিমপুর,	
joki,	জোকি,	জকি,	
pracharanamulak,	প্রচরণমূলক,	প্রচারণামূলক,	
sombhobonaao,	সম্ভবনাও,	সম্ভবনাও,	
dhandu,	ধান্দু,	ধন্দু,	
srisri,	শ্রীশ্রী,	শ্রীশ্রী,	
geejeeteeda,	গীজেতা,	গেজেটেড,	
madhoboir,	মাধবীর,	মাধবীর,	
nothibhukteer,	নথিভুক্তির,	নথিভুক্তির,	
engrejer,	এঙ্গেজের,	ইংরেজের,	
prothar,	প্রথার,	প্রথার,	
foolkopi,	ফুলকোপি,	ফুলকপি,	
baasaate,	বাসাতে,	বাসাতে,	
swatantrata,	স্বনত্রত্ত,	স্বতন্ত্রতা,	
abodamaner,	অবদামানের,	অবদমনের,	
dito,	ডিটো,	দিতো,	
chokhwala,	চোখবালা,	চোখওয়ালা,	
naabyota,	নাব্যতা,	নাব্যতা,	
tophaat,	টোফাট,	তফাৎ,	
makong,	মাকং,	মেকং,	
dharavahik,	ধারাবিখিক,	ধারাবাহিক,	
temanti,	টেমানটি,	তেমনটি,	
parkasa,	পারকাসা,	পার্কস,	
probhur,	প্রভুর,	প্রভুর,	
chhooti,	ছুতি,	ছুটি,	
dajjha,	দাজঝা,	দাহ্য,	
bhromonkaale,	ভ্রমণকালে,	ভ্রমণকালে,	
muradpur,	মুরাদপুর,	মুরাদপুর,	
rilayensha,	রিলয়েন্শ,	রিলায়েন্স,	
pratisthanikvabe,	প্রতিস্থানীকভাবে,	প্রাতিষ্ঠানিকভাবে,	
tintikey,	তিনটিকে,	তিনটিকে,	
murader,	মুরাদের,	মুরাদের,	
byaboharkarike,	ব্যবহারকারীকে,	ব্যবহারকারীকে,	
chalachchitroi,	চালাচ্ছিত্রই,	চলচ্চিত্রই,	
siddhante,	সিদ্ধান্তে,	সিদ্ধান্তে,	
ovidhaner,	অভিধানের,	অভিধানের,	
redcrosser,	রেড্রক্সের,	রেডক্রসের,	
kalakushalir,	কালাকুশালীর,	কলাকুশলীর,	
eokee,	ইওকি,	এওকি,	
mah,	মাহ,	মাহে,	
sallallahu,	সাল্লাল্লাহু,	সল্লাল্লাহু,	
patininda,	পাতিনিন্দা,	পতিনিন্দ,	
torikher,	তরিখের,	তরিখের,	
spreadshiit,	স্প্রেডশটিট,	স্প্রেডশীট,	
jalbe,	জালবে,	জ্বলবে,	
protul,	প্রতুল,	প্রতুল,	
dhwajbhango,	ধ্বাজভঙ্গ,	ধ্বজভঙ্গ,	
mahasava,	মহাসভা,	মহাসভা,	
elakatite,	এলাকাটিতে,	এলাকাটিকে,	
rayyaleti,	রয়ালেটি,	রয়্যালটি,	
moonshi,	মুনশি,	মুন্সি,	
eukalyptus,	ইউকালিপ্পাস,	ইউক্যালিপ্টাস,	
obosan,	অবসান,	অবসান,	
caramiks,	কারামিকস,	সিরামিকস,	
plaiin,	প্লেইন,	প্লেন,	
ansarir,	আনসারির,	আনসারীর,	
fising,	ফিসিং,	ফিসিং,	
badaghat,	বাদাঘাট,	বাদাঘাট,	
brittakar,	বৃত্তকার,	বৃত্তাকার,	
himsrot,	হিমস্রট,	হিমস্রোত,	
sharoker,	শারকের,	স্মারকের,	
ul,	ইউল,	উল,	
nirarthak,	নিরারথক,	নিরর্থক,	
bahjya,	বাহজ্যা,	বাহ্য,	
baire,	বাইরে,	বাইরে,	
gonohotyakey,	গণহত্যাকে,	গণহত্যাকে,	
shikare,	শিকারে,	শিকারে,	
edmeeral,	এডমিরাল,	এডমিরাল,	
deh,	দেহ,	দেহ্,	
gopalrao,	গোপালরাও,	গোপালরাও,	
murali,	মুরালি,	মুরলী,	
oswastikor,	অস্বাস্তিকর,	অস্বস্তিকর,	
bbiswashke,	বিব্বিশ্বকে,	বিশ্বাসকে,	
jones,	জোনেস,	জোন্স,	
shikkhartheerao,	শিক্ষার্থীরাও,	শিক্ষার্থীরাও,	
graambaaseer,	গ্রামবাইসার,	গ্রামবাসীর,	
badargaji,	বদরগাজি,	বদরগাজী,	
dharabahikotitey,	ধারাবাহকিতিতে,	ধারাবাহিকটিতে,	
dharmantor,	ধর্মান্তর,	ধর্মান্তর,	
byapoktor,	ব্যাপক্তর,	ব্যাপকতর,	
makhno,	মাখনো,	মাখনো,	
harysoner,	হ্যারিসনের,	হ্যারিসনের,	
chalochchitraeeo,	চালচ্চিত্রাও,	চলচ্চিত্রেও,	
jonee,	জনন,	জনি,	
jotota,	যততা,	যতোটা,	
dipon,	ডিপন,	দীপন,	
maudelti,	মৌডেলটি,	মডেলটি,	
gandhiio,	গান্ধিও,	গান্ধীও,	
rajbondir,	রাজবন্দির,	রাজবন্দীর,	
bokul,	বকুল,	বকুল,	
abdan,	আবদান,	আব্দান,	
sausage,	সৌসাগে,	সসেজ,	
whole,	ভোলে,	হোল,	
addabaj,	আদ্দাবাজ,	আড্ডাবাজ,	
bhalobaas,	ভালোবাস,	ভালোবাসা,	
gosthike,	গোস্থীকে,	গোষ্ঠীকে,	
bakhyateet,	বাখ্যাতেত,	ব্যাখ্যাতীত,	
turisht,	তুরিষ্ট,	টুরিস্ট,	
jolaatonko,	জলাতানকো,	জলাতঙ্ক,	
station,	স্টেশন,	ষ্টেশন,	
soleel,	সলিল,	সলিল,	
peerry,	পিরিরি,	পেরি,	
natshi,	নাটশি,	নাত্সি,	
torunra,	তোরুনরা,	তরুণরা,	
donat,	দোনাত,	ডোনাট,	
manbe,	মানবে,	মানবে,	
bodhirota,	বধিরতা,	বধিরতা,	
tawnship,	তাউনশীপ,	টাউনশিপ,	
pachchi,	পাচ্ছি,	পাচ্ছি,	
sokkhomotabriddhi,	সক্ষতমাবৃদ্ধি,	সক্ষমতাবৃদ্ধি,	
bandhan,	বান্ধন,	বাঁধন,	
bairey,	বাইরে,	বাইরে,	
khalidke,	খালিদকে,	খালিদকে,	
ahalyar,	আহল্যার,	অহল্যার,	
saver,	সাভের,	সেভার,	
dharabahikbhabe,	ধারাবাহিকভাবে,	ধারাবাহিকভাবে,	
bbiswash,	বিব্ব্বাস,	বিশ্বাস,	
mimgulor,	মিমগুলোর,	মিমগুলোর,	
bim,	বিম,	বিম,	
sampadoner,	সম্পাদনের,	সম্পাদনের,	
pharn,	ফার্ন,	ফার্ন,	
themekey,	থেমেকে,	থিমকে,	
sangharshik,	সংঘর্ষিক,	সাংঘর্ষিক,	
debdebie,	দেবদেবি,	দেবদেবী,	
bongshokey,	বংশকে,	বংশকে,	
erajyobasi,	এরজ্জাবাসী,	এরাজ্যবাসী,	
michir,	মিচির,	মিচির,	
sten,	স্টেন,	স্টেন,	
xpose,	ক্ষিপসে,	এক্সপোজ,	
breel,	ব্রিল,	ব্রিল,	
oncoleo,	অনকোলেও,	অঞ্চলেও,	
shringgo,	শ্রীংগো,	শৃঙ্গ,	
maktum,	মাক্তুম,	মাকতুম,	
mujuru,	মুজুরু,	মুজুরু,	
bee,	বিআই,	বি,	
laagche,	লাগছে,	লাগছে,	
abeganuvutir,	আবেগানাভুটির,	আবেগানুভূতির,	
kampita,	কাম্পিতা,	কম্পিত,	
ganosochetonota,	গণসচেতনতা,	গণসচেতনতা,	
temone,	টেমোন,	তেমনই,	
mentither,	মেন্টিথের,	মেনটিথের,	
bachai,	বাচাই,	বাছাই,	
nutan,	নুতান,	নূতন,	
shrabosty,	শ্রাসস্তি,	শ্রাবস্তী,	
digreeke,	ডিগ্রিকে,	ডিগ্রিকে,	
zeebonto,	জীবনত,	জীবন্ত,	
daayitto,	দায়ীত্ব,	দায়িত্ব,	
premoronge,	প্রেমরঙ্গে,	প্রেমরঙে,	
batikromshalee,	বাতিক্রমালী,	ব্যতিক্রমধর্মী,	
photanor,	ফটোনার,	ফোটানোর,	
scholarsip,	স্কোর্সিপ,	স্কলারশিপ,	
neck,	নেক,	নেক,	
uchchotara,	উচ্চতারা,	উচ্চতর,	
murad,	মুরাদ,	মুরাদ,	
carloos,	কারলোস,	কার্লোস,	
awrbit,	অ্যাবিত,	অরবিট,	
saifullahil,	সাইফুল্লাহিল,	সাইফুল্লাহিল,	
durgotshob,	দুর্গতৎব,	দুর্গোৎসব,	
kormobuddhite,	কর্মবুদ্ধিতে,	কর্মবুদ্ধিতে,	
karmosansthan,	কর্মসনস্থান,	কর্মসংস্থান,	
sarder,	সার্ডের,	সরদার,	
aakaabaar,	আকাবার,	আকাবার,	
karuna,	কারুনা,	করুণা,	
itostatah,	ইতোস্টাঃ,	ইতস্ততঃ,	
dooburira,	দুবুরীরা,	ডুবুরিরা,	
shommoteer,	শম্মতির,	সম্মতির,	
beshyasdone,	বেশ্যাসদনে,	বেশ্যাসদনে,	
dharmadasbabu,	ধর্মদবাবু,	ধর্মদাসবাবু,	
huk,	হুক,	হুক,	
ancholgoolote,	অঙ্চলগুলোতে,	অঞ্চলগুলোতে,	
pooshteer,	পুশ্টির,	পুষ্টির,	
hena,	হেনা,	হেনা,	
amudey,	আমুদে,	আমুদে,	
prokolpogulikei,	প্রকল্পগুলিকেই,	প্রকল্পগুলিকেই,	
karmokarke,	কার্মকারকে,	কর্মকারকে,	
forex,	ফোরেক্স,	ফরেক্স,	
prothakey,	প্রথাকে,	প্রথাকে,	
dhojovongo,	ধ্বজঙ্গ,	ধ্বজভঙ্গ,	
bonsho,	বনশো,	বংশ,	
segular,	সেগুলার,	সেগুলোর,	
juakhelar,	জুয়াখেলার,	জুয়াখেলার,	
akpaase,	আকপাসে,	একপাশে,	
artherer,	আর্থেরের,	আর্থারের,	
peshto,	পেষ্টো,	পেষ্ট,	
sharansthal,	শরনস্থল,	শরণস্থল,	
asamonjasyopurno,	অসমাণযুজ্রস্ণ,	অসামঞ্জস্যপূর্ণ,	
chiroharit,	চিরোহারিত,	চিরহরিৎ,	
sangkalanti,	সংকল্নটি,	সংকলনটি,	
aditisaha,	আদিতিসহ,	অদিতিসহ,	
vugoley,	ভুগলে,	ভূগোলে,	
obdee,	অবদে,	অব্দি,	
kamti,	কামতি,	কমতি,	
khudrokar,	ক্ষুদ্রকার,	ক্ষুদ্রকার,	
mexicoteo,	মেক্সিকোটেও,	মেক্সিকোতেও,	
dijijer,	দিজিজের,	ডিজিজের,	
asaktibandhan,	অসম্তিক্বান্ধন,	আসক্তিবন্ধন,	
loombinee,	লুমবিনি,	লুম্বিনী,	
puroheetder,	পুরহীতদের,	পুরোহিতদের,	
laaisens,	লেইসেন্স,	লাইসেন্স,	
danab,	দানাব,	দানব,	
hupile,	হুপিলে,	হুপিলে,	
ghotol,	ঘটল,	ঘটল,	
nothiboddho,	নথিবদ্ধ,	নথিবদ্ধ,	
chhutir,	ছুটির,	ছুটির,	
raghubar,	রঘুবার,	রঘুবীর,	
poriharsoho,	পরিরাসহ,	পরিহারসহ,	
kekru,	কেকরু,	কেকরু,	
boikalyo,	বৈকল্য,	বৈকল্য,	
dorgah,	দোরগাহ,	দরগাহ,	
durgatsob,	দুর্গাৎসব,	দুর্গোৎসব,	
eshiyetika,	এশিয়েতিকা,	এশিয়াটিক,	
tigre,	টাইগ্রে,	টাইগার,	
hafsa,	হাফসা,	হাফসা,	
sommotite,	সম্মতিতে,	সম্মতিতে,	
prasadhani,	প্রসাধনী,	প্রসাধনী,	
prokolpogulor,	প্রকল্পগুলোর,	প্রকল্পগুলোর,	
sontoshpur,	সন্তপ্ুর,	সন্তোষপুর,	
reshidensha,	রেশিনেশদ,	রেসিডেন্স,	
kompeeto,	কম্পীত,	কম্পিত,	
ramachandranke,	রামাচন্দ্রকে,	রামাচন্দ্রনকে,	
siddhantoke,	সিদ্ধান্তকে,	সিদ্ধান্তকে,	
machsoho,	মাচসহ,	মাছসহ,	
taufiq,	তাফিক,	তৌফিক,	
bhimsenkei,	ভিমসেনকেই,	ভীমসেনকেই,	
teoner,	টেওনের,	টিওনার,	
prime,	প্রাইম,	প্রাইম,	
drissoke,	দৃষ্মকে,	দৃশ্যকে,	
hajeerhatt,	হাজেরহাট্ট,	হাজিরহাট,	
graambaashee,	গ্রা্বাশী,	গ্রামবাসী,	
vitti,	ভিত্তি,	ভিত্তিই,	
abheedhaaneek,	অভিধাইক,	অভিধানিক,	
romjaner,	রোমজানের,	রমযানের,	
dhaleshorii,	ধালেশরি,	ধলেশ্বরী,	
anandamahale,	আনন্দমহলে,	আনন্দমহলে,	
dormetori,	দর্মেতোরি,	ডরমিটরি,	
moresbai,	মোরেসবাই,	মোরেসবাই,	
dai,	দাই,	ডে,	
agomonke,	আগমনকে,	আগমনকে,	
daktikit,	ডাক্তিকিট,	ডাকটিকিট,	
spreedashita,	স্প্রীদশিত,	স্প্রেডশীট,	
oporishodhito,	অপরিষিদত,	অপরিশোধিত,	
nishad,	নিশাদ,	নিষাদ,	
garora,	গারোরা,	গারোরা,	
dorneca,	ডর্নেকা,	ডরনেকা,	
enginiiring,	ইঞ্জিনিরিং,	ইঞ্জিনিয়ারিং,	
urey,	ইউরে,	ইউরি,	
gaichhe,	গাইছে,	গাইছে,	
pachak,	পাচক,	পাচক,	
gazetted,	গেজেটেটেড,	গেজেটেড,	
pabo,	পাবো,	পাব,	
duhsthanostho,	দুঃস্থানস্থ,	দুঃস্থানস্থ,	
ramnathbabur,	রামনাথবাবুর,	রামনাথবাবুর,	
sikkhokder,	শিক্ষকদের,	শিক্ষকদের,	
upobasee,	উপবাসী,	উপবাসী,	
oncholeo,	অঞ্চলেও,	অঞ্চলেও,	
kadam,	কাদাম,	কদম,	
kuldip,	কুল্ডিপ,	কুলদীপ,	
kurdider,	কুর্দিদের,	কুর্দিদের,	
ayumi,	আয়ুমি,	আয়ুমি,	
addata,	আদ্যাতা,	আড্ডাটা,	
showtey,	শোতে,	শোতে,	
qrisenta,	ক্রিসেন্ট,	ক্রিসেন্ট,	
kushumba,	কুশুমবা,	কুশুম্বা,	
manushgulor,	মানুশগুলোর,	মানুষগুলোর,	
bangulzai,	বাঙ্গুলজাই,	বঙ্গুলিজাই,	
sanaktokaran,	সনক্তকরণ,	সনাক্তকরণ,	
distibutor,	ডিস্টিবুটর,	ডিস্টিবিউটারের,	
debholopar,	দেবলপার,	ডেভলপার,	
lyataa,	ল্যাটা,	ল্যাটা,	
bisnuke,	বিস্নুকে,	বিষ্ণুকে,	
khagen,	খাগেন,	খগেন,	
omarader,	ওমারাদের,	ওমারাদের,	
hillse,	হিলসে,	হিলসে,	
landin,	ল্যান্ডিন,	ল্যান্ডিং,	
taims,	টাইমস,	টাইমস্,	
salchak,	সালচক,	সালচাক,	
dhache,	ধাচে,	ধাঁচে,	
bhadaka,	ভাদাকা,	ভদকা,	
ronangane,	রোনাঙ্গানে,	রণাঙ্গনে,	
rudroke,	রুদ্রকে,	রুদ্রকে,	
fanding,	ফ্যান্ডিং,	ফান্ডিং,	
hughkey,	হুঘকে,	হিউজকে,	
chitlar,	চিটলার,	চিতলার,	
torabgonj,	তরাবগঞ্জ,	তোরাবগঞ্জ,	
chinito,	চিনিত,	চিনতো,	
jumlalancer,	জুমলালাঙ্কের,	জুমলাল্যান্সার,	
aalkaatra,	আলকাত্র,	আলকাতরা,	
maunchostho,	মানচস্থ,	মঞ্চস্থ,	
eesa,	ইসসা,	আইএএস,	
soinyora,	সৈন্যরা,	সৈন্যরা,	
sookumari,	সুকুমারী,	সুকুমারী,	
soource,	সুউর্স,	সোর্স,	
akhhunno,	আখুন্ন,	অক্ষুণ্ণ,	
gonesher,	গনেষের,	গণেশের,	
chadake,	চাদাকে,	চড়াকে,	
graambasio,	গ্রাম্বাসিও,	গ্রামবাসীও,	
jyaqasana,	জ্যাকাসান,	জ্যাকসন,	
harris,	হ্যারির,	হ্যারিস,	
protectionism,	প্রটেকননশিম,	প্রোটেকশনিজম,	
baman,	বামান,	বামন,	
jackey,	জ্যাকে,	জকি,	
shariba,	শরিবা,	শরিবা,	
asantosh,	আসন্তোষ,	অসন্তোষ,	
hosney,	হোসনে,	হোসনে,	
lakkhero,	লাক্ষেরও,	লক্ষেরও,	
sobaiderke,	সবাইদেরকে,	সবাইদেরকে,	
elakatir,	এলাকাতির,	এলাকাটির,	
mosjidtir,	মসজিদটির,	মসজিদটির,	
shektor,	শেক্তর,	সেক্টর,	
uporoshtho,	উপরর্থ্থ,	উপরস্থ,	
waal,	ওয়াল,	উল,	
hariken,	হারিকেন,	হ্যারিকেন,	
jonesh,	জনেশ,	জোন্স,	
gabhaskaar,	গাভাস্কার,	গাভাস্কার,	
battery,	ব্যাটারি,	ব্যাটারী,	
vogno,	ভগ্ন,	ভগ্ন,	
srk,	স্র্ক,	শাহরুখ,	
recondishon,	রেকোন্ডিশন,	রিকন্ডিশন,	
unchuporjayer,	উঁচুপগর্যয়ের,	উঁচুপর্যায়ের,	
bonnopran,	বন্যপ্রাণ,	বন্যপ্রাণ,	
yanqee,	যানকী,	ইয়াংকি,	
esasiyetasa,	এসাসিয়েতাস,	এসোসিয়েটস,	
cheekitshar,	চিকিতিসর,	চিকিত্সার,	
ganoporibahon,	গণপরিবহহন,	গণপরিবহন,	
elakai,	এলাকাই,	এলাকাই,	
phiksim,	ফিকসিম,	ফিক্সিং,	
bisnoo,	বিস্নুও,	বিষ্ণু,	
bisheshyo,	বিশেষ্য,	বিশেষ্য,	
otyacharer,	অত্যচারের,	অত্যাচারের,	
difinisian,	ডিফিনিসিয়ান,	ডেফিনেশন,	
graambashee,	গ্রা্বাশী,	গ্রামবাসী,	
erythrian,	ইরিথ্রিয়ান,	এরিথ্রিয়ান,	
besirvagei,	বেসির্াভেই,	বেশিরভাগেই,	
obosore,	অবসরে,	অবসরে,	
somoibo,	সমইবো,	সমৈব,	
postac,	পোস্টাক,	পোস্টকে,	
shikkhakram,	শিক্ষাক্রম,	শিক্ষাক্রম,	
giitikobita,	গীতিকোবিতা,	গীতিকবিতা,	
eura,	ইউরু,	ইউরো,	
graambaashio,	গ্রামবাশীও,	গ্রামবাসীও,	
chikkingsasoho,	চিক্সিংসাসহ,	চিকিংসাসহ,	
shommotite,	শম্মতিতে,	সম্মতিতে,	
difinishion,	ডিফিনিশন,	ডেফিনেশন,	
argho,	আর্ঘো,	অর্ঘ্য,	
byabaharkareer,	ব্যবহারকারীর,	ব্যবহারকারীর,	
chandrima,	চন্দ্রিমা,	চন্দ্রিমা,	
rinobodh,	ঋণবোধ,	ঋণবোধ,	
chrystal,	ক্রিস্টাল,	ক্রাইস্টাল,	
tapdei,	তাপদেই,	তাপড়েই,	
bagdadii,	বাগদাডি,	বাগদাদী,	
bhugol,	ভূগল,	ভূগোল,	
porjotoker,	পর্যটকের,	পর্যটকের,	
nazranar,	নজরানার,	নাজরানার,	
edaningkale,	এডানিংকালে,	ইদানীংকালে,	
goora,	গোরা,	গোর,	
colgirl,	কলগির্ল,	কলগার্ল,	
peterke,	পেটারকে,	পিটারকে,	
scorey,	স্কোরে,	স্কোরে,	
liedtke,	লাইডেটকে,	লইডটক,	
rakhtokkharone,	রাখকতকারণে,	রক্তক্ষরণে,	
lutharan,	লুথারান,	লুথেরান,	
sealvi,	সিলভি,	সিলভি,	
deeares,	ডায়েরেস,	ডিআরএস,	
sahittopritite,	সাহিত্যপৃতিতেতে,	সাহিত্যপ্রীতিতে,	
prokolpoti,	প্রকলপতি,	প্রকল্পটি,	
bostubad,	বস্তুবাদ,	বস্তুবাদ,	
dokkhinangsho,	দক্ষিণাংশ,	দক্ষিণাংশ,	
remission,	রেমিশন,	রিমিশন,	
adhunikkaley,	আধুনিককলে,	আধুনিককালে,	
kormokarke,	কর্মকারকে,	কর্মকারকে,	
sithilotar,	সীথিলতার,	শিথিলতার,	
koyekbare,	কয়েকবারে,	কয়েকবারে,	
popaike,	পোপাইকে,	পপাইকে,	
riphleksa,	রিফলেকসা,	রিফ্লেক্স,	
sonaktokaran,	সোনাক্তকারণ,	সনাক্তকরণ,	
jamjamat,	জামজামত,	জমজমাট,	
oisamoyer,	ঐসময়ের,	ঐসময়ের,	
jontrangshogulor,	যন্ত্রাংশগুলোর,	যন্ত্রাংশগুলোর,	
shikkharthirao,	শিক্ষার্থীরাও,	শিক্ষার্থীরাও,	
suiti,	সুইতি,	সুইটি,	
hypar,	হাইপার,	হাইপার,	
tukrote,	তুক্রতে,	টুকরোতে,	
koordira,	কোর্ডিরা,	কুর্দিরা,	
udbodhaney,	উদ্বধানে,	উদ্বোধনে,	
barrageke,	বারেজেকে,	ব্যারেজকে,	
azin,	আজিন,	আজিন,	
babare,	বাবারে,	বাবারে,	
spredashiita,	স্প্রেডাশিতা,	স্প্রেডশীট,	
parswer,	পার্সবার,	পার্শ্বের,	
munim,	মুনিম,	মুনিম,	
pacbar,	প্যাকবার,	পাঁচবার,	
nirbahey,	নির্বাহে,	নির্বাহে,	
binee,	বিনী,	বেনি,	
ganaparibahan,	গণপরিবহণ,	গণপরিবহন,	
anyorup,	অন্যরূপ,	অন্যরূপ,	
gorrer,	গোর্রের,	গোরের,	
chilahaati,	চিলাহাটি,	চিলাহাটি,	
jocqey,	জকে,	জকি,	
elaakate,	এলাকাতে,	এলাকাতে,	
abheedhaneek,	অভিধানক,	অভিধানিক,	
abdoone,	আবদুনে,	আবদুন,	
bohorompurer,	বহরপমপুরের,	বহরমপুরের,	
torutoler,	তরুতলের,	তরুতলের,	
jhalkanite,	ঝাককানিতে,	ঝলকানীতে,	
rajshri,	রাজশরী,	রাজশ্রী,	
middleton,	মিডলটটন,	মিডলটন,	
mohit,	মহিত,	মুহিত,	
hoteltee,	হটেলটি,	হোটেলটি,	
mele,	মেল,	মাইল,	
siqhar,	সিকহার,	শিকার,	
snehban,	স্নেহবান,	স্নেহবান,	
restuarant,	রেস্টুর্যান্ট,	রেষ্টুরেন্ট,	
dhos,	ধোস,	ধস,	
ikbaaler,	ইকবালের,	ইকবালের,	
dristiheen,	দৃষ্টিহীন,	দৃষ্টিহীন,	
golimodhye,	গলিমধ্যে,	গলিমধ্যে,	
steeit,	স্টিইট,	স্টেইট,	
palestine,	প্যালেস্টাইন,	প্যালেস্টাইনে,	
elaaka,	এলাকা,	এলাকা,	
bhangchur,	ভাংচুর,	ভাংচুর,	
projanankal,	প্রজানকাল,	প্রজননকাল,	
lutharen,	লুথারেন,	লুথেরান,	
shansthaner,	শান্স্থানের,	সংস্থানের,	
vabook,	ভাবুক,	ভাবুক,	
kraim,	ক্রাইম,	ক্রাইম,	
parking,	পার্কিং,	পার্কিং,	
jor,	জর,	জ্বর,	
maradeha,	মারাদেহা,	মরদেহ,	
saainyo,	সাইন্য,	সৈন্য,	
khoor,	খুউর,	ক্ষুর,	
supparak,	সুপ্পারক,	সুপ্পারক,	
bouddho,	বৌদ্ধ,	বৌদ্ধ,	
samanyai,	সামান্ই,	সামান্যই,	
aarik,	আরিক,	আরিক,	
cantan,	ক্যান্টান,	ক্যান্টন,	
parikha,	পরিখা,	পরিখার,	
chorban,	চরবান,	চর্বন,	
senabahineeow,	সেনাবাহিন,	সেনাবাহিনীও,	
abhiyojan,	অভিযোজন,	অভিযোজন,	
bosben,	বসবেন,	বসবেন,	
kantajir,	কান্তাজির,	কান্তজির,	
farna,	ফার্না,	ফার্ন,	
tachnach,	টাচনাচ,	তছনছ,	
nirvaha,	নির্ভাহা,	নির্বাহ,	
ritesh,	ঋতেশ,	রিতেশ,	
muradkey,	মুরাকডে,	মুরাদকে,	
byabaharkareederke,	ব্যবহারকীদেরকে,	ব্যবহারকারীদেরকে,	
ghuznavi,	গুজনাভী,	গজনভি,	
victor,	ভিক্টর,	ভিক্টর,	
udvaboney,	উদভানে,	উদ্ভাবনে,	
karaa,	করা,	কারো,	
mirina,	মিরিনা,	মিরিনা,	
dai,	দাই,	দিই,	
shilbar,	শিলবার,	সিলভার,	
teunar,	তেউনার,	টিউনার,	
bujhechhila,	বুঝেছিলা,	বুঝেছিল,	
deputee,	দেপুতি,	ডেপুটি,	
kinenni,	কিনেন্নি,	কিনেননি,	
swajan,	স্বজন,	স্বজন,	
semai,	সেমাই,	সেমাই,	
onurbar,	অনুর্বার,	অনুর্বর,	
muradke,	মুরাডকে,	মুরাদকে,	
shulfate,	শুলফাতে,	সালফেট,	
neerbahi,	নীরবাহী,	নির্বাহি,	
macbeth,	মাকবেছ,	ম্যাকবেথ,	
shangsthatikey,	সংস্থাটিকে,	সংস্থাটিকে,	
treebhuj,	ত্রিুজ,	ত্রিভূজ,	
thyachar,	থ্যাচার,	থ্যাচার,	
elakaate,	এলাকাতে,	এলাকাতে,	
monjooshree,	মঞ্জশূরী,	মঞ্জুশ্রী,	
seqtara,	সেকতারা,	সেক্টর,	
armashtram,	আর্মাষ্ট্রম,	আর্মস্ট্রং,	
bikretaara,	বিক্রেতারা,	বিক্রেতারা,	
proo,	প্রু,	প্রো,	
tolemy,	টোলেমি,	টলেমির,	
shuchonakal,	শুচনাকল,	সূচনাকাল,	
chakundite,	চকুন্দিতে,	চাকুন্দিতে,	
nirikhe,	নিরিখে,	নিরিখ,	
jibonnogor,	জীবনগগর,	জীবননগর,	
bike,	বিকে,	বাইক,	
sonaicha,	সোনাইচা,	সোনাইচা,	
shasankarta,	শসনকর্তা,	শাসনকর্তা,	
mausumer,	মাসুমের,	মৌসুমের,	
thailandshoho,	থাইলান্দোহ,	থাইল্যান্ডসহ,	
mugdha,	মুগ্ধ,	মুগ্ধ,	
dibet,	দিবেত,	ডিবেট,	
debete,	দেবেতে,	ডিবেট,	
ashirbadatri,	অশীরবাদত্রী,	আশীর্বাদাত্রী,	
seguloi,	সেগুলোই,	সেগুলোই,	
uporzon,	উপরজন,	উপার্জন,	
suraaropeeto,	সুরাপিত,	সুরারোপিত,	
bondhuvabaponyo,	বন্ধুভাবাপন্য,	বন্ধুভাবাপন্ন,	
hurricane,	হুরিযাকানে,	হ্যারিকেন,	
firozapure,	ফিরোজাপুরে,	ফিরোজাপুরে,	
marpit,	মারপিত,	মারপিট,	
gandhiir,	গান্ধিয়ির,	গান্ধীর,	
abosare,	অবসারে,	অবসরে,	
krishibigyani,	কৃষিবিজ্ঞানী,	কৃষিবিজ্ঞানী,	
phormat,	ফরমাত,	ফরম্যাট,	
nirikh,	নিরিখ,	নিরিখ,	
paramartha,	পরমর্থ,	পরমার্থ,	
freekeh,	ফ্রিকেহ,	ফ্রিকেহ,	
ghumachche,	ঘুমাচ্ছে,	ঘুমাচ্ছে,	
scholars,	স্কোর্স,	স্কলার্স,	
heart,	হির্ট,	হার্ট,	
notikotar,	নতিকতার,	নৈতিকতার,	
poddhotiteyi,	পদ্ধতিতেইই,	পদ্ধতিতেই,	
chalake,	চালাকে,	চালকে,	
koro,	কোরো,	করো,	
pyatarne,	প্যাটার্নে,	প্যাটার্নে,	
prokolpow,	প্রকল্পু,	প্রকল্পও,	
prokolpotike,	প্রকলপতিকে,	প্রকল্পটিকে,	
kurdira,	কুরদিরা,	কুর্দিরা,	
lendl,	লেন্ডল,	লেন্ডল,	
kormyi,	করমি,	কর্মই,	
bijito,	বিজিত,	বিজিত,	
siima,	সিমা,	সীমা,	
sangbadmadhyame,	সংবাদমাযম্মে,	সংবাদমাধ্যমে,	
moshahidur,	মশাহিদুর,	মোশাহিদুর,	
ghumunoi,	ঘুমুনোই,	ঘুমুনোই,	
taronee,	তারণী,	তরণী,	
qaferder,	কাফারদের,	কাফেরদের,	
sweety,	স্বিটি,	সুইটি,	
kobutorer,	কবুতরের,	কবুতরের,	
mmehonoti,	মেমেহনতি,	মেহনতি,	
bisshas,	বিশ্বাস,	বিশ্বাস,	
poriikkhateo,	পরিষ্ঠেকেও,	পরীক্ষাতেও,	
bhabatarini,	ভাবাতিণী,	ভবতারিণী,	
deool,	ডেওল,	দেউল,	
guzober,	গুজবের,	গুজবের,	
shamshernagar,	শমশেরনগরের,	শমশেরনগর,	
safiin,	সাফিইন,	সাফিন,	
jhumjhumita,	ঝুমঝুমিতা,	ঝুমঝুমিটা,	
graambaaseeo,	গ্রামবাসীও,	গ্রামবাসীও,	
peeth,	পিথ,	পীঠ,	
ruptan,	রূপতান,	রূপটান,	
porizoner,	পরিজনের,	পরিজনের,	
dakkhinkare,	দক্ষিণকারে,	দক্ষিণকরে,	
safiha,	সাফিহা,	সাফিহা,	
shishu,	শিশু,	শিশু,	
kayartara,	কায়ারটারা,	কোয়ার্টার,	
biswashi,	বিশ্বাসী,	বিশ্বাসই,	
yak,	যাক,	ইয়াক,	
byatari,	ব্যাটারি,	ব্যাটারী,	
nagorikota,	নাগরিকোটা,	নাগরিকতা,	
lakshmir,	লক্ষ্মীর,	লক্ষ্মীর,	
deenes,	ডিনেস,	দীনেশ,	
turky,	টার্কি,	তুর্কি,	
sheets,	শিটস,	শীটস,	
infarmatian,	ইনফার্যায়ান,	ইনফরমেশন,	
otyacharito,	অত্যাচারিত,	অত্যাচারিত,	
alimpiqa,	আলিম্পিকা,	অলিম্পিক,	
norfolk,	নরফলক,	নরফোক,	
sures,	সুরেস,	সুরেশ,	
dakticket,	ডাক্িকেট,	ডাকটিকিট,	
land,	ল্যান্ড,	ল্যান্ড,	
byabaharkariderke,	ব্যবহারীকেরীদেরকে,	ব্যবহারকারীদেরকে,	
oichchheek,	ঐচ্ছিক,	ঐচ্ছিক,	
venuser,	ভেনেসের,	ভেনাসের,	
hadisti,	হাদিস্তি,	হাদিসটি,	
phising,	ফিসিং,	ফিসিং,	
sima,	সিমা,	সীমা,	
musolmanera,	মুসলমানেরা,	মুসলমানেরা,	
konroop,	কনরূপ,	কোনরূপ,	
sthaponagulo,	স্থাপনাগুলো,	স্থাপনাগুলো,	
oitijjha,	ঐতিজ্ঝা,	ঐতিহ্য,	
backflipe,	ব্যাকফ্লিপ,	ব্যাকফ্লিপে,	
ghetu,	ঘেতু,	ঘেটু,	
grotha,	গ্রোথা,	গ্রোথ,	
musalmanderke,	মুসলমনদেরকে,	মুসলমানদেরকে,	
chorchita,	চরচিতা,	চর্চিত,	
koordider,	কৌর্দীদের,	কুর্দিদের,	
orthobochorke,	অর্থবছকে,	অর্থবছরকে,	
sommotitey,	সম্মতিতে,	সম্মতিতে,	
mirakela,	মিরাকেলা,	মিরাকেল,	
ardasha,	আর্ডশ,	আর্দশ,	
brindaboney,	বৃন্দাবনে,	বৃন্দাবনে,	
ashonkai,	আশঙ্কাই,	আশঙ্কাই,	
pleeta,	প্লিটা,	প্লেট,	
kade,	কাদে,	কোড,	
syfy,	সিফি,	সাইফাই,	
qyantana,	ক্যান্তানা,	ক্যান্টন,	
durgotsabe,	দুর্গৎসাবে,	দুর্গোৎসবে,	
hajirhat,	হাজিরহাট,	হাজিরহাট,	
cs,	সিএসএস,	সিএস,	
prithibir,	পৃথিবির,	পৃথবীর,	
majdur,	মজজদুর,	মজদুর,	
onchalti,	অঞ্চলটি,	অঞ্চলটি,	
sthapanagulo,	স্থাপনাগুলো,	স্থাপনাগুলো,	
akheli,	আখেলি,	আখেলী,	
yura,	য়়ারা,	ইউরো,	
vetrillocuism,	ভেট্রিলিক্সমাম,	ভেট্রিলোকুইজম,	
byathapather,	ব্থথাপথের,	ব্যথাপথের,	
madaspushto,	মদস্পাষ্ট,	মদদপুষ্ট,	
gobeshonar,	গবেষণার,	গবেষনার,	
foxcon,	ফক্সন,	ফক্সকন,	
hosto,	হোস্ত,	হস্ত,	
nirmalata,	নির্মালতা,	নির্মলতা,	
kash,	কাশ,	কাস,	
shatokeo,	শতকেও,	শতকেও,	
bamni,	বামনি,	বামনী,	
ovinetar,	অভিনেতার,	অভিনেতার,	
oxforde,	অক্সফোর্ডে,	অক্সফোর্ডে,	
cholocchitrer,	চলচ্চিত্রের,	চলচ্চিত্রের,	
armshtronj,	আর্মোোষ্টররজ,	আর্মস্ট্রং,	
alsaar,	আলসার,	আলসার,	
besooro,	বেসুরো,	বেসুর,	
bufer,	বুফার,	বাফার,	
phutbolarder,	ফুটবলার্ডের,	ফুটবলারদের,	
rijoor,	রিজৌর,	রিজুর,	
yukeliptash,	যুকেলিপ্লাশ,	ইউক্যালিপ্টাস,	
dep,	ডেপ,	ডেপ,	
ajijer,	আজিজের,	আজিজের,	
chalai,	চালাই,	চালাবে,	
adhunikkale,	আধুনিককালে,	আধুনিককালে,	
chowdhurir,	চৌধুরীর,	চৌধুরীর,	
horipur,	হরিপুর,	হরিপুর,	
meridiane,	মেরিডিয়ান,	মেরিডিয়ানে,	
sinaake,	সিনাকে,	সিনাকে,	
pohnpeic,	পোহনপেইক,	ফোনপেইক,	
uqeliptas,	ইকেলিপ্টাস,	ইউক্যালিপ্টাস,	
ispreedshiit,	ইস্প্রিশিট,	স্প্রেডশীট,	
naper,	নেপার,	ন্যাপের,	
landey,	ল্যান্ডে,	ল্যান্ডে,	
ceramiker,	সেরামিকের,	সিরামিকের,	
chhotogolper,	ছোটলগেপের,	ছোটগল্পের,	
eshtoniya,	এস্টনিয়া,	এস্তোনিয়া,	
generalissimo,	জেনেরালিসিমো,	জেনারেলিসিমো,	
tyap,	টায়াপ,	ট্যাপ,	
zubokder,	যুবকদের,	যুবকদের,	
seconder,	সেকন্ডার,	সেকেন্ডের,	
tennis,	টেনিস,	টেনিস,	
ekatto,	একাত্ত,	একাত্ব,	
horidbar,	হরিদবার,	হরিদ্বার,	
setike,	সেতিকে,	সেটিকে,	
jokkher,	যক্ষের,	যক্ষের,	
vagini,	ভাগিনি,	ভগিনী,	
cocaine,	কোকেইন,	কোকেইন,	
parther,	পার্থের,	পার্থের,	
bosontokke,	বসনতককে,	বসন্তকে,	
antennal,	এন্তেন্নাল,	অ্যান্টেনাল,	
ashok,	আশোক,	আশোক,	
shaahaabiike,	শাহাবিকে,	সাহাবীকে,	
houzgulite,	হাউজগুলিতে,	হাউজগুলিতে,	
seshardhe,	সেষররে,	শেষার্ধে,	
bisshasyi,	বিশসাসী,	বিশ্বাসই,	
sampadon,	সম্পাদন,	সম্পাদন,	
choukato,	চৌকাতো,	চৌকাত,	
akram,	আকরাম,	আকরাম,	
starker,	স্টার্কের,	স্টার্কের,	
iqbalke,	ইকবালকে,	ইকবালকে,	
kheshar,	খেশার,	খেশার,	
uponeeshod,	উপনিশদ,	উপনিষদ,	
manohputa,	মনোহপুতা,	মনঃপুত,	
protijogii,	প্রতিযোগী,	প্রতিযোগী,	
manober,	মানবের,	মানবের,	
plak,	প্লাক,	প্ল্যাক,	
parabortee,	পারাবর্তী,	পরর্বতী,	
oncolsoho,	অন্কলসহ,	অঞ্চলসহ,	
gabinius,	গাবিনিয়াস,	গাবিনিআস,	
kleentoner,	ক্লিনোটনের,	ক্লিনটনের,	
graambasheeo,	গ্রাম্বাশও,	গ্রামবাসীও,	
klaud,	ক্লাউ,	ক্লাউড,	
bhumija,	ভূমিজা,	ভূমিজ,	
heawy,	হীউ,	হেভি,	
chikitshar,	চিকিৎসার,	চিকিত্সার,	
bowie,	বাউয়ে,	বওই,	
tanshree,	তানশ্রী,	তানশ্রী,	
geographics,	জিওগ্রোফিকসস,	জিওগ্রাফিকস,	
mane,	মানে,	মানে,	
ekghore,	একঘরে,	একঘরে,	
soomitrar,	সুমিত্রার,	সুমিত্রার,	
nirmolota,	নির্মলতা,	নির্মলতা,	
dei,	ডেই,	দিই,	
zubokra,	যুবকরা,	যুবকরা,	
mitrota,	মিত্রতা,	মিত্রতা,	
naubom,	নৌবম,	নবম,	
sangbadmadhyamgulote,	সংবাদমাধ্যাগুলোতে,	সংবাদমাধ্যমগুলোতে,	
romarder,	রোমার্ডের,	রোমারদের,	
playtey,	প্লেটে,	প্লেটে,	
haripur,	হরিপুর,	হরিপুর,	
palta,	পালটা,	পালটা,	
tinhazar,	তিনহাজার,	তিনহাজার,	
dadar,	দাদার,	দাদার,	
mosjidsoho,	মসজিদসহ,	মসজিদসহ,	
parishram,	পরিশ্রম,	পরিশ্রম,	
cathalic,	ক্যাথালিক,	ক্যাথলিক,	
jahangirbad,	জাহাঙ্গীরবাদ,	জাহাঙ্গীরবাদ,	
sethai,	সেথাই,	সেথাই,	
khiladirao,	খিলাদিরাও,	খিলাড়িরাও,	
chargar,	চারগার,	চার্জার,	
shnaipara,	শ্নাপারা,	স্নাইপার,	
shector,	শেক্টর,	সেক্টর,	
carzar,	কার্জার,	চার্জার,	
sulfatee,	সালফিট,	সালফেট,	
dikpal,	দিকপাল,	দিকপাল,	
queri,	কুয়েরি,	কোয়েরি,	
kottar,	কোট্তার,	কট্টর,	
somosto,	সমস্ত,	সমস্ত,	
sepha,	সেফা,	শেফ,	
bidhirnityang,	বিধির্ণিত্যাং,	বিধির্নিত্যং,	
abosan,	অবসান,	অবসান,	
naazee,	নাজী,	নাত্সি,	
mase,	মাসে,	মাসে,	
rilayensa,	রিলায়েনস,	রিলায়েন্স,	
sompadon,	সম্পাদন,	সম্পাদন,	
ghatiti,	ঘাতি,	ঘাঁটিটি,	
nottee,	নটটী,	নোটটি,	
susamo,	সুসামো,	সুসম,	
sahocorje,	সাহকর্যে,	সাহচর্যে,	
tiuning,	টিউনিং,	টিউনিং,	
bohudeen,	বহুদীন,	বহুদিন,	
megh,	মেঘ,	মেঘ,	
marri,	মাররি,	ম্যারি,	
chirantan,	চিরান্তন,	চিরন্তন,	
jinsa,	জিনসা,	জিন্স,	
jamkaalo,	জামকালো,	জমকালো,	
bhejaano,	ভেজানো,	ভেজানো,	
korush,	করুশ,	ক্রুশ,	
hetimganje,	হেতিমগঞ্জে,	হেতিমগঞ্জে,	
proteemake,	প্রতিমাকে,	প্রতিমাকে,	
domonmulok,	দমনমূলক,	দমনমূলক,	
jacksoner,	জ্যাকসনের,	জ্যাকসনের,	
omanisa,	ওমানিসা,	অমানিশা,	
kushakhali,	কুশাখালি,	কুশাখালি,	
timathi,	তিমাঠি,	টিমোথি,	
kajangale,	কাজালগালে,	কজঙ্গলে,	
vince,	ভিন্স,	ভিন্স,	
heze,	হেজে,	হেজ,	
kirke,	কিরকে,	কিরকে,	
everestey,	ইভারেস্টে,	এভারেস্টে,	
shilpojaat,	শিল্পজাত,	শিল্পজাত,	
kolkarkhana,	কোলকারখোনা,	কলকারখানা,	
chokrantosoho,	চক্রান্তসহ,	চক্রান্তসহ,	
dip,	ডিপ,	দীপ,	
haitasha,	হাইতাশা,	হাইটস,	
narishwar,	নারীশ্বর,	নারীশ্বরের,	
meloonborroner,	মেলউনবর্রনের,	মেলবোর্নের,	
bandra,	বান্দ্রা,	বন্দীরা,	
bangobandhu,	বঙ্গবন্ধু,	বঙ্গবন্ধু,	
uddharkarmirai,	উদ্ধারকর্মীরাই,	উদ্ধারকর্মীরাই,	
shangsthaner,	শাংস্থানের,	সংস্থানের,	
aamor,	আমর,	আমর,	
ramolino,	রামোলিনো,	রামোলিনো,	
neshnos,	নেশনোস,	নেশনস,	
rajtontre,	রাজতন্ত্রে,	রাজতন্ত্রে,	
johny,	জোহি,	জনি,	
sarboshokteeman,	সর্বশক্তিমান,	সর্বশক্তিমান,	
atmiyasulabh,	আত্মীয়ালুভা,	আত্মীয়সুলভ,	
chaudhuriyo,	চৌধুরীও,	চৌধুরীও,	
mukhya,	মুখ্যা,	মুখ্য,	
gronthoti,	গ্রন্থটি,	গ্রন্থটি,	
rubala,	রুবালা,	রুবল,	
bojhe,	বোঝে,	বোঝে,	
konistho,	কনিষ্ঠ,	কনিষ্ঠ,	
firth,	ফির্থ,	ফার্থ,	
jothon,	যথন,	যথন,	
skolarsip,	স্কোর্লাইপ,	স্কলারশিপ,	
krom,	ক্রম,	ক্রম,	
senabahineekey,	সেনাবাহীনেক,	সেনাবাহিনীকে,	
amiya,	আমিয়া,	অমিয়,	
pulivendla,	পুলিভেন্ডলা,	পুলিভেন্ডলা,	
bishnoo,	বিশ্নুও,	বিষ্ণু,	
cheenja,	চিনজা,	চেঞ্জ,	
artore,	আর্তোরে,	আর্টরে,	
poste,	পোস্তে,	পোস্টে,	
sadeep,	সাদীপ,	সদীপ,	
probhuder,	প্রভুদের,	প্রভুদের,	
notey,	নোটে,	নোটে,	
gej,	গেজ,	গেজ,	
jeebanjapon,	জীবনাপপন,	জীবনযাপন,	
fostar,	ফোস্টার,	ফস্টার,	
cloudbook,	ক্লোববুক,	ক্লাউডবুক,	
podarthobidder,	পদার্থবিদদের,	পদার্থবিদদের,	
gloria,	গ্লোরিয়া,	গ্লোরিয়া,	
chhedon,	ছেদন,	ছেদন,	
louhojato,	লোহজাত,	লৌহজাত,	
shikshakbrinda,	শিক্ষাকবৃন্দ,	শিক্ষকবৃন্দ,	
lat,	ল্যাট,	লাট,	
alaol,	অ্যালাওল,	আলাওল,	
badhamuktovabe,	বাধামুক্তভাবে,	বাধামুক্তভাবে,	
bolatkar,	বললতকার,	বলাৎকার,	
konnoder,	কন্যদের,	কন্যদের,	
damakalkarmirao,	দমকল্কারমারাও,	দমকলকর্মীরাও,	
hert,	হার্ট,	হার্ট,	
nehle,	নেহলে,	নেহলে,	
maailkhanek,	মাইলখানেক,	মাইলখানেক,	
tongaa,	টঙ্গা,	টোঙ্গা,	
argead,	আর্জেড,	আর্জিদ,	
byaktikegreptar,	ব্যক্তিপেগ্রাপ্তর,	ব্যক্তিকেগ্রেপ্তার,	
chotogolper,	চোটলগের,	ছোটগল্পের,	
saqara,	সাকারা,	সাকার,	
deputy,	ডিপেটি,	ডেপুটি,	
shamijir,	শামিজির,	স্বামীজীর,	
shho,	শো,	শো,	
chalachchitra,	চলাচ্চিত্র,	চলচ্চিত্র,	
uporitaley,	উপরিতালে,	উপরিতলে,	
volapuk,	ভোলাপুক,	ভোলাপুক,	
bage,	বাগে,	বাগে,	
orthanitir,	অর্থানীতির,	অর্থনীতির,	
kingsh,	কিংস,	কিংস,	
uindoos,	ইউন্ডৌস,	উইন্ডোস,	
idipasha,	ইদিপাশা,	ইডিপাস,	
beetloser,	বিটলোসের,	বিটলসের,	
shringey,	শ্রেং,	শৃঙ্গে,	
shikhaboudi,	শিখাবুদি,	শিখাবৌদি,	
bipajjanak,	বিপাজজনক,	বিপজ্জনক,	
qraima,	ক্রামা,	ক্রাইম,	
deliver,	ডেলিভার,	ডেলিভার,	
shrimoti,	শ্রিমতি,	শ্রীমতি,	
ayantarqatiqa,	আয়ান্তরকাতিক,	অ্যান্টার্কটিকা,	
aizulke,	আইজুলকে,	আইজুলকে,	
sangkulaan,	সংকুলান,	সংকুলান,	
crucer,	ক্রেসের,	ক্রুশের,	
somratra,	সম্রত্র,	সম্রাটরা,	
felto,	ফেলতো,	ফেলত,	
samoshtigato,	সম্ততিগত,	সমষ্টিগত,	
veenish,	ভিনিশ,	ভেনিস,	
akpashe,	আকপাশে,	একপাশে,	
shourshe,	সৌর্শে,	সোর্স,	
gobeshokgon,	গবেষকগণ,	গবেষকগণ,	
kareer,	কারীর,	কারীর,	
nirgoon,	নিরগুন,	নির্গুণ,	
aswasteekor,	অস্বাস্তিকের,	অস্বস্তিকর,	
nodimatrik,	নোদিমাত্রিক,	নদীমাতৃক,	
madhobi,	মাধবী,	মাধবী,	
parikhar,	পরিকার,	পরিখার,	
internship,	ইন্টারনশিপ,	ইন্টার্নশিপ,	
as,	এসয়াস,	অস,	
suisharke,	সুইশারকে,	সুইশারকে,	
pratiyogitar,	প্রতিযোগীতার,	প্রতিযোগীতার,	
shchalastic,	স্স্যালাস্টিক,	স্কলাস্টিক,	
grootha,	গ্রোথা,	গ্রোথ,	
rakkhanbhag,	রক্ষণভাগ,	রক্ষণভাগ,	
naobihar,	নাওবিহার,	নৌবিহার,	
gyandaas,	জ্ঞানদাস,	জ্ঞানদাস,	
ghoorchen,	ঘুরছেন,	ঘুরেছেন,	
alexanderke,	অ্যালেক্সান্ডেরকে,	আলেকজান্ডারকে,	
bhaisaho,	ভাইসাহ,	ভাইসহ,	
welaqama,	ওয়ালকামা,	ওয়েলকাম,	
weenis,	উইনিস,	ভেনিস,	
tikto,	টিকতো,	তিক্ত,	
pranidero,	প্রাণীদেরও,	প্রানীদেরও,	
seekkhokbrindo,	সিক্ষকবৃন্দ,	শিক্ষকবৃন্দ,	
brahmanera,	ব্রাহ্মানেরা,	ব্রাহ্মণেরা,	
salmanul,	সালমানুল,	সালমানুল,	
batistambhatike,	বাতিস্তামভতিকে,	বাতিস্তম্ভটিকে,	
prosadhoni,	প্রসাধনী,	প্রসাধনী,	
pare,	পারে,	পাড়ে,	
seramiks,	সেরামিক্স,	সিরামিকস,	
dolphiny,	ডলফিনি,	ডলফিনি,	
icelands,	আইইসেন্ডস,	আইসল্যান্ডসহ,	
samle,	সামলে,	সামলে,	
choson,	চসন,	চোষণ,	
hosbaleke,	হোসবালেকে,	হোসবালেকে,	
harbare,	হারববারে,	হারবারে,	
beam,	বিয়াম,	বিম,	
indrakanan,	ইন্দ্রকান,	ইন্দ্রকানন,	
prapokkey,	প্রাপক্কে,	প্রাপককে,	
raagee,	রাগী,	রাগী,	
bandhubhaabaapanna,	বন্ধুভাপন্ন,	বন্ধুভাবাপন্ন,	
maryir,	মার্ির,	ম্যারির,	
ashiatic,	এশিইটিক,	এশিয়াটিক,	
maaktoome,	মাক্তমে,	মাকতুম,	
daebug,	দীবুগ,	ডিবাগ,	
autopromotioner,	অটোপ্রোশনের,	অটোপ্রমোশনের,	
bharotchilo,	ভারতছিল,	ভারতছিল,	
khuizza,	খুইজ্জা,	খুইজ্জা,	
jalarong,	জালারং,	জলরঙ,	
sahab,	সাহাব,	সাহাব,	
laishensh,	লাইশেনস,	লাইসেন্স,	
america,	আমেরিকা,	আমেরিকা,	
basturoi,	বাস্তুরই,	বস্তুরই,	
bhiktara,	ভিক্তরা,	ভিক্টর,	
govindarajan,	গোবিন্দরাজান,	গোবিন্দরাজন,	
dumaa,	দুমা,	দুমা,	
noditir,	নদীতির,	নদীটির,	
sikarder,	সিকারদের,	শিকারদের,	
bojata,	বোজাতা,	বোজাটা,	
sucre,	সাক্রে,	সাকার,	
abhidhanick,	অভিচানিক,	অভিধানিক,	
bonvumi,	বনভূমি,	বনভূমি,	
bastubad,	বস্তুবাদ,	বস্তুবাদ,	
krema,	ক্রেমা,	ক্রাইম,	
ahmed,	আহমেদ,	আহামদ,	
nek,	নেক,	নেক,	
kogake,	কোগাকে,	কোগাকে,	
laesens,	লেসেন্স,	লাইসেন্স,	
hepatetisa,	হেপাটেটিসা,	হেপাটাইটিস,	
tookror,	তুক্র,	টুকরোর,	
piulir,	পিউলির,	পিউলির,	
maner,	ম্যানার,	মানে,	
nutunotto,	নুতুনত্ব,	নতুনত্ব,	
metropalitana,	মেট্রোপালিটোনা,	মেট্রোপলিটন,	
jhanjra,	ঝাঁজরা,	ঝাঁজরা,	
sahozlabhbhatar,	সহলভাভভতার,	সহজলভ্যতার,	
janoganonar,	জনগণনার,	জনগণনার,	
sarollo,	সারোল্লো,	সারল্য,	
ramonar,	রামোনার,	রমনার,	
bhogiroth,	ভগীরোথ,	ভগীরথ,	
omkar,	ওমকার,	ওঙ্কার,	
militarir,	মিলততরির,	মিলিটারির,	
sohojlovyotar,	সহল্যব্যতার,	সহজলভ্যতার,	
shahjapur,	শাহজাপুর,	শাহজাপুর,	
batikromee,	বাতিক্রমী,	ব্যতিক্রমী,	
uzobekeestaan,	উজবেক্তিন,	উজবেকিস্তান,	
sthapanagulor,	স্থাপানগুলোর,	স্থাপনাগুলোর,	
deciliter,	ডেসিলাইটের,	ডেসিলিটার,	
bojhao,	বোঝাও,	বোঝাও,	
khaaneker,	খানেকের,	খানেকের,	
dhormokorme,	ধর্মকর্মে,	ধর্মকর্মে,	
manushe,	মনুষে,	মানুষে,	
sthapanatir,	স্থাপনাটির,	স্থাপনাটির,	
marathi,	মারাথি,	মরাঠি,	
himchi,	হিমচি,	হিমচি,	
monzushree,	মন্জুশ্রী,	মঞ্জুশ্রী,	
heteler,	হেটেলের,	হেটেলের,	
bhaangchur,	ভাংছুর,	ভাংচুর,	
drissogulo,	দৃষ্গগুলো,	দৃশ্যগুলো,	
abanishankar,	অবনিশঙ্কর,	অবনিশংকর,	
eesosiyeetasa,	ইসোসিতিয়াসা,	এসোসিয়েটস,	
bodhir,	বোধির,	বধির,	
blyaka,	ব্ল্যাকা,	ব্ল্যাক,	
lavta,	লাভতা,	লাভটা,	
nogore,	নগরে,	নগরে,	
adhikartai,	অধিকারটাই,	অধিকর্তাই,	
shangkalonti,	শংকললন্তি,	সংকলনটি,	
iub,	ইউবিইএ,	আইইউবি,	
hijrite,	হিজরিতে,	হিজরীতে,	
teentir,	তিনটির,	তিনটির,	
anusthane,	অনুষ্ঠানে,	অনুষ্ঠানে,	
gaphiloti,	গ্যাফিলোটি,	গাফিলতি,	
maailey,	মাইলে,	মাইলে,	
suraropito,	সুরারিপিত,	সুরারোপিত,	
emerjency,	এমেরজেন্সি,	এমার্জেন্সি,	
poderthobid,	পদের্থবিদ,	পদার্থবিদ,	
parinati,	পরিনাতি,	পরিণতি,	
sahooseekotar,	সহুসককতার,	সাহসিকতার,	
bhandar,	ভান্ডার,	ভাণ্ডার,	
baptics,	ব্যাপটিক্স,	ব্যাপটিকস,	
purohitder,	পুরোহিতদের,	পুরোহিতদের,	
bishasey,	বিশাে,	বিশ্বাসে,	
bipradas,	বিপ্রাদাস,	বিপ্রদাস,	
siddharther,	সিদ্ধার্থের,	সিদ্ধার্থের,	
amontronkarider,	আমন্ত্রনকারীদের,	আমন্ত্রণকারীদের,	
stona,	স্তোনা,	স্টোন,	
toroonra,	তরুনরা,	তরুণরা,	
nirbaaho,	নির্বাহ,	নির্বাহ,	
bayii,	বায়ি,	বাঈ,	
shibraj,	শিবরাজ,	শিবরাজ,	
utotoro,	উতততর,	উততর,	
masjidsaho,	মাসজিদসহ,	মসজিদসহ,	
sobrakamer,	সোব্রাকামের,	সবরকমের,	
thaii,	থাই়,	থাই,	
chetanagato,	চেতানাগত,	চেতনাগত,	
pichte,	পিছতে,	পিছতে,	
korimer,	করিমের,	করিমের,	
mohajot,	মহাজত,	মহাজোট,	
arthurer,	অর্থুরের,	আর্থারের,	
bifol,	বিফোল,	বিফল,	
ekatitto,	একাতিত্ব,	একাতিত্ব,	
quota,	কোওটা,	কোটা,	
orthoneeti,	অর্থনীতি,	অর্থনীতির,	
balaruma,	বালারুমা,	বলরুম,	
sip,	সিপ,	শিপ,	
kyatgarite,	ক্যাটগারিতে,	ক্যাটগারিতে,	
sumeeta,	সুমিতা,	সুমিতা,	
soori,	সূরি,	সুরি,	
silabhara,	সিলাভরা,	সিলভার,	
alkatra,	আলকাত্রা,	আলকাতরা,	
diiptii,	দিপ্তিই,	ডেপুটি,	
paste,	পাস্তে,	পেষ্ট,	
chet,	চেট,	চ্যাট,	
mitrer,	মিত্রের,	মিত্রের,	
nick,	নিকি,	নিক্,	
mmadhukkori,	ম্মাধুকককরী,	মাধুকরী,	
blogarra,	ব্লোগাররা,	ব্লগাররা,	
matt,	ম্ট্ট,	ম্যাট,	
aakaabar,	আকাবার,	আকাবার,	
mozdoor,	মজদুর,	মজদুর,	
balabhadra,	বালাভদ্রা,	বলভদ্র,	
concerter,	কনসার্টের,	কানসাটের,	
bikargrasta,	বিকারগ্রাস্তা,	বিকারগ্রস্ত,	
borlen,	বর্লেন,	বরলেন,	
swostir,	স্বস্তির,	স্বস্তির,	
oswasteekor,	অস্বাস্তেকেরও,	অস্বস্তিকর,	
protinito,	প্রতিনিত,	প্রতিনিত,	
mookhomandoler,	মখুমণ্ডলের,	মুখমণ্ডলের,	
proboleme,	প্রবলেমে,	প্রবলেমে,	
kakhnoba,	কাখনোবা,	কখনওবা,	
hijritey,	হিজরিতে,	হিজরীতে,	
cholochchitrer,	চলচ্চিত্রের,	চলচ্চিত্রের,	
lesense,	লেইনেন্স,	লাইসেন্স,	
anagarikra,	অনাগারিকরা,	অনাগরিকরা,	
nothivuktir,	নথিভূক্তির,	নথিভুক্তির,	
ashamorthito,	আশামর্থিত,	অসমর্থিত,	
gunje,	গুঞ্জে,	গুঁজে,	
abheedhanik,	অভিধানিক,	অভিধানিক,	
nosihote,	নসিহতে,	নসিহতে,	
karmakarke,	কর্মারারকে,	কর্মকারকে,	
chalochchitrogulor,	চালোচ্ছিত্রগুলোর,	চলচ্চিত্রগুলোর,	
vabaponno,	ভাবাপন্ন,	ভাবাপন্ন,	
saalsa,	সালসা,	সালসা,	
pravritir,	প্রাভরীতির,	প্রভৃতির,	
riazuddin,	রিয়াজউদ্দিন,	রিয়াজউদ্দীন,	
aziboner,	আজিবনের,	আজীবনের,	
directorate,	ডিরেক্টরাট,	ডিরেক্টরেট,	
nibondhocheler,	নিবন্ধেছেলের,	নিবন্ধছেলের,	
bornanukrome,	বর্ণানুক্রমে,	বর্নানুক্রমে,	
jaubankal,	যৌবনকাল,	যৌবনকাল,	
koreempoor,	করিমপুর,	করিমপুর,	
chaaktir,	চাক্তির,	চাকতির,	
atmira,	আতমিরা,	আত্মীরা,	
eduardo,	এডুয়ার্ড,	এডুয়ার্দো,	
rudrasagar,	রুদ্রসগর,	রুদ্রসাগরের,	
pratijogitamulak,	প্রতিযোগিতমূলক,	প্রতিযোগীতামূলক,	
bhenise,	ভেনিসে,	ভেনিসে,	
shikshakrom,	শিক্ষাক্রম,	শিক্ষাক্রম,	
bhenom,	ভেনম,	ভেনম,	
abhidhaner,	অভিধানের,	অভিধানের,	
caroline,	ক্যারোলিন,	ক্যরোলিন,	
godamjato,	গোদাজজাত,	গুদামজাত,	
bossoben,	বস্বেন,	বসবেন,	
baibosthar,	বাযবস্থার,	ব্যবস্থার,	
mumtajer,	মুমতাজের,	মুমতাজের,	
dovaar,	ডোভার,	ডোভার,	
qlauda,	ক্লাউড,	ক্লাউড,	
nirbahi,	নির্বাহী,	নির্বাহি,	
niketaner,	নিকেতানের,	নিকেতনের,	
qaro,	কারো,	কারো,	
joisttho,	জৈস্থ,	জ্যৈষ্ঠ,	
folleni,	ফলেনি,	ফলেনি,	
proshtutkarok,	প্রশ্তুতকারক,	প্রস্তুতকারক,	
gonona,	গণনা,	গননা,	
hansasya,	হানসাস্য,	হংসস্য,	
attacharito,	অত্তাচারিত,	অত্যাচারিত,	
mohammadi,	মহাম্মাদি,	মুহাম্মদী,	
ispredsiit,	ইস্প্রেডসিট,	স্প্রেডশীট,	
gaddaphii,	গাড়াফিই,	গাদ্দাফী,	
machhti,	মাছটি,	মাছটি,	
kaferderke,	কাফেরদেরকে,	কাফেরদেরকে,	
thaanobhi,	থানভি,	থানভী,	
orbit,	অর্বিত,	অরবিট,	
mandanda,	মান্ডনন্ডা,	মানদণ্ড,	
ateetkaale,	আতিকালে,	অতীতকালে,	
breqathru,	ব্রেকারথু,	ব্রেকথ্রু,	
poketchorder,	পোকেটচররদের,	পকেটচরদের,	
chasee,	চাসী,	চেস,	
siit,	সিত,	শীত,	
orhan,	ওরহান,	ওরহান,	
machgulo,	মাছগুলো,	মাছগুলো,	
shumo,	শুমো,	সুমো,	
liseensee,	লিইসনিস,	লাইসেন্স,	
jyesthaa,	জ্যাস্থা,	জ্যেষ্ঠা,	
pratijogider,	প্রতিযোগীদের,	প্রতিযোগীদের,	
asthishondhi,	অস্থিনস্ধি,	অস্থিসন্ধি,	
scholastic,	স্কোলাস্টিক,	স্কলাস্টিক,	
jubokti,	যুবক্তি,	যুবকটি,	
daaoon,	দাওন,	ডাউন,	
gronthao,	গ্রন্থাও,	গ্রন্থও,	
fotanor,	ফটোনোর,	ফোটানোর,	
mandarbani,	মন্দরবানী,	মন্দারবাণী,	
site,	সিতে,	সিটে,	
lyandim,	ল্যান্ডিম,	ল্যান্ডিং,	
latsaheb,	লাটসাহেব,	লাটসাহেব,	
pader,	পাদের,	প্যাডের,	
dharabahiktite,	ধারাবাহিকটিতে,	ধারাবাহিকটিতে,	
yaak,	যাক,	ইয়াক,	
sosoa,	সোসা,	শশা,	
anhu,	আনহু,	আনহু,	
turista,	তুরিস্তা,	টুরিস্ট,	
mumtaz,	মুমতাজ,	মুমতাজ,	
ajij,	আজিজ,	আজিজ,	
elahabade,	এলাহাবাদে,	এলাহাবাদে,	
abheedhaaneeck,	অভিচানিক,	অভিধানিক,	
aashtikotaa,	অষ্টিকতা,	আস্তিকতা,	
mail,	মাইল,	মাইল,	
nisader,	নিসাদের,	নিষাদের,	
gaziipur,	গাজিইপুর,	গাজীপুর,	
shtona,	স্টোনা,	স্টোন,	
chuti,	চুটি,	ছুটি,	
saabyastha,	সাব্যস্থা,	সাব্যস্থ,	
mitroder,	মিত্রদের,	মিত্রদের,	
deaubande,	দেউবান্দে,	দেওবন্দে,	
manushera,	মনুষেরা,	মানুষেরা,	
tantubayer,	তান্তুবায়ের,	তন্তুবায়ের,	
sheepha,	সেফ,	শেফ,	
manob,	মানব,	মানব,	
manir,	মানির,	মনির,	
porobortii,	পরবর্তিই,	পরর্বতী,	
lambaate,	ল্যাম্বাতে,	লম্বাটে,	
poorohitra,	পৌরহিত্র,	পুরোহিতরা,	
laiseensee,	লয়েসনিস,	লাইসেন্স,	
cheentaikaree,	চিঁটাইকারী,	ছিনতাইকারী,	
chongar,	চোঙ্গার,	চোঙ্গার,	
bonshi,	বনশি,	বংশী,	
mashtarsha,	মাস্তরর্ষ,	মাস্টার্স,	
kaleo,	কালেও,	কালেও,	
eeksapreeshana,	এক্সপ্রেশন,	এক্সপ্রেশন,	
nikela,	নিকেলা,	নিকেল,	
boikolyo,	বৈকল্য,	বৈকল্য,	
transapharma,	ট্রানসাফফর্মা,	ট্রান্সফর্ম,	
bapokotor,	বাপকতর,	ব্যাপকতর,	
telakucha,	তেলাকুচা,	তেলাকুচা,	
amarjito,	আমরজিত,	অমার্জিত,	
aireshe,	এইরেশে,	আইরেসে,	
nagorikke,	নাগরীককে,	নাগরিককে,	
jerusalema,	জেরুসেলামা,	জেরুসালেম,	
odeb,	ওডেব,	ওদেব,	
shomser,	শমসের,	সমশের,	
asif,	আসিফ,	আসিফ,	
jamaanor,	জামানোর,	জমানোর,	
mononiitoder,	মননিতিতদের,	মনোনীতদের,	
bisshonath,	বিশ্বনাথ,	বিশ্বনাথ,	
jyaqa,	জ্যাকা,	জ্যাক,	
install,	ইনস্টাল,	ইন্সটল,	
ostheesandhi,	অস্থিসান্ধি,	অস্থিসন্ধি,	
khali,	খালি,	খালি,	
zerusalem,	জেরুসেলাম,	জেরুসালেম,	
injiniyarim,	ইন্জিনিরামীম,	ইঞ্জিনিয়ারিং,	
neshnosh,	নেশনো,	নেশনস,	
vvimsenn,	ভিভিমসেন,	ভীমসেন,	
farid,	ফারিদ,	ফরিদ,	
prajanankal,	প্রজননকাল,	প্রজননকাল,	
poriskoron,	পরিস্করণ,	পরিষ্করণ,	
oojbekistan,	ওজবেকসিতান,	উজবেকিস্তান,	
nariider,	নারীদের,	নারীদের,	
byaboharkariyi,	ব্যবহারকারীয়ি,	ব্যবহারকারীই,	
soundarja,	সৌন্দর্যা,	সৌর্ন্দয্য,	
rohasyer,	রোহস্যের,	রহস্যের,	
dhalur,	ধালুর,	ঢালুর,	
hastantar,	হাস্তান্তর,	হস্তান্তর,	
agomoney,	অ্যামনে,	আগমনে,	
orthonitir,	অর্থনীতির,	অর্থনীতির,	
bornolikhon,	বর্ণলিকোষণ,	বর্ণলিখন,	
niropekshtar,	নিরেপেক্ষতার,	নিরপেক্ষতার,	
jesh,	জেশ,	জেস,	
creshcent,	ক্রেশেন্ট,	ক্রিসেন্ট,	
prakalpagulor,	প্রকলপপুলোর,	প্রকল্পগুলোর,	
nobotom,	নবতম,	নবতম,	
sangbadmadhyome,	সংবাদমধ্যমে,	সংবাদমাধ্যমে,	
pratishthanik,	প্রতিষ্ঠানিক,	প্রাতিষ্ঠানিক,	
khaschandpur,	খাসচান্দপুর,	খাসচাঁদপুর,	
oncholsomuho,	অঞ্চমূূহ,	অঞ্চলসমূহ,	
nariderke,	নারীদেরকে,	নারিদেরকে,	
mausumeo,	মাসুমেও,	মৌসুমেও,	
gronther,	গ্রন্থের,	গ্রন্থের,	
rajyotiro,	রাজ্যতিরও,	রাজ্যটিরও,	
krush,	ক্রুশ,	ক্রুশ,	
aasar,	আসার,	আসর,	
chhutee,	ছুটি,	ছুটি,	
heerani,	হিরানি,	হিরানি,	
upbasher,	উপবাশের,	উপবাসের,	
narsinghomgulor,	নারসিংহগুলোর,	নার্সিংহোমগুলোর,	
jhonkar,	ঝোঁকার,	ঝঙ্কার,	
baipash,	বাইশাশ,	বাইপাস,	
qonflict,	কনফ্লিক্ট,	কনফ্লিক্ট,	
inphormeshon,	ইনফর্মেশন,	ইনফরমেশন,	
venush,	ভেনুশ,	ভেনাস,	
apad,	আপাড,	আপদ,	
akkelpure,	আক্কেলপুরে,	আক্কেলপুরে,	
gatibege,	গতিবেগে,	গতিবেগে,	
rubidium,	রুবিডিউম,	রুবিডিয়াম,	
shatan,	শাতান,	শয়তান,	
myari,	ম্যারি,	ম্যারি,	
cinemapremider,	সিনেপ্রামীদের,	সিনেমাপ্রেমীদের,	
valobase,	ভালোবাসে,	ভালোবাসে,	
sarjur,	সার্ুর,	সরযূর,	
itastata,	ইতস্ততা,	ইতস্তত,	
kirti,	কিরতি,	কীর্তি,	
choudry,	চৌউড্রি,	চৌধুরী,	
uindos,	ইইন্ডোস,	উইন্ডোস,	
bhyaatikaner,	ভ্যাতিকানের,	ভ্যাটিকানের,	
horiddare,	হরিদ্দারে,	হরিদ্বারে,	
uthe,	উঠে,	উঠে,	
jontrototto,	যন্ত্রতত্ত,	যন্ত্রতত্ত্ব,	
sangitanusthane,	সঙ্গীতানুষ্ঠানে,	সঙ্গীতানুষ্ঠানে,	
gara,	গারা,	গোর,	
omeettrakkhor,	অমেত্রাক্ষর,	অমিত্রাক্ষর,	
ghamta,	ঘামতা,	ঘোমটা,	
gandharir,	গান্ধারির,	গান্ধারীর,	
lagchhe,	লাগছে,	লাগছে,	
byaboharkareer,	ব্যবহারকারীর,	ব্যবহারকারীর,	
ghaghat,	ঘাঘাত,	ঘাঘট,	
madhabi,	মাধববি,	মাধবী,	
pingna,	পিংনা,	পিংনা,	
shikshagata,	শিক্ষাগত,	শিক্ষাগত,	
gondhe,	গন্ধে,	গন্ধে,	
masjidtir,	মাসজিদটির,	মসজিদটির,	
batom,	বাতম,	বাটম,	
elaakati,	এলাকাতি,	এলাকাটি,	
torkareer,	তর্কারীর,	তরকারীর,	
foreks,	ফোরকক্স,	ফরেক্স,	
kalkarkhana,	কল্করখানা,	কলকারখানা,	
kumbhalnar,	কুম্ভালনার,	কুম্ভালনার,	
sikha,	সিখা,	শিখ,	
toufiq,	তৌফিক,	তৌফিক,	
patjata,	পাটজাটা,	পাটজাত,	
osthishondhi,	অস্থিনন্ধি,	অস্থিসন্ধি,	
bo,	বোয়,	বু,	
pisach,	পিসাচ,	পিশাচ,	
sayanaida,	সায়াইনাদ,	সায়ানাইড,	
transform,	ট্রান্সফোর্ম,	ট্রান্সফর্ম,	
pettern,	পেটার্ন,	প্যাটার্ন,	
arsie,	আর্সিয়ে,	আরসিএ,	
gajiipur,	গাজিপুরের,	গাজীপুর,	
dokaangoolote,	ডোকাংগুলোতে,	দোকানগুলোতে,	
bishesyo,	বিশেষ্য,	বিশেষ্য,	
asabhya,	অসভ্য,	অসভ্য,	
chaloke,	চালোকে,	চালকে,	
venkates,	ভেঙ্কেটস,	ভেঙ্কটেশ,	
sbajan,	স্বান,	স্বজন,	
neermol,	নীরমোল,	নির্মল,	
purbanchaler,	পূর্বাঞ্চলের,	পূর্বাঞ্চলের,	
reetesh,	ঋতেশ,	রিতেশ,	
shudhir,	শুধির,	শুধীর,	
vejjanno,	ভেজনান্ন,	ভেজানো,	
mugdal,	মুগদাল,	মুগডাল,	
modhyekar,	মধ্যেকের,	মধ্যেকার,	
ramantic,	রামান্টিক,	রোমান্টিক,	
ishahak,	ইশাহাক,	ইসাহাক,	
andamana,	আন্দামানা,	আন্দামান,	
gandagol,	গান্দাগল,	গন্ডগোল,	
mukhomandaley,	মুখমণ্ডলে,	মুখমণ্ডলে,	
siitei,	সিতেই,	শীতেই,	
mitrata,	মিত্রাটা,	মিত্রতা,	
shikkharrthirao,	শিক্ষার্থীরাও,	শিক্ষার্থীরাও,	
ebhara,	এভারা,	এভার,	
chhuteete,	ছুটিতে,	ছুটিতে,	
jaandrel,	জান্দ্রেল,	জাঁদরেল,	
ganokantha,	গণকান্ঠা,	গণকণ্ঠ,	
shit,	শিট,	শীত,	
sangsakti,	সংসকক্তি,	সংসক্তি,	
homshke,	হো্শকে,	হোমসকে,	
gingbhalobasen,	গিংখলাবাসেন,	গিংভালোবাসেন,	
shkalarashhipa,	স্কলারিশাপা,	স্কলারশিপ,	
kandy,	কান্ডি,	ক্যান্ডি,	
sikkharthirao,	শিক্ষার্থীরাও,	শিক্ষার্থীরাও,	
baarnish,	বার্নিশ,	বার্নিশ,	
siddhanter,	সিদ্ধান্তের,	সিদ্ধান্তের,	
bangalore,	বাঙ্গালোর,	ব্যাঙ্গালুরে,	
miitar,	মিতার,	মিত্র,	
rahee,	রাহী,	রাহি,	
serology,	সেরোলজি,	সেরোলজি,	
dharavahikbhabe,	ধারাবিকভাবে,	ধারাবাহিকভাবে,	
calabe,	ক্যালাবে,	চালাবে,	
chandil,	চান্দিল,	চান্ডিল,	
orthisoho,	অর্থিসহ,	অর্থিসহ,	
tetela,	টেটেল,	টাইটেল,	
dormitory,	ডরিমটরি,	ডরমিটরি,	
laaishheshh,	লাইেশ,	লাইসেন্স,	
nanabornobishishto,	নানারবনিশিষ্ট,	নানাবর্ণবিশিষ্ট,	
atighataner,	অতিঘাতেনের,	অতিঘটনের,	
katbe,	কাটবে,	কাটবে,	
aashanka,	আশাঙ্কা,	আশংকা,	
karir,	কারির,	কারীর,	
gamdan,	গামদান,	গামদান,	
peengna,	পিংনা,	পিংনা,	
drissogoolote,	দৃষ্গগুলোতে,	দৃশ্যগুলোতে,	
philipiner,	ফিলিপিনের,	ফিলিপাইনের,	
utpatti,	উৎপত্তি,	উতপত্তি,	
saras,	সারাস,	সরস,	
qarpeta,	কারপেটা,	কার্পেট,	
rushad,	রুশাদ,	রুশদ,	
horidwar,	হরিদ্বার,	হরিদ্বার,	
segulo,	সেগুলো,	সেগুলো,	
eenameela,	ইনেমল,	এনামেল,	
canservatian,	ক্যার্সভেশন,	কনসারভেশন,	
osamarik,	ওসামারিক,	অসামরিক,	
dooburir,	দৌবুরির,	ডুবুরির,	
istoone,	ইস্টুনে,	স্টোন,	
quartar,	কুয়ার্টার,	কোয়ার্টার,	
chilahatee,	চিলাহাতে,	চিলাহাটি,	
eporzonto,	এপরজন্ত,	এপর্যন্ত,	
pretti,	প্রেতটি,	প্রিটি,	
huka,	হুকা,	হুক,	
jini,	জিনি,	যিনি,	
adhyatmik,	অধ্যাত্মিক,	আধ্যাত্মিক,	
sanstha,	সানস্থা,	সংস্থা,	
anchalgulir,	অঞ্চলগুলির,	অঞ্চলগুলির,	
kani,	কানি,	কানি,	
jathartho,	যাথার্থ,	যথার্থ,	
stana,	স্টানা,	স্টোন,	
aakabar,	আকাবার,	আকাবার,	
sbaajan,	স্বাজন,	স্বজন,	
dombhoke,	দম্ভকে,	দম্ভকে,	
soteciety,	সোটেসিটি,	সোসাইটিতে,	
nazad,	নাজাড,	নাজাদ,	
paolasthi,	পাযালস্থি,	পাওলাসথি,	
nagorikra,	নাগোরিকরা,	নাগরিকরা,	
codee,	কোডি,	কোডে,	
oncholshomuher,	অঞ্চলমূহের,	অঞ্চলসমূহের,	
khilaphat,	খিলাফত,	খিলাফত,	
graambaasheeo,	গ্রাম্বাশেও,	গ্রামবাসীও,	
hilser,	হিলসের,	হিলসের,	
dacope,	ডাকোপে,	দাকোপ,	
hisabagyan,	হিসাবাজ্ঞান,	হিসাবজ্ঞান,	
phonekari,	ফোনেকারি,	ফোনকারী,	
bosano,	বসানো,	বসানো,	
hitokor,	হিতকর,	হিতকর,	
ponjikar,	পঞ্জিকার,	পঞ্জিকার,	
yuro,	যুরো,	ইউরো,	
bishaashke,	বিষাশকে,	বিশ্বাসকে,	
duuma,	ডুয়ামা,	দুমা,	
innahu,	ইন্নাহু,	ইন্নাহু,	
thanvi,	থানভি,	থানভী,	
siddhanto,	সিদ্ধান্ত,	সিদ্ধান্তও,	
jerusalemer,	জেরুসেলামের,	জেরুজালেমের,	
templet,	টেম্পলেট,	টেম্পলেট,	
steen,	স্টেন,	স্টেন,	
lahano,	লাহানো,	লাহানো,	
probhura,	প্রভুরা,	প্রভুরা,	
aakik,	আকিক,	আকিক,	
armeeniyana,	আর্মিনীয়া,	আর্মেনিয়ান,	
dwipke,	দ্বিপকে,	দ্বীপকে,	
soolke,	সুলকে,	শুল্কে,	
thakeni,	থাকেনি,	থাকেনি,	
corymb,	করিম্ব,	করিম,	
chaudhurider,	চৌধুরীদের,	চৌধুরীদের,	
bhageri,	ভাগেরি,	ভাগেরই,	
seekkharthirao,	শীক্ষার্থীরাও,	শিক্ষার্থীরাও,	
breakthrough,	ব্র্যাকরুঠ,	ব্রেকথ্রু,	
nikate,	নিকাতে,	নিকটে,	
hertj,	হের্টজ,	হার্জ,	
aalaa,	আলা,	আলা,	
toptoshele,	তপ্তশেলে,	তপ্তশেলে,	
ekekrokom,	একেক্রম,	একেকরকম,	
remacry,	রিমাল্রি,	রেমাক্রী,	
jhamala,	ঝামালা,	ঝামালা,	
osoborno,	অসবর্ণ,	অসবর্ণ,	
premo,	প্রেমো,	প্রিমো,	
keui,	কেউই,	কেউই,	
deenesh,	দীনেশ,	দীনেশ,	
alpa,	আলপা,	অল্প,	
addhattikotar,	আদ্ধাত্যিকতার,	আধ্যাত্মিকতার,	
wishnu,	উইন্নু,	বিষ্ণু,	
mulbhitti,	মূলভিত্তি,	মূলভিত্তি,	
fasi,	ফাসি,	ফাঁসী,	
anchalsaho,	অঞ্চালসহ,	অঞ্চলসহ,	
konagoolo,	কনাগুলো,	কণাগুলো,	
soheensotar,	সহিনসতার,	সহিংসতার,	
rotheen,	রথেন,	রথীন,	
ekbai,	একবাই,	একবাই,	
ruble,	রাবলে,	রুবল,	
nothibhukta,	নথিভূক্তা,	নথিভুক্ত,	
bhutbhut,	ভূতভূট,	ভুটভুট,	
ralf,	র্যালফ,	রালফ,	
tarunra,	তরুনরা,	তরুণরা,	
hugeke,	হুগেকে,	হিউজকে,	
cholochchitrai,	চলচ্চিত্রায়,	চলচ্চিত্রই,	
akkaas,	আক্কাস,	আককাস,	
ssahocorze,	স্হাকর্জে,	সাহচর্যে,	
pharanyeta,	ফরনেতে,	ফরম্যাট,	
casper,	ক্সপপার,	ক্যাসপার,	
logotype,	লোগোটাইপ,	লোগোটাইপ,	
daakticketer,	ডাকটিকেটের,	ডাকটিকিটের,	
horeepur,	হরিপুর,	হরিপুর,	
societyke,	সোসিটিকে,	সোসাইটিকে,	
chapal,	চাপাল,	চপল,	
shite,	শিতে,	শীতে,	
cinematographar,	সিনেমাট্রফার,	সিনেমাটোগ্রাফার,	
obdi,	অবিডি,	অব্দি,	
windows,	উইনডাস,	উইন্ডোস,	
dholeshwari,	ধলেশ্বরী,	ধলেশ্বরী,	
sukumaree,	সুকুমারী,	সুকুমারী,	
path,	পাথ,	পাথ,	
horippur,	হরিপপুর,	হরিপুর,	
melbourner,	মেলবোর্নের,	মেলবোর্নের,	
camerapersoner,	ক্যামেরাপেরসনের,	ক্যামেরাপার্সনের,	
sabrakamer,	সব্রকমের,	সবরকমের,	
anichchi,	অনিচ্ছি,	আনিচ্ছি,	
carlo,	কার্লো,	কার্লো,	
direqtareta,	ডিরেক্েরেটা,	ডিরেক্টরেট,	
volivoler,	ভলিভোলের,	ভলিভলের,	
juktorastrer,	যুক্তরাস্ত্রের,	যুক্তরাষ্ট্রের,	
saqara,	সাকারা,	সকার,	
asovyo,	আসভ্য,	অসভ্য,	
borkhastokritora,	বর্খাস্তক্তিরা,	বরখাস্তকৃতরা,	
bhagnekeo,	ভাগনেকেও,	ভাগ্নেকেও,	
nothibhukto,	নথিভুক্ত,	নথিভুক্ত,	
byabosthar,	ব্যবস্থার,	ব্যবস্থার,	
superheiroo,	সুপেরহেরোর,	সুপারহিরো,	
kaathhaamaandu,	কথ্মমুণ্ডু,	কাঠমান্ডু,	
jonomukhi,	জনমুখী,	জনমুখী,	
graambasider,	গ্রামবাসীদের,	গ্রামবাসীদের,	
youth,	যথৌথ,	ইয়ুথ,	
satan,	সতন,	শয়তান,	
bohoodin,	বহুদিন,	বহুদিন,	
vesselli,	ভেসেল্লি,	ভেসেলি,	
chalachchitrotike,	চালাচ্ছিত্রটিকে,	চলচ্চিত্রটিকে,	
bardhitansh,	বর্ধীতানস,	বর্ধিতাংশ,	
manatmulak,	মনতমূলক,	মানতমূলক,	
ixprission,	ইক্সপ্রিশন,	এক্সপ্রেশন,	
mandondo,	মান্ডন্ড,	মানদণ্ড,	
delibhara,	দেলিভারা,	ডেলিভার,	
mercedes,	মার্সডেস,	মার্সেডেস,	
chinto,	চিন্তো,	চিনতো,	
licensedhari,	লাইসেন্ধারি,	লাইসেন্সধারী,	
taunsheep,	টাউনশীপ,	টাউনশিপ,	
fatakasto,	ফাতাকাস্ত,	ফাটাকেষ্ট,	
mulor,	মুলোর,	মুলোর,	
byboshthar,	বিবশ্থার,	ব্যাবস্থার,	
dishani,	দিশানি,	দিশানি,	
manobikotao,	মানবিকতাও,	মানবিকতাও,	
songbadmadhyomer,	সংবাদমাধ্যমের,	সংবাদমাধ্যমের,	
bodna,	বোডনা,	বদনা,	
chouhate,	চৌহাতে,	চৌহাটে,	
kalki,	কালকি,	কালকি,	
duryogamoyee,	দুর্যগামীয়ী,	দুর্যোগময়ী,	
futote,	ফুটোতে,	ফুটোতে,	
kanshater,	কানশাতের,	কানসাটের,	
motabolombira,	মতাবলম্বিরা,	মতাবলম্বীরা,	
akhando,	আখণ্ড,	অখন্ড,	
shakara,	শাকারা,	সাকার,	
siropa,	সিরোপা,	শিরোপা,	
soundorjotakei,	সৌন্দর্যতাকেই,	সৌন্দর্যটাকেই,	
kaalengaa,	কালেঙ্গা,	কালেঙ্গা,	
manushsoho,	মানুষসহ,	মানুষসহ,	
alpo,	অল্পো,	অল্প,	
bondhukey,	বন্ধুকে,	বন্ধুকে,	
bamon,	বামন,	বামন,	
shashtra,	শাষ্ট্র,	শাস্ত্র,	
pustir,	পুস্তির,	পুষ্টির,	
dankaan,	ডানকান,	ডানকান,	
tolemyr,	টোলেমির,	টলেমির,	
khelaphate,	খেলাফেতে,	খেলাফতে,	
khorsed,	খোর্সড,	খোরশেদ,	
vishnuu,	বিশ্নু,	বিষ্ণু,	
baait,	বাইত,	বাইট,	
marketin,	মার্কেটিন,	মার্কেটিং,	
taap,	তাপ,	ট্যাপ,	
nikote,	নিকতে,	নিকটে,	
ghotleo,	ঘটলেও,	ঘটলেও,	
chomski,	চম্স্কি,	চমস্কি,	
nisshongotake,	নিঃশঙ্গতাকে,	নিঃসঙ্গতাকে,	
torunosomriddho,	তরুণসমৃদ্ধ,	তরুণসমৃদ্ধ,	
elakayi,	এলাকায়া,	এলাকাই,	
katateo,	কাটাতেও,	কাটাতেও,	
krisenta,	ক্রিসেন্ট,	ক্রিসেন্ট,	
hank,	হ্যাংকং,	হাঙ্ক,	
nepchooner,	নেপচুনের,	নেপচুনের,	
hijri,	হিজরি,	হিজরী,	
mach,	মাচ,	মাছ,	
teliha,	তেলিহা,	তেলিহা,	
panchadadu,	পঞ্চাদাদু,	পঞ্চাদাদু,	
azijer,	আজিজের,	আজিজের,	
hool,	হুল,	হুল,	
hooq,	হুক,	হুক,	
nirikho,	নিরিখো,	নিরিখ,	
hisaber,	হিসাবের,	হিসাবের,	
panchashjan,	পঞ্চশ্জন,	পঞ্চাশজন,	
tyapa,	তিপা,	ট্যাপ,	
deebug,	দীবুগ,	ডিবাগ,	
kram,	ক্রাম,	ক্রম,	
bonnypran,	বনিপ্রাণ,	বন্যপ্রাণ,	
rohinibabu,	রোহিনীবাবু,	রোহিনীবাবু,	
shucharita,	শুচারিতা,	সুচরিতা,	
gudamjat,	গুডমজাত,	গুদামজাত,	
madhoori,	মাধুরী,	মাধুরী,	
sangasthagulo,	সংস্থাগুলো,	সংস্থাগুলো,	
tookrokey,	টুকরকে,	টুকরোকে,	
teenej,	তীনেজ,	টিনেজ,	
elakaasoho,	এলাকাসহ,	এলাকাসহ,	
gavaskar,	গাভাস্কার,	গাভাস্কার,	
kaansaat,	কানসাত,	কানসাট,	
holdim,	হোল্ডিং,	হোল্ডিং,	
kortam,	করতাম,	করতাম,	
qonfliqt,	কনফ্লিক্ট,	কনফ্লিক্ট,	
phood,	ফুড,	ফুড,	
zerusaleme,	জেরুসেলেমে,	জেরুসালেমে,	
niknayman,	নিকনামান,	নিকনেইমান,	
doltyagi,	দলত্যাগী,	দলত্যাগী,	
avidur,	আভিদুর,	আভিদুর,	
shektore,	শেক্তরে,	সেক্টরে,	
madhumati,	মধুমতি,	মধুমতী,	
chopal,	চোপাল,	চপল,	
jitpur,	জিতপুর,	জিতপুরের,	
bulichev,	বুলিচেভ,	বুলিচেভ,	
asaciates,	এসিয়েটেস,	এসোসিয়েটস,	
bondishalatei,	বন্দিশালাতেই,	বন্দিশালাতেই,	
dharavahiker,	ধারাবিখের,	ধারাবাহিকের,	
fakhrul,	ফাখরুল,	ফাখরুল,	
sthitiko,	স্থিতিকো,	স্থিতিকো,	
poripakey,	পরিপাকে,	পরিপাকে,	
bhenus,	ভেনুস,	ভেনাস,	
rahee,	রাহী,	রাহী,	
sookkho,	সুক্ষ,	সুক্ষ্ম,	
abhidhaaner,	অভিধানের,	অভিধানের,	
melborrone,	মেলবোরেন,	মেলবোর্নে,	
ohalyar,	ওহল্যার,	অহল্যার,	
halding,	হ্যালিং,	হোল্ডিং,	
samyuktha,	সম্যুক্থা,	সামিউক্তা,	
mukhomondoler,	মুখমণ্ডলের,	মুখমণ্ডলের,	
prabhritite,	প্রাভ্রীতিতে,	প্রভৃতিতে,	
poorohitder,	পুরোহিতদের,	পুরোহিতদের,	
cholochchitro,	চল্চিত্র,	চলচ্চিত্র,	
poribahokotto,	পরিবাহকত্ত,	পরিবাহকত্ব,	
baharamporer,	বাহারামপরের,	বহরমপুরের,	
kourabe,	কৌরাবে,	কৌরবে,	
gitikobita,	গীতিকবাটি,	গীতিকবিতা,	
hazat,	হাজাত,	হজত,	
songasthatir,	সংস্থাহিতর,	সংস্থাটির,	
ghoshito,	ঘোষিত,	ঘোষিত,	
baugey,	বাগে,	বাগে,	
jansha,	জনশা,	জন্স,	
jewellery,	জেওলেরি,	জুয়েলারির,	
hingsar,	হিংসার,	হিংসার,	
kotibondhe,	কতিবন্ধে,	কটিবন্ধে,	
sangbadmadhyomgulote,	সংবাদমাম্যগুলোতে,	সংবাদমাধ্যমগুলোতে,	
dushtogone,	দুষ্টগণে,	দুষ্টগণে,	
aprasangikbhabei,	আপ্রাসঙ্গীকভাবেই,	অপ্রাসঙ্গিকভাবেই,	
samaptir,	সমাপ্তির,	সমাপ্তির,	
qanasarabheshana,	কানারাভেশন,	কনসারভেশন,	
daqop,	ডাকোপ,	দাকোপ,	
gondogol,	গণ্ডগোল,	গন্ডগোল,	
brojomohun,	ব্রহমহুন,	ব্রোজোমোহন,	
konisttha,	কনিষ্ট্থা,	কনিষ্ঠ,	
orgho,	অর্ঘ,	অর্ঘ্য,	
suparichiti,	সুপারিচিতি,	সুপরিচিতি,	
nutoner,	নুটনের,	নূতনের,	
ved,	ভেদ,	বেদ,	
nabatamo,	নাবাতোম,	নবতম,	
dhanijomite,	ধানিযোমীতে,	ধানিজমিতে,	
khanonkaj,	খানোকাজ,	খননকাজ,	
bojhaao,	বোঝাও,	বোঝাও,	
sharthe,	শার্থে,	স্বার্থে,	
kanasharabheshhana,	কনসরভভেশন,	কনসারভেশন,	
kanasarabheeshana,	কনারভেষণা,	কনসারভেশন,	
rajtantrey,	রাজতন্ত্রের,	রাজতন্ত্রে,	
hafej,	হাফেজ,	হাফেয,	
tennys,	টেনিস,	টেনিস,	
blacker,	ব্লেকার,	ব্ল্যাকের,	
nationalser,	নেটোনালসের,	ন্যাশনালসের,	
probhritike,	প্রভৃতিকে,	প্রভৃতিকে,	
taateo,	তাতেও,	তাতেও,	
karmasampadon,	কর্মাসমদপন,	কর্মসম্পাদন,	
provritike,	প্রভৃতিকে,	প্রভৃতিকে,	
milton,	মিলটন,	মিলটন,	
aairish,	আইরিশ,	আইরিস,	
taalaal,	তালাল,	তালাল,	
grambasheeo,	গ্রামবাশীও,	গ্রামবাসীও,	
choritrotakeo,	চরিত্রতাকেও,	চরিত্রটাকেও,	
iraner,	ইরানের,	ইরানের,	
birishiritey,	বিরিশিরিতে,	বিরিশিরিতে,	
bisshasi,	বিশ্বাসী,	বিশ্বাসী,	
stonehenje,	স্টোনেহজেন্জে,	স্টোনহেঞ্জ,	
lishenshe,	লিশেনশে,	লাইসেন্স,	
monjurul,	মঞ্জুরুল,	মনজুরুল,	
sqirt,	স্কার্ট,	স্কার্ট,	
amar,	আমার,	আমর,	
shudhui,	শুধুই,	শুধুই,	
sportstar,	স্পোর্টস্টার,	স্পোর্টসস্টার,	
bouddher,	বৌদ্ধের,	বৌদ্ধের,	
pouchute,	পৌঁচুতে,	পৌঁছুতে,	
thechar,	ঠেচার,	থ্যাচার,	
dobhaar,	দোভার,	ডোভার,	
mojlish,	মজলিশ,	মজলিশ,	
nirbahe,	নিরবাহে,	নির্বাহে,	
bairer,	বাইরের,	বাইরের,	
dhonni,	ধোন্নি,	ধন্যি,	
dibate,	দিবাতে,	ডিবেট,	
roktokhoron,	রক্তধরণ,	রক্তক্ষরণের,	
kaley,	কালে,	কালে,	
aembed,	এম্বেড,	এম্বেড,	
taholo,	তাহোলো,	তাহলো,	
jonosomaj,	জনসমাজ,	জনসমাজ,	
ghurte,	ঘুর্তে,	ঘুরতে,	
kraanti,	ক্রান্তি,	ক্রান্তি,	
average,	এভারেজ,	এভারেজ,	
thailand,	থাইলান্ড,	থাইল্যান্ড,	
coons,	কুন্স,	কুনস,	
charpanch,	চরপপচ্চ,	চারপাঁচ,	
marmader,	মারমাদের,	মারমাদের,	
taroni,	তারোনী,	তরণী,	
dagmukta,	দগমুক্ত,	দাগমুক্ত,	
aranyani,	আরণ্যানি,	অরণ্যানী,	
talaa,	তালা,	তালা,	
trutimatra,	ট্রুটিমাত্রা,	ত্রুটিমাত্র,	
uttor,	উত্তর,	উওর,	
naajii,	নাজি,	নাত্সি,	
messengerer,	মেসেংগারের,	মেসেঞ্জারের,	
dhanak,	ধনক,	ধানক,	
drishi,	দৃশী,	দৃশ্যই,	
lajik,	লাজিক,	লজিক,	
laaishenshh,	লয়েেন্স,	লাইসেন্স,	
ponera,	পোনেরা,	পনের,	
sipa,	সিপা,	শিপ,	
aalkatraa,	আলকাত্রা,	আলকাতরা,	
shasonamoleri,	শাসনামেলীরই,	শাসনামলেরই,	
dienes,	ডিয়েনেস,	ডিএনএস,	
kosambir,	কোসম্বির,	কোসাম্বীর,	
robot,	রোবোট,	রোবোট,	
bhebechili,	ভেবেছিলি,	ভেবেছিলি,	
kuronir,	কুরোনির,	কুরনীর,	
heena,	হীনা,	হেনা,	
lobbytey,	লবিবেট,	লবিতে,	
firalem,	ফিরালেম,	ফিরালেম,	
phaltu,	ফালটু,	ফালতু,	
hattey,	হ্যাটি,	হাঁটতে,	
lubitz,	লুবিৎজ,	লুবিৎজ,	
shhikara,	শিকারা,	শিকার,	
giitikobitar,	গীতিকোবিতার,	গীতিকবিতার,	
daktickete,	ডাক্টিকেতে,	ডাকটিকিটে,	
drabyatah,	দ্রা্বাতঃ,	দ্রব্যতঃ,	
attorkite,	অত্তর্কিতে,	অতর্কিতে,	
rajbandir,	রাজবন্দির,	রাজবন্দীর,	
plator,	প্ল্যাটর,	প্লেটোর,	
khude,	খ্ষুড়ে,	ক্ষুদে,	
gaj,	গাজ,	গেজ,	
chalochchitreer,	চালচচিত্রিত্রীর,	চলচ্চিত্রের,	
joones,	জুনেস,	জোন্স,	
catholicder,	ক্যাথোলিকদের,	ক্যাথলিকদের,	
headquartus,	হেইডকার্টাস,	হেডকোয়ার্টাস,	
salsa,	সালসা,	সালসা,	
nischoy,	নিশচয়,	নিশ্চয়,	
swairacharibirodhi,	স্বরীচারবিরোধী,	স্বৈরাচারীবিরোধী,	
kormoke,	কর্মকে,	কর্মকে,	
pakistanira,	পাকিস্তানিরা,	পাকিস্তানীরা,	
sheekar,	শীকার,	শিকার,	
atarkitey,	আতার্কিতে,	অতর্কিতে,	
puding,	পুড়িং,	পুডিং,	
kaalki,	কালকি,	কালকি,	
ajeem,	আজিম,	আজিম,	
hoteltite,	হোটেলটিতে,	হোটেলটিতে,	
eupheike,	ইউফেইকে,	ইউফেইকে,	
spancer,	স্পান্সার,	স্পেন্সার,	
karore,	কারোরে,	কারোর,	
shfingtar,	এমিংটার,	স্ফিংটার,	
capshule,	কাপশুলে,	ক্যাপসুল,	
lyaanding,	ল্যান্ডিং,	ল্যান্ডিং,	
chakradhare,	চাকরাচারে,	চক্রধরে,	
rokibul,	রোকিবুল,	রকিবুল,	
oikhan,	ঐখান,	ঐখান,	
esoosiyetasa,	এসুয়েসিইটাস,	এসোসিয়েটস,	
akkheperi,	অক্ষেপেরই,	আক্ষেপেরই,	
qaferderkey,	কাফারডেরকে,	কাফেরদেরকে,	
nimitte,	নিমিত্তে,	নিমিত্তে,	
gurmukh,	গুরমুখ,	গুরমুখ,	
uter,	উতের,	উটের,	
monur,	মনুর,	মনুর,	
shakankti,	শাকান্কি,	শকাঙ্কটি,	
daybhager,	ডায়াভের,	দায়ভাগের,	
shommotir,	শম্মতির,	সম্মতির,	
korkotkraantee,	কর্তকান্ত্র,	কর্কটক্রান্তি,	
bojhey,	বোঝে,	বোঝে,	
janar,	জানার,	জানার,	
ganohotyake,	গণহত্যাকে,	গণহত্যাকে,	
shasonkarta,	শাসনকার্তা,	শাসনকর্তা,	
samajikatar,	সমাজিকতার,	সামাজিকতার,	
highcomissione,	হাইক্লোমিনে,	হাইকমিশনে,	
anubhutimalar,	অনুভূতিমালার,	অনুভূতিমালার,	
mukhoshdharir,	মুখোষধারীর,	মুখোশধারীর,	
dhaleshwari,	ধলেশ্বরী,	ধলেশ্বরী,	
ancholgoolir,	আঞ্চলগুলির,	অঞ্চলগুলির,	
elgoridom,	এলগোরিডম,	এলগরিদম,	
bharatey,	ভারাতে,	ভারতে,	
emarjenshi,	এমারজেন্শি,	এমার্জেন্সি,	
ukeliptas,	ইকেলিপ্লাস,	ইউক্যালিপ্টাস,	
srabosty,	স্রেস্টি,	শ্রাবস্তী,	
adarsho,	আদারশো,	আর্দশ,	
sthapona,	স্থাপোনা,	স্থাপনা,	
kaathhmaandute,	কাঠমমণ্ডুতে,	কাঠমান্ডুতে,	
judge,	জুডেগে,	জাজ,	
kiuti,	কিউটি,	কিউটি,	
dorun,	দোরুন,	দরুণ,	
jorury,	জোরুরি,	জরূরী,	
transhapharma,	ট্রান্সফর্ম,	ট্রান্সফর্ম,	
faaj,	ফাজ,	ফাজ,	
granthatyke,	গ্রান্থাটিকে,	গ্রন্থটিকে,	
samajik,	সমাজিক,	সামাজিক,	
nanir,	নানির,	নানীর,	
diniphition,	ডিনিশেন,	ডেফিনেশন,	
jeebonnogor,	জীবনগোর,	জীবননগর,	
ghomtaa,	ঘোঁটা,	ঘোমটা,	
dhanyi,	ধানই,	ধন্যি,	
carlos,	কার্লোস,	কার্লোস,	
ekghare,	একঘরে,	একঘরে,	
sqolastiq,	স্কোলাস্কিক,	স্কলাস্টিক,	
teestar,	টিস্টার,	তিস্তার,	
chaudhurio,	চাউধেরিও,	চৌধুরীও,	
zerusalem,	জেরুসেলাম,	জেরুজালেম,	
faase,	ফাসে,	ফাঁসে,	
pancbaar,	প্যানব্যার,	পাঁচবার,	
hariner,	হারিনার,	হরিণের,	
browser,	ব্রাসের,	ব্রাউজার,	
fongli,	ফংলগি,	ফংলি,	
bodhukeo,	বধুকেও,	বধুকেও,	
nirgaman,	নির্গামান,	নির্গমন,	
grahoksebai,	গ্রাহকেসবাই,	গ্রাহকসেবায়,	
sanghatakder,	সংঘটকদের,	সংঘটকদের,	
veemsen,	ভিমসেন,	ভীমসেন,	
jakatke,	জাকাতকে,	যাকাতকে,	
postay,	পোস্টে,	পোস্টে,	
bachhaikrito,	বাচাইকৃত,	বাছাইকৃত,	
chahidapotrer,	চাহিদাপত্রের,	চাহিদাপত্রের,	
sumitrar,	সুমিত্রার,	সুমিত্রার,	
ekroop,	একরূপ,	একরূপ,	
digrir,	ডিগ্রির,	ডিগ্রির,	
nariderke,	নারীদেরকে,	নারীদেরকে,	
ashamarthita,	আশমর্থীতা,	অসমর্থিত,	
pyaleshtainer,	প্লেইশ্টানের,	প্যালেস্টাইনের,	
sponsorshipe,	স্পনশোর্িপে,	স্পন্সরশীপে,	
vaphara,	ভাফারা,	বাফার,	
ovarview,	ওভারভিউ,	ওভারভিউ,	
tintir,	তিন্তির,	তিনটির,	
moorali,	মূরালি,	মুরলী,	
falak,	ফালাক,	ফলক,	
tecnokret,	টেকনক্রেট,	টেকনোক্র্যাট,	
bibecchyo,	বিবেচ্ছ,	বিবেচ্য,	
abhidhaaneeck,	অভিধান্ক,	অভিধানিক,	
sectore,	সেক্টোর,	সেক্টরে,	
gemske,	জেমস্কে,	জেমসকে,	
chalachchitro,	চালাচিত্র,	চলচ্চিত্র,	
goodamjato,	গৌড়মজাত,	গুদামজাত,	
jegulur,	জেগুলুর,	যেগুলুর,	
tanu,	তানু,	তনু,	
saatzoner,	সাতজনের,	সাতজনের,	
baaiq,	বাইক,	বাইক,	
gobeshakgon,	গবেষকগণ,	গবেষকগণ,	
prakar,	প্রকার,	প্রকার,	
epiela,	এপিয়েলা,	আইপিএল,	
hakone,	হাকোন,	হাকোনে,	
suhasini,	সুহাসিনী,	সুহাসিনী,	
minishtarer,	মিনিশ্টারের,	মিনিস্টারের,	
michhilti,	মিছিলটি,	মিছিলটি,	
chereche,	চেরেছে,	ছেড়েছে,	
bagdad,	বাগদাড়,	বাগদাদে,	
torkarir,	তর্কারীর,	তরকারীর,	
capsule,	ক্যাপসলে,	ক্যাপ্সুল,	
punosthaner,	পুনঃ্থানের,	পুনঃস্থানের,	
tigmanshu,	তিগমানশু,	তিগ্মাংশু,	
danaqana,	ডানাকানা,	ডানকান,	
vagni,	ভাগনি,	ভগ্নী,	
seebiai,	সিবিয়াই,	সিবিআই,	
ashor,	আশোর,	আসর,	
aasirbaad,	আসীরবাদ,	আশির্বাদ,	
niphelheim,	নিফেলহেমম,	নিফেলহেইম,	
raia,	রাইয়া,	রায়,	
ghumacchilo,	ঘুমাক্ছিল,	ঘুমাচ্ছিল,	
bishashke,	বিষাষকে,	বিশ্বাসকে,	
pratisthanik,	প্রতিস্থানিক,	প্রাতিষ্ঠানিক,	
paira,	পাইরা,	পাইরা,	
shunani,	শুনানি,	শুনানী,	
nederlande,	নেদারল্যান্ডে,	নেদারল্যান্ডে,	
nabyata,	নব্যতা,	নাব্যতা,	
varma,	ভারমা,	ভার্মা,	
zeeland,	জিল্যান্ড,	জিল্যান্ড,	
ceramicer,	সারেমিইসের,	সিরামিকের,	
pratijogira,	প্রতিযোগীরা,	প্রতিযোগীরা,	
laesensh,	লাইসেন,	লাইসেন্স,	
baet,	বেইট,	বাইট,	
roopdan,	রূপডান,	রুপদান,	
kings,	কিংস,	কিংস,	
brail,	ব্রাইল,	ব্রেইল,	
phakay,	ফাকা,	ফাকে,	
shringge,	শ্রিঙ্গে,	শৃঙ্গে,	
aziza,	আজিজা,	আজিজা,	
shrabastee,	শ্রাবস্তি,	শ্রাবস্তী,	
rakkhandurga,	রক্ষণদুর্গ,	রক্ষণদুর্গ,	
prasadhoni,	প্রাসাধনী,	প্রসাধনী,	
afrazuler,	আফরাজুলের,	আফরাজুলের,	
udbhabaney,	উদ্ভাবনে,	উদ্ভাবনে,	
shem,	শেম,	সেম,	
orbi,	অরবি,	ওরবি,	
cxt,	সিএিটিসি,	সিএক্সটি,	
goteehin,	গতিহীন,	গতিহীন,	
madhuri,	মাধুরি,	মাধুরী,	
domone,	দমনোনে,	দমনে,	
antarctica,	অ্যান্টার্টিকা,	অ্যান্টার্কটিকা,	
khitkar,	খিতকার,	ক্ষিতকর,	
jatinkey,	জাতিনকে,	যতীনকে,	
paroner,	পারণের,	পারণের,	
chupani,	চুপানি,	চুপানি,	
myat,	ম্যাট,	ম্যাট,	
slatgulor,	স্লাটগুলোর,	স্ল্যাটগুলোর,	
ponchashjon,	পঞ্চাশন,	পঞ্চাশজন,	
mochlekha,	মোচলেখা,	মোছলেখা,	
kanuner,	কানুনের,	কানুনের,	
prokar,	প্রকার,	প্রকার,	
mithener,	মিথেনের,	মিথেনের,	
dakten,	ডাকতেন,	ডাকতেন,	
quary,	কোয়ারি,	কোয়েরি,	
samaveshke,	সমাভেষকে,	সমাবেশকে,	
kuresher,	কুরেশের,	কুরেশের,	
sobche,	সব্ছে,	সবচে,	
ajuhat,	আজুহাত,	অজুহাত,	
dinar,	দিনার,	ডিনার,	
chaalkee,	চালকে,	চালকে,	
rajnaiteek,	রাজনাইতক,	রাজনৈতীক,	
satarkatar,	সতরকাতার,	সতর্কতার,	
kamla,	কামলা,	কামলা,	
maritimer,	মারিটিমের,	মেরিটাইমের,	
gujab,	গুজাব,	গুজব,	
degree,	ডেগ্রি,	ডিগ্রি,	
aarke,	আরকে,	আরকে,	
doloo,	দালুও,	ডলু,	
serup,	সেরুপ,	সেরূপ,	
poripake,	পরিপাকে,	পরিপাকে,	
edseler,	এডসেলের,	এডসেলের,	
protisthan,	প্রতিস্থান,	প্রতিষ্টান,	
bandhano,	বাঁধানো,	বাঁধানো,	
zerusalemer,	জেরুসেলামের,	জেরুজালেমের,	
jins,	জিন্স,	জিন্স,	
thandabhabe,	তাঁদাভাবে,	ঠাণ্ডাভাবে,	
bsnleu,	বিএসএনএএউএ,	বিএসএনএলইইউ,	
chhintayikari,	ছিন্তায়িকারী,	ছিনতাইকারী,	
suchanakal,	সূচনকল,	সূচনাকাল,	
senabahinio,	সেনাবিহীও,	সেনাবাহিনীও,	
ghomta,	ঘোমটা,	ঘোমটা,	
parshwer,	পার্শ্বের,	পার্শ্বের,	
mette,	মেট্তে,	ম্যাট,	
habsi,	হাবসি,	হাবশী,	
utsahi,	উৎসাহী,	উৎসাহী,	
krisenter,	ক্রিসেন্টের,	ক্রিসেন্টের,	
dhyanastha,	ধ্বনস্থ,	ধ্যানস্থ,	
rajtantra,	রাজতন্ত্র,	রাজতন্ত্র,	
hoonayin,	হুইনিয়ান,	হুনাইন,	
mohajote,	মহাজতে,	মহাজোট,	
dalee,	দালী,	ডালে,	
gananatyo,	গণনাত্য,	গণনাট্য,	
dharabahikvabe,	ধারাবাহিকভাবে,	ধারাবাহিকভাবে,	
notti,	নটটি,	নোটটি,	
torunderke,	তরুণ্ডেরকে,	তরুণদেরকে,	
shekarone,	শেকারণে,	সেকারণে,	
vortuki,	ভর্তুকি,	ভর্তুকি,	
kkomandar,	ক্মোন্ডার,	কমাণ্ডার,	
highcommissionay,	হাইমস্োমিন,	হাইকমিশনে,	
kathmandu,	কাঠমণ্ডু,	কাঠমান্ডু,	
remakri,	রেমাকরি,	রেমাক্রী,	
scholarship,	স্কোরশশিপ,	স্কলারশিপ,	
planey,	প্লেন,	প্লেনে,	
militaryr,	মিলিটারির,	মিলিটারির,	
black,	ব্ল্যাক,	ব্ল্যাক,	
peri,	পেরি,	পেরি,	
ramchander,	রামচন্দের,	রামচন্দরের,	
mahafezkhanar,	মহাফেখখানার,	মহাফেজখানার,	
okkhorke,	অক্ষরকে,	অক্ষরকে,	
gasthi,	গাস্থী,	গোষ্ঠী,	
niurolaji,	নিউরোজাজি,	নিউরোলজি,	
shikshagato,	শিক্ষাগত,	শিক্ষাগত,	
jemy,	জেমি,	জেমি,	
annimated,	অ্যান্মিটাটেড,	এনিমেটেড,	
neutrinoo,	নিউট্রনোও,	নিউট্রিনো,	
capsul,	ক্যাপসুল,	ক্যাপসুল,	
manabmaner,	মানবামানের,	মানবমনের,	
senabahinikey,	সেনাবাহিনীকে,	সেনাবাহিনীকে,	
liaodong,	লিয়েডং,	লিয়াওদং,	
chalochchitraeei,	চালচ্চিত্রায়,	চলচ্চিত্রেই,	
skirt,	স্কির্ট,	স্কার্ট,	
karima,	করিমা,	করিম,	
magrey,	ম্যাগ্রে,	ম্যাগ্রে,	
utkhaat,	উৎখাত,	উত্খাত,	
vaabnake,	ভাবনাকে,	ভাবনাকে,	
jonmobhumitir,	জন্মুভিমিতির,	জন্মভূমিটির,	
lambi,	লাম্বি,	লম্বি,	
abhirupbabuke,	অভিরূপবাবুকে,	অভিরূপবাবুকে,	
nowel,	নওয়েল,	নভেল,	
oitijje,	ঐতিজ্যে,	ঐতিহ্যে,	
amburi,	আম্বুরি,	আম্বুরি,	
poscater,	পস্কেটের,	পশ্চাতের,	
pathanirdeshona,	পাথানিরদেশনা,	পথনির্দেশনা,	
groth,	গ্রোথ,	গ্রোথ,	
chetanagoto,	চেতানাগত,	চেতনাগত,	
norpholk,	নরফলক,	নরফোক,	
osthisondhi,	অস্থিসন্ধি,	অস্থিসন্ধি,	
azimpur,	আজিমপুর,	আজিমপুর,	
kaale,	কালে,	কালে,	
brixfield,	ব্রিক্সফাইল্ড,	ব্রিক্সফিল্ড,	
adorsho,	আদর্শ,	আর্দশ,	
tokeo,	টোকেও,	টোকেও,	
ragee,	রাগে,	রাগী,	
fokskon,	ফক্সকন,	ফক্সকন,	
nagorikra,	নাগোরিকরা,	নাগরিকেরা,	
samratra,	সম্রত্র,	সম্রাটরা,	
bishhnu,	বিষ্ণু,	বিষ্ণু,	
plasse,	প্লেসে,	প্লাসে,	
samanwitovabe,	সমমন্তিভতাবে,	সমন্বিতভাবে,	
shiter,	শিতের,	শীতের,	
dalnata,	দলনাটা,	ডালনাটা,	
ghoomachhilo,	ঘুমাছিল,	ঘুমাচ্ছিল,	
ucchosito,	উচ্চসিত,	উচ্ছসিত,	
boshoborti,	বশবর্তী,	বশবর্তী,	
bikretara,	বিক্রেতারা,	বিক্রেতারা,	
chhayi,	ছায়ি,	ছাই,	
hukar,	হুকার,	হুকার,	
ajibon,	অজিবন,	আজীবন,	
qulim,	কুলিম,	কুলিং,	
simantarkkhibahinir,	সীমান্তকার্থবাহিনীর,	সীমান্তরক্ষীবাহিনীর,	
nirbachakder,	নির্বাচকদের,	নির্বাচকদের,	
juktarashtrasaha,	যুক্তঃরাষ্রস্থা,	যুক্তরাষ্ট্রসহ,	
sawam,	সায়াম,	সাওম,	
bhogno,	ভগ্ন,	ভগ্ন,	
laaisheesh,	লাইশস,	লাইসেন্স,	
gajetted,	গেজেটেটেড,	গেজেটেড,	
oxfordey,	অক্সফোর্ডে,	অক্সফোর্ডে,	
engrejra,	এন্জেররা,	ইংরেজরা,	
assexe,	এসেক্সে,	অ্যাসেক্সে,	
orthanitike,	অর্থানীতিকে,	অর্থনীতিকে,	
nirapattamulok,	নিরাপত্তামূলক,	নিরাপত্তামূলক,	
prarthitao,	প্রার্থিতাও,	প্রার্থীতাও,	
bibader,	বিবাদের,	বিবাদের,	
pronoti,	প্রণটি,	প্রণতি,	
sathik,	সাথিক,	সঠিক,	
suri,	সুরি,	সুরি,	
overholing,	ওভারহলিং,	ওভারহোলিং,	
barbadoj,	বারবাদজ,	বার্বাডোজ,	
pyor,	প্যোর,	পিওর,	
karmazog,	কর্মাোগ,	কর্মযোগ,	
pinogbagke,	পিনবগাজকে,	পিনগবাগকে,	
priseflex,	প্রাইফেল্ক্স,	প্রাইজফ্লেক্স,	
bhittiti,	ভিত্তিটি,	ভিত্তিটি,	
bharpur,	ভারপুর,	ভরপুর,	
saptahokal,	সপ্তাহকাল,	সপ্তাহকাল,	
sursur,	সুরসুর,	সুরসুর,	
hindutirtha,	হিন্দুতির্থ,	হিন্দুতীর্থ,	
rajotta,	রাজত্বা,	রাজত্ব,	
haridware,	হরিদ্বারে,	হরিদ্বারে,	
yaq,	য্ক,	ইয়াক,	
graambasi,	গ্রামবাসী,	গ্রামবাসী,	
rakhete,	রাখেতে,	রাখেতে,	
vushito,	ভূষিত,	ভূষিত,	
zozyota,	যোজ্যতা,	যোজ্যতা,	
gardeen,	গার্ডিন,	গার্ডেন,	
kayed,	কায়েদ,	কায়েদ,	
karadando,	কারাদান্দ,	কারাদণ্ড,	
byabaharkaree,	ব্যবহারকারী,	ব্যবহারকারী,	
obhijojan,	অভিজজান,	অভিযোজন,	
bhabaponno,	ভবপন্ন,	ভাবাপন্ন,	
krimlin,	ক্রিমিন,	ক্রিমলিন,	
akkhunno,	অক্ষুন্ন,	অক্ষুণ্ণ,	
asbab,	আসবাব,	আসবাব,	
lisense,	লিইনেন্স,	লাইসেন্স,	
ateetkale,	আতিককলে,	অতীতকালে,	
konoroop,	কনরূপ,	কোনরূপ,	
flux,	ফ্লাক্স,	ফ্লাস্ক,	
chhaikalo,	ছাইকালো,	ছাইকালো,	
ghotleyo,	ঘোটলেও,	ঘটলেও,	
terlarang,	টেরলারং,	তেরলারং,	
ghoshanapatratio,	ঘোষণাপত্রটিও,	ঘোষণাপত্রটিও,	
nilkuthir,	নীলকুঠির,	নীলকুঠির,	
saamaanya,	সামন্য,	সামান্য,	
suhayeler,	সুহায়েলের,	সুহায়েলের,	
probeshkari,	প্রবেশকারী,	প্রবেশকারী,	
mukhbondho,	মুখবন্ধ,	মুখবন্ধ,	
protishtan,	প্রতিষ্টান,	প্রতিষ্টান,	
billaho,	বিল্লাহো,	বিল্লাহ,	
teemothy,	টিমোথি,	টিমোথি,	
somraatder,	সম্রাতদের,	সম্রাটদের,	
prottokkhovabe,	প্রত্যক্ষভাবে,	প্রত্যক্ষভাবে,	
shuperheiro,	শুপেরহেরো,	সুপারহিরো,	
standards,	স্ট্যান্ডর্ডস,	স্টান্ডার্ডস,	
gaaddafee,	গাডফা,	গাদ্দাফী,	
sharifpur,	শরীপপুর,	শরিফপুর,	
turkii,	তুরকিই,	তুর্কি,	
stoic,	স্টক,	স্টোয়িক,	
sorting,	সর্টিং,	সর্টিং,	
jamarate,	জামারাতে,	জামারাতে,	
fatkabazare,	ফাৎকাবাজারে,	ফাটকাবাজারে,	
deefinision,	ডিফিনিশন,	ডেফিনেশন,	
mosharroph,	মোশারফো,	মশাররফ,	
mastarsa,	মাস্তারসা,	মাস্টার্স,	
porirshoder,	পরির্শদের,	পরির্ষদের,	
daaktikite,	দাক্তিকিতে,	ডাকটিকিটে,	
rahimed,	রহিমেদ,	রহিমেদ,	
maila,	মাইলা,	মাইল,	
gaje,	গাজে,	গেজ,	
surakarder,	সুরাকারদের,	সুরকারদের,	
kusumeshu,	কুশুমেষু,	কুসুমেষু,	
pharmesigulote,	ফার্মেসিগুলোতে,	ফার্মেসীগুলোতে,	
rifleksa,	রিফলেক্সা,	রিফ্লেক্স,	
firozaa,	ফিরোজা,	ফিরোজা,	
kyathlik,	ক্যাঠলিক,	ক্যাথলিক,	
akhandata,	আখন্দতা,	অখণ্ডতা,	
medilek,	মেডিলেক,	মেডিলেক,	
byatikrami,	ব্যত্রকমমী,	ব্যতিক্রমী,	
spredashita,	স্প্রেদাশিত,	স্প্রেডশীট,	
monzooshree,	মন্জশূর্যে,	মঞ্জুশ্রী,	
prokalpagulo,	প্রকালপাগুলো,	প্রকল্পগুলো,	
choudhursoho,	চৌধুরসহ,	চৌধুরসহ,	
aamoode,	আমুওদে,	আমুদে,	
korley,	করলে,	করলে,	
pluck,	প্লাক,	প্ল্যাক,	
mukhomandal,	মুখমণ্ডল,	মুখমণ্ডল,	
sambhabonao,	সম্ভাবনাও,	সম্ভবনাও,	
joubanbatee,	যৌবনবাতে,	যৌবনবতী,	
charukala,	চারুকালা,	চারুকলা,	
gostigulo,	গোস্তিগুলো,	গোষ্ঠীগুলো,	
evereste,	ইভারেস্টে,	এভারেস্টে,	
saraiki,	সরাইকি,	সরাইকি,	
atwabishvashi,	অত্ববিশ্বাষী,	আত্মবিশ্বাসী,	
madhukori,	মাধুকোরি,	মাধুকরী,	
zonsa,	জোন্সা,	জোন্স,	
rananganey,	রাঙ্গনে,	রণাঙ্গনে,	
manab,	মানাব,	মানব,	
lotharan,	লোথারান,	লুথেরান,	
sangram,	সংগ্রাম,	সঙ্গ্রাম,	
teksuser,	টেকসাসের,	টেক্সাসের,	
ministara,	মিনিস্তারা,	মিনিস্টার,	
laishenshim,	লাইশেনমিম,	লাইসেন্সিং,	
sobchey,	সবচে,	সবচে,	
prashikkhane,	প্রশিক্ষণে,	প্রশিক্ষণে,	
charban,	চরবান,	চর্বন,	
marry,	মারি,	ম্যারি,	
dakteekiter,	ডাক্টিকিতের,	ডাকটিকিটের,	
shcholastic,	স্চোলাস্টিক,	স্কলাস্টিক,	
gandhike,	গাঁধিকে,	গান্ধীকে,	
achintyabhedaved,	অচিন্ত্যরেভাদ,	অচিন্ত্যভেদাভেদ,	
acrolect,	অ্যাক্রোলেক্ট,	অ্যাক্রোলেক্ট,	
masjidke,	মাসজিককে,	মসজিদকে,	
zibonnogor,	জীবনগগর,	জীবননগর,	
rajbandi,	রাজবন্দি,	রাজবন্দী,	
daakteekite,	দাক্তিতিতে,	ডাকটিকিটে,	
bisheshshyo,	বিশেষ্য,	বিশেষ্য,	
modhumotii,	মধুমতিই,	মধুমতী,	
shajano,	শাজানো,	সাজানো,	
chhon,	ছন,	ছোঁ,	
parjotaker,	পার্যতাকের,	পর্যটকের,	
gasthii,	গাস্থিই,	গোষ্ঠীই,	
boner,	বনের,	বনের,	
nodiiteyi,	নদীয়েতই,	নদীতেই,	
chapchap,	চাপচাপ,	চাপচাপ,	
dhani,	ধানী,	ধানি,	
ingrejra,	ইংরেজরা,	ইংরেজরা,	
carlosh,	কার্লোশ,	কার্লোস,	
deepan,	ডিপান,	দীপন,	
ase,	এসে,	আসে,	
lyaataa,	ল্যাট,	ল্যাটা,	
bbosonto,	ব্বসনটো,	বসন্ত,	
mukhabandha,	মুখবন্ধ,	মুখবন্ধ,	
minilosar,	মিনিলোসার,	মিনিলোসার,	
iuro,	আউউর,	ইউরো,	
summer,	সাম্মার,	সামার,	
ganosachetanata,	গণস্চানেতা,	গণসচেতনতা,	
indrani,	ইন্দ্রানি,	ইন্দ্রাণী,	
emarjensi,	এমারজেন্সি,	এমার্জেন্সি,	
landing,	ল্যান্ডিং,	ল্যান্ডিং,	
umb,	ইউএমএবি,	ইউএমবি,	
polashir,	পলাশির,	পলাশীর,	
kisti,	কিস্তি,	কিস্তি,	
hunine,	হুনিনে,	হুনাইন,	
mokhmoley,	মখমোলে,	মখমলে,	
haris,	হারিস,	হ্যারিস,	
superheroo,	সুপারহেরো,	সুপারহিরো,	
conservetion,	কনভারসেশন,	কনসারভেশন,	
jeten,	জেতেন,	জেতেন,	
jolrong,	জলরং,	জলরঙ,	
shootar,	সুতার,	শ্যুটার,	
gafeeloti,	গাফোলি,	গাফিলতি,	
monir,	মনির,	মনির,	
kei,	কেই,	কেই,	
bojiye,	বজিয়ে,	বজিয়ে,	
agomone,	আগোমনে,	আগমনে,	
maarmaader,	মারমাদের,	মারমাদের,	
yathaarthabhaabe,	যথার্থভাবে,	যথার্থভাবে,	
biswashi,	বিশ্বাসী,	বিশ্বাসী,	
muhurtati,	মুহুরতাটি,	মুহুর্তটি,	
mailkhanek,	মাইলখানকে,	মাইলখানেক,	
shalook,	শালুক,	শালুক,	
lutherana,	লুথেরানা,	লুথেরান,	
tooku,	টুকু,	টুকু,	
crime,	ক্রিইম,	ক্রাইম,	
meropenemer,	মেরোপেনমমের,	মেরোপেনেমের,	
miraqela,	মিরাকেলা,	মিরাকেল,	
oshtader,	ওষ্টাদের,	ওস্তাদের,	
lebina,	লেবিনা,	লেবিনা,	
zakharovar,	যাখারভভার,	জাখারোভার,	
dibi,	ডিবি,	দিবি,	
gonjona,	গঞ্জনা,	গঞ্জনা,	
byaptikaler,	ব্যাপ্তিকালের,	ব্যাপ্তিকালের,	
chitronattakar,	চিত্রনাত্তাকার,	চিত্রনাট্যকার,	
mulyayonsapekkhe,	মূল্যায়নমেশকে,	মূল্যায়নসাপেক্ষে,	
byomkes,	ব্যোমকেস,	ব্যোমকেশ,	
taderek,	তাদেরেক,	তাদেরেক,	
madhabike,	মাধাবীকে,	মাধবীকে,	
furio,	ফুরিও,	ফুরিও,	
sikkhakromer,	শিক্ষাক্রমের,	শিক্ষাক্রমের,	
kk,	কেকে,	কেকে,	
pinglateo,	পিংলাতেও,	পিংলাতেও,	
duple,	ডাপলে,	ডুপ্লে,	
shanno,	শান্ন,	সান্নো,	
jolrang,	জোলরাং,	জলরঙ,	
prachirer,	প্রাচীরের,	প্রাচিরের,	
sinakey,	সিনাকে,	সিনাকে,	
sahojatprobritti,	সহজতপ্রবৃত্তি,	সহজাতপ্রবৃত্তি,	
prijon,	প্রিজন,	প্রিজন,	
bii,	বিইইইই,	বি,	
mulyabriddhikale,	মূল্যবৃদ্ধিকালে,	মূল্যবৃদ্ধিকালে,	
kholdhular,	খোলদুলার,	খোলধূলার,	
hondooras,	হন্ডরাস,	হন্ডুরাস,	
neemeetto,	নেমিত্ব,	নিমিত্ত,	
toroonraa,	তরুনরা,	তরুণরা,	
shahanara,	শাহানারা,	শাহানারা,	
basaake,	বাসাকে,	বাসাকে,	
panda,	পান্ডা,	পান্ডে,	
show,	শোভ,	শো,	
manoharpur,	মনোহরপুর,	মনোহরপুর,	
protizogiita,	প্রতিযোগিতা,	প্রতিযোগীতা,	
pyetarna,	প্যাটার্না,	প্যাটার্ন,	
gaddaafee,	গা্্ফাফী,	গাদ্দাফী,	
laishensha,	লইশেনসহ,	লাইসেন্স,	
vugorvey,	ভুগরভে,	ভূগর্ভে,	
abikaul,	অবিকৌল,	অবিকল,	
ummool,	উম্মুল,	উম্মুল,	
oncholtee,	অঞ্চল্তে,	অঞ্চলটি,	
chhuti,	ছুটি,	ছুটি,	
japanostho,	যাপাসন্থ,	জাপানস্থ,	
protisthar,	প্রতিস্থার,	প্রতিষ্ঠার,	
sambatsarkal,	সম্বতৎস্কাল,	সম্বৎসরকাল,	
prodiiper,	প্রদীপের,	প্রদীপের,	
akai,	আকাই,	একাই,	
sheshardhe,	শেষার্ধে,	শেষার্ধে,	
ekhate,	এখাতে,	একহাতে,	
ghenshei,	ঘেঁশেই,	ঘেঁষেই,	
lutheerana,	লুথুরিনা,	লুথেরান,	
greenald,	গ্রিনল্ড,	গ্রিনল্ড,	
sangaskritipreme,	সংস্কৃতিপ্রেমে,	সংস্কৃতিপ্রেমে,	
krus,	ক্রুস,	ক্রুশ,	
modelkey,	মডেলকে,	মডেলকে,	
upobasher,	উপবাষের,	উপবাসের,	
aieesha,	আইশে,	আইএএস,	
taranee,	তারানী,	তরণী,	
konflict,	কনফ্লিক্ট,	কনফ্লিক্ট,	
soketgulor,	সোকেটগুলোর,	সকেটগুলোর,	
biphal,	বিফাল,	বিফল,	
labonaaktotaar,	লবণক্ততার,	লবণাক্ততার,	
akten,	আক্তেন,	অকটেন,	
cheef,	চীফ,	শেফ,	
nazad,	নাজাড,	নজদ,	
barack,	ব্যারাক,	বারাক,	
keu,	কেউ,	কেউ,	
turbine,	টারববাইন,	টারবাইন,	
municipal,	মুনিসিপাল,	মিউনিসিপ্যাল,	
beekaargrasta,	বিকারগ্রস্তা,	বিকারগ্রস্ত,	
laaisensh,	লয়েনেেশ,	লাইসেন্স,	
chiraharit,	চিরাহারিত,	চিরহরিৎ,	
prrajanankaal,	প্রজননকাল,	প্রজননকাল,	
fanse,	ফ্যান্সে,	ফাঁসে,	
europia,	ইউরোপিয়া,	ইউরোপিয়া,	
kindom,	কিন্ডম,	কিংডম,	
qyapasula,	ক্যাপাসুলা,	ক্যাপসুল,	
foloshrutite,	ফলশ্রুটিতে,	ফলশ্রুতিতে,	
chemjong,	চেমজং,	চেমজং,	
monchosthol,	মন্থসথল,	মঞ্চস্থল,	
themeke,	থেমেকে,	থিমকে,	
alaul,	আলাউল,	আলাওল,	
ipl,	আইপিএল,	আইপিএল,	
pratisthasaho,	প্রতিষ্ঠাসহ,	প্রতিষ্ঠাসহ,	
eexpreession,	এক্সপ্রিশন,	এক্সপ্রেশন,	
shudden,	শুদ্দেন,	সাডেন,	
monroe,	মনরো,	মনেরোর,	
bajhyo,	বাঝ্য,	বাহ্য,	
armori,	আরমোরি,	আরমোরি,	
godabari,	গোডাবারি,	গোদাবরী,	
onucheeder,	অনুচিদের,	অনুচ্ছেদের,	
srichoitonnodeb,	শ্রীচৈতন্যবনেবেব,	শ্রীচৈতন্যদেব,	
jaruri,	জারুরি,	জরূরী,	
lyaandeeng,	ল্যান্ডিং,	ল্যান্ডিং,	
taler,	ট্যালার,	তালের,	
refleks,	রেফলেকস,	রিফ্লেক্স,	
dibya,	দিবিয়া,	দিব্যা,	
nathivookteer,	নাথিবকুত্রের,	নথিভুক্তির,	
pooshti,	পুষ্টি,	পুষ্টি,	
ispredseet,	ইসপ্রেডসট,	স্প্রেডশীট,	
aaziz,	আজিজ,	আজিজ,	
oitijhya,	ঐতিহ্যা,	ঐতিহ্য,	
navaratri,	নবরত্রী,	নবরাত্রি,	
shamshere,	শমমেরে,	শমসের,	
vittiteo,	ভিত্তিতেও,	ভিত্তিতেও,	
paikgachha,	পাইকগাছা,	পাইকগাছা,	
associatis,	অ্যাসিয়েটিস,	এসোসিয়েটস,	
samley,	সামলে,	সামলে,	
osamanno,	অসামান্ন,	অসামান্য,	
rca,	রিসিএ,	আরসিএ,	
bisheshya,	বিশেষ্য,	বিশেষ্য,	
wilderske,	উইল্ডার্সকে,	উইল্ডার্সকে,	
qirq,	কির্ক,	কার্ক,	
bahubar,	বাহুবার,	বহুবার,	
ishtone,	ইশতনে,	স্টোন,	
balatarin,	বালাতারিন,	বালাতারিয়ান,	
shloker,	শ্লোকের,	শ্লোকের,	
bishwaashshke,	বিশ্বাষকে,	বিশ্বাসকে,	
talaal,	তালাল,	তালাল,	
licensin,	লাইসেনসিন,	লাইসেন্সিং,	
difinishian,	ডিফিনিশন,	ডেফিনেশন,	
rahshahi,	রাহশাহী,	রাহশাহী,	
zaire,	জায়ারে,	জাইরে,	
zoojyota,	যোজ্যতা,	যোজ্যতা,	
contemporary,	কন্টেমপারি,	কন্টেম্পোরারি,	
naazi,	নাজি,	নাত্সি,	
narsaari,	নরসারি,	নার্সারি,	
onchalgulir,	অঞ্চালগুলির,	অঞ্চলগুলির,	
abhidhaanic,	অভিচানিক,	অভিধানিক,	
becha,	বেচা,	বেচা,	
bhushito,	ভূষিত,	ভূষিত,	
uparjon,	উপার্যন,	উপার্জন,	
obhaarbhiu,	ওভারভিউ,	ওভারভিউ,	
bhagno,	ভাগনো,	ভগ্ন,	
maudelgulo,	মাউডেলগুলো,	মডেলগুলো,	
auttacharer,	অট্টাচারের,	অত্যাচারের,	
songkoloney,	সংকোলে,	সংকলনে,	
amor,	অমর,	আমর,	
digree,	ডিগ্রি,	ডিগ্রি,	
ghoomachhe,	ঘোমাচে,	ঘুমাচ্ছে,	
ddheela,	ঢেল,	ঢিলা,	
tinage,	টিনাজে,	টিনেজ,	
arg,	আর্গ,	আর্গ,	
ernad,	এরনাড,	এরনাড,	
kutubuddinke,	কুতুব্দিনকে,	কুতুবুদ্দিনকে,	
edaning,	এডানিং,	ইদানিং,	
aagera,	আগেরা,	আগোরা,	
niketon,	নিকেতন,	নিকেতন,	
kadapaker,	কাদাপাকের,	কড়াপাকের,	
doorger,	ডুর্গার,	দুর্গের,	
plate,	প্লাতে,	প্লেট,	
gaandaas,	গান্দাস,	জ্ঞানদাস,	
armstronz,	আর্মস্ট্রন,	আর্মস্ট্রং,	
santaa,	সান্তা,	সান্তা,	
ponchaashjon,	পঞ্চাশন,	পঞ্চাশজন,	
chandanara,	চন্দনারা,	চন্দনারা,	
nobotomo,	নবতম,	নবতম,	
bishshaasho,	বিশ্বাষ,	বিশ্বাসও,	
lettar,	লেট্টার,	লেটার,	
madhobeer,	মাধবীর,	মাধবীর,	
brookoleen,	ব্রোকুলিন,	ব্রুকলিন,	
bipti,	বিপ্তি,	বিপ্তি,	
rasunkunchi,	রাসুনচুঁচি,	রসুনকুঁচি,	
sumi,	সুমি,	সুমি,	
muktilav,	মুক্তিলাভ,	মুক্তিলাভ,	
lagto,	ল্যাগটো,	লাগতো,	
adbhanced,	অ্যাডভ্যান্ডে,	অ্যাডভান্সড,	
keuoi,	কেওও,	কেউই,	
boshoborty,	বোষবর্তী,	বশবর্তী,	
uponeesoder,	উপনিসদের,	উপনিষদের,	
rokkhonabekkhoner,	রক্ষ্ণকাবেষ্ণের,	রক্ষণাবেক্ষণের,	
rushod,	রুশোড,	রুশদ,	
baibosthaar,	বৈবস্থার,	ব্যবস্থার,	
vorkendra,	ভোর্কেন্দ্র,	ভরকেন্দ্র,	
chai,	চাই,	ছাই,	
atwobishvashi,	অত্ববিশ্ষাসী,	আত্মবিশ্বাসী,	
lagche,	লাগছে,	লাগছে,	
bosturoi,	বস্তুরই,	বস্তুরই,	
jolbe,	জলবে,	জ্বলবে,	
antorvuktimulak,	আন্তর্ভূতিমূলক,	অন্তর্ভুক্তিমূলক,	
paripakey,	পরিপকে,	পরিপাকে,	
scuvi,	স্কুভি,	স্কুভি,	
langhaner,	লাঘঘানের,	লংঘনের,	
dighol,	দিঘল,	দীঘল,	
bagicha,	বাগিচা,	বাগিচা,	
gotirodh,	গতিরোধ,	গতিরোধ,	
poscime,	পোস্মাইম,	পশ্চিমে,	
laaz,	লাজ,	লাজ,	
salafeta,	সালাফেটা,	সালফেট,	
ikboler,	ইকবোলের,	ইকবলের,	
ultrasonography,	আল্টারাস্গোরগ্ফি,	আলট্রাসনোগ্রাফিও,	
chalachchitroke,	চালাচ্ছিত্রকে,	চলচ্চিত্রকে,	
hossne,	হোসন,	হোসনে,	
dapadpi,	দাপাদপি,	দাপাদপি,	
shahoshikatar,	শাহশিকাতার,	সাহসিকতার,	
nabotom,	নাবতম,	নবতম,	
asiatic,	এসিয়াটিক,	এশিয়াটিক,	
hul,	হুল,	হুল,	
direectoratee,	ডারিক্টেরেট,	ডিরেক্টরেট,	
booksar,	বুকসার,	বুক্সার,	
dera,	ডেরা,	ডেরা,	
gabhaaskar,	গাভাস্কার,	গাভাস্কার,	
antorbhuktimulak,	অন্তর্ভূতিকলক,	অন্তর্ভুক্তিমূলক,	
choshon,	চোষন,	চোষণ,	
rakkhanvag,	রক্ষণভাগ,	রক্ষণভাগ,	
uddhritto,	উদ্ধিত্ব,	উদ্ধৃত,	
udyem,	উদ্যেম,	উদ্যেম,	
bhabanipur,	ভবাণীপুর,	ভবানীপুর,	
sadadyarao,	সদদ্যারও,	সদদ্যরাও,	
munjur,	মুঞ্জুর,	মুনজুর,	
with,	উইথা,	ভিত,	
byomkesh,	ব্যোমকেশ,	ব্যোমকেশ,	
temonbhabe,	টেমনভাবে,	তেমনভাবে,	
kiibord,	কীইবোর্ড,	কীবোর্ড,	
bibadey,	বিবাদে,	বিবাদে,	
meshmeshya,	মেশমেশ্য,	মেশহমেশহিইয়া,	
poste,	পোস্তে,	পোষ্টে,	
gazipur,	গাজিপুর,	গাজিপুর,	
hizriite,	হিজরাইট,	হিজরীতে,	
assaciates,	এসেয়েইটস,	এসোসিয়েটস,	
akar,	আকার,	একার,	
mukhobondho,	মুখবন্ধ,	মুখবন্ধ,	
dupleks,	ডাপলেক্স,	ডুপ্লে,	
seniar,	সেনিয়ার,	সিনিয়র,	
porbotmala,	পর্বত্বমালা,	পর্বতমালা,	
residensa,	রেসিডেন্স,	রেসিডেন্স,	
simons,	সিমনস,	সিমন্স,	
drishyogulotey,	দৃশ্যগুলেতে,	দৃশ্যগুলোতে,	
nomo,	নমো,	নমো,	
societytey,	সোসিটিটে,	সোসাইটিতে,	
query,	কুয়ারি,	কোয়েরি,	
ragei,	রাগেই,	রাগেই,	
balithubar,	বলিঠুবার,	বালিথুবার,	
apolokbhabe,	অপলকভাবে,	অপলকভাবে,	
phokser,	ফকসের,	ফক্সের,	
helly,	হেলি,	হিলি,	
purushika,	পুরুশিকা,	পুরুষিকা,	
enjineers,	এনজিনির্স,	ইঞ্জিনিয়ার্স,	
soommita,	সোমিতা,	সুমিতা,	
fooloo,	ফুলোও,	পোলো,	
female,	ফেমালে,	ফিমেল,	
bhittitei,	ভিত্তিতেই,	ভিত্তিতেই,	
shiulijhra,	শিউলিফরা,	শিউলিঝরা,	
relance,	রিল্যান্স,	রিলায়েন্স,	
duiekdiner,	ডুইকেদনিনের,	দুইএকদিনের,	
jeshh,	জেশ,	জেস,	
baaik,	বাইক,	বাইক,	
chat,	চট,	চ্যাট,	
ganaporibahaner,	গণপরিবাহণের,	গণপরিবহনের,	
hamburgey,	হ্যাম্বার্গে,	হামবুর্গে,	
ajeeboner,	আজীবনের,	আজীবনের,	
eigulor,	এইগুলোর,	এইগুলোর,	
chakrapani,	চক্রপণি,	চক্রপানী,	
torabganj,	তরাবগঞ্জ,	তোরাবগঞ্জ,	
moreecha,	মরিচা,	মরিচা,	
residence,	রেসিডেন্স,	রেসিডেন্স,	
nichupattir,	নিচুপত্তির,	নিচুপট্টির,	
masjidsaha,	মসজিদসহ,	মসজিদসহ,	
teennis,	টিনিস,	টেনিস,	
johor,	জহর,	জহর,	
kuttake,	কুট্তাকে,	কুত্তাকে,	
nabatarange,	নাবর্গে,	নবতরঙ্গে,	
institutione,	ইন্সটিউশেনে,	ইনস্টিটিউশনে,	
swartho,	স্বর্থ,	স্বার্থ,	
drissotir,	দৃশ্বতির,	দৃশ্যটির,	
hitlere,	হিটলেরে,	হিটলারে,	
naabbota,	নাব্যতা,	নাব্যতা,	
subader,	সুবাদের,	সুবাদে,	
poddhotitei,	পদ্ধতিতেই,	পদ্ধতিতেই,	
poroborti,	পরবর্তী,	পরর্বতী,	
panchbar,	পাঁচবার,	পাঁচবার,	
krusher,	ক্রুশের,	ক্রুশের,	
arke,	আরকে,	আরকে,	
shiropar,	শিরোপার,	শিরোপার,	
toufik,	তৌফিক,	তৌফিক,	
asovarno,	অসভার্ন,	অসবর্ণ,	
kul,	কুল,	কুল,	
jund,	জান্ড,	জুন্দ,	
ooipokar,	উপকার,	উইপোকার,	
prosadhani,	প্রসাধানী,	প্রসাধনী,	
shukraanoo,	শুক্রাণু,	শুক্রানু,	
dufresne,	ডাফ্রেসন,	ডুফরেস্ন,	
onker,	অঙ্কের,	ওঙ্কার,	
iling,	ইলিং,	ইলিং,	
biplobi,	বিপ্লবি,	বিপ্লবী,	
daakten,	দাকতেন,	ডাকতেন,	
alonkaran,	আলঙ্করণ,	অলঙ্করণ,	
oitijjo,	ঐতিজ্য,	ঐতিহ্য,	
boiporiityen,	বৈপরিত্যেনেয়,	বৈপরীত্যেন,	
shishupalgarh,	শিশুপল্গাহ,	শিশুপালগড়ে,	
dipti,	দিপ্তি,	ডেপুটি,	
kaloniir,	কালনীয়ির,	কালনীর,	
damodar,	দামোদার,	দামদর,	
songbadmadhyame,	সংবাদমাধ্যমে,	সংবাদমাধ্যমে,	
ranangone,	রানাঙ্গনে,	রণাঙ্গনে,	
darjiling,	ডার্জিলিং,	দার্জিলিং,	
stoonahenja,	স্তুনাহেনজা,	স্টোনহেঞ্জ,	
bonorajite,	বনরাজিতে,	বনরাজিতে,	
nartana,	নরতানা,	নর্টন,	
marodeho,	মারোদেহো,	মরদেহ,	
chhutochhuti,	ছুটোছুটি,	ছুটোছুটি,	
sossar,	সোসার,	সকার,	
dokanei,	দোকানেই,	দোকানেই,	
uthhaane,	উঠানে,	উঠানে,	
wrighter,	ঘিইচটার,	রাইটের,	
israelbahini,	ইসরানলাহিবানী,	ইস্রায়েলবাহিনী,	
sohokari,	সহকারি,	সহকারী,	
ooipoka,	উপপা,	উইপোকা,	
bhabotarini,	ভাবতারিণী,	ভবতারিণী,	
bbosben,	ব্বসেন,	বসবেন,	
sombhobonao,	সম্ভবনাও,	সম্ভবনাও,	
jaanar,	জানার,	জানার,	
carbus,	কারবাস,	কারবাস,	
kiandi,	কিয়ান্ডি,	ক্যান্ডি,	
armeenian,	আরমিনিয়ান,	আর্মেনিয়ান,	
protibedokrao,	প্রতিবেদকরাও,	প্রতিবেদকরাও,	
babona,	বাবোনা,	বাবনা,	
bhandti,	ভান্দটি,	ভাণ্ডটি,	
serveray,	সারভভারে,	সার্ভারে,	
rajashri,	রাজশ্রী,	রাজশ্রী,	
manjushri,	মঞ্জুষ্রী,	মঞ্জুশ্রী,	
tuni,	টুউনি,	টুনি,	
ispredsheet,	ইসপ্রেডটিত,	স্প্রেডশীট,	
devolapar,	দেবলাপার,	ডেভলপার,	
mawdeel,	মাওদিল,	মডেল,	
songasthatike,	সংস্থাতিকে,	সংস্থাটিকে,	
pujito,	পুজিত,	পুজিত,	
hames,	হ্যামেস,	হোমস,	
oindrila,	ঐন্দ্রিলা,	ঐন্দ্রিলা,	
hari,	হারি,	হরি,	
karecho,	কারেছো,	করেছ,	
noiteek,	নৈতিক,	নৈতিক,	
gratha,	গ্রাথা,	গ্রোথ,	
plainey,	প্লেই,	প্লেনে,	
dipgulote,	ডিপগুলোতে,	দ্বীপগুলোতে,	
banshite,	বাঁশিতে,	বাঁশিতে,	
sangkoolan,	সংকুলন,	সংকুলান,	
qarlosa,	কারলোসা,	কার্লোস,	
girilal,	গিরিলাল,	গিরিলাল,	
shaater,	সাতের,	শ্যুটার,	
morathee,	মোরাথী,	মরাঠি,	
shringa,	শ্রিং,	শৃঙ্গ,	
hugheke,	হুঘেকে,	হিউজকে,	
plate,	প্লাতে,	প্লেটে,	
cholochchitrake,	চলচ্চিত্রকে,	চলচ্চিত্রকে,	
falasrutite,	ফালাস্তুরিতে,	ফলশ্রুতিতে,	
laatimer,	লাতিমের,	লাটিমের,	
chhanada,	ছানাদা,	ছানাদা,	
bbiswashi,	বিব্বশবি,	বিশ্বাসই,	
naneer,	নানির,	নানীর,	
licenshe,	লাইসেন্সে,	লাইসেন্স,	
grontho,	গ্রন্থ,	গ্রন্থ,	
cena,	সেনা,	সিনা,	
musabbirul,	মুসববিরুল,	মুসাব্বিরুল,	
ciima,	সিমমা,	সীমা,	
daaun,	ডাউন,	ডাউন,	
bhramapraban,	ভ্রমাপ্রবণ,	ভ্রমপ্রবণ,	
sahapathike,	সহপথিকে,	সহপাঠীকে,	
ujbekistaner,	উজ্বেক্তিনানের,	উজবেকিস্তানের,	
ajuhath,	অজুহাত,	অজুহাত,	
nadike,	নাদিকে,	নদীকে,	
baju,	বাজু,	বাজু,	
stanahenja,	স্তানাহেঞ্জা,	স্টোনহেঞ্জ,	
bokahoke,	বোাহকে,	বকাহকে,	
rayyalati,	রয়ালতি,	রয়্যালটি,	
aqram,	আকরাম,	আকরাম,	
senior,	সেনিওর,	সিনিয়র,	
vobani,	ভোবানি,	ভবানী,	
fevarite,	ফেবারিতে,	ফেভারিট,	
behrampurer,	বেহরামপুরের,	বহরমপুরের,	
ghamtaa,	ঘামটা,	ঘোমটা,	
ekbakke,	একবাককে,	একবাক্যে,	
dola,	ডোলা,	দলা,	
sakshatkarer,	সাকশাতকরের,	সাক্ষাৎকারের,	
indra,	ইন্দ্রা,	ইন্দ্র,	
nischitobhabe,	নিশ্চিতভাবে,	নিশ্চিতভাবে,	
kyatagorir,	ক্যাটগগির,	ক্যাটাগরির,	
