totokson,	তোটকসন,	ততক্ষন,	
rakkhanbhag,	রক্ষণভাগ,	রক্ষণভাগ,	
bangulzai,	বাঙ্গুলজাই,	বঙ্গুলিজাই,	
proo,	প্রুও,	প্রো,	
srisri,	শ্রীশ্রি,	শ্রীশ্রী,	
chhutochhuti,	ছুটোছুটি,	ছুটোছুটি,	
fake,	ফাকে,	ফাকে,	
philipiner,	ফিলিপিনের,	ফিলিপাইনের,	
aaireshe,	আইরেশে,	আইরেসে,	
kushumba,	কুশুম্বা,	কুশুম্বা,	
dumaa,	ডুমা,	দুমা,	
boiporiityen,	বৈপরিতিয়েন,	বৈপরীত্যেন,	
metropolitan,	মেট্রোপিলাটন,	মেট্রোপলিটন,	
dorun,	দরুন,	দরুণ,	
bondishalatei,	বন্দিশালাতেই,	বন্দিশালাতেই,	
aansareer,	আনসারীর,	আনসারীর,	
jolaatonko,	জলাাতনকো,	জলাতঙ্ক,	
bandi,	বান্দি,	বন্দী,	
dabarer,	দাবারের,	দাবারের,	
sambhabonao,	সম্ভাবনাও,	সম্ভবনাও,	
aziza,	আজিজা,	আজিজা,	
pratijogider,	প্রতিযোগীদের,	প্রতিযোগীদের,	
cxt,	সিএসএিটি,	সিএক্সটি,	
uporitaley,	উপরিতালে,	উপরিতলে,	
koreempoor,	করিমপুর,	করিমপুর,	
bokahoke,	বোকাহোকে,	বকাহকে,	
kodorer,	কোরের,	কদরের,	
daakten,	ডাকতেন,	ডাকতেন,	
batsmanei,	বাটসমানেই,	ব্যাটসম্যানই,	
bongshokey,	বংশকে,	বংশকে,	
laishensha,	লৈশেনশা,	লাইসেন্স,	
baibosthar,	বৈবস্থার,	ব্যবস্থার,	
arasie,	আরাসি,	আরসিএ,	
madelim,	মাদেলিম,	মডেলিং,	
hevy,	হেভি,	হেভি,	
dipgulote,	ডিপগুলোতে,	দ্বীপগুলোতে,	
batikromee,	বাতিক্রমী,	ব্যতিক্রমী,	
samanwitovabe,	সমন্বিতভাবে,	সমন্বিতভাবে,	
elakaatite,	এলাকাটিতে,	এলাকাটিকে,	
amittrakkhor,	অমিত্রাক্ষর,	অমিত্রাক্ষর,	
arsie,	আরসি,	আরসিএ,	
shlok,	শ্লোক,	শ্লোক,	
doorger,	ডার্জার,	দুর্গের,	
naubom,	নওবম,	নবম,	
grambaashi,	গ্রামবাশী,	গ্রামবাসী,	
superheroo,	সুপারহেরও,	সুপারহিরো,	
parq,	পার্ক,	পার্ক,	
mandanda,	মন্দন্ডা,	মানদণ্ড,	
biswashi,	বিশ্বাশী,	বিশ্বাসই,	
munshiji,	মুনশিজি,	মুনশীজি,	
zonsa,	জনসা,	জোন্স,	
scholastic,	স্কোলাসটিক,	স্কলাস্টিক,	
fongli,	ফোংলি,	ফংলি,	
jotharthovabey,	যথার্থভাবে,	যথার্থভাবে,	
brekthrough,	ব্রেক্র্থুচ,	ব্রেকথ্রু,	
ansarir,	আনসারীর,	আনসারীর,	
sarboporee,	সর্বপরী,	সর্বোপরী,	
naraphoka,	নারাফোকা,	নরফোক,	
saamaanya,	সামা্য,	সামান্য,	
qredita,	ক্রেডিটা,	ক্রেডিট,	
nabatarange,	নবতরঙ্গে,	নবতরঙ্গে,	
anchalo,	অঞ্চলো,	অঞ্চলও,	
panthar,	পান্থার,	পন্থার,	
landing,	ল্যান্ডিং,	ল্যান্ডিং,	
bishhnu,	বিষ্ণু,	বিষ্ণু,	
subader,	সুবাদের,	সুবাদে,	
glanio,	গ্লানিও,	গ্লানিও,	
makame,	মাকামে,	মাকামে,	
shten,	স্টেন,	স্টেন,	
chire,	চিরে,	চিরে,	
protijogiider,	প্রতিযোগীদের,	প্রতিযোগীদের,	
jatinkey,	জাতিনকে,	যতীনকে,	
deliver,	ডেলিভার,	ডেলিভার,	
qulim,	কুলিম,	কুলিং,	
batikromi,	বাতিক্রমী,	ব্যতিক্রমী,	
balokarak,	বালোকারক,	বলকারক,	
abadamoner,	আবাদামনের,	অবদমনের,	
pitiler,	পিতিলের,	পিটিলের,	
oswastikor,	অস্বাস্তিকর,	অস্বস্তিকর,	
naajii,	নাজি,	নাত্সি,	
sift,	সিফট,	শিফট,	
gaje,	গাজে,	গেজ,	
chhuti,	ছুটি,	ছুটি,	
deqe,	ডেকে,	ডেকে,	
engrejra,	এনরেজ্রা,	ইংরেজরা,	
aieesha,	আইসা,	আইএএস,	
shikhaboudi,	শিখাবৌদি,	শিখাবৌদি,	
oikhan,	ঐখান,	ঐখান,	
jonmobhumitir,	জন্মভূমিতির,	জন্মভূমিটির,	
paira,	পাইরা,	পাইরা,	
baibosthaar,	বৈবস্থার,	ব্যবস্থার,	
podotyagsongkranto,	পদত্যাসংক্রান্ত,	পদত্যাগসংক্রান্ত,	
gotihin,	গতিহীন,	গতিহীন,	
simons,	সিমোন্স,	সিমন্স,	
chikittsar,	চিকিটসার,	চিকিত্সার,	
masjidke,	মাসজিদকে,	মসজিদকে,	
bii,	বিআইআআই,	বি,	
myathiou,	ম্যাথিও,	ম্যাথিউ,	
siqhar,	সিখার,	শিকার,	
hetimganje,	হেতিমগঞ্জে,	হেতিমগঞ্জে,	
bipajjanak,	বিপাজ্জনক,	বিপজ্জনক,	
uponishad,	উপনিষাদ,	উপনিষদ,	
bhoutikeshu,	ভৌতিকেশু,	ভৌতিকেষু,	
patigoniter,	পাতিগণিতের,	পাটিগণিতের,	
tanu,	তানু,	তনু,	
sikkhagata,	শিক্ষাগত,	শিক্ষাগত,	
jacksoner,	জ্যাকসনের,	জ্যাকসনের,	
beekaargrasta,	বিকারগ্রস্ত,	বিকারগ্রস্ত,	
nanir,	নানির,	নানীর,	
brekethru,	ব্রেকেখুরু,	ব্রেকথ্রু,	
kamti,	কামটি,	কমতি,	
akeeb,	আকিব,	আকিব,	
panchasjan,	পঞ্চসগান,	পঞ্চাশজন,	
daacktickete,	ড্যাক্টিকেতে,	ডাকটিকিটে,	
prokolpogulor,	প্রকল্পগুলোর,	প্রকল্পগুলোর,	
swarther,	স্বার্থের,	স্বার্থের,	
kormokarer,	কর্মকারের,	কর্মকারের,	
byaktigotovabeo,	ব্যক্তিগতভাবেও,	ব্যাক্তিগতভাবেও,	
obharbhiu,	ওভারভি,	ওভারভিউ,	
saras,	সরাস,	সরস,	
pettern,	পেটার্ন,	প্যাটার্ন,	
torunosomriddho,	তরুণসমৃদ্ধ,	তরুণসমৃদ্ধ,	
dovaar,	দোভার,	ডোভার,	
bisheshshyer,	বিশেষ্যের,	বিশেষ্যের,	
sthaponagulo,	স্থাপনাগুলো,	স্থাপনাগুলো,	
antarctika,	অ্যান্টারক্কিকা,	অ্যান্টার্কটিকা,	
noiteekotar,	নৈটকিতার,	নৈতিকতার,	
reetesh,	রেতেশ,	রিতেশ,	
sorano,	সোরানো,	সরানো,	
emargency,	এমারজেন্সি,	এমার্জেন্সি,	
sonaicha,	সোনাইচা,	সোনাইচা,	
rilayensa,	রিলয়েন্,	রিলায়েন্স,	
prosadhoner,	প্রসাধনের,	প্রসাধনের,	
ramchander,	রামচন্দের,	রামচন্দরের,	
bodhukeo,	বধুকেও,	বধুকেও,	
bolvodro,	বলভদ্র,	বলভদ্র,	
aborto,	অবর্ত,	আবর্ত,	
monir,	মনির,	মনির,	
fimela,	ফিমেলা,	ফিমেল,	
parikhar,	পরীখর,	পরিখার,	
paadee,	পাদি,	পাড়ে,	
purushika,	পুরুষিকা,	পুরুষিকা,	
golimodhye,	গোলিমধ্যে,	গলিমধ্যে,	
patininda,	পাতিনিন্দা,	পতিনিন্দ,	
horipur,	হরিপুর,	হরিপুর,	
byabaharkareederke,	ব্যবহারকারীদেরকে,	ব্যবহারকারীদেরকে,	
asovya,	অসভ্যা,	অসভ্য,	
lampot,	ল্যাম্পোট,	লম্পট,	
atmira,	আত্মীরা,	আত্মীরা,	
sithilotar,	সিথিলতার,	শিথিলতার,	
atighataner,	অতিঘাটনের,	অতিঘটনের,	
bhadaka,	ভাদাকা,	ভদকা,	
engrejer,	এনরেজ্রের,	ইংরেজের,	
bishashke,	বিশাসকে,	বিশ্বাসকে,	
amburi,	আম্বুরি,	আম্বুরি,	
bee,	বিআইআই,	বি,	
maritimer,	মারিটিমের,	মেরিটাইমের,	
soource,	সার্স,	সোর্স,	
manob,	মানব,	মানব,	
hugheke,	হুঘেকে,	হিউজকে,	
zommu,	জমমু,	জম্মু,	
marmaraa,	মারমারা,	মারমারা,	
piulir,	পিউলির,	পিউলির,	
pack,	প্যাক,	প্ল্যাক,	
gronther,	গ্রন্থের,	গ্রন্থের,	
muhaiminer,	মুহাইমিনের,	মুহাইমিনের,	
bibader,	বিবাদের,	বিবাদের,	
manohputa,	মনোহপুতা,	মনঃপুত,	
aamor,	আমোর,	আমর,	
shommoteer,	শম্মতির,	সম্মতির,	
prarthonakokkher,	প্রার্থনাক্ষের,	প্রার্থনাকক্ষের,	
bangladesh,	বাংলাদেশ,	বঙ্গালাদেস,	
besirvagei,	বেসিরভাগেই,	বেশিরভাগেই,	
akram,	আক্রাম,	আকরাম,	
neshnos,	নেশনস,	নেশনস,	
sardar,	সরদার,	সরদার,	
chaka,	চাকা,	চাকা,	
thailand,	থাইল্যান্ড,	থাইল্যান্ড,	
gondogol,	গণ্ডগল,	গন্ডগোল,	
mahbunur,	মাহবুনুর,	মাহবুনুর,	
croak,	ক্রোক,	ক্রোক,	
tennis,	টেনিস,	টেনিস,	
byabaharkarike,	ব্যবহারকারীকে,	ব্যবহারকারীকে,	
obdee,	ওব্দি,	অব্দি,	
dolu,	দোলু,	ডলু,	
goteehin,	গতিহীন,	গতিহীন,	
mishal,	মিশাল,	মিশাল,	
sectore,	সেক্টরে,	সেক্টরে,	
siraju,	সিরাজু,	সিরাজু,	
maudelder,	মাউডেল্ডের,	মডেলদের,	
mithener,	মিথেনের,	মিথেনের,	
hertj,	হার্টজ,	হার্জ,	
ucchosito,	উচ্চসিত,	উচ্ছসিত,	
johny,	জনহি,	জনি,	
soketgulor,	সোকেটগুলোর,	সকেটগুলোর,	
ukeliptash,	উউকেলিপ্তাশ,	ইউক্যালিপ্টাস,	
chenza,	চেঞ্জা,	চেঞ্জ,	
kinsa,	কিনসা,	কিংস,	
gandagol,	গান্দাগোল,	গন্ডগোল,	
mukhomondoler,	মুখমণ্ডলের,	মুখমণ্ডলের,	
janmat,	জানমাত,	জন্মাত,	
protijogii,	প্রতিযোগী,	প্রতিযোগী,	
nirmankaaj,	নির্মানকাজ,	নির্মাণকাজ,	
vortuki,	ভর্তুকি,	ভর্তুকি,	
ramantic,	র্যামেন্টিক,	রোমান্টিক,	
rohosyoti,	রহষ্যতি,	রহস্যটি,	
kiandi,	কিয়ান্দি,	ক্যান্ডি,	
anyarup,	অন্যাূপ,	অন্যরূপ,	
chhon,	ছোন,	ছোঁ,	
chowdhurir,	চৌধুরির,	চৌধুরীর,	
durgatsober,	দুর্গাতসবের,	দুর্গোৎসবে,	
shrichaitanyadev,	শ্রীচাতত্যাদেব,	শ্রীচৈতন্যদেব,	
nodimatrik,	নোদিমাত্রিক,	নদীমাতৃক,	
logic,	লোজিক,	লজিক,	
samajikatar,	সমাজিকতার,	সামাজিকতার,	
sheshardhe,	শেষার্ধে,	শেষার্ধে,	
residence,	রেসিডেন্সে,	রেসিডেন্স,	
motke,	মোককে,	মতকে,	
shithilata,	শিথিলতা,	শিথিলতা,	
monjurul,	মঞ্জুরুল,	মনজুরুল,	
amanisha,	আমানিশা,	অমানিশা,	
fokskon,	ফকস্কন,	ফক্সকন,	
elakatikay,	এলাকাটিকা,	এলাকাটিকে,	
foolkopi,	ফুলকোপি,	ফুলকপি,	
sallallahu,	সাল্লাল্লাহু,	সল্লাল্লাহু,	
bonbhumi,	বনভুমি,	বনভূমি,	
protinito,	প্রতিনিত,	প্রতিনিত,	
uporitale,	উপরিতালে,	উপরিতলে,	
rajyotiro,	রাজ্যটিরও,	রাজ্যটিরও,	
karecho,	কারেছো,	করেছো,	
gemske,	জেমসকে,	জেমসকে,	
gobeshakgon,	গবেষাকগণ,	গবেষকগণ,	
shulfate,	শুলফাটে,	সালফেট,	
neker,	নেকের,	নেকের,	
uter,	উতের,	উটের,	
summer,	সুমার,	সামার,	
machgulo,	মাছগুলো,	মাছগুলো,	
sharif,	শরীফ,	শরিফ,	
tasminer,	তাসমিনের,	তাসমিনের,	
tinhazar,	তিনহাজার,	তিনহাজার,	
pachattar,	পাচাত্তার,	পাচাত্তার,	
uponeesoder,	উপনিসদের,	উপনিষদের,	
kaaferder,	কাফেরদের,	কাফেরদের,	
siddhanto,	সিদ্ধান্ত,	সিদ্ধান্তও,	
dimbacriti,	ডিম্বাকরিটি,	ডিম্বাকৃতি,	
dikpal,	দিকপাল,	দিকপাল,	
gobeshokgon,	গবেষকগণ,	গবেষকগণ,	
songbadmadhyomer,	সংবাদমাধ্যমের,	সংবাদমাধ্যমের,	
janamukhi,	জানামুখী,	জনমুখী,	
bokul,	বোকুল,	বকুল,	
ala,	আলা,	আলা,	
jotinkey,	জটিনকে,	যতীনকে,	
kichudinpar,	কিছুদিনপার,	কিছুদিনপর,	
dankaan,	দানকান,	ডানকান,	
moushum,	মৌশুম,	মৌসুম,	
lendol,	লেন্ডল,	লেন্ডল,	
municipal,	মুনিসিপাল,	মিউনিসিপ্যাল,	
ciima,	সিইমা,	সীমা,	
ghumachche,	ঘুমাচ্ছে,	ঘুমাচ্ছে,	
brixfield,	ব্রিক্ফিল্ড,	ব্রিক্সফিল্ড,	
khamotagulor,	ক্ষাততগুলোর,	ক্ষমতাগুলোর,	
siitei,	সিইতেই,	শীতেই,	
vorkendra,	ভরকেন্দ্রের,	ভরকেন্দ্র,	
societytey,	সোিয়েটি,	সোসাইটিতে,	
uttor,	উত্তর,	উওর,	
jorury,	জোরুরি,	জরূরী,	
birishiritey,	বিরিশিরিতে,	বিরিশিরিতে,	
mmadhukkori,	ম্যামধুকরি,	মাধুকরী,	
direqtareta,	দীরেক্টারেতা,	ডিরেক্টরেট,	
shhow,	শুয়,	শো,	
lakshmir,	লক্ষ্মীর,	লক্ষ্মীর,	
horas,	হোরাস,	হোরাস,	
bhagnekeo,	ভাগনেকেও,	ভাগ্নেকেও,	
pisach,	পিসাচ,	পিশাচ,	
ajibooner,	আজিবুনের,	আজীবনের,	
kharar,	খারার,	খরার,	
debeting,	ডেবেটিং,	ডিবেটিং,	
niropekkho,	নিরপপেক্ষ,	নিরপেক্ষ,	
dwijenbabuder,	দ্বিজেনবাবুদের,	দ্বিজেনবাবুদের,	
ruptan,	রূপ্তান,	রূপটান,	
teamothy,	টিমোটি,	টিমোথি,	
sector,	সেক্টর,	সেক্টর,	
taunsheep,	তাউনশীপ,	টাউনশিপ,	
fasi,	ফাসি,	ফাঁসী,	
bhenkates,	ভেঙ্কেটেস,	ভেঙ্কটেশ,	
duio,	দুইও,	দুইও,	
kaalki,	কালকি,	কালকি,	
dhhaloor,	ঢালুর,	ঢালুর,	
melborrone,	মেলবররোনে,	মেলবোর্নে,	
padee,	পাডি,	পাড়ে,	
proshtutkarok,	প্রস্তুতকারক,	প্রস্তুতকারক,	
jonosomaj,	জনসমাজ,	জনসমাজ,	
bakhyateet,	বাখ্যাটিত,	ব্যাখ্যাতীত,	
kooshumba,	কুশম্বা,	কুশুম্বা,	
ganokantha,	গণকাঠা,	গণকণ্ঠ,	
khanonkaj,	খানোকাজ,	খননকাজ,	
satjaner,	সতজানের,	সাতজনের,	
ishahak,	ইশাহক,	ইসাহাক,	
deares,	ডিয়ারেস,	ডিআরএস,	
jalbe,	জলবে,	জ্বলবে,	
kormoi,	কর্মই,	কর্মই,	
ap,	এপিপ,	আপ,	
ceramiksh,	সেরামিক্ষ,	সিরামিকস,	
adarsho,	আদর্শ,	আর্দশ,	
gandhike,	গা্ধীকে,	গান্ধীকে,	
falak,	ফালাক,	ফলক,	
nariderke,	নারিদেরকে,	নারিদেরকে,	
saarbhaarti,	সারভারটি,	সার্ভারটি,	
mukhoshdharir,	মুখোশধারীর,	মুখোশধারীর,	
bujhtepari,	বুঝতেপারী,	বুঝতেপারি,	
bosonte,	বসন্তে,	বসন্তে,	
madaspushto,	মাদাপসূষ্ট,	মদদপুষ্ট,	
temonvabe,	তেমনভাবে,	তেমনভাবে,	
poscime,	পশ্িম,	পশ্চিমে,	
varote,	ভারোতে,	ভারতে,	
daktikit,	ডক্তিকিত,	ডাকটিকিট,	
uindos,	উইন্ডস,	উইন্ডোস,	
prachirer,	প্রাচিরের,	প্রাচিরের,	
eshtoniya,	এসতনীয়া,	এস্তোনিয়া,	
bonnypran,	বন্নিপ্রাণ,	বন্যপ্রাণ,	
adhikartai,	অধিকর্তাই,	অধিকর্তাই,	
karmakarke,	কর্মকররকে,	কর্মকারকে,	
krema,	ক্রেমা,	ক্রাইম,	
jotsna,	জোটসনা,	জ্যোৎস্না,	
protijogiitamulok,	প্রতিযোগিতামূলক,	প্রতিযোগীতামূলক,	
purohitder,	পুরোহিতদের,	পুরোহিতদের,	
nirapattamulok,	নিরাপত্তামূলক,	নিরাপত্তামূলক,	
laicenshe,	লেইসেন্শে,	লাইসেন্স,	
grambasheeo,	গ্রামবাশেও,	গ্রামবাসীও,	
fol,	ফোল,	ফল,	
jeebonnogor,	জীবন্গগর,	জীবননগর,	
dokan,	দোকান,	দোকান,	
tyapa,	ত্যাপা,	ট্যাপ,	
sokkhomotabriddhi,	সক্ষমতার্ৃদ্ধি,	সক্ষমতাবৃদ্ধি,	
injiniyarim,	ইনজিনিয়ারিম,	ইঞ্জিনিয়ারিং,	
kanshater,	কাশশতের,	কানসাটের,	
kanar,	কানার,	কণার,	
fooloo,	ফুলো,	পোলো,	
otyacharito,	অত্যাচারিত,	অত্যাচারিত,	
pujit,	পুজিত,	পুজিত,	
ruby,	রুবি,	রুবী,	
dakshinangsho,	দক্ষিণাংশ,	দক্ষিণাংশ,	
with,	উইথ,	ভিত,	
kramp,	ক্রাম্প,	ক্র্যাম্প,	
tata,	তাতা,	তাতা,	
pragreesa,	প্রগ্রিস,	প্রগ্রেস,	
mawdeel,	মাউজিল,	মডেল,	
lyaandeeng,	ল্যান্ডিং,	ল্যান্ডিং,	
graambaasheeo,	গ্রামবাশিও,	গ্রামবাসীও,	
chaudhurio,	চাধুরিও,	চৌধুরীও,	
balakarak,	বালাকারক,	বলকারক,	
kram,	ক্রাম,	ক্রম,	
dipankar,	দীপাঙ্কার,	দিপঙ্কর,	
hock,	হক,	হুক,	
nagorikota,	নাগরিকতা,	নাগরিকতা,	
mahasava,	মহাসাভা,	মহাসভা,	
oncholshomuh,	অঞ্চলসমূহ,	অঞ্চলসমূহ,	
protishtan,	প্রতিষ্টান,	প্রতিষ্টান,	
pushtee,	পুশতি,	পুষ্টি,	
rajnikant,	রাজনিকান্ত,	রাজনীকান্ত,	
nothibhukta,	নথিভুক্ত,	নথিভুক্ত,	
mosjidtir,	মসজিদটির,	মসজিদটির,	
gardeen,	গার্ডিন,	গার্ডেন,	
ssahocorze,	স্বাহরকজে,	সাহচর্যে,	
mooney,	মুনে,	মুনে,	
byaboharkari,	ব্যবহারকারী,	ব্যবহারকারী,	
naazee,	নাজী,	নাত্সি,	
cheekitshar,	চিকিৎশার,	চিকিত্সার,	
bahati,	বাহাতি,	বাহাতি,	
gore,	গোরে,	গোর,	
chaudhuriyo,	চৌধুরিও,	চৌধুরীও,	
kanasarabheeshana,	কাসর্ভিষণ,	কনসারভেশন,	
sangram,	সংগ্রাম,	সঙ্গ্রাম,	
sofie,	সফিয়,	সোফি,	
hilser,	হিলসের,	হিলসের,	
vabnakey,	ভব্নাকে,	ভাবনাকে,	
prithibir,	পৃথিবির,	পৃথবীর,	
taronee,	তারণী,	তরণী,	
atmiyasulabh,	আত্মিবালুভা,	আত্মীয়সুলভ,	
mandope,	মাণ্ডোপে,	মন্ডপে,	
kailashrao,	কাইলশ্রও,	কৈলাশরাও,	
smarok,	স্মারক,	স্মারক,	
sthaponagulor,	স্থাপনাগুলোর,	স্থাপনাগুলোর,	
chhutir,	ছুটির,	ছুটির,	
chhotogolper,	ছোটগল্পের,	ছোটগল্পের,	
comoros,	কমোরোস,	কোমোরোস,	
pluck,	প্লাক,	প্ল্যাক,	
nehle,	নেহলে,	নেহলে,	
angkita,	অঙ্কিতা,	অঙ্কিতা,	
hepatitis,	হেপাটিটিস,	হেপাটাইটিস,	
tahorir,	তাহোরীর,	তাহরীর,	
farhetin,	ফারেটিন,	ফারহেতিন,	
manibhaijaner,	মনিভাজানের,	মণিভাইজানের,	
uddharkarmirai,	উদ্ধর্ক্মেরাই,	উদ্ধারকর্মীরাই,	
alaul,	আলাউল,	আলাওল,	
lagchhe,	লাগছে,	লাগছে,	
headquartus,	হেডকাকার্টাস,	হেডকোয়ার্টাস,	
carlosh,	কার্লোশ,	কার্লোস,	
shipley,	শিপলে,	শিপলে,	
baibasthaar,	বৈবস্থার,	ব্যবস্থার,	
modhyekar,	মধ্যেকার,	মধ্যেকার,	
shikhra,	শিখরা,	শিখরা,	
phareeksa,	ফরিকসা,	ফরেক্স,	
monzushree,	মন্জশুরী,	মঞ্জুশ্রী,	
seconder,	সেকন্ডার,	সেকেন্ডের,	
parshwer,	পার্শ্বের,	পার্শ্বের,	
shhepha,	শেফা,	শেফ,	
otyacharer,	অত্যাচরের,	অত্যাচারের,	
juktorashtreo,	যুক্তরাশ্ত্রেও,	যুক্তরাষ্ট্রেও,	
charpanch,	চরপাঙ্চ,	চারপাঁচ,	
onurbar,	অনুর্বার,	অনুর্বর,	
songrahak,	সংগ্রহক,	সংগ্রাহক,	
khali,	খালি,	খালি,	
shahurgulor,	শহুরগুলোর,	শহুরগুলোর,	
iuro,	ইউরো,	ইউরো,	
biplabee,	বিপ্লবি,	বিপ্লবী,	
besur,	বেসুর,	বেসুর,	
aakaabar,	আকাবার,	আকাবার,	
lopjonito,	লোপজনিত,	লোপজনিত,	
tigmanshu,	তিগমানশু,	তিগমংশু,	
ponchaasjon,	পঞ্চাসজন,	পঞ্চাশজন,	
kindom,	কিন্দোম,	কিংডম,	
kareer,	কারীর,	কারীর,	
bedanta,	বেদান্ত,	বেদান্ত,	
qara,	কারা,	কর,	
rachanakal,	রচনাকাল,	রচনাকাল,	
shomostigoto,	শমস্তিগত,	সমষ্টিগত,	
upbasher,	উপবাশের,	উপবাসের,	
goora,	গুরা,	গোর,	
perri,	পেরি,	পেরি,	
dipke,	দিপকে,	দ্বীপকে,	
eucalyptus,	ইউক্ল্যাপিটস,	ইউক্যালিপ্টাস,	
ateetkale,	অতিতকালে,	অতীতকালে,	
grambaashio,	গ্রামবাশিও,	গ্রামবাসীও,	
mile,	মিলে,	মিলে,	
moreecha,	মরিচ্ছা,	মরিচা,	
shrimoti,	শ্রীমতি,	শ্রীমতি,	
jontrangshogulor,	যন্ত্রাংশগুলোর,	যন্ত্রাংশগুলোর,	
phiksim,	ফিকসিম,	ফিক্সিং,	
gate,	গাতে,	গ্যেটে,	
chheher,	ছেহের,	ছেহের,	
bidghootey,	বিডঘোটে,	বিদঘুটে,	
byan,	ব্যান,	ব্যাং,	
sobaiderke,	সোবাইদেরকে,	সবাইদেরকে,	
sahooseekotar,	সহসীকতার,	সাহসিকতার,	
chalai,	চালাই,	চালাবে,	
chalochchitreer,	চালচ্ছিত্রীর,	চলচ্চিত্রের,	
gagee,	গগী,	গেজ,	
ashociatesh,	অশোচিয়াতেশ,	এসোসিয়েটস,	
naobihar,	নওবিহার,	নৌবিহার,	
amar,	আমার,	আমর,	
suparahiro,	সুপারাহীরও,	সুপারহিরো,	
toki,	তোকি,	তকি,	
nationalser,	ন্যাটনালের,	ন্যাশনালসের,	
chilahatee,	চিলাহাটি,	চিলাহাটি,	
assaciates,	অ্যাসিকিটেটেজ,	এসোসিয়েটস,	
graambaashio,	গ্রামবাশিও,	গ্রামবাসীও,	
deejeejer,	দিজিজের,	ডিজিজের,	
deil,	দেইল,	ডেইল,	
ongkush,	অংকুশ,	অংকুশ,	
hariken,	হরিকেন,	হ্যারিকেন,	
abhiyojan,	অভিযোজন,	অভিযোজন,	
monzeele,	মঞ্জিলে,	মঞ্জিলে,	
janghu,	জাংহু,	জঙ্ঘু,	
swadhinotatukui,	স্বাধীনতাটুকুই,	স্বাধীনতাটুকুই,	
chandrima,	চন্দ্রীমা,	চন্দ্রিমা,	
hypar,	হাইপার,	হাইপার,	
champa,	চামপা,	চাঁপা,	
booroon,	বুরোন,	বোরন,	
mohit,	মহিত,	মুহিত,	
vogiroth,	ভোগিরোথ,	ভগীরথ,	
sahittekder,	সাহিত্যেকদের,	সাহিত্যেকদের,	
chaanoo,	চানুও,	চানু,	
mirakela,	মিরাকেলা,	মিরাকেল,	
suhasini,	সুহাসিনী,	সুহাসিনী,	
rakkhandurga,	রক্ষণদুরগা,	রক্ষণদুর্গ,	
asovyo,	অসভ্য,	অসভ্য,	
shikshagato,	শিক্ষাত,	শিক্ষাগত,	
sylvi,	সিলভি,	সিলভি,	
rahimed,	রহিমেদ,	রহিমেদ,	
raia,	রায়াই,	রায়,	
abhidhaaner,	অভিধানের,	অভিধানের,	
hondooras,	হন্ডোরাস,	হন্ডুরাস,	
jaandrel,	জান্ড্রেল,	জাঁদরেল,	
teentir,	টিন্টির,	তিনটির,	
tikto,	টিকটো,	তিক্ত,	
venisey,	ভেনিসে,	ভেনিসে,	
tantubayer,	তান্তুবায়ের,	তন্তুবায়ের,	
kaash,	কাশ,	কাস,	
platform,	প্ল্যাটফর্ম,	প্লাটফর্ম,	
edseler,	এডসেলের,	এডসেলের,	
parqim,	পারকিম,	পার্কিং,	
jounatar,	যৌনতার,	যৌনতার,	
laishenshim,	লৈশেনশিম,	লাইসেন্সিং,	
cholochchitratike,	চলচ্চিত্রাটিকে,	চলচ্চিত্রটিকে,	
sikarer,	সিকারের,	শিকারের,	
charban,	চরবান,	চর্বন,	
rca,	আরসিএ,	আরসিএ,	
swostir,	স্বস্তির,	স্বস্তির,	
dooburira,	দুবুরীরা,	ডুবুরিরা,	
sahachke,	সাচাকে,	সাহাচকে,	
mahafezkhanar,	মহাফেখখানার,	মহাফেজখানার,	
kanshat,	কাশশত,	কানসাট,	
shikshagata,	শিক্ষাত,	শিক্ষাগত,	
uzobekeestaan,	উজবেকিস্তান,	উজবেকিস্তান,	
nischitobhabe,	নিশ্চিতভাবে,	নিশ্চিতভাবে,	
aatmobishwasi,	আত্মবিশ্বাসী,	আত্মবিশ্বাসী,	
tintir,	তিনটির,	তিনটির,	
aagera,	আজেরা,	আগোরা,	
kalkarkhana,	কলকরখানা,	কলকারখানা,	
shhikara,	শিকারা,	শিকার,	
sobrakamer,	সব্রকামের,	সবরকমের,	
nirbahi,	নির্বাহী,	নির্বাহি,	
rakkhanvag,	রক্ষণভাগ,	রক্ষণভাগ,	
abhidhaaneeck,	অভিধানিক,	অভিধানিক,	
phokser,	ফকসের,	ফক্সের,	
poripaker,	পরিপাকের,	পরিপাকের,	
swastir,	স্বস্তির,	স্বস্তির,	
chapal,	চাপাল,	চপল,	
ujbekistaner,	উজবেকিস্তানের,	উজবেকিস্তানের,	
ancholsomuho,	অঞ্চলসমূহ,	অঞ্চলসমূহ,	
shorifer,	শরিফের,	শরিফের,	
rahee,	রাহী,	রাহি,	
cholochchitra,	চলচ্চিত্রা,	চলচ্চিত্র,	
horidwar,	হরিদ্বার,	হরিদ্বার,	
heze,	হেজে,	হেজ,	
sucre,	সাকরে,	সাকার,	
abhidhaanic,	অভিধানিক,	অভিধানিক,	
elbamtite,	এলবামটিতে,	এলবামটিতে,	
jokkher,	জক্ষের,	যক্ষের,	
patengar,	পাটেঙ্গার,	পতেঙ্গার,	
parqa,	পারকা,	পার্ক,	
pothon,	পথন,	পঠন,	
harris,	হ্যারিস,	হ্যারিস,	
dhormokorme,	ধর্মকর্মে,	ধর্মকর্মে,	
torikher,	তরিখের,	তরিখের,	
priseflex,	প্রিইসেল্সেক্স,	প্রাইজফ্লেক্স,	
indro,	ইন্দ্রো,	ইন্দ্র,	
teman,	তেমান,	তেমন,	
kaia,	কাইয়া,	কায়া,	
kortona,	কর্তনা,	করতনা,	
forex,	ফরেক্স,	ফরেক্স,	
ivil,	ইভিল,	ইভিল,	
istoone,	ইস্তুনে,	স্টোন,	
buth,	বুথ,	বুথ,	
kuldip,	কুলদিপ,	কুলদীপ,	
paroner,	পারণের,	পারণের,	
palestine,	পেলেস্টিনে,	প্যালেস্টাইনে,	
terlarang,	টের্লার্গ,	তেরলারং,	
chaiten,	চেইতেন,	চাইতেন,	
kushakhali,	কুশাখালি,	কুশাখালি,	
moshjidke,	মোশজিদকে,	মসজিদকে,	
balabhadra,	বালাভাদরা,	বলভদ্র,	
mohajot,	মহাজত,	মহাজোট,	
songkolonti,	সংকলনটি,	সংকলনটি,	
ramachandranke,	রামান্দ্রকেণে,	রামাচন্দ্রনকে,	
japanostho,	জাপানস্থ,	জাপানস্থ,	
concerter,	কনসার্টের,	কানসাটের,	
satan,	সতান,	শয়তান,	
karima,	কারিমা,	করিম,	
ramonar,	রামনার,	রমনার,	
amudey,	আমুদে,	আমুদে,	
nojder,	নজদের,	নজদের,	
graambaaseer,	গ্রাম্বাসার,	গ্রামবাসীর,	
maner,	মানের,	মানে,	
ahmed,	আহমেদ,	আহামদ,	
kuronir,	কুরোনির,	কুরনীর,	
khude,	খুদে,	ক্ষুদে,	
booponer,	বুপনের,	বপনের,	
pyetarna,	পায়াট্রান,	প্যাটার্ন,	
pracharanamulak,	প্রচারণামূলক,	প্রচারণামূলক,	
deilee,	দেইলি,	ডেইলি,	
engrezder,	এনরজজ্ের,	ইংরেজদের,	
salmanul,	সালমানুল,	সালমানুল,	
cloudbook,	ক্লাডবুক,	ক্লাউডবুক,	
zaire,	জায়ার,	জাইরে,	
salsa,	সালসা,	সালসা,	
bhenus,	ভেনুস,	ভেনাস,	
nirgaman,	নিরগামান,	নির্গমন,	
battery,	ব্যাটারি,	ব্যাটারী,	
lekhaksattwar,	লেখকস্তত্বর,	লেখকসত্ত্বার,	
pouchute,	পৌছুতে,	পৌঁছুতে,	
dalip,	ডালিপ,	দালিপ,	
shaater,	শাতের,	শ্যুটার,	
prasadhoni,	প্রাসাধনী,	প্রসাধনী,	
ostheesandhi,	অস্থিসান্ধি,	অস্থিসন্ধি,	
lungiti,	লুঙ্গীতি,	লুঙ্গিটি,	
hillse,	হিলসে,	হিলসে,	
subade,	সুবাদে,	সুবাদে,	
kayech,	কয়েচ,	কায়েছ,	
favorite,	ফ্যাভারিতে,	ফেভারিট,	
bhabotarini,	ভবতারিণী,	ভবতারিণী,	
brittakarey,	বৃত্তাকারে,	বৃত্তাকারে,	
meghacchonno,	মেঘাক্্যন,	মেঘাচ্ছন্ন,	
prity,	প্রিটি,	প্রিটি,	
ganosachetanata,	গণসাচাতেনতা,	গণসচেতনতা,	
bifol,	বিফল,	বিফল,	
grahoksebai,	গ্রাহকসেবাই,	গ্রাহকসেবায়,	
dhadhiye,	ধাধিয়ে,	ধাধিয়ে,	
firoza,	ফিরোজা,	ফিরোজা,	
difinishian,	ডিফিনিশিয়ান,	ডেফিনেশন,	
scholars,	স্কোলারস,	স্কলার্স,	
gronthao,	গ্রন্থাও,	গ্রন্থও,	
sudrissho,	সুদৃশ্,	সুদৃশ্য,	
krimlin,	ক্রিলিন,	ক্রিমলিন,	
laps,	ল্পাস,	ল্যাপস,	
plak,	প্লেক,	প্ল্যাক,	
maailkhanek,	মালখখানেক,	মাইলখানেক,	
alkatra,	আলকাত্র,	আলকাতরা,	
azijer,	আজিজের,	আজিজের,	
qor,	কোর,	কর,	
sheshdinti,	শেষদিনটি,	শেষদিনটি,	
ancholgoolir,	অঞ্চলগুলির,	অঞ্চলগুলির,	
ishter,	ইশ্টার,	ইস্টের,	
banshite,	বাঁশীতে,	বাঁশিতে,	
murader,	মুরাদের,	মুরাদের,	
templet,	টেম্পলেট,	টেম্পলেট,	
porirshoder,	পরীর্ষদের,	পরির্ষদের,	
gujob,	গুজব,	গুজব,	
golghare,	গোঘঘরে,	গোলঘরে,	
ceramiker,	সেরামিকের,	সিরামিকের,	
mah,	মাহ,	মাহে,	
laat,	লাত,	লাট,	
zeebonto,	জীবন্ত,	জীবন্ত,	
cholocchitrer,	চলচ্যিত্রের,	চলচ্চিত্রের,	
kurdira,	কুরদিরা,	কুর্দিরা,	
bedantodhormo,	বেদানতধর্ম,	বেদান্তধর্ম,	
greenald,	গ্রিনল্ড,	গ্রিনল্ড,	
ramolino,	রামোলিনো,	রামোলিনো,	
krusher,	ক্রুষের,	ক্রুশের,	
fuss,	ফুস,	ফাস,	
erythrian,	এরিথ্রিয়ান,	এরিথ্রিয়ান,	
drishyogulotey,	দৃশ্যগুলততে,	দৃশ্যগুলোতে,	
sweety,	স্বিটি,	সুইটি,	
kormoke,	কর্মকে,	কর্মকে,	
directarate,	ডিরেক্টারেট,	ডিরেক্টরেট,	
pleto,	প্লেটো,	প্লেটো,	
chotogolper,	চটোগল্পের,	ছোটগল্পের,	
elaakaati,	এলাকাটি,	এলাকাটি,	
grootha,	গ্রুথা,	গ্রোথ,	
tookrokey,	তুকরোকে,	টুকরোকে,	
ganohotyake,	গণহত্যাকে,	গণহত্যাকে,	
maaktoome,	মাকতুমে,	মাকতুম,	
gavaskar,	গাভাসকার,	গাভাস্কার,	
laga,	লাগা,	লগ,	
akhhunno,	আখুন্ন,	অক্ষুণ্ণ,	
hoil,	হয়েল,	হইল,	
rayyalati,	রয়়ইলতি,	রয়্যালটি,	
dalnata,	দলনাটা,	ডালনাটা,	
lendal,	লেন্ডাল,	লেন্ডল,	
udbhabaney,	উদ্ভাবণে,	উদ্ভাবনে,	
temonbhabe,	তেমনভাবে,	তেমনভাবে,	
kaande,	কান্ডে,	কাণ্ডে,	
shuperheiro,	শুপেরহেরও,	সুপারহিরো,	
audioguloke,	অডিওগুলোকে,	অডিওগুলোকে,	
towraat,	টুরেট,	তওরাত,	
poddhotiteyi,	পদ্ধতিতেই,	পদ্ধতিতেই,	
dharabahikotitey,	ধারাবাহিকতিতে,	ধারাবাহিকটিতে,	
ceramicsh,	সেরামিক্,	সিরামিকস,	
mookhomaundoler,	মুখমানউদলের,	মুখমণ্ডলের,	
durlabhatwang,	দুর্মভত্বাং,	দুর্লভত্বং,	
jakso,	জাকসো,	যক্ষ,	
narbur,	নারবুর,	নরবুর,	
tukroti,	তুক্রতি,	টুকরোটি,	
gasthii,	গা্্থি,	গোষ্ঠীই,	
jamarate,	জামারাতে,	জামারাতে,	
jyesthaa,	জ্যাশ্থ,	জ্যেষ্ঠা,	
maarmaader,	মারমাদের,	মারমাদের,	
nibondhocheler,	নিবন্ধছেলের,	নিবন্ধছেলের,	
shakar,	শাকার,	সকার,	
olympic,	অলিম্পিক,	অলিম্পিক,	
dubureer,	দুবুরীর,	ডুবুরির,	
teenej,	তিনেজ,	টিনেজ,	
streegon,	স্ট্রিগণ,	স্ত্রীগণ,	
romantik,	রোমান্তিক,	রোমান্টিক,	
songkoloney,	সংকোলনে,	সংকলনে,	
pichte,	পিছতে,	পিছতে,	
ponjikar,	পঞ্জিকার,	পঞ্জিকার,	
umedpoor,	উমেদপুর,	উমেদপুর,	
probondhobhittik,	প্রবন্ধভিত্তিক,	প্রবন্ধভিত্তিক,	
upobasee,	উপবাসী,	উপবাসী,	
rinobodh,	ঋণবোধ,	ঋণবোধ,	
juddhahato,	যুদ্ধাহাত,	যুদ্ধাহত,	
shniper,	শ্নীপের,	স্নাইপার,	
sadbi,	সাদবী,	সাধ্বী,	
farid,	ফারিদ,	ফরিদ,	
kormokarke,	কর্মকারকে,	কর্মকারকে,	
renoo,	রেনো,	রেনো,	
hoteltee,	হোটেলটি,	হোটেলটি,	
shishupalgarh,	শিশুপলগর,	শিশুপালগড়ে,	
bandra,	বাঁদ্রা,	বন্দীরা,	
qyantana,	ক্যান্টনন,	ক্যান্টন,	
brojomohun,	ব্রজমহুন,	ব্রোজোমোহন,	
hitaishi,	হিতাইশি,	হিতৈষী,	
lirikti,	লিরিকটি,	লিরিকটি,	
change,	চাঙ্গে,	চেঞ্জ,	
nutan,	নুটান,	নূতন,	
karuna,	করুণা,	করুণা,	
salchak,	সালচক,	সালচাক,	
natshi,	নাতশি,	নাত্সি,	
themeke,	থেমেকে,	থিমকে,	
windo,	উইন্ডো,	উইন্ডো,	
liaodong,	লিয়াডোং,	লিয়াওদং,	
alaoler,	আলাওলের,	আলাওলের,	
osthishondhi,	অস্থিসন্ধি,	অস্থিসন্ধি,	
planea,	প্ল্যানি,	প্লেনে,	
niutrino,	নিউট্রিনো,	নিউট্রিনো,	
steeit,	স্টিইট,	স্টেইট,	
srivatsalakshanang,	শ্রীবতসলস্্তংং,	শ্রীবৎসলক্ষণং,	
rakhtokkharoner,	রাখ্তক্ষণের,	রক্তক্ষরণের,	
poriskoron,	পরিস্করণ,	পরিষ্করণ,	
mugdal,	মুগদাল,	মুগডাল,	
seqtara,	সেক্টারা,	সেক্টর,	
oncholke,	অঁচলকে,	অঞ্চলকে,	
kloud,	ক্লড,	ক্লাউড,	
beam,	বিয়াম,	বিম,	
chetanagoto,	চেতানাগত,	চেতনাগত,	
nanabornobishishto,	নানাবর্বিশ্বিষ্ট,	নানাবর্ণবিশিষ্ট,	
hoonayin,	হুনায়িন,	হুনাইন,	
kormyi,	করমি,	কর্মই,	
hoondayi,	হুন্দায়ি,	হুন্দাই,	
canflikt,	ক্যানফলিক্ট,	কনফ্লিক্ট,	
aakkaash,	আক্কাশ,	আককাস,	
venush,	ভেনুশ,	ভেনাস,	
mekong,	মেকং,	মেকং,	
dajjha,	দাজ্,	দাহ্য,	
heelser,	হিলসের,	হিলসের,	
firti,	ফিরতি,	ফিরতি,	
bonorajite,	বনরাজিতে,	বনরাজিতে,	
kusumeshu,	কুসুমেষু,	কুসুমেষু,	
meloonborrone,	মেলোজনবররণে,	মেলবোর্নে,	
dokaangulotey,	দোকানগুলোতে,	দোকানগুলোতে,	
aairees,	আই়ারিশ,	আইরিস,	
hastamathun,	হস্তমাথুন,	হস্তমথুন,	
chakurijibirao,	চাকুরিজীবীরাও,	চাকুরীজীবীরাও,	
premo,	প্রেমো,	প্রিমো,	
protizogii,	প্রতিযোগী,	প্রতিযোগী,	
satarka,	সতর্কা,	সতর্ক,	
bijito,	বিজিত,	বিজিত,	
ghumachhe,	ঘুমাচে,	ঘুমাচ্ছে,	
sanghatakder,	সংহটাদকের,	সংঘটকদের,	
jibanto,	জীবান্ত,	জীবন্ত,	
jyaqasana,	জ্যাকাসন,	জ্যাকসন,	
temanti,	তেমানটি,	তেমনটি,	
dabliudabliui,	ডাবলিবউডিয়ি,	ডাব্লিউডাব্লিউই,	
relance,	রিলান্স,	রিলায়েন্স,	
jaanachhe,	জানাছে,	জানাচ্ছে,	
onkush,	অঙ্কুশ,	অংকুশ,	
asiatic,	অ্যাসিটিট,	এশিয়াটিক,	
shiulijhra,	শিউলিঝরা,	শিউলিঝরা,	
rakim,	রাকিম,	রাকিম,	
patjata,	পাটজাতা,	পাটজাত,	
oitijjo,	ঐতিহ্য,	ঐতিহ্য,	
bastubad,	বাস্তুবাদ,	বস্তুবাদ,	
rudrasagar,	রুদ্রসগর,	রুদ্রসাগরের,	
pet,	পেট,	পেত,	
seeramiks,	সিরামিকস,	সিরামিকস,	
ragei,	রাগেই,	রাগেই,	
durarohini,	দুরারহীনী,	দুরারোহিণী,	
krush,	ক্রুশ,	ক্রুশ,	
hundai,	হুন্ডাই,	হুন্দাই,	
ganaporibahaner,	গণপরিবাহণের,	গণপরিবহনের,	
average,	এভারেজ,	এভারেজ,	
naneer,	নানীর,	নানীর,	
bhramarotsab,	ভ্রমরতৎসব,	ভ্রমরোৎসব,	
artilary,	আর্টিলারী,	আর্টিলারি,	
rilayensha,	রিলয়েনশ,	রিলায়েন্স,	
nakkal,	নককাল,	নক্কল,	
yuroo,	যুরোও,	ইউরো,	
utotoro,	উততর,	উততর,	
suraaropeeto,	সুরাপরীপত,	সুরারোপিত,	
lendl,	লেন্ডল,	লেন্ডল,	
masto,	মাসতো,	মাস্ত,	
surakarder,	সুরাকরদের,	সুরকারদের,	
bojhaao,	বোঝাও,	বোঝাও,	
bharpur,	ভারপুর,	ভরপুর,	
grontho,	গ্রন্থ,	গ্রন্থ,	
biplabeer,	বিপ্লবির,	বিপ্লবীর,	
swadesh,	স্বদেশ,	স্বদেশ,	
bapokotor,	বাপকতটর,	ব্যাপকতর,	
sossar,	সোসার,	সকার,	
ingrezeeteo,	ইংরেজিতেও,	ইংরেজিতেও,	
shatan,	শতন,	শয়তান,	
zesa,	জেস,	জেস,	
serology,	সেরোলজি,	সেরোলজি,	
america,	আমেরিকা,	আমেরিকা,	
sheepha,	শিফা,	শেফ,	
chuti,	চুটি,	ছুটি,	
bone,	বোন,	বনে,	
afzol,	আফজল,	আফজল,	
poketchorder,	পকেচর্তদের,	পকেটচরদের,	
venkates,	ভেঙ্কেটেস,	ভেঙ্কটেশ,	
mast,	মাস্ট,	মাস্ত,	
baasaate,	বাসাতে,	বাসাতে,	
gitikobita,	গীতিকবিতা,	গীতিকবিতা,	
aditisaha,	আদিতিসহ,	অদিতিসহ,	
jackey,	জ্যাকে,	জকি,	
manjushree,	মঞ্জুশ্রী,	মঞ্জুশ্রী,	
mitro,	মিত্রো,	মিত্র,	
amor,	আমোর,	আমর,	
manoharpur,	মনোহারপুর,	মনোহরপুর,	
rajdhani,	রাজধানি,	রাজধানি,	
porizoner,	পরিজনের,	পরিজনের,	
dajhyo,	দাঝ্য,	দাহ্য,	
alumni,	আলুমি,	অ্যালমনি,	
irish,	ইরিশ,	আইরিস,	
ekbai,	একবাই,	একবাই,	
modelgulo,	মোডেলগুলো,	মডেলগুলো,	
shangkulaan,	শংকুলা,	সংকুলান,	
munsi,	মুনসি,	মুন্সী,	
lettere,	লেটারে,	লেটারে,	
romarder,	রোমার্ডের,	রোমারদের,	
billaho,	বিল্লাহ,	বিল্লাহ,	
modyer,	মদদিয়ার,	মদ্যের,	
shamshernagar,	শমশেরগর,	শমশেরনগর,	
nachiketa,	নাচিকেতা,	নচিকেতা,	
byaboharkarie,	ব্যবহারকারী,	ব্যবহারকারীই,	
atmobonchito,	আত্মবঞ্চিত,	আত্মবঞ্চিত,	
sommotitey,	সম্মতিতে,	সম্মতিতে,	
khitkar,	খিটকর,	ক্ষিতকর,	
lambaate,	ল্যাম্বেট,	লম্বাটে,	
digree,	ডিগ্রি,	ডিগ্রি,	
prosadhoni,	প্রসাধনী,	প্রসাধনী,	
edipass,	এডিপ্যাস,	ইডিপাস,	
gabhaskaar,	গাভাসকার,	গাভাস্কার,	
dhwajbhango,	ধ্বাবভাঙ্গ,	ধ্বজভঙ্গ,	
krus,	ক্রাস,	ক্রুশ,	
esprito,	এসপ্রিত,	এস্পিরিটো,	
steena,	স্তিনা,	স্টেন,	
raagee,	রাগী,	রাগী,	
aalkaatra,	আলকাত্র,	আলকাতরা,	
bhowanipur,	ভূয়ানীপুর,	ভবানীপুর,	
upbrazillian,	আপবরিজিয়ালিন,	আপব্রাজিলিয়ান,	
chyeta,	চ্যাত,	চ্যাট,	
vabook,	বাবুক,	ভাবুক,	
bondiira,	বন্ডিয়ারা,	বন্দীরা,	
sinakey,	সিনাকে,	সিনাকে,	
premoronge,	প্রেমরঙ্গে,	প্রেমরঙে,	
restuarant,	রেস্টুরেন্ট,	রেষ্টুরেন্ট,	
hizrite,	হিজরিতে,	হিজরীতে,	
brail,	ব্রাইল,	ব্রেইল,	
ispreedshiit,	ইসপ্রিডশিত,	স্প্রেডশীট,	
matrirup,	মাতৃরূপ,	মাতৃরূপ,	
neerbachoker,	নির্বাচকের,	নির্বাচকের,	
aairish,	আইরিশ,	আইরিস,	
rashider,	রাশীদের,	রশিদের,	
laaz,	লাজ,	লাজ,	
atak,	আটাক,	আটক,	
dorgah,	দোরগাহ,	দরগাহ,	
motabolombira,	মতাবল্মীবার,	মতাবলম্বীরা,	
ashirbadatri,	অশির্বদাত্রী,	আশীর্বাদাত্রী,	
ajuhat,	অজুহাত,	অজুহাত,	
nirvachokder,	নির্ভাচকদের,	নির্বাচকদের,	
danakana,	দানাকানা,	ডানকান,	
vince,	ভিন্স,	ভিন্স,	
dhonni,	ধন্নি,	ধন্যি,	
feroza,	ফেরোজা,	ফিরোজা,	
nirbachakder,	নির্বাচকদের,	নির্বাচকদের,	
zubokder,	যুবকদের,	যুবকদের,	
maadla,	মাদলা,	মাদলা,	
sumi,	সুমি,	সুমি,	
pretti,	প্রেটি,	প্রিটি,	
kakhnoba,	কাখ্যবা,	কখনওবা,	
labonaaktotaar,	লবণণততাতার,	লবণাক্ততার,	
metropalitana,	মেট্রোপেলোনিতা,	মেট্রোপলিটন,	
makong,	মাকং,	মেকং,	
ghamtaa,	ঘামটা,	ঘোমটা,	
jeher,	জেহের,	জেহের,	
futonta,	ফুতন্তা,	ফুটন্ত,	
shajano,	শাজানো,	সাজানো,	
gajetted,	গ্যাজেটেট,	গেজেটেড,	
gara,	গারা,	গোর,	
jyaqa,	জ্যাক,	জ্যাক,	
ghuznavi,	ঘুজনাভি,	গজনভি,	
nathivukteer,	নাঠিভুক্তির,	নথিভুক্তির,	
shitei,	শিতেই,	শীতেই,	
kormobuddhite,	কর্মবুদ্ধিতে,	কর্মবুদ্ধিতে,	
chongar,	চঙ্গার,	চোঙ্গার,	
godabari,	গোদাবারী,	গোদাবরী,	
zohns,	জোনস,	জন্স,	
batikromshalee,	বাতিক্রমশলি,	ব্যতিক্রমধর্মী,	
vault,	ভাল্ট,	ভল্ট,	
sosoa,	সোসোয়া,	শশা,	
noteti,	নোটেটি,	নোটটি,	
choopi,	চুপি,	চুপি,	
ghumunoi,	ঘুমুনোই,	ঘুমুনোই,	
sadadyarao,	সদদ্যারাও,	সদদ্যরাও,	
nodimaatrik,	নোদিমাত্রিক,	নদীমাতৃক,	
orthobochorke,	অর্থবচরকে,	অর্থবছরকে,	
maunchostho,	মৌঁচস্থ,	মঞ্চস্থ,	
fostar,	ফোস্টার,	ফস্টার,	
samratder,	সমর্তদের,	সম্রাটদের,	
kanuner,	কানুনের,	কানুনের,	
hyaloyin,	হ্যালোইন,	হ্যালোইন,	
laiseensim,	লেইসিনসিম,	লাইসেন্সিং,	
uparjon,	উপার্যন,	উপার্জন,	
manushgulor,	মানুষগুলোর,	মানুষগুলোর,	
ajeejer,	আজিজের,	আজিজের,	
byaktikegreptar,	ব্যক্তিপেরেপ্তর,	ব্যক্তিকেগ্রেপ্তার,	
osoborno,	অসবর্ণ,	অসবর্ণ,	
ishton,	ইস্টন,	স্টোন,	
generalissimo,	জেনেরালিজমিস,	জেনারেলিসিমো,	
norfolk,	নরফলক,	নরফোক,	
chalochchitrogulor,	চলচ্চিত্রগুলোর,	চলচ্চিত্রগুলোর,	
sangasthagulo,	সংস্থাগুলো,	সংস্থাগুলো,	
udbhaboney,	উদ্ভাবনে,	উদ্ভাবনে,	
bisshas,	বিশশ,	বিশ্বাস,	
eukalyptus,	ইউক্লিপ্টাস,	ইউক্যালিপ্টাস,	
gobeshonar,	গবেষণার,	গবেষনার,	
shrabastee,	শ্রাবাস্তি,	শ্রাবস্তী,	
obosorer,	অবসরের,	অবসরের,	
somraatra,	সোমরাত্র,	সম্রাটরা,	
sqolastiq,	স্কোলস্টিক,	স্কলাস্টিক,	
raghubar,	রঘুবার,	রঘুবীর,	
militaryr,	মিলেটারির,	মিলিটারির,	
baieq,	বাঁঁক,	বাইক,	
bizito,	বিজিতো,	বিজিত,	
kaley,	কালে,	কালে,	
yanqee,	যানকি,	ইয়াংকি,	
reshidensha,	রেশিডেন্শা,	রেসিডেন্স,	
tunaita,	টুনাইতা,	টুনাইট,	
samajeek,	সমাজিক,	সামাজিক,	
harza,	হারজা,	হার্জ,	
dologuloo,	দলগুলোও,	দলগুলোও,	
taatey,	ট্যাটে,	তাতে,	
sipa,	সিপাআ,	শিপ,	
holuder,	হোলুদের,	হলুদের,	
chalachchitrotike,	চালচ্ছিত্রটিকে,	চলচ্চিত্রটিকে,	
pillai,	পিল্লাই,	পিল্লাই,	
emerjency,	এমেরজেন্সি,	এমার্জেন্সি,	
murali,	মুরালি,	মুরলী,	
sarboshokteeman,	সর্বশক্তিমান,	সর্বশক্তিমান,	
primoo,	প্রিমুও,	প্রিমো,	
aarke,	আরকে,	আরকে,	
jaubankal,	জৌবনকাল,	যৌবনকাল,	
talaa,	তালা,	তালা,	
chomski,	চমস্কি,	চমস্কি,	
shcholastic,	স্কোলস্টিক,	স্কলাস্টিক,	
aakabar,	আকাবার,	আকাবার,	
alsaar,	আলসার,	আলসার,	
romancha,	রোমাঞ্চ,	রোমাঞ্চ,	
bedey,	বেদে,	বেদে,	
girilal,	গিরিলাল,	গিরিলাল,	
panda,	পান্ডা,	পান্ডে,	
daraider,	দারাইদের,	দরাইদের,	
amarjito,	অমার্যত,	অমার্জিত,	
carlos,	কার্লোস,	কার্লোস,	
plate,	প্ল্যাট,	প্লেট,	
notey,	নোটে,	নোটে,	
jwar,	জ্বার,	জ্বর,	
pariyech,	পরিয়েছ,	পরিয়েছ,	
shamshere,	শামশেরে,	শমসের,	
tahalo,	তাহালো,	তাহলো,	
mukhomandaley,	মুখমণ্ডলে,	মুখমণ্ডলে,	
ghoomachhilo,	ঘুমাছিলো,	ঘুমাচ্ছিল,	
pratijogira,	প্রতিযোগীরা,	প্রতিযোগীরা,	
torunderke,	তরুন্দরকে,	তরুণদেরকে,	
byabaharkariderke,	ব্যবহারকারীদেরকে,	ব্যবহারকারীদেরকে,	
nibobondhonkrito,	নিববন্ধনকৃত,	নিববন্ধনকৃত,	
benojir,	বেনোজির,	বেনজীর,	
khuizza,	খুইজ্জা,	খুইজ্জা,	
torkarite,	তরকারিতে,	তরকারিতে,	
ragee,	রাগী,	রাগী,	
ghumacchilo,	ঘুমাচ্ছিল,	ঘুমাচ্ছিল,	
parishram,	পরিশ্রম,	পরিশ্রম,	
pronoti,	প্রণতি,	প্রণতি,	
emiratas,	এমিরাতাস,	এমিরেটাস,	
aembed,	আম্বেড,	এম্বেড,	
paste,	পাস্তে,	পেষ্ট,	
tomader,	তোমাদের,	তোমাদের,	
prakare,	প্রকারে,	প্রকারে,	
leaders,	লিডার্স,	লিডার্স,	
shardotsobei,	শর্দসতবেই,	শারদোৎসবেই,	
dokaangoolote,	দোকানগুলোতে,	দোকানগুলোতে,	
anchalgulir,	অঞ্চলগুলির,	অঞ্চলগুলির,	
lebina,	লেবিনা,	লেবিনা,	
proteemar,	প্রতিমার,	প্রতিমার,	
spreadshiit,	স্প্রেডশিট,	স্প্রেডশীট,	
bosontoke,	বসনটকে,	বসন্তকে,	
magical,	ম্যাজিক্যাল,	ম্যাজিকাল,	
ajibon,	অজিবন,	আজীবন,	
carloos,	কার্লোস,	কার্লোস,	
kolkarkhana,	কোলকারখানা,	কলকারখানা,	
bodna,	বদনা,	বদনা,	
saralya,	সরল্য,	সারল্য,	
gaziipur,	গাজিইপুর,	গাজীপুর,	
nanilalke,	নানিলালকে,	ননীলালকে,	
venice,	ভেনিস,	ভেনিস,	
akatwa,	আকাত্ব,	একাত্ব,	
suparharo,	সুপারহরর,	সুপারহিরো,	
beem,	বিম,	বিম,	
churger,	চুর্গের,	চার্জের,	
bouddho,	বৌদ্ধ,	বৌদ্ধ,	
dijmarescu,	ডিজমেরেসকু,	দিজমার্সাকু,	
blogarra,	ব্লগাররা,	ব্লগাররা,	
russad,	রুসদ,	রুশদ,	
ganjana,	গঞ্জনা,	গঞ্জনা,	
siramikasa,	সিরামিকাসা,	সিরামিকস,	
machkabar,	মাচকাবার,	মাচকাবার,	
oxfordey,	অক্সফোর্ডে,	অক্সফোর্ডে,	
plaiin,	প্লেইন,	প্লেন,	
torkareer,	তরকারীর,	তরকারীর,	
cinemapremider,	সিনেম্প্রেমিদের,	সিনেমাপ্রেমীদের,	
arthurer,	অর্থুরের,	আর্থারের,	
distibutor,	ডিস্টিবুটর,	ডিস্টিবিউটারের,	
ovidhanik,	অভিধানিক,	অভিধানিক,	
badhamuktovabe,	বাধুমক্তভাবে,	বাধামুক্তভাবে,	
bamni,	বামনি,	বামনী,	
saarbharti,	সারভর্তি,	সার্ভারটি,	
bade,	বাদে,	বাদে,	
bethikata,	বেথিকাটা,	বেঠিকতা,	
times,	টিমেস,	টাইমস্,	
laaisheesh,	লাইশিশ,	লাইসেন্স,	
hena,	হেনা,	হেনা,	
pulivendla,	পুলিভেন্ডলা,	পুলিভেন্ডলা,	
planeti,	প্ল্যানটি,	প্লেনটি,	
hijrite,	হিজরিতে,	হিজরীতে,	
scorey,	স্কোরে,	স্কোরে,	
casper,	ক্যাসপার,	ক্যাসপার,	
pacchi,	পাচচি,	পাচ্ছি,	
barack,	ব্যারাক,	বারাক,	
byabosthar,	ব্যবস্থার,	ব্যবস্থার,	
boikolyo,	বৈকল্য,	বৈকল্য,	
byabaharkaree,	ব্যবহারকারী,	ব্যবহারকারী,	
show,	শুয়,	শো,	
nikote,	নিকোতে,	নিকটে,	
tolemy,	টোলেমি,	টলেমির,	
toxoid,	টক্সইড,	টক্সয়েড,	
jandrel,	জান্দ্রেল,	জাঁদরেল,	
boiragirhat,	বৈরাগীরঘাট,	বৈরাগিরহাট,	
thakeni,	থাকেনি,	থাকেনি,	
planey,	প্ল্যানে,	প্লেনে,	
sangosrobomukto,	সংস্র্্মক্ত,	সংস্রবমুক্ত,	
manobikotao,	মানবিকতাও,	মানবিকতাও,	
sikha,	সিখা,	শিখ,	
oisamoyer,	ঐহসময়ের,	ঐসময়ের,	
dai,	দায়,	দিই,	
rashedul,	রাশেদুল,	রাশিদুল,	
bisshonath,	বিশ্নাথ,	বিশ্বনাথ,	
vagini,	ভাগিনি,	ভগিনী,	
prokar,	প্রকার,	প্রকার,	
anichchi,	অনিচ্ছি,	আনিচ্ছি,	
okkhorke,	অক্ষরকে,	অক্ষরকে,	
suraropito,	সুরাপরিত,	সুরারোপিত,	
reflex,	রেফ্লেক্স,	রিফ্লেক্স,	
khappar,	খাপপার,	খপ্পর,	
srabosty,	শ্রাবোস্টি,	শ্রাবস্তী,	
sobchey,	সবছে,	সবচে,	
sahozlabhbhotar,	সহলাবভাতার,	সহজলভ্যতার,	
chalochchitreei,	চালচ্চিত্রেই,	চলচ্চিত্রেই,	
korimpur,	করিমপুর,	করিমপুর,	
bhumija,	ভূমিজা,	ভূমিজ,	
roopmatro,	রূপমাত্র,	রূপমাত্র,	
chirkut,	চিরকুট,	চিরকুট,	
shikh,	শিখ,	শিখ,	
gandharir,	গন্ধারীর,	গান্ধারীর,	
ranangone,	রানাঙ্গনে,	রণাঙ্গনে,	
shukraanoo,	শুক্রানও,	শুক্রানু,	
prosadhani,	প্রসাধানি,	প্রসাধনী,	
daaktikite,	ডাক্তিকেতে,	ডাকটিকিটে,	
shainyader,	শৈন্যাদের,	সৈন্যদের,	
byomkes,	ব্যোমকেস,	ব্যোমকেশ,	
kathghera,	কাঠঘেরা,	কাঠঘেরা,	
somoibo,	সমমিব,	সমৈব,	
soheensotar,	সোহীনসতার,	সহিংসতার,	
nirmolota,	নির্মলতা,	নির্মলতা,	
pratijogitamulak,	প্রতিযোগিতমূলক,	প্রতিযোগীতামূলক,	
danaqana,	দানাকানা,	ডানকান,	
uparjoner,	উপার্যনের,	উপার্জনের,	
dokkhinangsho,	দক্ষিণাংশ,	দক্ষিণাংশ,	
agaldar,	আগালদার,	আগলদার,	
uindoos,	উইন্ডোস,	উইন্ডোস,	
taap,	টাপ,	ট্যাপ,	
dipti,	ডিপটি,	ডেপুটি,	
deefinition,	ডিফিনিশন,	ডেফিনেশন,	
tatey,	তাতে,	তাতে,	
bonnopran,	বন্যপ্রাণ,	বন্যপ্রাণ,	
bsnleu,	বিএসএলনি,	বিএসএনএলইইউ,	
chaaktir,	চাকটির,	চাকতির,	
doorotaumo,	দূরতামও,	দূরতম,	
bajite,	বাজিতে,	বাজিতে,	
munjur,	মুনজুর,	মুনজুর,	
besooro,	বেসুরো,	বেসুর,	
feemalee,	ফিমালি,	ফিমেল,	
ekok,	একক,	একক,	
ansareer,	আনশারীর,	আনসারীর,	
suiti,	সুইটি,	সুইটি,	
quota,	কোওটা,	কোটা,	
sookkho,	সুক্ষ,	সুক্ষ্ম,	
graambaaseeo,	গ্রামবাসেও,	গ্রামবাসীও,	
koyekbare,	কয়েকবারে,	কয়েকবারে,	
jolrang,	জলরাং,	জলরঙ,	
epiela,	এপিয়েলা,	আইপিএল,	
harishankar,	হরিশঙ্করের,	হরিশংকর,	
bunot,	বুনত,	বুনট,	
stoic,	স্টিইক,	স্টোয়িক,	
baharamporer,	বাহারাম্পরের,	বহরমপুরের,	
abheedhaaneeck,	অভেধানিক,	অভিধানিক,	
stander,	স্ট্যান্ডার,	স্ট্যাণ্ডের,	
middleton,	মিডলেটন,	মিডলটন,	
acrolect,	অ্যার্রোলেক্ট,	অ্যাক্রোলেক্ট,	
machhti,	মাছতি,	মাছটি,	
upobaashee,	উপবাশী,	উপবাসী,	
bahjya,	বাহজ্যা,	বাহ্য,	
addhattikotar,	অদ্ধাত্তিকতার,	আধ্যাত্মিকতার,	
dharmee,	ধর্মী,	ধর্মী,	
aswasteekor,	অস্বাস্তিকর,	অস্বস্তিকর,	
chalchhe,	চালচে,	চলছে,	
ooipoka,	ওফপাকা,	উইপোকা,	
pachchi,	পাচ্ছি,	পাচ্ছি,	
hattey,	হ্যাটে,	হাঁটতে,	
samoshtigato,	সমস্তিগত,	সমষ্টিগত,	
bhorkendra,	ভরকেন্দ্রের,	ভরকেন্দ্র,	
safiin,	সাফিন,	সাফিন,	
giitikobitar,	গীতিকতিবার,	গীতিকবিতার,	
hul,	হুল,	হুল,	
saseza,	সাসেজা,	সসেজ,	
mosjidsoho,	মসজিদসহ,	মসজিদসহ,	
khalidke,	খালিদকে,	খালিদকে,	
sangbadmadhyame,	সংবাদমধ্যমে,	সংবাদমাধ্যমে,	
projanankal,	প্রজানকাল,	প্রজননকাল,	
phox,	ফক্স,	ফক্স,	
baaiq,	বাইক,	বাইক,	
hurricane,	হ্যারিকেন,	হ্যারিকেন,	
chet,	চেত,	চ্যাট,	
gabeshonar,	গবেষণার,	গবেষনার,	
nirbachokder,	নির্বাচকদের,	নির্বাচকদের,	
palashir,	পালাশির,	পলাশীর,	
idyi,	ইদ্যি,	আইডিই,	
saoum,	সাওয়াম,	সাওম,	
ghatleo,	ঘাতলেও,	ঘটলেও,	
shasonkarta,	শাসনকর্তা,	শাসনকর্তা,	
jones,	জনস,	জোন্স,	
manab,	মানব,	মানব,	
brindaboney,	বৃন্দাবনে,	বৃন্দাবনে,	
postay,	পোস্টায়,	পোস্টে,	
transapharma,	ট্রান্সফারমা,	ট্রান্সফর্ম,	
utsahamulak,	উৎসমহুলাক,	উৎসাহমূলক,	
muhurtati,	মুহুরটাটি,	মুহুর্তটি,	
madhabi,	মাধাবী,	মাধবী,	
macbeth,	ম্যাকবেথ,	ম্যাকবেথ,	
byboshthar,	বিব্্থার,	ব্যাবস্থার,	
saabyastha,	সাব্যস্থা,	সাব্যস্থ,	
sponsorshipe,	স্পন্শরশীপে,	স্পন্সরশীপে,	
patrol,	পাত্রোল,	পেট্রোল,	
ekroop,	একরূপ,	একরূপ,	
mokhmoley,	মোখমলে,	মখমলে,	
treend,	ট্রিন্ড,	ট্রেন্ড,	
mukherjee,	মুখের্জী,	মুখার্জী,	
hights,	হাইটস,	হাইটস,	
aizulke,	আইজলুকে,	আইজুলকে,	
huk,	হুক,	হুক,	
bhogiroth,	ভোগীরোথ,	ভগীরথ,	
bhittitei,	ভিত্তিতেই,	ভিত্তিতেই,	
peengna,	পিংগানা,	পিংনা,	
doula,	দুয়ালা,	দৌলা,	
torabganj,	তোরাবগঞ্জ,	তোরাবগঞ্জ,	
amiretus,	অ্যামিরেটাস,	এমিরেটাস,	
nirikhe,	নিরীখে,	নিরিখ,	
dala,	ডালা,	দলা,	
adhunikkale,	অধুনিকালে,	আধুনিককালে,	
salphat,	সালফাট,	সালফেট,	
ovarview,	ওভারভিভ,	ওভারভিউ,	
nishad,	নিশাদ,	নিষাদ,	
upobashii,	উপবাশী,	উপবাসী,	
abheedhanik,	অভিধানিক,	অভিধানিক,	
dada,	দাদা,	দাদা,	
jaanar,	জানার,	জানার,	
labonaktatar,	লবণণক্ততার,	লবণাক্ততার,	
pratista,	প্রতিস্তা,	প্রতিষ্টা,	
dibi,	দিবি,	দিবি,	
chalochchitrei,	চালচ্ছিত্রেই,	চলচ্চিত্রেই,	
nathivookto,	নাঠিভুক্ত,	নথিভুক্ত,	
aarik,	আরিক,	আরিক,	
brookoleen,	ব্রুকোলিন,	ব্রুকলিন,	
dakticket,	ডাক্টিকেট,	ডাকটিকিট,	
kiuti,	কিউটি,	কিউটি,	
krechi,	ক্রেচি,	করেছি,	
dhyana,	ধ্যান,	ধ্যান,	
codee,	কোড,	কোডে,	
katiusha,	কাতিশা,	কাতিউশা,	
sukumaree,	সুকুমারী,	সুকুমারী,	
helly,	হেলি,	হিলি,	
sarajibonbyapi,	সরাজীবন্যাপী,	সারাজীবনব্যাপী,	
raiialati,	রেইলাইটি,	রয়্যালটি,	
plack,	প্ল্যাক,	প্ল্যাক,	
karpeter,	কারপেটের,	কার্পেটের,	
ratishilatai,	রতিশীলতাই,	রতিশীলতায়,	
stanahenja,	স্তানেনহ্য,	স্টোনহেঞ্জ,	
kathmandute,	কাঠমন্ডুতে,	কাঠমান্ডুতে,	
tuleche,	তুলেছে,	তুলেছে,	
prottokkhovabe,	প্রত্যক্ষভাবে,	প্রত্যক্ষভাবে,	
keu,	কেউ,	কেউ,	
louhojato,	লৌহজাত,	লৌহজাত,	
sarder,	সারদের,	সরদার,	
shchalastic,	স্ক্যালাসটিক,	স্কলাস্টিক,	
kode,	কোদে,	কোড,	
shikkharrthirao,	শিক্ষার্থীরাও,	শিক্ষার্থীরাও,	
swartho,	স্বার্থ,	স্বার্থ,	
hindutirtha,	হিন্দুতির্থ,	হিন্দুতীর্থ,	
nazad,	নাজাদ,	নাজাদ,	
baet,	বিত,	বাইট,	
deputi,	ডেপুটি,	ডেপুটি,	
confliqt,	কনফ্লিক্ট,	কনফ্লিক্ট,	
jatinke,	জাতিনকে,	যতীনকে,	
waal,	ওয়াল,	উল,	
mausumeo,	মৌসুমেও,	মৌসুমেও,	
pratisthanik,	প্রতিষ্ঠানিক,	প্রাতিষ্ঠানিক,	
arashie,	আরাশী,	আরসিএ,	
angsogrohone,	অংশগ্রহণে,	অংশগ্রহনের,	
raunanganey,	রৌনাঙ্গনে,	রণাঙ্গনে,	
shumo,	শুমো,	সুমো,	
shommotite,	শম্মতিতে,	সম্মতিতে,	
courtcaser,	কার্টকেসের,	কোর্টকেসের,	
arke,	আরকে,	আরকে,	
neutrinoo,	নিউট্রিনো,	নিউট্রিনো,	
chirontan,	চিরন্তান,	চিরন্তন,	
popke,	পপকে,	পোপকে,	
ooipokar,	ওফপকার,	উইপোকার,	
madhoboir,	মাধবীর,	মাধবীর,	
eura,	ইউরা,	ইউরো,	
ekirokom,	একিরকম,	একইরকম,	
poste,	পোস্টে,	পোষ্টে,	
shatodha,	শতোধা,	শতধা,	
dhaleshwari,	ধলেশ্বরী,	ধলেশ্বরী,	
maley,	ম্যালে,	মালে,	
teemothi,	তিমোথি,	টিমোথি,	
pabo,	পাবো,	পাব,	
pradoshik,	প্রদাশিক,	প্রাদশিক,	
nothivukto,	নথিভুক্ত,	নথিভুক্ত,	
hari,	হারি,	হরি,	
fulkapi,	ফুলকাপি,	ফুলকপি,	
shahabike,	শাহাবীকে,	সাহাবীকে,	
elakayi,	এলাকায়ি,	এলাকাই,	
tonoo,	তোনো,	তনু,	
daaradaa,	দারাদা,	দারদা,	
dhangsachchi,	ধাংশাচ্ছি,	ধ্বংসাচ্ছি,	
sangharshik,	সংহর্ষিক,	সাংঘর্ষিক,	
bim,	বিএম,	বিম,	
firth,	ফির্থ,	ফার্থ,	
ganesh,	গনেশ,	গণেশ,	
shfingtar,	শ্ফিগতার,	স্ফিংটার,	
anyorup,	অন্যরূপ,	অন্যরূপ,	
samashtike,	সমাসটিকে,	সমষ্টিকে,	
kings,	কিংস,	কিংস,	
adbhanced,	অ্যাডভাঞ্সেড,	অ্যাডভান্সড,	
choson,	চসন,	চোষণ,	
firoze,	ফিরোজ,	ফিরোজ,	
bosante,	বসনান্তে,	বসন্তে,	
klaud,	ক্লড,	ক্লাউড,	
chadake,	চাদাকে,	চড়াকে,	
bhardwaj,	ভর্দ্বাজ,	ভরদ্বাজ,	
barbadoj,	বারবাদজ,	বার্বাডোজ,	
elaaka,	এলাকা,	এলাকা,	
protijogi,	প্রতিযোগী,	প্রতিযোগী,	
korush,	করুশ,	ক্রুশ,	
tukrowti,	টুক্রোটি,	টুকরোটি,	
akkharkey,	অক্ষারকে,	অক্ষরকে,	
laesensh,	লেসেন্শ,	লাইসেন্স,	
faase,	ফাসে,	ফাঁসে,	
mach,	মাচ,	মাছ,	
antarctica,	অ্যান্টার্ক্টিকা,	অ্যান্টার্কটিকার,	
bhenom,	ভেনোম,	ভেনম,	
gaaddafee,	গাদ্ডাফী,	গাদ্দাফী,	
jolrong,	জলরং,	জলরঙ,	
adwanced,	অ্যাডান্সেড,	অ্যাডভান্সড,	
guzober,	গুজবের,	গুজবের,	
sangkoolan,	সংকুলোন,	সংকুলান,	
ase,	আসে,	আসে,	
ebham,	এভাম,	ইভিএম,	
mankisundar,	মানকিসুন্দর,	মানকিসুন্দর,	
disni,	ডিসনি,	ডিজনী,	
shanno,	শান্য,	সান্নো,	
koruna,	কোরুনা,	করুণা,	
suporichita,	সুপরিচিত,	সুপরিচিত,	
abdi,	আব্দি,	অব্দি,	
cooda,	কোড,	কোডা,	
chhuteer,	ছুটির,	ছুটির,	
scoore,	স্কার,	স্কোর,	
kyatagorir,	ক্যাটাগরির,	ক্যাটাগরির,	
sayanaida,	সায়নাইদা,	সায়ানাইড,	
jaistho,	জাইস্থ,	জ্যৈষ্ঠ,	
tennys,	টেনিস,	টেনিস,	
kadam,	কাদাম,	কদম,	
conflikt,	কনফ্লিক্ট,	কনফ্লিক্ট,	
orthanitir,	অর্থানিতির,	অর্থনীতির,	
joumana,	জৌমানা,	জুমানা,	
khilaphat,	খিলাফাত,	খিলাফত,	
somosto,	সমস্ত,	সমস্ত,	
seo,	সিওও,	সেও,	
oswasteekor,	অস্বাস্তিকর,	অস্বস্তিকর,	
makhno,	মাখনো,	মাখনো,	
karam,	করম,	কেরাম,	
dosha,	দোষা,	দোসা,	
nischoy,	নিশ্চয়,	নিশ্চয়,	
maladabha,	মালাদাভা,	মলদোভা,	
nirarthak,	নিরার্থক,	নিরর্থক,	
trenda,	ট্রেন্ডা,	ট্রেন্ড,	
panchashjon,	পঞ্চাশজন,	পঞ্চাশজন,	
mumtajer,	মুমতাজের,	মুমতাজের,	
snehban,	স্নেহবান,	স্নেহবান,	
thanvi,	থানভি,	থানভী,	
oojbekistan,	ওজবেকিস্তান,	উজবেকিস্তান,	
shatoke,	শাতোকে,	শতকে,	
teoyana,	তেওয়ানা,	তাইওয়ান,	
proshtotto,	প্রস্তত্ব,	প্রস্ত্তত,	
niphelheim,	নিফেলিমেম,	নিফেলহেইম,	
dharavahik,	ধারাভাহিক,	ধারাবাহিক,	
distance,	ডিস্ট্যান্স,	ডিসট্যান্স,	
sooya,	সুয়া,	সোয়া,	
soommita,	সুমতি,	সুমিতা,	
euqalyptus,	ইকল্যাপিটাস,	ইউক্যালিপ্টাস,	
saqara,	সাকারা,	সকার,	
ekekrokom,	একেকরকোম,	একেকরকম,	
karmokarke,	কর্মকারকে,	কর্মকারকে,	
graambasi,	গ্রাম্বাসী,	গ্রামবাসী,	
vabuk,	ভাবুক,	ভাবুক,	
laesens,	লেসেন্স,	লাইসেন্স,	
bikargrosto,	বিকারগ্রস্ত,	বিকারগ্রস্ত,	
shattoki,	শত্টকি,	সাত্যকি,	
kruser,	ক্রুসের,	ক্রুশের,	
ashanka,	আশঙ্কা,	আশংকা,	
tiuning,	টিউনিং,	টিউনিং,	
scholarsip,	স্কলারসিপ,	স্কলারশিপ,	
bhalobaas,	ভালোবাস,	ভালোবাসা,	
dupleks,	ডুপলেক্স,	ডুপ্লে,	
parijaner,	পরিজানের,	পরিজনের,	
lokhindorer,	লোখিন্দরের,	লখিন্দরের,	
aamoode,	আমুদে,	আমুদে,	
janoganonar,	জানোগানার,	জনগণনার,	
edmeeral,	এডমিরাল,	এডমিরাল,	
debdebie,	দেবদেবী,	দেবদেবী,	
rohinibabu,	রোহিনীবাবু,	রোহিনীবাবু,	
sten,	স্টেন,	স্টেন,	
deelibhara,	দিলিভরা,	ডেলিভার,	
akai,	আকাই,	একাই,	
difinishion,	ডিফিনিশন,	ডেফিনেশন,	
koro,	কোরো,	করো,	
madrasake,	মাদ্রাসাকে,	মাদ্রাসাকে,	
satarkokari,	সতর্ককারী,	সতর্ককারী,	
shrabasti,	শ্রাবাস্তি,	শ্রাবস্তী,	
quartar,	কোয়ার্টার,	কোয়ার্টার,	
basturoi,	বাস্তুরোই,	বস্তুরই,	
ship,	শিপ,	শিপ,	
tarkareer,	তারকারীর,	তরকারীর,	
parswer,	পারস্বের,	পার্শ্বের,	
booksar,	বুক্সার,	বুক্সার,	
shikhbe,	শিখবে,	শিখবে,	
kharavel,	খারাভেল,	খারবেল,	
hitlere,	হিটলারে,	হিটলারে,	
protisthar,	প্রতিষ্ঠার,	প্রতিষ্ঠার,	
banglota,	বাংলোটা,	বাংলোটা,	
rajbandi,	রাজবন্দী,	রাজবন্দী,	
deep,	দীপ,	দীপ,	
samle,	সামলে,	সামলে,	
protishta,	প্রতিষ্টা,	প্রতিষ্টা,	
qlauda,	ক্লাডা,	ক্লাউড,	
spredashita,	স্প্রেদশিত,	স্প্রেডশীট,	
satarkakari,	সতর্কাকারী,	সতর্ককারী,	
slatgulor,	স্লাটগুলোর,	স্ল্যাটগুলোর,	
pnouchute,	পুঁচুতে,	পৌঁছুতে,	
rejidens,	রেজিডেন্স,	রেসিডেন্স,	
mmehonoti,	ম্মমেহনতি,	মেহনতি,	
chalachchitrei,	চালচ্ছিত্রেই,	চলচ্চিত্রেই,	
footbalarra,	ফুটবালরারা,	ফুটবলাররা,	
mandape,	মান্ডাপে,	মন্ডপে,	
kholdhular,	খোলধুলার,	খোলধূলার,	
mataram,	মাতারাম,	মাতরম,	
akhandata,	আখণ্ডতা,	অখণ্ডতা,	
qarqa,	কার্কা,	কার্ক,	
iling,	ইলিং,	ইলিং,	
tukrote,	টুকরোতে,	টুকরোতে,	
pyatarne,	প্যাটার্নে,	প্যাটার্নে,	
trutimatra,	ত্রুতিমাত্র,	ত্রুটিমাত্র,	
pakistanira,	পাকিস্তানীরা,	পাকিস্তানীরা,	
karim,	কারিম,	করিম,	
zerusaleme,	জেরুসালেম,	জেরুসালেমে,	
commissionvogider,	কমিসনভোগীদের,	কমিশনভোগীদের,	
sombhobonao,	সম্ভবনাও,	সম্ভবনাও,	
ved,	ভেড,	বেদ,	
foloshrutite,	ফলশ্রুতিতে,	ফলশ্রুতিতে,	
elakaai,	এলাকাই,	এলাকাই,	
ajeem,	আজিম,	আজিম,	
gandhiir,	গান্ধির,	গান্ধীর,	
rubidium,	রুবিডিয়াম,	রুবিডিয়াম,	
ahalya,	আহাল্যা,	অহল্যা,	
shroddhabihin,	শ্রো্ধাবিহীন,	শ্রদ্ধাবিহীন,	
cholechi,	চলেছি,	চলেছি,	
playtey,	প্লেটে,	প্লেটে,	
said,	সাইদ,	সাইদ,	
bhushito,	ভূষিত,	ভূষিত,	
dokanei,	দোকানেই,	দোকানেই,	
shotodha,	শতধা,	শতধা,	
kraim,	ক্রাম,	ক্রাইম,	
aasirbaad,	আসিরবাদ,	আশির্বাদ,	
chhuteete,	ছুটিতে,	ছুটিতে,	
jatata,	জাতাতা,	যতোটা,	
keyu,	কেয়ু,	কেউ,	
uddhritir,	উদ্ধৃতির,	উদ্ধৃতির,	
digrir,	ডিগ্রির,	ডিগ্রির,	
bhageri,	ভাগেরি,	ভাগেরই,	
gafeeloti,	গাফেলোটি,	গাফিলতি,	
ashankai,	আশঙ্কাই,	আশঙ্কাই,	
alexandar,	আলেক্স্ন্দার,	আলেকজান্ডার,	
bane,	বাঁে,	বনে,	
akpashe,	আক্পশে,	একপাশে,	
baptics,	ব্যাপটিক্স,	ব্যাপটিকস,	
echhti,	এচতি,	এছটি,	
roopdan,	রূপডান,	রুপদান,	
eeksapreeshana,	এক্সপ্রেশন,	এক্সপ্রেশন,	
parka,	পারকা,	পার্ক,	
cocaine,	কোকেইন,	কোকেইন,	
rahee,	রাহী,	রাহী,	
everage,	এভেরেজ,	এভারেজ,	
salafeta,	সালাফেটা,	সালফেট,	
gananatyo,	গণনাত্য,	গণনাট্য,	
sommotite,	সম্মতিতে,	সম্মতিতে,	
udbodhaney,	উদ্বোধনে,	উদ্বোধনে,	
shikkharthirao,	শিক্ষার্থীরাও,	শিক্ষার্থীরাও,	
matorom,	মাতোরম,	মাতরম,	
madeling,	ম্যাডেলিং,	মডেলিং,	
kanasarabhesana,	কাসররভেষণ,	কনসারভেশন,	
shhashtra,	শাষ্ট্র,	শাস্ত্র,	
dwipke,	দ্বীপকে,	দ্বীপকে,	
vobani,	ভবানী,	ভবানী,	
shikkhartheerao,	শিক্ষার্থীরাও,	শিক্ষার্থীরাও,	
byke,	ব্ইক,	বাইক,	
bijepi,	বিজেপি,	বিজেপি,	
neemeette,	নিমিত্তে,	নিমিত্তে,	
manushe,	মানুষে,	মানুষে,	
neermol,	নির্মোল,	নির্মল,	
weelcomee,	উইলকমি,	ওয়েলকাম,	
gobeshana,	গোবেশন,	গবেষনা,	
foxer,	ফক্সের,	ফক্সের,	
juktorastrer,	যুক্তরাস্ত্রের,	যুক্তরাষ্ট্রের,	
vvimsenn,	ভিভিমসেন,	ভীমসেন,	
kayed,	কায়েদ,	কায়েদ,	
nosihote,	নসীহতে,	নসিহতে,	
muktilav,	মুক্তিলাভ,	মুক্তিলাভ,	
mochlekha,	মোচখেখা,	মোছলেখা,	
ghoshito,	ঘোষিত,	ঘোষিত,	
bonsho,	বনশো,	বংশ,	
jahangirbad,	জাহানীগ্রাদ,	জাহাঙ্গীরবাদ,	
melbourner,	মেলবার্নের,	মেলবোর্নের,	
eporzonto,	এপরজন্ত,	এপর্যন্ত,	
sumitrar,	সুমিত্রার,	সুমিত্রার,	
sportstar,	স্পোর্টস্টার,	স্পোর্টসস্টার,	
konruup,	কোনরুপ,	কোনরূপ,	
besirbhaagi,	বেসিরভাগী,	বেশিরভাগই,	
youth,	য়ুথ,	ইয়ুথ,	
bhimsenkei,	ভীমসেনকেই,	ভীমসেনকেই,	
bamon,	বামন,	বামন,	
rajtontre,	রাজতন্ত্রে,	রাজতন্ত্রে,	
fansi,	ফানসি,	ফাঁসী,	
borkhastokritora,	বর্খাস্তকৃততা,	বরখাস্তকৃতরা,	
khonjena,	খোঁজেনা,	খোঁজেনা,	
ched,	চেদ,	ছেদ,	
gronthoti,	গ্রন্থতি,	গ্রন্থটি,	
morodeho,	মরোদেহ,	মরদেহ,	
soori,	সুরি,	সুরি,	
bachai,	বাচাই,	বাছাই,	
johor,	জহর,	জহর,	
alonkaran,	আলঙ্করণ,	অলঙ্করণ,	
eenameela,	এমামেলা,	এনামেল,	
bardhitansh,	বার্ধিতান্শ,	বর্ধিতাংশ,	
reejideencee,	রিজিডিনসি,	রেসিডেন্স,	
daebug,	দাবিগ,	ডিবাগ,	
dakten,	ডাকতেন,	ডাকতেন,	
kaalaam,	কালাম,	কালাম,	
lavta,	লাভটা,	লাভটা,	
proteemake,	প্রতিমাকে,	প্রতিমাকে,	
daybhager,	দাভেগের,	দায়ভাগের,	
bajhyo,	বাঝ্য,	বাহ্য,	
teter,	টেটার,	টেটের,	
mojdur,	মোজদুর,	মজদুর,	
veenis,	ভিইনিস,	ভেনিস,	
bitertrate,	বাটারট্রেট,	বাইটারট্রেট,	
fiksing,	ফিক্সিং,	ফিক্সিং,	
bhittow,	ভিত্তু,	ভিত্তিও,	
aprasangikbhabei,	অপ্রসংগ্খভাবেই,	অপ্রাসঙ্গিকভাবেই,	
cheekitsar,	চিকিৎসার,	চিকিত্সার,	
mmadhuri,	ম্যামধুরি,	মাধুরী,	
medilek,	মেডিলেক,	মেডিলেক,	
nothiboddho,	নথিবদ্ধ,	নথিবদ্ধ,	
ghomta,	ঘোমটা,	ঘোমটা,	
songasthaner,	সংগ্ঠানের,	সংস্থানের,	
hupile,	হুপিলে,	হুপিলে,	
enjineers,	এনজিনিরস,	ইঞ্জিনিয়ার্স,	
sumeeta,	সুমিতা,	সুমিতা,	
mangolic,	ম্যাঙ্গোলিক,	মাঙ্গলিক,	
poscater,	পোস্কেটের,	পশ্চাতের,	
akkelpure,	আক্কেলপুরে,	আক্কেলপুরে,	
akhando,	আখণ্ড,	অখন্ড,	
shringgo,	শৃঙ্গো,	শৃঙ্গ,	
kaatbey,	কাতবে,	কাটবে,	
zerusalem,	জেরুসালেম,	জেরুজালেম,	
kraanti,	ক্রান্টি,	ক্রান্তি,	
redcrosser,	রেডক্রোসের,	রেডক্রসের,	
dighol,	দিঘল,	দীঘল,	
harasta,	হারাস্তা,	হারাস্তা,	
futote,	ফুটোতে,	ফুটোতে,	
deool,	দেওল,	দেউল,	
wedanta,	ওয়েদান্তা,	বেদান্ত,	
anusthane,	অনুষ্ঠানে,	অনুষ্ঠানে,	
bolechile,	বলেছিলে,	বলেছিলে,	
mononiitoder,	মনোনীতদের,	মনোনীতদের,	
niketaner,	নিকেতানের,	নিকেতনের,	
khoakshir,	খোয়াক্ষীর,	খোয়াক্ষীর,	
spredasita,	স্প্রেডাসিটা,	স্প্রেডশীট,	
pharn,	ফার্ন,	ফার্ন,	
safin,	সাফিন,	সাফিন,	
brittakar,	বৃত্তকার,	বৃত্তাকার,	
beshakbar,	বেশাকবার,	বেশকবার,	
bisshaskey,	বিশশাস্কে,	বিশ্বাসকে,	
rudroke,	রুদ্রকে,	রুদ্রকে,	
jaatti,	জাত্তি,	জাতটি,	
vaibon,	ভাইবন,	ভাইবোন,	
toptoshele,	তপ্তশেলে,	তপ্তশেলে,	
pohnpeic,	পোনসেপেক,	ফোনপেইক,	
bagdadii,	বাগদাদী,	বাগদাদী,	
ray,	রায়া,	রায়,	
konorup,	কোনরূপ,	কোনরূপ,	
antarvuktimulak,	অন্তর্ুভুলিতক,	অন্তর্ভুক্তিমূলক,	
fanding,	ফ্যান্ডিং,	ফান্ডিং,	
daakteekite,	ডাক্তিকেতে,	ডাকটিকিটে,	
katateo,	কাটাতেও,	কাটাতেও,	
liedtke,	লিয়েটকে,	লইডটক,	
taufik,	তাউফিক,	তৌফিক,	
hingsar,	হিংসার,	হিংসার,	
capshule,	কাপশুলে,	ক্যাপসুল,	
ghamta,	ঘামটা,	ঘোমটা,	
provritike,	প্রভৃতিকে,	প্রভৃতিকে,	
sanaktokaron,	সানাক্তকরণ,	সনাক্তকরণ,	
niemond,	নিয়মন্ড,	নিমন্ড,	
dapadpi,	দাপাদপি,	দাপাদপি,	
seguloi,	সেগুলোই,	সেগুলোই,	
shandra,	শান্দ্রা,	শান্দ্রার,	
satarkabhabey,	সতরকাভাবে,	সতর্কভাবে,	
soteciety,	সটিকিটি,	সোসাইটিতে,	
shringa,	শৃঙ্গা,	শৃঙ্গ,	
munot,	মুনত,	মুনোট,	
bhagno,	ভাগনো,	ভগ্ন,	
gosthike,	গোষ্ঠীকে,	গোষ্ঠীকে,	
informetion,	ইনফোরমেশন,	ইনফরমেশন,	
madrasi,	মাদ্রাসি,	মাদ্রাজি,	
alpa,	আল্পা,	অল্প,	
chouhate,	চৌহাতে,	চৌহাটে,	
pingna,	পিংগানা,	পিংনা,	
jewellery,	জিওয়েরলির,	জুয়েলারির,	
teliha,	তেলিহা,	তেলিহা,	
agomonke,	আগমনকে,	আগমনকে,	
shangsthatikey,	শাংস্থাটিকে,	সংস্থাটিকে,	
caramiks,	ক্যারামিক্স,	সিরামিকস,	
showtey,	শাটে,	শোতে,	
chopal,	চোপাল,	চপল,	
pancbaar,	পাঁ্ববার,	পাঁচবার,	
dharabahikbhabe,	ধারাবাহিকভাবে,	ধারাবাহিকভাবে,	
damodar,	দামোদার,	দামদর,	
deepan,	দীপান,	দীপন,	
puroheetder,	পুরহীতদের,	পুরোহিতদের,	
dharavahikbhabe,	ধারাভাহিকভাবে,	ধারাবাহিকভাবে,	
catholicder,	ক্যাথোলিকদের,	ক্যাথলিকদের,	
rena,	রেনা,	রেনো,	
jontrototto,	যন্ত্রত্ব্ব,	যন্ত্রতত্ত্ব,	
mangoleek,	মঙ্গলীক,	মাঙ্গলিক,	
mulbhitti,	মূলভিত্তি,	মূলভিত্তি,	
manabmaner,	মানবমানের,	মানবমনের,	
kommandar,	কমম্নদার,	কমাণ্ডার,	
ganakantha,	গণকান্ঠ,	গণকণ্ঠ,	
tirmijii,	তীরমিজি,	তিরমিজি,	
annimated,	অ্যানিমেটেড,	এনিমেটেড,	
dakope,	ডাকোপে,	দাকোপ,	
dhanak,	ধনক,	ধানক,	
chat,	চাত,	চ্যাট,	
suchanakal,	সুচনকাল,	সূচনাকাল,	
auttacharer,	অট্চচরের,	অত্যাচারের,	
iksaprishana,	ইকস্প্রিনা,	এক্সপ্রেশন,	
hosbaleke,	হোসবালেকে,	হোসবালেকে,	
baikalyo,	বৈকল্য,	বৈকল্য,	
grauth,	গ্রাউথ,	গ্রোথ,	
jamjamat,	জমজামাত,	জমজমাট,	
backflipe,	ব্যাকফ্লিপে,	ব্যাকফ্লিপে,	
avisongson,	অভিসংসন,	অভিশংসন,	
ultrasonography,	আলট্রাসনোোগ্রাফি,	আলট্রাসনোগ্রাফিও,	
chowdhuryke,	চুডহিরিকে,	চৌধুরীকে,	
monroe,	মনরর,	মনেরোর,	
marketin,	মার্কেটিন,	মার্কেটিং,	
jakatke,	জাকাতকে,	যাকাতকে,	
choddo,	চড্ডো,	চোদ্দো,	
ronodeep,	রোনোীপ,	রণদীপ,	
rajtontro,	রাজতন্ত্র,	রাজতন্ত্র,	
korimkey,	করিমকে,	করিমকে,	
mulor,	মুলোর,	মুলোর,	
skolastik,	স্কলস্টিক,	স্কলাস্টিক,	
chakti,	চাকটি,	চাকতি,	
orthisoho,	অর্থিসহ,	অর্থিসহ,	
bandhubhaabaapanna,	বন্ধুভাবপ্্ন,	বন্ধুভাবাপন্ন,	
chhutochhooti,	ছুটোছুটি,	ছুটোছুটি,	
soundorjotakei,	সৌন্দ্যজতাকেই,	সৌন্দর্যটাকেই,	
konar,	কোনার,	কণার,	
tinage,	তিনাগে,	টিনেজ,	
cheerontan,	চিরণ্তান,	চিরন্তন,	
jins,	জিন্স,	জিন্স,	
sainyader,	সৈন্যাদের,	সৈন্যদের,	
biprodas,	বিপ্রোদাস,	বিপ্রদাস,	
jahara,	জাহারা,	যাহরা,	
existing,	এক্সিস্টিং,	এক্সিসটিং,	
literacy,	লিটারেসি,	লিটারেসি,	
laaisensh,	লাইসেন্শ,	লাইসেন্স,	
poste,	পোস্টে,	পোস্টে,	
plato,	প্ল্যাটো,	প্লেটো,	
konnoder,	কন্যদের,	কন্যদের,	
abosare,	অবসারে,	অবসরে,	
gandhikey,	গা্ধীকে,	গান্ধীকে,	
patishapta,	পতিশাপ্ত,	পাটিসাপটা,	
donat,	ডোনাট,	ডোনাট,	
baipash,	বাইপাশ,	বাইপাস,	
rudiger,	রুডিগের,	রুদিগের,	
detik,	ডেটিক,	দেতিক,	
bohorompurer,	বহরমপুরের,	বহরমপুরের,	
bibadey,	বিবাদে,	বিবাদে,	
nachar,	নাচার,	নাচার,	
porishongkhanbid,	পরিষ্ংখাবিন,	পরিসংখ্যানবিদ,	
aakaabaar,	আকাবার,	আকাবার,	
sheekar,	শিকার,	শিকার,	
mumtaz,	মুমতাজ,	মুমতাজ,	
pothnirdeshona,	পথ্নির্দেশনা,	পথনির্দেশনা,	
shrabostee,	শ্রাবস্তি,	শ্রাবস্তী,	
carlo,	কার্লো,	কার্লো,	
nirikho,	নিরিখো,	নিরিখ,	
drishyer,	দৃষ্যের,	দৃশ্যের,	
mukhamandoler,	মুখামন্ডলের,	মুখমণ্ডলের,	
telakucha,	তেলাকুচা,	তেলাকুচা,	
gudamjat,	গুদাজাত,	গুদামজাত,	
jemy,	জেমি,	জেমি,	
baman,	বামান,	বামন,	
phiksa,	ফিকসা,	ফিক্স,	
zibonnogor,	জীবন্গগর,	জীবননগর,	
wictor,	উইকটটর,	ভিক্টর,	
phood,	ফুড,	ফুড,	
tateo,	তাতেও,	তাতেও,	
postac,	পোস্টাক,	পোস্টকে,	
pakhtunistan,	পাখতুনিস্তান,	পাখতুনিস্তান,	
udvabani,	উদ্ভবানী,	উদ্ভাবনী,	
prakalpagulor,	প্রকল্পগুলোর,	প্রকল্পগুলোর,	
prothakey,	প্রথাকে,	প্রথাকে,	
poriharsoho,	পরিহারসহ,	পরিহারসহ,	
fibergulote,	ফাবারগুলোতে,	ফাইবারগুলোতে,	
anchalei,	অঞ্চলেই,	অঞ্চলেই,	
konflict,	কনফ্লিক্ট,	কনফ্লিক্ট,	
nothivuktir,	নথিভুক্তির,	নথিভুক্তির,	
sexperter,	সেক্সপার্টের,	সেক্সপার্টের,	
hastantar,	হস্তান্তর,	হস্তান্তর,	
dwibidho,	দ্বিবিধো,	দ্বিবিধ,	
liceensee,	লিসেন্সি,	লাইসেন্স,	
dinar,	দিনার,	ডিনার,	
vezano,	ভেজানো,	ভেজানো,	
chhooteer,	ছুটির,	ছুটির,	
nothivookta,	নথিভুক্তা,	নথিভুক্ত,	
shaahaabiike,	শাহাবিইকে,	সাহাবীকে,	
toroonra,	তোরনরা,	তরুণরা,	
batom,	বাতম,	বাটম,	
jubokti,	যুবকটি,	যুবকটি,	
arthanitike,	অর্থানীতিকে,	অর্থনীতিকে,	
protul,	প্রতুল,	প্রতুল,	
durtomo,	দূর্তমো,	দূরতম,	
nirmankarmisaha,	নির্মণকৃমসহ,	নির্মাণকর্মীসহ,	
tetela,	টেতেলা,	টাইটেল,	
songkulan,	সংকুলান,	সংকুলান,	
saraiki,	সারাইকি,	সরাইকি,	
dola,	দোলা,	দলা,	
kayartara,	কায়ারটার,	কোয়ার্টার,	
dhrubaker,	ধ্রুবাকের,	ধ্রুবকের,	
phutbolarder,	ফুটবলরদের,	ফুটবলারদের,	
baarnish,	বার্নিশ,	বার্নিশ,	
anandamahale,	আনন্দমহলে,	আনন্দমহলে,	
nirvachaker,	নির্ভাচাকের,	নির্বাচকের,	
devolapar,	দেবলাপার,	ডেভলপার,	
motkey,	মোককে,	মতকে,	
matis,	মাতিস,	ম্যাটিস,	
sachetonvabe,	সচেতনভাবে,	সচেতনভাবে,	
vaider,	ভাইদের,	ভাইদের,	
pranibigyani,	প্রাণিবিজ্ঞানী,	প্রাণীবিজ্ঞানী,	
monchosthol,	মন্চস্থল,	মঞ্চস্থল,	
alpo,	আলপপো,	অল্প,	
veemsen,	ভিমসেন,	ভীমসেন,	
gazetted,	গ্যাজেটেড,	গেজেটেড,	
masjidsaha,	মাসজিদসহ,	মসজিদসহ,	
ancholsaha,	অঞ্চলসহ,	অঞ্চলসহ,	
oboshore,	অবশরে,	অবসরে,	
shahjapur,	শাহজাপুর,	শাহজাপুর,	
niurolaji,	নিউরলাজি,	নিউরোলজি,	
mukhbondho,	মুখবন্ধ,	মুখবন্ধ,	
jerushalema,	জেরুশলেমা,	জেরুসালেম,	
vobobibhuti,	ভববিভূতি,	ভববিভূতি,	
duuma,	ডুয়ামা,	দুমা,	
bulan,	বুলান,	বুলান,	
promothesh,	প্রমথেষ,	প্রমথেশ,	
bojata,	বোজাতা,	বোজাটা,	
jonee,	জনি,	জনি,	
parkasa,	পারকাসা,	পার্কস,	
joubanbatee,	জৌবনবাটি,	যৌবনবতী,	
chirantan,	চিরানতান,	চিরন্তন,	
agora,	আগোরা,	আগোরা,	
kompeeto,	কম্পিত,	কম্পিত,	
deefinishion,	দিফিনিশন,	ডেফিনেশন,	
prakar,	প্রকার,	প্রকার,	
abodamaner,	অবদামানের,	অবদমনের,	
folleni,	ফলেনি,	ফলেনি,	
bbiswashke,	বিবিস্বাশকে,	বিশ্বাসকে,	
oncolsoho,	অনকলসহ,	অঞ্চলসহ,	
mitrer,	মিত্রের,	মিত্রের,	
kingsh,	কিংশ,	কিংস,	
nuhas,	নুহাস,	নুহাশ,	
srichoitonnodeb,	শ্রীচীতনন্যবে,	শ্রীচৈতন্যদেব,	
mukhomandoler,	মুখমণ্ডলের,	মুখমণ্ডলের,	
mozdur,	মোজদুর,	মজদুর,	
markeetim,	মার্কিটিম,	মার্কেটিং,	
phartha,	ফার্থা,	ফার্থ,	
horash,	হোরাশ,	হোরাস,	
bhittiti,	ভিত্তিটি,	ভিত্তিটি,	
nadnadeer,	নদনদীর,	নদনদীর,	
noitikota,	নৈটিকতা,	নৈতিকতা,	
hunine,	হুনিন,	হুনাইন,	
sthapanagulo,	স্থাপানগুলো,	স্থাপনাগুলো,	
bhaangchur,	ভা্চুর,	ভাংচুর,	
poderthobid,	পদের্থবিদ,	পদার্থবিদ,	
barder,	বার্ডার,	বার্ডের,	
philo,	ফিলো,	ফিলো,	
dhani,	ধানি,	ধানি,	
plasse,	প্লাসে,	প্লাসে,	
bandhano,	বাঁধানো,	বাঁধানো,	
gonohotyakey,	গণহত্যাকে,	গণহত্যাকে,	
ghurechen,	ঘুরেছেন,	ঘুরেছেন,	
gingbhalobasen,	গিংভালাসেন,	গিংভালোবাসেন,	
dayitta,	দায়িত্া,	দায়িত্ব,	
lutharan,	লুথারণ,	লুথেরান,	
shudhui,	শুধুই,	শুধুই,	
nagorikderkey,	নাগরীকদেরকে,	নাগরিকদেরকে,	
sbajan,	স্বজন,	স্বজন,	
batistambhatike,	বাতিস্তামথািকে,	বাতিস্তম্ভটিকে,	
toroonraa,	তোরনরা,	তরুণরা,	
puding,	পুদিং,	পুডিং,	
sithilota,	সিথিলতা,	শিথিলতা,	
kaamij,	কামিজ,	কামিজ,	
shoreefpur,	শরীপপুর,	শরিফপুর,	
sonaktokaran,	সোনাক্তকরণ,	সনাক্তকরণ,	
chaloke,	চালোকে,	চালকে,	
aflatoxin,	অফলাটক্সিন,	আ্যফ্ল্যাটক্সিন,	
hakone,	হাকোন,	হাকোনে,	
probolshoktio,	প্রবলশক্তিও,	প্রবলশক্তিও,	
difinisian,	ডিফিনিয়ান,	ডেফিনেশন,	
narsinghomgulor,	নরসিংহোমগুলোর,	নার্সিংহোমগুলোর,	
spredashiita,	স্প্রেদশিতা,	স্প্রেডশীট,	
oxforde,	অক্সফোর্ডে,	অক্সফোর্ডে,	
grotha,	গ্রোথা,	গ্রোথ,	
osommotite,	অসম্মতিতে,	অসম্মতি,	
saqara,	সাকারা,	সাকার,	
black,	ব্ল্যাক,	ব্ল্যাক,	
zakharovar,	যখরোভার,	জাখারোভার,	
ronangane,	রোনাঙ্গানে,	রণাঙ্গনে,	
steen,	স্টিন,	স্টেন,	
ministara,	মিনিস্তারা,	মিনিস্টার,	
pathanirdeshona,	পাঠনির্দেশনা,	পথনির্দেশনা,	
reliance,	রিলিয়ান্স,	রিলায়েন্স,	
turky,	টার্কি,	তুর্কি,	
institutione,	ইনস্টিটিওশেন,	ইনস্টিটিউশনে,	
vedanta,	ভেদান্তা,	বেদান্ত,	
manbe,	মানবে,	মানবে,	
enamela,	এনামেলা,	এনামেল,	
duhsthanostho,	দুহস্থানস্থ,	দুঃস্থানস্থ,	
byapoktor,	ব্যাপক্তর,	ব্যাপকতর,	
bisnoo,	বিস্নু,	বিষ্ণু,	
marri,	মাররি,	ম্যারি,	
debholopar,	দেভোলাপ,	ডেভলপার,	
olpo,	অল্পো,	অল্প,	
milekhaanek,	মিলেখানেক,	মাইলখানেক,	
gunje,	গুঞ্জে,	গুঁজে,	
megacaldera,	মেগাকল্ডেরা,	মেগাক্যাল্ডেরা,	
turisht,	তুরিশ্ট,	টুরিস্ট,	
dewaben,	দেওয়াবেন,	দেওয়াবেন,	
hozot,	হজত,	হজত,	
blasterke,	ব্ল্যাস্টারকে,	ব্লাস্টারকে,	
saurce,	সার্সে,	সোর্স,	
onchalti,	অঞ্চলটি,	অঞ্চলটি,	
swairacharibirodhi,	স্বৈরাচরিবরোধী,	স্বৈরাচারীবিরোধী,	
firozapure,	ফিরোজাপুরে,	ফিরোজাপুরে,	
daktickete,	ডাক্টিকেতে,	ডাকটিকিটে,	
kinenni,	কিনেননি,	কিনেননি,	
marpit,	মারপিট,	মারপিট,	
milea,	মিলিয়া,	মাইলে,	
korle,	করলে,	করলে,	
bohudeen,	বহুদীন,	বহুদিন,	
segulo,	সেগুলো,	সেগুলো,	
timathi,	তিমাথি,	টিমোথি,	
mekon,	মেকন,	মেকং,	
kamla,	কামলা,	কামলা,	
mukhomandaler,	মুখমণ্ডলের,	মুখমণ্ডলের,	
rajyabhogi,	রাজ্যভোগী,	রাজ্যভোগী,	
taateo,	টাতেও,	তাতেও,	
uthaney,	উথানে,	উঠানে,	
dianes,	ডায়ানেস,	ডিএনএস,	
juakhelar,	জুয়াখেলার,	জুয়াখেলার,	
olympicer,	অলিম্পাসের,	অলিম্পিকের,	
aansaareer,	আনসারীর,	আনসারীর,	
kaale,	কালে,	কালে,	
survative,	সুরভাভাইভ,	সারভেটিভ,	
bikretara,	বিক্রেতারা,	বিক্রেতারা,	
cholochchitro,	চলচ্ছিত্র,	চলচ্চিত্র,	
janagononar,	জানাগোনার,	জনগণনার,	
bairer,	বাইরের,	বাইরের,	
dreeshtiheen,	দৃষ্টিহীন,	দৃষ্টিহীন,	
langhoner,	লাংহণের,	লংঘনের,	
akhandota,	আখণ্ডতা,	অখণ্ডতা,	
daqop,	ডাকোপ,	দাকোপ,	
brindabane,	বৃন্দাবানে,	বৃন্দাবনে,	
baait,	বাইত,	বাইট,	
accountdharira,	আকযাউউটন্ধারীরা,	একাউন্টধারীরা,	
bowie,	বোঁই,	বওই,	
laaishheshh,	লাইশেশ,	লাইসেন্স,	
vagni,	ভাগনি,	ভগ্নী,	
borlen,	বর্লেন,	বরলেন,	
nothivukta,	নথিভুক্ত,	নথিভুক্ত,	
ghumachchila,	ঘুমাচ্ছিলা,	ঘুমাচ্ছিল,	
proboleme,	প্রবলেমে,	প্রবলেমে,	
shringey,	শ্ঙ্ঙ্গে,	শৃঙ্গে,	
teoner,	তেওনের,	টিওনার,	
avinetar,	অভিনেতার,	অভিনেতার,	
yukeliptash,	যুকেলিপ্তাশ,	ইউক্যালিপ্টাস,	
hank,	হ্যাংক,	হাঙ্ক,	
freekeh,	ফ্রিকেহ,	ফ্রিকেহ,	
ernad,	এরনাড,	এরনাড,	
doobate,	দুবাতে,	ডুবাতে,	
kabutorer,	কাবুটরের,	কবুতরের,	
akreetokarjo,	অক্রিতকর্জ,	অকৃতকার্য,	
jeebanjapon,	জীবানজাপন,	জীবনযাপন,	
janar,	জানার,	জানার,	
victor,	ভিক্টর,	ভিক্টর,	
akpaase,	আক্পাস,	একপাশে,	
alpakichudin,	আল্পাউচিদিন,	অল্পকিছুদিন,	
santoshpore,	সন্তোষ্পরে,	সন্তোষপুর,	
miley,	মিলে,	মিলে,	
dakkhinkare,	দক্ষিণকারে,	দক্ষিণকরে,	
eigulor,	এইগুলোর,	এইগুলোর,	
sangbadmadhyome,	সংবাদমধ্যমে,	সংবাদমাধ্যমে,	
mahakabi,	মহাকাবি,	মহাকবি,	
ipl,	আইপিএল,	আইপিএল,	
kantojir,	কাঁটোজির,	কান্তজির,	
metrikoleshana,	মেট্রিকোলেশন,	মেট্রিকোলেশন,	
shekarmani,	শেকর্মণি,	শেকরমানি,	
chalachchitro,	চালচ্ছিত্র,	চলচ্চিত্র,	
esoosiyetasa,	এসোযিয়েটাসা,	এসোসিয়েটস,	
adhyattikota,	অধ্যাত্তিকতা,	আধ্যাত্মিকতা,	
ayumi,	আয়ুমি,	আয়ুমি,	
rajashri,	রাজশ্রী,	রাজশ্রী,	
bhyaatikaner,	ভ্যাতিকানের,	ভ্যাটিকানের,	
tintikey,	তিনটিকে,	তিনটিকে,	
judge,	জুগগে,	জাজ,	
anusvara,	অনুষ্বরা,	অনুস্বার,	
onupater,	অনুপাতের,	অনুপাতের,	
agomoney,	আগমণে,	আগমনে,	
senabahineekey,	সেনাবাহিনীকে,	সেনাবাহিনীকে,	
shasankarta,	শাসঙ্করতা,	শাসনকর্তা,	
khudhartara,	ক্ষুধার্তা,	ক্ষুধার্তরা,	
senior,	সেনিওর,	সিনিয়র,	
hert,	হার্ট,	হার্ট,	
taposgoner,	তাপসগণের,	তাপসগণের,	
votar,	ভোটার,	ভোটার,	
mulyabriddhikale,	মূল্যবৃদ্ধিকালে,	মূল্যবৃদ্ধিকালে,	
basermick,	বেসারমিক,	বেসারমিক,	
swasthohinotay,	স্বাস্থ্যহীনতায়,	স্বাস্থ্যহীনতায়,	
dagmukta,	দাগমুক্ত,	দাগমুক্ত,	
sarbhaarti,	সর্ভরটি,	সার্ভারটি,	
lyataa,	ল্যা,	ল্যাটা,	
jens,	জেন্স,	জিন্স,	
chaalaabi,	চালাবি,	চালাবে,	
bhangchur,	ভাঙ্চুর,	ভাংচুর,	
sheets,	শিটস,	শীটস,	
rajendracholer,	রাজেন্দ্রাছলের,	রাজেন্দ্রচোলের,	
sookumari,	সুকুমারি,	সুকুমারী,	
parisankhanvid,	পরিসংখানভিদ,	পরিসংখ্যানবিদ,	
qaferder,	কাফেরদের,	কাফেরদের,	
cathalic,	ক্যাথালিক,	ক্যাথলিক,	
cheentaikaree,	চিন্তাইকারী,	ছিনতাইকারী,	
jonoshongjog,	জনসংযোগ,	জনসংযোগ,	
fanse,	ফ্যানসে,	ফাঁসে,	
oncholeo,	অঁচলেও,	অঞ্চলেও,	
peterke,	পেটারকে,	পিটারকে,	
tanshree,	তাঁশরি,	তানশ্রী,	
parkin,	পারকিন,	পার্কিং,	
juboksoho,	যুবকসহ,	যুবকসহ,	
lahano,	লাহানো,	লাহানো,	
shalook,	শালুক,	শালুক,	
rushod,	রুশোদ,	রুশদ,	
chetanagato,	চেতানগত,	চেতনাগত,	
probhura,	প্রভূরা,	প্রভুরা,	
ritesh,	রিতেশ,	রিতেশ,	
karmoi,	কার্মই,	কর্মই,	
sommoteer,	সম্মতির,	সম্মতির,	
eokee,	ইওকি,	এওকি,	
jaaygata,	জায়গত,	জায়গাটা,	
noditir,	নোড়িটির,	নদীটির,	
chalochchitro,	চালচ্ছিত্র,	চলচ্চিত্র,	
toranganj,	তোরঙ্গঙ্গজ,	তোরাবগঞ্জ,	
rakhtokkharone,	রাখ্তক্ষণণে,	রক্তক্ষরণে,	
skirt,	স্কার্ট,	স্কার্ট,	
wagadada,	ওয়াদাদা,	বাগদাদ,	
jaunotar,	যৌনতার,	যৌনতার,	
chalochchitraeeo,	চালচচিত্রাও,	চলচ্চিত্রেও,	
nutunotto,	নুতুনত্ত,	নতুনত্ব,	
bisshasi,	বিশশাসী,	বিশ্বাসী,	
tokeo,	তোকেও,	টোকেও,	
shilpikuler,	শিল্পীকুলের,	শিল্পীকুলের,	
samaptir,	সমাপ্তির,	সমাপ্তির,	
farna,	ফারনা,	ফার্ন,	
avetar,	অভেতার,	অবতার,	
darji,	দার্জী,	দরজি,	
peri,	পেরি,	পেরি,	
neerbahi,	নিরবাহী,	নির্বাহি,	
elakaasoho,	এলাকাসহ,	এলাকাসহ,	
plainey,	প্লেনে,	প্লেনে,	
inapharameshana,	ইনাপারহেশন,	ইনফরমেশন,	
jaruri,	জারুরি,	জরূরী,	
alaol,	আলাওল,	আলাওল,	
opohoron,	অপহরণ,	অপহরন,	
birmuktijoddhagan,	বির্মুক্তিযোদ্ধাগণ,	বীরমুক্তিযোদ্ধাগণ,	
chitlar,	চিতলার,	চিতলার,	
jommu,	জম্মু,	জম্মু,	
durgotsab,	দুর্গৎসা,	দুর্গোৎসব,	
basaalt,	বাসালাট্ট,	ব্যাসল্ট,	
shrabosty,	শ্রাবোস্টি,	শ্রাবস্তী,	
armeenian,	আর্মিনিয়ান,	আর্মেনিয়ান,	
foreks,	ফরেক্স,	ফরেক্স,	
tachnach,	তাচনাচ,	তছনছ,	
qraima,	ক্রেমা,	ক্রাইম,	
sushposhtolikhito,	সুষ্পশ্িথিকুত,	সুষ্পষ্টলিখিত,	
mutar,	মুতার,	মুতার,	
meshintao,	মেশিনটাও,	মেশিনটাও,	
spredshiit,	স্প্রেশশিট,	স্প্রেডশীট,	
ispredsiit,	ইসপ্রেস্ডিট,	স্প্রেডশীট,	
mail,	মেল,	মাইল,	
sthapanatir,	স্থাপানতির,	স্থাপনাটির,	
kkomandar,	ক্লমান্দার,	কমাণ্ডার,	
pooshti,	পুষ্টি,	পুষ্টি,	
koyeeri,	কয়রি,	কোয়েরি,	
haitasha,	হাইতাশা,	হাইটস,	
saifullahil,	সাইফুল্লহিল,	সাইফুল্লাহিল,	
rajtantro,	রাজতান্ত্র,	রাজতন্ত্র,	
adhyatmik,	অধ্যাত্মিক,	আধ্যাত্মিক,	
bhenasha,	ভেনাশা,	ভেনাস,	
blacq,	ব্ল্যাক,	ব্ল্যাক,	
shektor,	শেক্তর,	সেক্টর,	
aasar,	আসার,	আসর,	
oitijhya,	ঐতিহ্য,	ঐতিহ্য,	
syfy,	সিফি,	সাইফাই,	
byabosthar,	ব্যবস্থার,	ব্যাবস্থার,	
qrisenta,	ক্রিসেন্টা,	ক্রিসেন্ট,	
stagecraft,	স্টেগ্ফার্ফ্ট,	স্টেজক্রাফট,	
babona,	বাবোনা,	বাবনা,	
hisaber,	হিসাবের,	হিসাবের,	
bosoben,	বসবেন,	বসবেন,	
qarpeta,	করপপতা,	কার্পেট,	
tophaat,	তোফাত,	তফাৎ,	
footballerra,	ফুটবলরেরা,	ফুটবলাররা,	
graambasheeo,	গ্রামবাশও,	গ্রামবাসীও,	
camerapersoner,	ক্যামেরাপরেশনের,	ক্যামেরাপার্সনের,	
bojhao,	বোঝাও,	বোঝাও,	
bbosben,	ব্ববসেন,	বসবেন,	
jani,	জানি,	জনি,	
collaborators,	কলাবারাটরস,	কলাবরেটরস,	
hughes,	হুউশেস,	হিউজেস,	
koomarir,	কুমারির,	কুমারীর,	
konagoolo,	কোনাগুলো,	কণাগুলো,	
borendroke,	বোরেন্দ্রকে,	বরেন্দ্রকে,	
dharmantor,	ধর্মান্তর,	ধর্মান্তর,	
diiptii,	দিপিটি,	ডেপুটি,	
uqeliptas,	ইউকেলিপ্টাস,	ইউক্যালিপ্টাস,	
elaakate,	এলাকাতে,	এলাকাতে,	
dharmadasbabu,	ধর্মদাসবাবু,	ধর্মদাসবাবু,	
zoojyota,	যুজ্যতা,	যোজ্যতা,	
gronthowo,	গ্রন্থ্যু,	গ্রন্থও,	
mane,	মানে,	মানে,	
jocqey,	জোকে,	জকি,	
mythological,	মিথোোজিক্ল,	মাইথলজিকাল,	
akkaas,	আক্কাস,	আককাস,	
peshto,	পেশতো,	পেষ্ট,	
samratra,	সম্রত্র,	সম্রাটরা,	
moresbai,	মোরেসবাই,	মোরেসবাই,	
prangulo,	প্রাণগুলো,	প্রানগুলো,	
pleta,	প্লেট,	প্লেটো,	
becha,	বেচা,	বেচা,	
nartana,	নাততানা,	নর্টন,	
saver,	সাভার,	সেভার,	
mujuru,	মুজুরু,	মুজুরু,	
definition,	ডিফিনিশন,	ডেফিনেশন,	
ashamorthito,	আশামর্থিত,	অসমর্থিত,	
bujhechhila,	বুঝেছিলা,	বুঝেছিল,	
keuoi,	কেওউ,	কেউই,	
larson,	লারসন,	লারসন,	
marmader,	মারমাদের,	মারমাদের,	
cheenja,	চিনজা,	চেঞ্জ,	
sumoo,	সুমু,	সুমো,	
vugoley,	ভুগলে,	ভূগোলে,	
kuttake,	কুটটাকে,	কুত্তাকে,	
mukhmondole,	মুখমণ্ডলে,	মুখমণ্ডলে,	
bitlaser,	বিটলাসের,	বিটলসের,	
spenser,	স্পেন্সের,	স্পেন্সার,	
asantosh,	অসন্তশ,	অসন্তোষ,	
kaansaat,	কানসাত,	কানসাট,	
liseensee,	লিসেনসি,	লাইসেন্স,	
zubokra,	যুবকরা,	যুবকরা,	
achintyabhedaved,	অচিন্তেভেবাধেদ,	অচিন্ত্যভেদাভেদ,	
ingrejra,	ইংরেজরা,	ইংরেজরা,	
basaake,	বাসাকে,	বাসাকে,	
elakatay,	এলাকাটা,	এলাকাতে,	
mesenjarer,	মেসেঞ্জারের,	মেসেঞ্জারের,	
ekoghore,	একঘরে,	একঘরে,	
shtonehenge,	স্টনেহেঙ্গে,	স্টোনহেঞ্জ,	
mumtazer,	মুমতাজের,	মুমতাজের,	
mohammadi,	মোহাম্মদি,	মুহাম্মদী,	
ponera,	পনেরা,	পনের,	
logotype,	লোগোইপে,	লোগোটাইপ,	
goshthiti,	গোষ্ঠীতি,	গোষ্ঠীটি,	
mirina,	মিরিনা,	মিরিনা,	
grushko,	গ্রুষ্কো,	গ্রুশকো,	
jamanataswarup,	জমনাতাস্বরূপ,	জামানতস্বরূপ,	
sadeena,	সদদীন,	সাডেন,	
procharjontrogulo,	প্রচার্ত্যরগগুলো,	প্রচারযন্ত্রগুলো,	
armshtronj,	আর্মস্টরর্জ,	আর্মস্ট্রং,	
apolokbhabe,	অপলকভাবে,	অপলকভাবে,	
spredsheet,	স্প্রেশশিট,	স্প্রেডশীট,	
chandrimaa,	চন্দ্রীমা,	চন্দ্রিমা,	
rajnoitik,	রাজনৈতিক,	রাজনৈতীক,	
maila,	মাইলা,	মাইল,	
ebhara,	এভারা,	এভার,	
gannaprakasham,	গণ্যপ্রকশশম,	গন্নাপ্রকাশম,	
prokolpoti,	প্রকল্পতি,	প্রকল্পটি,	
garora,	গারোরা,	গারোরা,	
bihar,	বিহার,	বিহার,	
pinglateo,	পিংলাটেও,	পিংলাতেও,	
poriikkhateo,	পরীক্ষাতেও,	পরীক্ষাতেও,	
muradkey,	মুরাদকে,	মুরাদকে,	
bossonte,	বসন্তে,	বসন্তে,	
aatto,	আট্টো,	আত্ম,	
spreedashita,	স্প্রীদশিত,	স্প্রেডশীট,	
deputy,	ডিপাটি,	ডেপুটি,	
ohalyar,	ওহাল্যার,	অহল্যার,	
nabotom,	নাবোম,	নবতম,	
salmaner,	সালমানের,	সালমানের,	
licensin,	লিইসেনিন,	লাইসেন্সিং,	
pharanyeta,	ফরণ্যেতা,	ফরম্যাট,	
bachhaikrito,	বাচাইকৃত,	বাছাইকৃত,	
lobbytey,	লবিটে,	লবিতে,	
cheess,	চিস,	চেস,	
bharotchilo,	ভারতচিলো,	ভারতছিল,	
fakhrul,	ফাখরুল,	ফাখরুল,	
lotharan,	লোথারান,	লুথেরান,	
anchalsaho,	অঞ্চলসহ,	অঞ্চলসহ,	
duple,	ডুপলে,	ডুপ্লে,	
siddhantoo,	সিদ্ধান্তও,	সিদ্ধান্তও,	
jounotar,	যৌনতার,	যৌনতার,	
yaak,	যাক,	ইয়াক,	
bm,	বিএমএ,	বিএম,	
shite,	শিতে,	শীতে,	
chikitshar,	চিকিৎশার,	চিকিত্সার,	
bupher,	বুফের,	বাফার,	
pyaleshtainer,	প্যালেশ্টাইনের,	প্যালেস্টাইনের,	
selim,	সেলিম,	সেলিম,	
manush,	মানুষ,	মানুষ,	
alraji,	আলরাজি,	আলরাজী,	
kartona,	কর্তনা,	করতনা,	
assexe,	অ্যাসেক্সে,	অ্যাসেক্সে,	
megh,	মেঘ,	মেঘ,	
thare,	থারে,	থরে,	
vaisoho,	ভাইসহ,	ভাইসহ,	
goolen,	গুলেন,	গুলেন,	
hooq,	হুক,	হুক,	
dijijer,	দিজিজের,	ডিজিজের,	
bhoolapuka,	ভূলাপুকা,	ভোলাপুক,	
argead,	আর্জড,	আর্জিদ,	
pleeta,	প্লিটা,	প্লেট,	
fatakasto,	ফতাকাস্ত,	ফাটাকেষ্ট,	
nederlande,	নেডারল্যান্ডে,	নেদারল্যান্ডে,	
pleena,	প্লিনা,	প্লেন,	
masjidsaho,	মাসজিদসহ,	মসজিদসহ,	
nutaner,	নুটানের,	নূতনের,	
saatzoner,	সাযজনের,	সাতজনের,	
geographics,	জিওগ্রেজিক্স,	জিওগ্রাফিকস,	
turista,	টুরিস্তা,	টুরিস্ট,	
sompadonkaree,	সম্পাদনকারী,	সম্পাদনকারী,	
amorendro,	অমর্নেদ্রো,	অমরেন্দ্র,	
haris,	হারিস,	হ্যারিস,	
abeganuvutir,	আবেগানুভূটির,	আবেগানুভূতির,	
sampadoner,	সম্পাদনের,	সম্পাদনের,	
gejetade,	জেজেটেড,	গেজেটেড,	
vange,	ভ্যাঙ্গে,	ভাঙ্গে,	
sotorkobhabey,	সতর্কভাবে,	সতর্কভাবে,	
damakalkarmirao,	দামাকল্্্মীরাও,	দমকলকর্মীরাও,	
societyke,	সোিযটেকে,	সোসাইটিকে,	
oiteejye,	ঐতিহ্যে,	ঐতিহ্যে,	
baarbadoj,	বার্বাদজ,	বার্বাডোজ,	
chalake,	চালাকে,	চালকে,	
ekghore,	একঘরে,	একঘরে,	
sutir,	সুতির,	সুতির,	
gaddaphii,	গাদদাফী,	গাদ্দাফী,	
yura,	যুরা,	ইউরো,	
suchonakal,	সূচনাকাল,	সূচনাকাল,	
cheerokoomari,	চিরকুমারী,	চিরকুমারী,	
chaudhurider,	চৌধুরীদের,	চৌধুরীদের,	
sompadon,	সম্পাদন,	সম্পাদন,	
jegulur,	জেগুলুর,	যেগুলুর,	
ekbakke,	একবাককে,	একবাক্যে,	
khuliechilam,	খুলিয়েছিলাম,	খুলিয়েছিলাম,	
antarbhutto,	অন্তর্ভুত্ব,	অন্তর্ভুক্ত,	
karu,	কারু,	কারু,	
drissoke,	দৃষ্ককে,	দৃশ্যকে,	
doloo,	দোলু,	ডলু,	
senabahineeow,	সেনাবাহীনহ,	সেনাবাহিনীও,	
karlei,	কারলেই,	করলেই,	
vaabnake,	ভব্নাকে,	ভাবনাকে,	
fatkabazare,	ফৎকাবাজারে,	ফাটকাবাজারে,	
lyaanding,	ল্যান্ডিং,	ল্যান্ডিং,	
cantan,	ক্যান্টান,	ক্যান্টন,	
obhaarbhiu,	ওভারভি,	ওভারভিউ,	
pratiyogitar,	প্রতিযোগিতার,	প্রতিযোগীতার,	
ghoor,	ঘুর,	ঘুর,	
groth,	গ্রোথ,	গ্রোথ,	
bhalobasar,	ভালোবাসার,	ভালোবাসার,	
irana,	ইরানা,	ইরান,	
highcommissionay,	হাইকম্মিশনেয়ান,	হাইকমিশনে,	
jibnagore,	জীবনগরে,	জীবননগর,	
scholarship,	স্কলারশিপ,	স্কলারশিপ,	
duiekdiner,	দুইকেদ্নিনের,	দুইএকদিনের,	
nirbaaho,	নির্বাহ,	নির্বাহ,	
coons,	কিনস,	কুনস,	
moorali,	মুরালি,	মুরলী,	
elakatite,	এলাকাটিতে,	এলাকাটিকে,	
modhumotii,	মধুমতিই,	মধুমতী,	
ummool,	উম্মুল,	উম্মুল,	
turkeyder,	টারকিইদের,	তুর্কিদের,	
ankanshilpe,	অঙ্কাঙ্শিল্পে,	অঙ্কনশিল্পে,	
kandy,	কান্ডি,	ক্যান্ডি,	
bipti,	বিপ্তি,	বিপ্তি,	
bikromei,	বিক্রমেই,	বিক্রমেই,	
parikha,	পরীখা,	পরিখার,	
toching,	টোচিং,	টোচিং,	
rajtantra,	রাজতন্ত্র,	রাজতন্ত্র,	
khiladirao,	খিলাদিরাও,	খিলাড়িরাও,	
tigre,	টাগ্রে,	টাইগার,	
sarjur,	সার্জুর,	সরযূর,	
poorohitra,	পোরহীত্র,	পুরোহিতরা,	
arthonitite,	অর্থনীতিতে,	অর্থনীতিতে,	
turkamena,	তুরকমেনা,	তুর্কমেন,	
chatrorai,	চাত্রোরাই,	ছাত্ররাই,	
shilpajata,	শিল্পজতা,	শিল্পজাত,	
greep,	গ্রিপ,	গ্রিপ,	
bhimsen,	ভীমসেন,	ভীমসেন,	
balithubar,	বালিতুবার,	বালিথুবার,	
giitikobita,	গীতিকিবতি,	গীতিকবিতা,	
sahocorje,	সহকর্যে,	সাহচর্যে,	
toler,	তোলের,	তালের,	
sahittopritite,	সাহিত্যপ্রিতে,	সাহিত্যপ্রীতিতে,	
kinto,	কিন্তো,	কিনত,	
duryogamoyee,	দুর্যোগাময়,	দুর্যোগময়ী,	
sakshatkarer,	সাক্ষতকারের,	সাক্ষাৎকারের,	
kadapaker,	কাড়াপাকের,	কড়াপাকের,	
neemitte,	নিমিত্তে,	নিমিত্তে,	
qirq,	কিরক,	কার্ক,	
elakatike,	এলাকাটিকে,	এলাকাটিকে,	
dorgaaho,	দরগাহা,	দরগাহ,	
saainyo,	সাইন,	সৈন্য,	
as,	এসিআ,	অস,	
mousumeo,	মৌসুমেও,	মৌসুমেও,	
lisense,	লিইসেন্স,	লাইসেন্স,	
jaadrel,	জাদ্রেল,	জাঁদরেল,	
procharona,	প্রচারনা,	প্রচারণা,	
kampita,	কামপিতা,	কম্পিত,	
drissoteer,	দৃষ্টতের,	দৃশ্যটির,	
nyeta,	ন্যাট,	ম্যাট,	
dormitory,	ডর্মটিরি,	ডরমিটরি,	
amarika,	আমারিকা,	আমেরিকা,	
ekshoti,	একশতি,	একশোটি,	
bonvumitey,	বনভুমিতে,	বনভূমিতে,	
siit,	সিত,	শীত,	
obosore,	অবসরে,	অবসরে,	
okritokarjo,	অক্রিতকর্য,	অকৃতকার্য,	
sontoshpur,	সন্তশপুর,	সন্তোষপুর,	
volapuk,	ভোলাপুক,	ভোলাপুক,	
protyokkhovabey,	প্রত্যক্ষভাবে,	প্রত্যক্ষভাবে,	
dhache,	ধাচে,	ধাঁচে,	
mulyayonsapekkhe,	মূল্যয়ননপ্যকেষে,	মূল্যায়নসাপেক্ষে,	
wishnu,	উইশনু,	বিষ্ণু,	
saalsa,	সালসা,	সালসা,	
machsoho,	মাছসহ,	মাছসহ,	
thailandshoho,	থাইলান্ডসহ,	থাইল্যান্ডসহ,	
taims,	তেইমস,	টাইমস্,	
ponchasjon,	পঞ্চাসজন,	পঞ্চাশজন,	
bisheshya,	বিশেষ্য,	বিশেষ্য,	
khargosher,	খরগোশের,	খরগোসের,	
emarjensi,	এমরজেনিসি,	এমার্জেন্সি,	
soomitrar,	সুমিত্রার,	সুমিত্রার,	
eupheike,	ইউফেইকে,	ইউফেইকে,	
soleel,	সোলিল,	সলিল,	
chal,	চাল,	চাল,	
beetloser,	বিটলোসের,	বিটলসের,	
silabhara,	সিলাভরা,	সিলভার,	
tongaa,	টঙ্গা,	টোঙ্গা,	
mercial,	মার্সিয়াল,	মার্শিয়াল,	
gazipur,	গজজিপুর,	গাজিপুর,	
goodamjato,	গুডামজাত,	গুদামজাত,	
ganoparibahaner,	গণপরিবাহানের,	গণপরিবহনের,	
shilver,	শিলভার,	সিলভার,	
abarte,	অবার্তে,	আবর্তে,	
erokomer,	এরকমের,	এরকমের,	
proshikkhane,	প্রশিক্ষণে,	প্রশিক্ষণে,	
bohoodin,	বহুদিন,	বহুদিন,	
supparak,	সুপ্রাক,	সুপ্পারক,	
bosano,	বসানো,	বসানো,	
muradpur,	মুরাদপুর,	মুরাদপুর,	
abhidhaner,	অভিধানের,	অভিধানের,	
kantajir,	কাঁটাজির,	কান্তজির,	
venus,	ভেনুস,	ভেনাস,	
murad,	মুরাদ,	মুরাদ,	
vodqa,	ভোক,	ভদকা,	
maail,	মাইল,	মাইল,	
binee,	বিনি,	বেনি,	
gaj,	গাজ,	গেজ,	
prokalpagulo,	প্রকল্পগুলো,	প্রকল্পগুলো,	
karadando,	কারাদান্ডো,	কারাদণ্ড,	
sulfatee,	সুলফাটি,	সালফেট,	
cholchhe,	চলছে,	চলছে,	
si,	সিআই,	এসআই,	
mathews,	মাযাভেয়াস,	ম্যাথিউস,	
heteler,	হেতেলের,	হেটেলের,	
ujobekeestan,	উজবেকিস্তান,	উজবেকিস্তান,	
israelbahini,	ইস্রালেবাহিনী,	ইস্রায়েলবাহিনী,	
uporitoler,	উপরিতলের,	উপরিতলের,	
muchlima,	মুছলিমা,	মুছলিমা,	
thaii,	থাই,	থাই,	
ingreziteo,	ইংরেজিতেও,	ইংরেজিতেও,	
shomser,	শোমসের,	সমশের,	
sthapanagulor,	স্থাপানগুলোর,	স্থাপনাগুলোর,	
tukroke,	তুকরকে,	টুকরোকে,	
khagen,	খাগেন,	খগেন,	
bhromoner,	ভ্রমণের,	ভ্রমণের,	
diibug,	দিয়ুগু,	ডিবাগ,	
dadapur,	দাদাপুর,	দাদাপুর,	
serup,	সেরুপ,	সেরূপ,	
latsaheb,	লাৎসাহেব,	লাটসাহেব,	
rokkhonabekkhoner,	রক্ষণাবেন্ষণের,	রক্ষণাবেক্ষণের,	
khudrokar,	ক্ষুদ্রকার,	ক্ষুদ্রকার,	
ixprission,	এক্সপ্রিশন,	এক্সপ্রেশন,	
bikretaara,	বিক্রেতারা,	বিক্রেতারা,	
remacri,	রিমারকি,	রেমাক্রী,	
riazuddin,	রিয়াজউদ্দিন,	রিয়াজউদ্দীন,	
diznee,	দিজনি,	ডিজনী,	
choudry,	চাউড্রি,	চৌধুরী,	
homsher,	হোমশের,	হোমসের,	
hadisti,	হাদিস্তি,	হাদিসটি,	
karmosansthan,	কর্মসংস্থান,	কর্মসংস্থান,	
khaaneker,	খানেকের,	খানেকের,	
asociatis,	অ্যাসিটিটিস,	এসোসিয়েটস,	
asamorik,	আসামরিক,	অসামরিক,	
dienes,	দাইনেস,	ডিএনএস,	
magrey,	ম্যাগরে,	ম্যাগ্রে,	
hajeerhatt,	হাজীরহাট,	হাজিরহাট,	
rinattak,	ঋণত্তক,	ঋনাত্মক,	
supreetira,	সুপ্রীতিরা,	সুপ্রীতিরা,	
dakteekiter,	ডাক্তিকেতের,	ডাকটিকিটের,	
shangkalonti,	শাঙ্কলনটি,	সংকলনটি,	
jonomukhi,	জনমুখী,	জনমুখী,	
chinito,	চিনিত,	চিনতো,	
rabo,	রাবো,	রব,	
canservatian,	ক্যানভারিস্যান,	কনসারভেশন,	
gondhe,	গণ্ধে,	গন্ধে,	
landey,	ল্যান্ডে,	ল্যান্ডে,	
akar,	আকার,	একার,	
chinto,	চিন্ত,	চিনতো,	
hepatetisa,	হেপাটিটিস,	হেপাটাইটিস,	
qanasarabheshana,	কাসারেশান,	কনসারভেশন,	
jothon,	যথন,	যথন,	
asabhya,	অসভ্য,	অসভ্য,	
titarer,	তিতারের,	তিতারের,	
osamanno,	ওসামান্ন,	অসামান্য,	
ekspression,	এক্সপ্রেশন,	এক্সপ্রেশন,	
charger,	চার্জের,	চার্জার,	
capsule,	ক্যাপসুলে,	ক্যাপ্সুল,	
osthisondhi,	অস্থিসন্ধি,	অস্থিসন্ধি,	
mekapgulo,	মেকাপগুলো,	মেকআপগুলো,	
mase,	মাসে,	মাসে,	
habathu,	হাবাথু,	হাবাথু,	
lettar,	লেট্টার,	লেটার,	
daltyagi,	দল্ত্যাগী,	দলত্যাগী,	
shektore,	শেকতরে,	সেক্টরে,	
drishi,	দৃষী,	দৃশ্যই,	
awrbit,	অর্বিট,	অরবিট,	
tricksguli,	ট্রিকসগুলি,	ট্রিকসগুলি,	
basakey,	বাসাকে,	বাসাকে,	
tyap,	ট্যাপ,	ট্যাপ,	
eduardo,	এডুয়ার্ডো,	এডুয়ার্দো,	
felto,	ফেল্টো,	ফেলত,	
sahozlabhbhatar,	সহলাবভাতার,	সহজলভ্যতার,	
bhogni,	ভগ্নি,	ভগ্নী,	
arthonitir,	অর্থনীতির,	অর্থনীতির,	
bhogno,	ভগ্ন,	ভগ্ন,	
halding,	হাল্ডিং,	হোল্ডিং,	
podarthobidder,	পদার্থবিদদের,	পদার্থবিদদের,	
jacksonke,	জ্যাকসনকে,	জ্যাকসনকে,	
baffer,	বাফার,	বাফার,	
samyuktha,	সমমুক্থ,	সামিউক্তা,	
kyatgarite,	ক্যাটগারিতে,	ক্যাটগারিতে,	
ateetkaale,	অতিতকালে,	অতীতকালে,	
kagbeni,	কাগবেনী,	কাগবেনি,	
artore,	আর্তরে,	আর্টরে,	
byomkesh,	ব্যমককেশ,	ব্যোমকেশ,	
gaichhe,	গাইছে,	গাইছে,	
majdur,	মাজদুর,	মজদুর,	
choudhurike,	চৌধুরীকে,	চৌধুরীকে,	
kalenga,	কালেঙ্গা,	কালেঙ্গা,	
chhanada,	ছানাড়া,	ছানাদা,	
andra,	আন্দ্রা,	আন্ড্রা,	
modelkey,	মোডেলকে,	মডেলকে,	
vins,	ভিন্স,	ভিন্স,	
gaichey,	গাইছে,	গাইছে,	
hukar,	হুকার,	হুকার,	
monchostho,	মন্চস্থ,	মঞ্চস্থ,	
yak,	যাকে,	ইয়াক,	
edic,	এডিক,	এডিক,	
jomoker,	জমকের,	জমকের,	
gandhariir,	গানধারীর,	গান্ধারীর,	
sikkhakromer,	শিক্ষাক্রমের,	শিক্ষাক্রমের,	
providere,	প্রভিদেরে,	প্রভাইডারে,	
palteche,	পাল্টেছে,	পাল্টেছে,	
keui,	কেউ,	কেউই,	
shikare,	শিকারে,	শিকারে,	
suparichiti,	সুপারিচিতি,	সুপরিচিতি,	
armstronz,	আর্মস্টরর্ন,	আর্মস্ট্রং,	
chorban,	চরবান,	চর্বন,	
ashiatic,	অশিয়াটিক,	এশিয়াটিক,	
nazranar,	নজররনার,	নাজরানার,	
drissogulote,	দৃষ্গগুলোতে,	দৃশ্যগুলোতে,	
sobrakomer,	সব্রাকমের,	সবরকমের,	
beila,	বেইলা,	বেইলা,	
houzgulite,	হাউজগুলিতে,	হাউজগুলিতে,	
jipiusamriddha,	জিপিমুস্দ্ধধ,	জিপিউসমৃদ্ধ,	
manatmulak,	মানতমূলক,	মানতমূলক,	
fishing,	ফিশিং,	ফিসিং,	
directorete,	ডিরেক্টরোট,	ডিরেক্টরেট,	
nibeditar,	নিবেদিতার,	নিবেদিতার,	
dormroome,	ডরমরমম,	ডর্মরুমে,	
kirke,	কিরকে,	কিরকে,	
ahong,	আহং,	অহং,	
bollov,	বল্লোভ,	বল্লভ,	
phutonta,	ফুটনটা,	ফুটন্ত,	
vishnuu,	বিশুনু,	বিষ্ণু,	
shikkhakram,	শিক্ষক্রম,	শিক্ষাক্রম,	
mosharroph,	মোশার্োফ,	মশাররফ,	
shubhag,	শুভাগ,	শুভাগ,	
nirbaho,	নির্বাহ,	নির্বাহ,	
bhramapraban,	ভ্রমপ্রবণ,	ভ্রমপ্রবণ,	
sthapona,	স্থাপনা,	স্থাপনা,	
uponeeshod,	উপনেষদ,	উপনিষদ,	
taitela,	তাইতেলা,	টাইটেল,	
addata,	আদ্দতা,	আড্ডাটা,	
ganochin,	গণচিন,	গণচীন,	
ancholgoolote,	অঞ্চলগুলোতে,	অঞ্চলগুলোতে,	
rifleksa,	রিফলেক্সা,	রিফ্লেক্স,	
phising,	ফিজিং,	ফিসিং,	
nabbata,	নব্বতা,	নাব্যতা,	
hosney,	হোসনে,	হোসনে,	
iqbalke,	ইকবালকে,	ইকবালকে,	
cs,	সিএস,	সিএস,	
ogovir,	অগভীর,	অগভীর,	
orunima,	ওরুণিমা,	অরুণিমা,	
biphal,	বিফাল,	বিফল,	
ekatto,	একাত্ত,	একাত্ব,	
doltyagi,	দলত্যাগী,	দলত্যাগী,	
bhugol,	ভুগোল,	ভূগোল,	
pratishthanik,	প্রতিষ্ঠানিক,	প্রাতিষ্ঠানিক,	
dobhaar,	দোভার,	ডোভার,	
abheedhaneek,	অভেধানীক,	অভিধানিক,	
nek,	নেক,	নেক,	
supplenza,	সাপ্লজেজা,	সাপলেঞ্জা,	
upobaasee,	উপবাসী,	উপবাসী,	
jeelyaand,	জিল্যান্ড,	জিল্যান্ড,	
ovinetar,	অভিনেতার,	অভিনেতার,	
ghenshei,	ঘেনশেই,	ঘেঁষেই,	
nikela,	নিকেলা,	নিকেল,	
sahapathike,	সহপাঠীকে,	সহপাঠীকে,	
shasyadi,	শস্যাদি,	শস্যাদি,	
mandondo,	মান্ডন্ড,	মানদণ্ড,	
kadakhonchar,	কাদাখোঁচার,	কাদাখোঁচার,	
marathi,	মারাথি,	মরাঠি,	
zeeland,	জিল্যান্ড,	জিল্যান্ড,	
video,	ভিডেও,	ভিডিয়োও,	
protistha,	প্রতিস্থা,	প্রতিষ্টা,	
annorup,	অন্নরূপ,	অন্যরূপ,	
somonnitobhabe,	সমন্নিতভাবে,	সমন্বিতভাবে,	
karmazog,	কর্মাজোগ,	কর্মযোগ,	
bodhir,	বোধীর,	বধির,	
kosambir,	কোসাম্বীর,	কোসাম্বীর,	
aniyantrita,	অনিয়ন্ত্রীত,	অনিয়ন্ত্রিত,	
chhayi,	ছায়ি,	ছাই,	
ponchashjon,	পঞ্চাশজন,	পঞ্চাশজন,	
samaveshke,	সমাভেশকে,	সমাবেশকে,	
marodeho,	মারোদেহো,	মরদেহ,	
veenish,	ভিনিশ,	ভেনিস,	
sathik,	সাথিক,	সঠিক,	
jonoikaa,	জোনকা,	জনৈকা,	
brittakare,	বৃত্তাকারে,	বৃত্তাকারে,	
sthitiko,	স্থিতিকও,	স্থিতিকো,	
shoriph,	সরীফ,	শরিফ,	
degreeo,	দিগ্রিও,	ডিগ্রিও,	
ukeliptas,	উউকেলিপ্টাস,	ইউক্যালিপ্টাস,	
oitijjha,	ঐতিয্,	ঐতিহ্য,	
antorvuktimulak,	অ্যান্টরভুটিমুলক,	অন্তর্ভুক্তিমূলক,	
kotibondhe,	কতিবন্ধে,	কটিবন্ধে,	
bbosonto,	ব্ববন্ত,	বসন্ত,	
karmojog,	কর্মযোগ,	কর্মযোগ,	
samajikotar,	সমাজিকতার,	সামাজিকতার,	
pinogbagke,	পিনোজবাগকে,	পিনগবাগকে,	
dombhoke,	দম্ভকে,	দম্ভকে,	
dokaanei,	দোকানেই,	দোকানেই,	
jitpur,	জিতপুরের,	জিতপুরের,	
fatakesto,	ফাতাকেস্ত,	ফাটাকেষ্ট,	
kalakushalir,	কালাকুশীলীর,	কলাকুশলীর,	
gajiipur,	গজিয়পুর,	গাজীপুর,	
nathivookteer,	নাথিভুক্তির,	নথিভুক্তির,	
boner,	বনের,	বনের,	
prachando,	প্রাচান্ড,	প্রচণ্ড,	
khalidkay,	খালিদকা,	খালিদকে,	
breq,	ব্রেক,	ব্রেক,	
bagicha,	বাগিচা,	বাগিচা,	
bhuushito,	ভৌষিত,	ভূষিত,	
kalki,	কালকি,	কালকি,	
kul,	কুল,	কুল,	
meghachchanno,	মেঘাচ্ছান্ন,	মেঘাচ্ছন্ন,	
oedipus,	ওডিপুস,	ইডিপাস,	
oitijhyotike,	ঐতিহ্যটিকে,	ঐতিহ্যটিকে,	
seniar,	সেনিয়ার,	সিনিয়র,	
alexanderke,	অ্যালেক্সান্ডারকে,	আলেকজান্ডারকে,	
hijri,	হিজরি,	হিজরী,	
andamana,	আন্দামনা,	আন্দামান,	
harja,	হার্জা,	হার্জ,	
loombinee,	লাম্বিন,	লুম্বিনী,	
karmasampadon,	কর্মসম্পাদন,	কর্মসম্পাদন,	
dito,	দিতো,	দিতো,	
tuni,	টুনি,	টুনি,	
tawnship,	তাউনশিপ,	টাউনশিপ,	
musabbirul,	মুসাববিরুল,	মুসাব্বিরুল,	
falasrutite,	ফলস্ুরিতে,	ফলশ্রুতিতে,	
habsi,	হাবসি,	হাবশী,	
asthishondhi,	অস্থিসন্ধি,	অস্থিসন্ধি,	
jeshtha,	জেশ্থা,	জ্যেষ্ঠা,	
ponchaashjon,	পঞ্চাশজন,	পঞ্চাশজন,	
dei,	দেই,	দিই,	
sangitanusthane,	সঙ্গীতানুষ্ঠানে,	সঙ্গীতানুষ্ঠানে,	
konistho,	কোনিষ্থ,	কনিষ্ঠ,	
ooporoshtho,	অপর্ষ্ঠ,	উপরস্থ,	
kash,	কাশ,	কাস,	
pyore,	প্যোরে,	পিওর,	
chakrapani,	চক্রপানি,	চক্রপানী,	
chintakarma,	চিন্তাকর্মা,	চিন্তাকর্ম,	
gyandas,	জ্ঞানদাস,	জ্ঞানদাস,	
breel,	ব্রিল,	ব্রিল,	
proshadhoner,	প্রশাধনের,	প্রসাধনের,	
shresthoshcho,	শ্রেষ্ঠশ্চ,	শ্রেষ্ঠশ্চ,	
somabeshti,	সমাবেষ্টি,	সমাবেশটি,	
vaticaner,	ভ্যাটিকেনের,	ভ্যাটিকানের,	
senabahinikey,	সেনাবাহিনীকে,	সেনাবাহিনীকে,	
suisharke,	সুইশারকে,	সুইশারকে,	
protisthan,	প্রতিষ্ঠান,	প্রতিষ্টান,	
setikey,	সেতিকে,	সেটিকে,	
bhikkharthe,	ভিক্ষার্থে,	ভিক্ষার্থে,	
hydrological,	হাইড্রোজিল্যাল,	হাইড্রোলজিক্যাল,	
soolke,	সুলকে,	শুল্কে,	
shloker,	শ্লোকার,	শ্লোকের,	
soorsa,	সুরসা,	সোর্স,	
kaathhaamaandu,	কথমানুন্ডু,	কাঠমান্ডু,	
orgho,	অর্ঘ,	অর্ঘ্য,	
dhaanche,	ধাছ্ছে,	ধাঁচে,	
uposhthit,	উপস্থিত,	উপস্থিত,	
jansha,	জনশা,	জন্স,	
santaa,	সান্তা,	সান্তা,	
nilfamarir,	নীলফারমীর,	নীলফামারীর,	
mukhomandal,	মুখমান্ডল,	মুখমণ্ডল,	
dakter,	ডাক্টার,	ডাকতের,	
anutpadanshil,	অনুতপাদনশীল,	অনুৎপাদনশীল,	
chokhwala,	চোখওয়ালা,	চোখওয়ালা,	
atwabishvashi,	অত্বব্যাশীশ,	আত্মবিশ্বাসী,	
aachhis,	আচিস,	আছিস,	
parinati,	পরিণাটি,	পরিণতি,	
peeri,	পিরি,	পেরি,	
phakay,	ফাকায়ে,	ফাকে,	
aakkas,	আক্কাস,	আককাস,	
shoori,	শুরী,	সুরি,	
bodhirta,	বোধিরটা,	বধিরতা,	
recondishon,	রেকন্িশন,	রিকন্ডিশন,	
attorkite,	অ্যাটরকিতে,	অতর্কিতে,	
sqirt,	স্কির্ট,	স্কার্ট,	
ramantika,	রামন্তিকা,	রোমান্টিক,	
ekghare,	একঘাে,	একঘরে,	
abhidhaanick,	অভিধানিক,	অভিধানিক,	
highcomissione,	হাইগমিশনে,	হাইকমিশনে,	
raagei,	রাগেই,	রাগেই,	
akkheperi,	অক্ষেপেরই,	আক্ষেপেরই,	
purple,	পুর্পলে,	পার্পেল,	
madhuree,	মধুরী,	মাধুরী,	
scuvi,	স্কাভি,	স্কুভি,	
vogno,	ভগ্ন,	ভগ্ন,	
nabyata,	নব্যতা,	নাব্যতা,	
pachak,	পাচাক,	পাচক,	
khaschandpur,	খাশচন্দপুর,	খাসচাঁদপুর,	
nirmolotaa,	নির্মলতা,	নির্মলতা,	
tistar,	তিস্তার,	তিস্তার,	
windows,	উইন্ডোয়াস,	উইন্ডোস,	
turbine,	টারবিন,	টারবাইন,	
infarmatian,	ইনফারমায়ান,	ইনফরমেশন,	
abhidhanick,	অভিধানিক,	অভিধানিক,	
onchalgulir,	অঞ্চলগুলির,	অঞ্চলগুলির,	
debete,	দেবেতে,	ডিবেট,	
beauby,	বিউবি,	বিউবি,	
ekjoge,	একযোগে,	একযোগে,	
dholeshwari,	ধলেশ্বরী,	ধলেশ্বরী,	
nottee,	নটি,	নোটটি,	
vushi,	ভুষি,	ভুষি,	
rockibul,	রকিবুল,	রকিবুল,	
jerusalemer,	জেরুসালেমের,	জেরুজালেমের,	
paramartha,	পরমার্থ,	পরমার্থ,	
humira,	হুমিরা,	হুমিরা,	
cholochchitrai,	চলচ্চিত্রায়,	চলচ্চিত্রই,	
kade,	কাদে,	কোড,	
chiraharit,	চিরাহারিত,	চিরহরিৎ,	
queri,	কোয়েরি,	কোয়েরি,	
bhittimul,	ভিত্তিমূল,	ভিত্তিমূল,	
thabai,	থাবাই,	থাবাই,	
zoubankal,	জৌবনকাল,	যৌবনকাল,	
ghotolen,	ঘোটলেন,	ঘটলেন,	
nichols,	নিচলস,	নিকলস,	
sabrakamer,	সব্রকমের,	সবরকমের,	
ekhate,	এখাতে,	একহাতে,	
kaferderke,	কাফেরদেরকে,	কাফেরদেরকে,	
neshadrabyer,	নেশারদ্ব্যের,	নেশাদ্রব্যের,	
darjiling,	দার্জিলিং,	দার্জিলিং,	
durgatsabe,	দুর্গাৎসবে,	দুর্গোৎসবে,	
prarthitao,	প্রার্থিতাও,	প্রার্থীতাও,	
bharatey,	ভারাতে,	ভারতে,	
degree,	ডিগ্রি,	ডিগ্রি,	
neck,	নেক,	নেক,	
remacry,	রিমার্কি,	রেমাক্রী,	
saptahokal,	সপ্তহাকাল,	সপ্তাহকাল,	
miraclee,	মিরাকলি,	মিরাকেল,	
janosamaj,	জনসমাজ,	জনসমাজ,	
saom,	সায়ামো,	সাওম,	
bhaibon,	ভাইবন,	ভাইবোন,	
bidyadanke,	বিদ্যাদানকে,	বিদ্যাদানকে,	
roy,	রয়ে,	রায়,	
graambaashee,	গ্রাম্বাশি,	গ্রামবাসী,	
dheke,	ধেকে,	ঢেকে,	
pranidero,	প্রাণীদেরও,	প্রানীদেরও,	
orrgho,	ওর্ঘ,	অর্ঘ্য,	
kale,	কালে,	কালে,	
shift,	শিফট,	শিফট,	
koordira,	কুরদিরা,	কুর্দিরা,	
granada,	গ্রানাদা,	গ্র্যানাডা,	
zarniz,	জার্জিজ,	জারনিজ,	
poddhotitei,	পদ্ধতিতেই,	পদ্ধতিতেই,	
saranor,	সরানোর,	সরানোর,	
elakaate,	এলাকাতে,	এলাকাতে,	
riphleksa,	রাফলেক্স,	রিফ্লেক্স,	
poribahokotto,	পরিবাহকত্ত,	পরিবাহকত্ব,	
jatotaa,	যাতোটা,	যতোটা,	
abheedhanic,	অভেধানিক,	অভিধানিক,	
rajpur,	রাজপুর,	রাজপুর,	
bojhe,	বোঝে,	বোঝে,	
sausagee,	সৌসাগী,	সসেজ,	
bosantake,	বসন্তাকে,	বসন্তকে,	
lagche,	লাগছে,	লাগছে,	
karaa,	কারা,	কারো,	
siddhantoke,	সিদ্ধান্তকে,	সিদ্ধান্তকে,	
joisttho,	জৈশ্ত্ত,	জ্যৈষ্ঠ,	
drissogulo,	দৃষ্গগুলো,	দৃশ্যগুলো,	
hariner,	হরিণের,	হরিণের,	
ganonanatto,	গণনানাট্,	গণনাট্য,	
songbadmadhyame,	সংবাদমধ্যমে,	সংবাদমাধ্যমে,	
peethey,	পিথে,	পীঠে,	
shtona,	স্তনা,	স্টোন,	
toufiq,	তুফিক,	তৌফিক,	
chrystal,	ক্রিস্টেল,	ক্রাইস্টাল,	
mele,	মেলে,	মাইল,	
deenesh,	দীনেশ,	দীনেশ,	
dufresne,	ডাফরেনে,	ডুফরেস্ন,	
oblivion,	ওবলাইজিন,	অবলিভিয়ন,	
shakara,	শাকারা,	সাকার,	
lambi,	লামবী,	লম্বি,	
themekey,	থেমেকে,	থিমকে,	
sollallhu,	সোল্লাল্লুহ,	সল্লাল্লাহু,	
aarmstrong,	আরমমস্ট্রং,	আর্মস্ট্রং,	
debdebyr,	ডেবডেবার,	দেবদেবীর,	
seebiai,	সীবিয়াই,	সিবিআই,	
gyada,	জ্ঞাদা,	গ্যাদা,	
aporishodhito,	অপরিষোধিত,	অপরিশোধিত,	
navaratri,	নাভারট্রী,	নবরাত্রি,	
uparzoner,	উপারজনের,	উপার্জনের,	
jini,	জিনি,	যিনি,	
indrani,	ইন্দ্রানী,	ইন্দ্রাণী,	
parjotaker,	পার্যতাকের,	পর্যটকের,	
achintopurer,	অচিন্তপুরের,	অচিন্তপুরের,	
jamjomat,	জমজমাত,	জমজমাট,	
dibate,	দিবাতে,	ডিবেট,	
ji,	জিয়,	জি,	
tooku,	তুকু,	টুকু,	
hool,	হুল,	হুল,	
fising,	ফিসিং,	ফিসিং,	
bidhirnityang,	বিধির্তিযাং,	বিধির্নিত্যং,	
talaal,	তালাল,	তালাল,	
bhyatikaner,	ভ্যাতিকানের,	ভ্যাটিকানের,	
choshon,	চোষণ,	চোষণ,	
holdim,	হোল্ডিং,	হোল্ডিং,	
carbus,	কার্বাস,	কারবাস,	
shapad,	শাপাদ,	শ্বাপদ,	
bishesyo,	বিশেষ্য,	বিশেষ্য,	
boudher,	বৌধের,	বৌদ্ধের,	
bage,	বাগে,	বাগে,	
edaning,	এডানিং,	ইদানিং,	
jhamala,	ঝামালা,	ঝামালা,	
buddhitii,	বুদ্ধিতিই,	বুদ্ধিটিই,	
saazano,	সাজানো,	সাজানো,	
moushumei,	মৌশুমেই,	মৌসুমেই,	
dai,	দায়,	ডে,	
popaike,	পোপাইকে,	পপাইকে,	
drabyatah,	দ্রা্যতঃ,	দ্রব্যতঃ,	
kod,	কোদ,	কোড,	
ceramicer,	সেরামিয়ার,	সিরামিকের,	
mojlish,	মোজলিশ,	মজলিশ,	
dhalur,	ধলুর,	ঢালুর,	
nomo,	নোমো,	নমো,	
sip,	সিপ,	শিপ,	
shudden,	শুদ্দেন,	সাডেন,	
kaloniir,	কালোনীর,	কালনীর,	
chorchita,	চরচচিতা,	চর্চিত,	
bisshasyi,	বিশ্ষা্য,	বিশ্বাসই,	
madraser,	মাদ্রাসের,	মাদ্রাজের,	
oncholshomuher,	অঞ্চলসূহের,	অঞ্চলসমূহের,	
lishenshe,	লিশেনশে,	লাইসেন্স,	
horiddar,	হরিদ্দার,	হরিদ্বার,	
starker,	স্টারকার,	স্টার্কের,	
afrazuler,	আফরাজুলের,	আফরাজুলের,	
teksuser,	টেক্সুসের,	টেক্সাসের,	
deebug,	দীবুগ,	ডিবাগ,	
heepatitis,	হিপাটিটিস,	হেপাটাইটিস,	
mayily,	মেয়িলি,	মাইলি,	
bikargrasta,	বিকারগ্রস্ত,	বিকারগ্রস্ত,	
dubaate,	দুবাতে,	ডুবাতে,	
varma,	ভারমা,	ভার্মা,	
nagorikkey,	নাগরীককে,	নাগরিককে,	
nabatamo,	নাবাতোমো,	নবতম,	
grambaaseeder,	গ্রাম্বাসাইডার,	গ্রামবাসীদের,	
cinematographar,	সিনেমাগোর্টাফার,	সিনেমাটোগ্রাফার,	
swatantrata,	স্বতন্ত্রতা,	স্বতন্ত্রতা,	
postar,	পোস্টার,	পোস্টের,	
sarollo,	সারললো,	সারল্য,	
chai,	চায়,	ছাই,	
shasheja,	শাশেজা,	সসেজ,	
atarkitey,	অতারকিতে,	অতর্কিতে,	
vabaponno,	ভবপান্ন,	ভাবাপন্ন,	
tikta,	টিকটা,	তিক্ত,	
hughkey,	হুঘকে,	হিউজকে,	
adhyatmikata,	অধ্যাম্মিতা,	আধ্যাত্মিকতা,	
somsher,	সমশের,	সমশের,	
lyandim,	ল্যান্ডিং,	ল্যান্ডিং,	
milton,	মিলটন,	মিলটন,	
oncholtee,	অঞ্চলটি,	অঞ্চলটি,	
cbi,	সিবিআই,	সিবিআই,	
huka,	হুকা,	হুক,	
deputee,	ডেপুটি,	ডেপুটি,	
daayitto,	দায়িত্ব,	দায়িত্ব,	
notikotar,	নটিকতার,	নৈতিকতার,	
noditei,	নোড়িতেই,	নদীতেই,	
mahibur,	মহিবুর,	মহিবুর,	
ghoshanapatratio,	ঘোষণাপত্রটিও,	ঘোষণাপত্রটিও,	
turbiner,	টার্বিনের,	টারবাইনের,	
nikate,	নিকাতে,	নিকটে,	
gurmukh,	গুরমুখ,	গুরমুখ,	
vobanipur,	ভবানীপুর,	ভবানীপুর,	
nirgomon,	নির্গমন,	নির্গমন,	
ancholtike,	অ্যাঞ্চলটিকে,	অঞ্চলটিকে,	
kalnir,	কালনির,	কালনীর,	
gaphiloti,	গাফিলতি,	গাফিলতি,	
chilahaati,	চিলাহাটি,	চিলাহাটি,	
browser,	ব্রাউজের,	ব্রাউজার,	
laishensh,	লৈশেংশ,	লাইসেন্স,	
urey,	উরে,	ইউরি,	
gaandaas,	গ্যান্ডাস,	জ্ঞানদাস,	
mitroder,	মিত্রদের,	মিত্রদের,	
shibraj,	শিবরাজ,	শিবরাজ,	
siima,	সিয়ামা,	সীমা,	
taunasipa,	তৌনসীপা,	টাউনশিপ,	
townshhip,	টাউনশিপ,	টাউনশিপ,	
charukala,	চরুকালা,	চারুকলা,	
nirbahey,	নির্বাহে,	নির্বাহে,	
tokee,	তোকি,	তকি,	
bishnoo,	বিষ্ণও,	বিষ্ণু,	
madhnagar,	মধ্গর,	মাধনগরের,	
qonflict,	কনফ্লিক্ট,	কনফ্লিক্ট,	
mukhyo,	মুখ্য,	মুখ্য,	
andon,	আ্যানডডন,	আন্দোন,	
aakik,	আকিক,	আকিক,	
niknayman,	নিক্নয়মণ,	নিকনেইমান,	
thyachara,	থিয়াচারা,	থ্যাচার,	
nobotomo,	নবতম,	নবতম,	
yucalyptus,	যুচল্যাপিটাস,	ইউক্যালিপ্টাস,	
naabbota,	নাব্বতা,	নাব্যতা,	
prothati,	প্রথাটি,	প্রথাটি,	
harbore,	হারবরে,	হারবারে,	
rajotwo,	রাজত্ব,	রাজত্ব,	
sohokari,	সোহাারী,	সহকারী,	
mentither,	মেন্টিথের,	মেনটিথের,	
kaferder,	কাফেরদের,	কাফেরদের,	
bagdad,	বাগদাদ,	বাগদাদে,	
sharthe,	শার্থে,	স্বার্থে,	
elahabade,	এলাহাবাদে,	এলাহাবাদে,	
basab,	বাসব,	বাসাব,	
fasir,	ফাসির,	ফাসীর,	
codeti,	কোদেটি,	কোডটি,	
bhabanir,	ভবানীর,	ভবানীর,	
firozaa,	ফিরোজা,	ফিরোজা,	
rajbondir,	রাজবন্দির,	রাজবন্দীর,	
ghomtaa,	ঘোমটা,	ঘোমটা,	
flirt,	ফ্লির্ট,	ফ্লার্ট,	
somonwitobhabey,	সমন্বিতভাবে,	সমন্বিতভাবে,	
sangkalanti,	সংকলানটি,	সংকলনটি,	
gujab,	গুজাব,	গুজব,	
blyaka,	ব্ল্যাক,	ব্ল্যাক,	
chitronattakar,	চিত্রনাত্তকর,	চিত্রনাট্যকার,	
taholo,	তাহোলো,	তাহলো,	
durgatsob,	দুর্গাতসব,	দুর্গোৎসব,	
shekender,	শেকেন্দের,	সেকেন্ডের,	
eesosiyeetasa,	এসসিয়েতাসা,	এসোসিয়েটস,	
paab,	পাব,	পাব,	
bhiktara,	ভিকটারা,	ভিক্টর,	
aireshe,	আইরেশে,	আইরেসে,	
mukhabandha,	মুখাবন্ধা,	মুখবন্ধ,	
chalachchitroke,	চালাচ্ছিত্রকে,	চলচ্চিত্রকে,	
chamski,	চ্মাসকি,	চমস্কি,	
nothibhukto,	নথিভুক্ত,	নথিভুক্ত,	
dhhaabi,	ঢাবি,	ঢাবি,	
sausage,	সৌগাগে,	সসেজ,	
sumita,	সুমিতা,	সুমিতা,	
talgachh,	তালগাছ,	তালগাছ,	
kei,	কেই,	কেই,	
heart,	হার্ট,	হার্ট,	
caroline,	ক্যারোলিন,	ক্যরোলিন,	
aaeerese,	আই়েরেস,	আইরেসে,	
torutoler,	তরুতলের,	তরুতলের,	
ashonkai,	আশোককাই,	আশঙ্কাই,	
madhabike,	মাধাবীকে,	মাধবীকে,	
standards,	স্ট্যান্ডার্ডসহ,	স্টান্ডার্ডস,	
krisenter,	ক্রিসেন্টের,	ক্রিসেন্টের,	
protizogiita,	প্রতিযোগিতা,	প্রতিযোগীতা,	
internship,	ইন্টারশনপপ,	ইন্টার্নশিপ,	
bayii,	বায়ি,	বাঈ,	
pratisthanikvabe,	প্রতিষ্ঠানিভভাবে,	প্রাতিষ্ঠানিকভাবে,	
chhootochhuti,	ছুটোচুটি,	ছুটোছুটি,	
tarunra,	তরুনরা,	তরুণরা,	
ajeeboner,	আজিবনের,	আজীবনের,	
bahubar,	বাহুবার,	বহুবার,	
obosan,	অবসান,	অবসান,	
chargar,	চার্গার,	চার্জার,	
purohitra,	পুরোহিত্র,	পুরোহিতরা,	
torunra,	তরুনরা,	তরুণরা,	
patochitra,	পাতচিত্র,	পটচিত্র,	
catholicbad,	ক্যাথোলিব্ডাড,	ক্যাথলিকবাদ,	
naazi,	নাজি,	নাত্সি,	
bhutbhut,	ভূটভুত,	ভুটভুট,	
ajuhath,	অজুহাথ,	অজুহাত,	
guha,	গুহা,	গোহ,	
probhritike,	প্রভৃতিকে,	প্রভৃতিকে,	
dekaner,	দেকানের,	দেকানের,	
sangsakti,	সংসক্তি,	সংসক্তি,	
prime,	প্রাইম,	প্রাইম,	
aranyani,	অরণ্যাণী,	অরণ্যানী,	
dristiheen,	দৃষ্টিহীন,	দৃষ্টিহীন,	
hames,	হ্যামস,	হোমস,	
dorneca,	ডর্নেকা,	ডরনেকা,	
graminphonor,	গ্রামিংফোনোর,	গ্রামীণফোনর,	
shikara,	শিকারা,	শিকার,	
shurugulo,	শুরুগুলো,	শুরুগুলো,	
pujito,	পুজিত,	পুজিত,	
susamo,	সুসামো,	সুসম,	
naabyota,	নব্যতা,	নাব্যতা,	
nirgoon,	নিরগুন,	নির্গুণ,	
moshzidtike,	মোশজিদটিকে,	মসজিদটিকে,	
dhanijomite,	ধনিজমিতে,	ধানিজমিতে,	
grambaasheeo,	গ্রামবাশীও,	গ্রামবাসীও,	
byaboharkarir,	ব্যবহারকারীর,	ব্যবহারকারীর,	
rahshahi,	রাহশাহী,	রাহশাহী,	
barrageke,	ব্রারেজে,	ব্যারেজকে,	
kajangale,	কাজঙ্গলে,	কজঙ্গলে,	
ahalyar,	আহাল্যার,	অহল্যার,	
rahi,	রাহি,	রাহী,	
kk,	কেএক,	কেকে,	
sheetke,	শেতকে,	শীতকে,	
ganosochetonota,	গণশোচতেনতা,	গণসচেতনতা,	
capsul,	ক্যাপসুল,	ক্যাপসুল,	
adhunikkaley,	অধুনীকালে,	আধুনিককালে,	
hazat,	হাজাত,	হজত,	
ghetu,	ঘেটু,	ঘেটু,	
helloin,	হেলোইন,	হ্যালোইন,	
oncoleo,	অনকোলেও,	অঞ্চলেও,	
chalochchitraeer,	চালচচিত্রীর,	চলচ্চিত্রের,	
yatharthabhabe,	যাথার্থভাবে,	যথার্থভাবে,	
musallati,	মুসালতা,	মুসল্লাটি,	
sohinsotar,	সোহিনসতার,	সহিংসতার,	
baarnis,	বার্নিস,	বার্নিশ,	
kani,	কানি,	কানি,	
rohosyo,	রোহস্য,	রহস্য,	
ghotleyo,	ঘোটলেও,	ঘটলেও,	
diniphition,	ডিনিফিশন,	ডেফিনেশন,	
nirdesika,	নির্দেসিকা,	নির্দেশিকা,	
poschime,	পশচিমে,	পশ্চিমে,	
votarer,	ভোতারের,	ভোটারের,	
nutoner,	নুটনের,	নূতনের,	
somraat,	সমরাত,	সম্রাট,	
nirbahe,	নির্বাহে,	নির্বাহে,	
nick,	নিক,	নিক্,	
gabhaaskar,	গভাস্কার,	গাভাস্কার,	
notti,	নটটি,	নোটটি,	
orbit,	অরবিট,	অরবিট,	
bondhuvabaponyo,	বন্ধুভাবান্য,	বন্ধুভাবাপন্ন,	
bhaisaho,	ভাইসহ,	ভাইসহ,	
photanor,	ফোটানোর,	ফোটানোর,	
nariderke,	নারিদেরকে,	নারীদেরকে,	
groundta,	গ্রান্ডটা,	গ্রাউন্ডটা,	
ajij,	আজিজ,	আজিজ,	
rotheen,	রথীন,	রথীন,	
kaleo,	কালেও,	কালেও,	
fand,	ফ্যান্ড,	ফান্ড,	
rata,	রাতা,	রত,	
ghotol,	ঘোটল,	ঘটল,	
sthapanar,	স্থাপানার,	স্থাপনার,	
station,	স্টেশন,	ষ্টেশন,	
prasadhoner,	প্রাসাধনের,	প্রসাধনের,	
kobulennechha,	কোবুলেনেছা,	কবুলেন্নেছা,	
orthoneeti,	অর্থনীতি,	অর্থনীতির,	
udor,	উদর,	উদর,	
gorjon,	গর্জন,	গর্জন,	
gratha,	গ্রাথা,	গ্রোথ,	
eevil,	ইভিল,	ইভিল,	
satarkatar,	সতরকাটার,	সতর্কতার,	
muchi,	মুচি,	মুচি,	
deeares,	দিরেস,	ডিআরএস,	
minister,	মিনিস্টার,	মিনিস্টার,	
mugdha,	মুগধা,	মুগ্ধ,	
dhila,	ধিলা,	ঢিলা,	
kyathlik,	ক্যাথলিক,	ক্যাথলিক,	
jhonkar,	ঝোঁকার,	ঝঙ্কার,	
samanyai,	সামা্যই,	সামান্যই,	
majlishpur,	মজলিশপুর,	মজলিশপুর,	
bishwaashshoi,	বিশ্বাশ্যই,	বিশ্বাসই,	
shommotir,	শম্মটির,	সম্মতির,	
elgoridom,	এলগরিমম,	এলগরিদম,	
plusey,	প্লাসে,	প্লাসে,	
spancer,	স্পেন্সের,	স্পেন্সার,	
kurdider,	কুরদিদের,	কুর্দিদের,	
ovidhaner,	অভিধানের,	অভিধানের,	
bornanukrome,	বর্ণানুক্রমে,	বর্নানুক্রমে,	
goonoman,	গুণমান,	গুণমান,	
prajanankal,	প্রজানকাল,	প্রজননকাল,	
obhijojan,	অভিযোজন,	অভিযোজন,	
sbaajan,	স্বাজন,	স্বজন,	
robot,	রবট,	রোবোট,	
hosne,	হোসনে,	হোসনে,	
somraatder,	সমরাতদের,	সম্রাটদের,	
panchadadu,	পঞ্চাদাদু,	পঞ্চাদাদু,	
abhirupbabuke,	অভিরূপবাবুকে,	অভিরূপবাবুকে,	
taranee,	তারানী,	তরণী,	
saramukhe,	সরমাখুখে,	সারামুখে,	
shahidputra,	শহিদপুত্র,	শহীদপুত্র,	
oporishodhito,	অপরিষধিত,	অপরিশোধিত,	
jolbe,	জলবে,	জ্বলবে,	
jesh,	জেশ,	জেস,	
cholochchitrer,	চলচ্চিত্রের,	চলচ্চিত্রের,	
chandanara,	চণ্দনারা,	চন্দনারা,	
ganochien,	গণচিয়েন,	গণচীন,	
nirmol,	নির্মল,	নির্মল,	
madhuri,	মধুরী,	মাধুরী,	
bisnuke,	বিসনুকে,	বিষ্ণুকে,	
azaan,	আজান,	আজান,	
durotamo,	দূরতামো,	দূরতম,	
teunar,	তেউনার,	টিউনার,	
shansthagulo,	শানসথথগুলো,	সংস্থাগুলো,	
olympik,	অলিম্পিক,	অলিম্পিক,	
agamane,	আগামানে,	আগমনে,	
chikitsanirbhar,	চিকিৎস্নরীভর,	চিকিৎসানির্ভর,	
suhayeler,	সুহায়েলের,	সুহায়েলের,	
hojurer,	হজুরের,	হজুরের,	
kuthibarike,	কুথিবারিকে,	কুঠিবাড়ীকে,	
gyandaas,	জ্ঞান্ডাস,	জ্ঞানদাস,	
dacope,	ড্যাকোপে,	দাকোপ,	
mercedes,	মার্সডেস,	মার্সেডেস,	
uddhritto,	উদ্ধৃত্ত,	উদ্ধৃত,	
dharabahiktite,	ধারাবাহিতটিতে,	ধারাবাহিকটিতে,	
chokrantosoho,	চক্রান্তসহ,	চক্রান্তসহ,	
shucharita,	শুচারিতা,	সুচরিতা,	
residensa,	রেসিডেনসা,	রেসিডেন্স,	
ajijer,	আজিজের,	আজিজের,	
freelancerra,	ফ্রিল্যান্সরের,	ফ্রিল্যান্সাররা,	
matthews,	ম্যাভেভাস,	ম্যাথিউস,	
foks,	ফকস,	ফক্স,	
nogore,	নগরে,	নগরে,	
vimsen,	ভিমসেন,	ভীমসেন,	
erajyobasi,	এরাজ্যবাসী,	এরাজ্যবাসী,	
bibechyo,	বিবেচ্য,	বিবেচ্য,	
kanasharabheshhana,	কাশররভেষণ,	কনসারভেশন,	
antercticker,	অ্যান্টারক্টকের,	অ্যান্টার্কটিকের,	
prodiiper,	প্রোডিইপার,	প্রদীপের,	
huqa,	হুকা,	হুক,	
prijon,	প্রিজন,	প্রিজন,	
shatokeo,	শাতকেও,	শতকেও,	
byathapather,	ব্যথাপথের,	ব্যথাপথের,	
alankorana,	আলঙ্করণা,	অলঙ্করণ,	
nischitvabe,	নিশ্চিতভাবে,	নিশ্চিতভাবে,	
nepchooner,	নেফচুনের,	নেপচুনের,	
militarite,	মিলিতারিতে,	মিলিটারিতে,	
chalaabi,	চালাবি,	চালাবে,	
remakri,	রেমারকি,	রেমাক্রী,	
songasthatike,	সংস্থাটিকে,	সংস্থাটিকে,	
rajotta,	রাজত্তা,	রাজত্ব,	
rushad,	রুশাদ,	রুশদ,	
rubala,	রুবালা,	রুবল,	
hansasya,	হাঁসস্য,	হংসস্য,	
shikshakbrindo,	শিক্ষাবৃন্দ,	শিক্ষকবৃন্দ,	
geejeeteeda,	গিজেতি,	গেজেটেড,	
bboponer,	ব্বপনের,	বপনের,	
elaakati,	এলাকাটি,	এলাকাটি,	
eexpreession,	এক্সপ্রিশন,	এক্সপ্রেশন,	
maailey,	মাইলে,	মাইলে,	
narishwar,	নরীশ্বর,	নারীশ্বরের,	
bhaandar,	ভান্দার,	ভাণ্ডার,	
manushera,	মনুশেরা,	মানুষেরা,	
akten,	আকতেন,	অকটেন,	
faaj,	ফাজ,	ফাজ,	
michhilti,	মিছিলটি,	মিছিলটি,	
bisheshyo,	বিশেষ্য,	বিশেষ্য,	
nirabota,	নিরাবতা,	নিরবতা,	
mukhobondho,	মুখবন্ধ,	মুখবন্ধ,	
myari,	ম্যারি,	ম্যারি,	
jiland,	জিল্যান্ড,	জিল্যান্ড,	
fevarite,	ফেভারিতে,	ফেভারিট,	
naagaalyand,	নাগালযান্দ,	নাগাল্যান্ড,	
krisenta,	ক্রিসেন্টা,	ক্রিসেন্ট,	
parisankhanbid,	পরিসংখানবিদ,	পরিসংখ্যানবিদ,	
dekhso,	দেখসো,	দেখসো,	
transform,	ট্রান্সফর্ম,	ট্রান্সফর্ম,	
bisheshshyo,	বিশেষ্ষ্য,	বিশেষ্য,	
morathee,	মোরাথি,	মরাঠি,	
jamaanor,	জামানোর,	জমানোর,	
chasee,	চাসী,	চেস,	
blacker,	ব্ল্যাকার,	ব্ল্যাকের,	
mexicoteo,	মেক্সিকোটেও,	মেক্সিকোতেও,	
lutheerana,	লুথীরন,	লুথেরান,	
conflict,	কনফ্লিক্ট,	কনফ্লিক্ট,	
associatis,	অ্যাসোসিটিসিস,	এসোসিয়েটস,	
phund,	ফুন্ড,	ফান্ড,	
qaro,	কারো,	কারো,	
minishtarer,	মিনিষ্টারের,	মিনিস্টারের,	
antarctica,	অ্যান্টার্ক্টিকা,	অ্যান্টার্কটিকা,	
bulano,	বুলানো,	বুলান,	
rajbandir,	রাজবন্দির,	রাজবন্দীর,	
brake,	ব্রাকে,	ব্রেক,	
ispredseet,	ইসপ্রেডসিট,	স্প্রেডশীট,	
totokhon,	ততখোন,	ততক্ষন,	
bhabatarini,	ভবতারিণী,	ভবতারিণী,	
footbalarer,	ফুটবালারের,	ফুটবলারের,	
bharotiyotar,	ভারতীয়তার,	ভারতীয়তার,	
obdi,	ওব্দি,	অব্দি,	
azin,	আজিন,	আজিন,	
dharavassokar,	ধারাবাস্কার,	ধারাভাষ্যকার,	
bishshasho,	বিশ্ষাষো,	বিশ্বাসও,	
sangbadmadhyomgulote,	সংবাদমাধ্যগুলোতে,	সংবাদমাধ্যমগুলোতে,	
bolbo,	বলবো,	বলবো,	
sanaktakaran,	সানাক্তরণ,	সনাক্তকরণ,	
zerusalemer,	জেরুসালের,	জেরুজালেমের,	
daaoon,	দাও,	ডাউন,	
shourshe,	শৌর্ষে,	সোর্স,	
abdan,	আবদান,	আব্দান,	
tarkale,	তারকালে,	তারকালে,	
umb,	উমমিবি,	ইউএমবি,	
gonjona,	গঞ্জনা,	গঞ্জনা,	
jerusaleme,	জেরুসালেমে,	জেরুসালেমে,	
horiddare,	হরিদ্দারে,	হরিদ্বারে,	
hafsa,	হাফসা,	হাফসা,	
sobche,	সবছে,	সবচে,	
tecno,	টেকনো,	টেকনো,	
treebhuj,	ত্রিভুজ,	ত্রিভূজ,	
cloring,	ক্লারিং,	ক্লোরিং,	
dip,	দিপ,	দীপ,	
dipon,	দিপন,	দীপন,	
nichupattir,	নিচুপাট্তির,	নিচুপট্টির,	
hafej,	হাফেজ,	হাফেয,	
rohasyer,	রোহাস্যের,	রহস্যের,	
asamonjasyopurno,	অসম্জনযোপনসূর্ণ,	অসামঞ্জস্যপূর্ণ,	
jor,	জোর,	জ্বর,	
dhormoprobortokder,	ধর্মপ্রবর্ত্ের,	ধর্মপ্রবর্তকদের,	
kottar,	কোট্টার,	কট্টর,	
evaner,	এভানের,	ইভানের,	
jerusalema,	জেরুসলেমা,	জেরুসালেম,	
neemeetto,	নিমিত্ত,	নিমিত্ত,	
kheshar,	খেশার,	খেশার,	
quata,	কোয়াত,	কোটা,	
siqh,	সিক,	শিখ,	
tiunara,	তিউনারা,	টিউনার,	
nagorikra,	নাগরিকরা,	নাগরিকেরা,	
shiropar,	শিরোপার,	শিরোপার,	
karadandey,	কারাদান্ডে,	কারাদণ্ডে,	
kichutei,	কিছুটেই,	কিছুতেই,	
ghoomachhe,	ঘুমাছে,	ঘুমাচ্ছে,	
mukhya,	মুখ্যা,	মুখ্য,	
bibhinno,	বিভিন্ন,	বিভন্ন,	
chaalkee,	চালকি,	চালকে,	
bo,	বোআই,	বু,	
hoteltite,	হোটেলটটিট,	হোটেলটিতে,	
gotirodh,	গতিরোধ,	গতিরোধ,	
lagto,	লাগতো,	লাগতো,	
suparichito,	সুপারিচিত,	সুপরিচিত,	
welaqama,	ওয়েলামা,	ওয়েলকাম,	
grooth,	গ্রুথ,	গ্রোথ,	
dhandu,	ধন্ডু,	ধন্দু,	
karaponner,	কারাপণ্নের,	কারাপণ্যের,	
mesenjjar,	মেসেঞ্জজার,	মেসেঞ্জার,	
sahojatprobritti,	সহজাপত্রবৃত্তি,	সহজাতপ্রবৃত্তি,	
panchbar,	পাঁচবার,	পাঁচবার,	
utsahi,	উৎসাহী,	উৎসাহী,	
hitokor,	হিতকর,	হিতকর,	
koordider,	কুরদিদের,	কুর্দিদের,	
mathieu,	মাথিয়ু,	ম্যাথিউ,	
ghotaibe,	ঘোটাইবে,	ঘটাইবে,	
bodhirota,	বোধীরতা,	বধিরতা,	
paner,	পানের,	পানের,	
gajano,	গাজানো,	গজানো,	
chemjong,	চেমজং,	চেমজং,	
jhanjra,	ঝাঁজরা,	ঝাঁজরা,	
unitgulo,	আউনিটগুলো,	ইউনিটগুলো,	
qarlosa,	কারলোসা,	কার্লোস,	
fud,	ফুদ,	ফুড,	
bondhukey,	বন্ধুকে,	বন্ধুকে,	
shuchonakal,	শুচনাকাল,	সূচনাকাল,	
kisti,	কিস্তি,	কিস্তি,	
ardasho,	আর্দাশো,	আর্দশ,	
shahanara,	শাহানারা,	শাহানারা,	
neerbahe,	নির্বাহে,	নির্বাহে,	
doneta,	ডোনেটা,	ডোনাট,	
plate,	প্ল্যাট,	প্লেটে,	
bouddha,	বৌদ্ধ,	বৌদ্ধ,	
shahoshikatar,	শহসিকতার,	সাহসিকতার,	
pretty,	প্রেটি,	প্রিটি,	
asovarno,	অসভার্ণ,	অসবর্ণ,	
khanabale,	খানাবালে,	খানাবলে,	
kazianis,	কাজিয়ানিস,	কাজানিস,	
senabahinio,	সেনাবাহিনিও,	সেনাবাহিনীও,	
shingping,	শিংপিং,	শিংপিং,	
keyboarder,	কেবোর্ডার,	কীবোর্ডের,	
choudhursoho,	চৌধুরসহ,	চৌধুরসহ,	
crime,	ক্রাইম,	ক্রাইম,	
scholastik,	স্কলস্তিক,	স্কলাস্টিক,	
landin,	ল্যান্ডিন,	ল্যান্ডিং,	
sikara,	সিকারা,	শিকার,	
torabgonj,	তোরাবগঞ্জ,	তোরাবগঞ্জ,	
gonona,	গণনা,	গননা,	
aqram,	আকরাম,	আকরাম,	
mitrata,	মিত্রাটা,	মিত্রতা,	
debate,	দেবাতে,	ডিবেট,	
jalarong,	জালারং,	জলরঙ,	
sondhisthaponer,	সন্ধিষ্ঠাপনের,	সন্ধিস্থাপনের,	
soundarja,	সৌন্দর্য,	সৌর্ন্দয্য,	
mausumer,	মৌসুমের,	মৌসুমের,	
kaathhmaandute,	কাঠমানদুতে,	কাঠমান্ডুতে,	
elakatir,	এলাকাটির,	এলাকাটির,	
whole,	হোল,	হোল,	
skolarsip,	স্কলারসিপ,	স্কলারশিপ,	
rubidiyaam,	রুবিদিয়াম,	রুবিডিয়াম,	
purbanchaler,	পূর্বঞ্চলের,	পূর্বাঞ্চলের,	
kortam,	কোরতাম,	করতাম,	
ekoirokom,	এককোরকম,	একইরকম,	
bongsho,	বংশ,	বংশ,	
bapio,	বাপিও,	বাপিও,	
boudhher,	বৌধের,	বৌদ্ধের,	
ghotleo,	ঘোটলেও,	ঘটলেও,	
omeettrakkhor,	অমিত্রাক্ষর,	অমিত্রাক্ষর,	
shilbar,	শিলবার,	সিলভার,	
airish,	আইরিশ,	আইরিস,	
beshyasdone,	বেশ্যাসদনে,	বেশ্যাসদনে,	
paolasthi,	পাওলাস্থি,	পাওলাসথি,	
uthe,	উঠে,	উঠে,	
seshardhe,	সেশার্ধে,	শেষার্ধে,	
heavy,	হিভি,	হেভি,	
danab,	দানাব,	দানব,	
deenes,	দিনেস,	দীনেশ,	
maryir,	মার্যির,	ম্যারির,	
bipradas,	বিপ্রদাস,	বিপ্রদাস,	
qonfliqt,	কনফ্লিক্ট,	কনফ্লিক্ট,	
arshie,	আরশি,	আরসিএ,	
innahu,	ইন্নাহু,	ইন্নাহু,	
atwobishvashi,	অত্ববিশ্ছাসী,	আত্মবিশ্বাসী,	
nisader,	নিসাদের,	নিষাদের,	
nirvaha,	নির্ভাহ,	নির্বাহ,	
rezidence,	রেজিডেন্সে,	রেসিডেন্স,	
nagorikke,	নাগরীককে,	নাগরিককে,	
sambatsarkal,	সম্বাৎসরকাল,	সম্বৎসরকাল,	
bhebechili,	ভেবেছিলি,	ভেবেছিলি,	
abosan,	অবসান,	অবসান,	
ralf,	রালফ,	রালফ,	
musalmani,	মুসলমানি,	মুসলমানই,	
bandhan,	বাঁধান,	বাঁধন,	
kaalengaa,	কালেঙ্গা,	কালেঙ্গা,	
bairey,	বাইরে,	বাইরে,	
palbongsher,	পালবংশের,	পালবংশের,	
joones,	জুনেস,	জোন্স,	
bbiswash,	বিবিশ্বাশ,	বিশ্বাস,	
ganoporibahon,	গণপরিবাহন,	গণপরিবহন,	
kekru,	কেকরু,	কেকরু,	
chikkingsasoho,	চিক্কিংসাসহ,	চিকিংসাসহ,	
siddhanter,	সিদ্ধান্তের,	সিদ্ধান্তের,	
dadar,	দাদার,	দাদার,	
shasonamoleri,	শাসনামলেরই,	শাসনামলেরই,	
sudrishya,	সুদৃশ্য,	সুদৃশ্য,	
purborekorde,	পূর্বরেকর্ডে,	পূর্বরেকর্ডে,	
nirikh,	নিরিখ,	নিরিখ,	
azimpur,	আজিমপুর,	আজিমপুর,	
shpredshiit,	স্প্রেশশিত,	স্প্রেডশীট,	
mitrota,	মিত্রতা,	মিত্রতা,	
jhalkanite,	ঝালকানিতে,	ঝলকানীতে,	
shef,	শেফ,	শেফ,	
anagarikra,	অনাগরীকরা,	অনাগরিকরা,	
jhimochchilo,	ঝিমচ্ছিল,	ঝিমোচ্ছিলো,	
gorrer,	গোরের,	গোরের,	
bhabaaponno,	ভাবাপন্ন,	ভাবাপন্ন,	
sanghar,	সংঘর,	সংহার,	
prosadhaner,	প্রসাধানের,	প্রসাধনের,	
armashtram,	অর্মশত্রম,	আর্মস্ট্রং,	
ruble,	রাবলে,	রুবল,	
byatikrami,	ব্যতিক্রমী,	ব্যতিক্রমী,	
setike,	সেটিকে,	সেটিকে,	
onker,	অঙ্কার,	ওঙ্কার,	
neelfamarir,	নীল্লারারীর,	নীলফামারীর,	
muhuriganj,	মুহুরীজ্ঞা,	মুহুরীগঞ্জ,	
madhobeer,	মাধবীর,	মাধবীর,	
gasthi,	গা্্থি,	গোষ্ঠী,	
touraat,	তুরাত,	তওরাত,	
nyata,	ন্যাতা,	ম্যাট,	
turkii,	তুরকি,	তুর্কি,	
biswashi,	বিশ্বাশী,	বিশ্বাসী,	
monzooshree,	মঞ্জশুরী,	মঞ্জুশ্রী,	
aalaa,	আলা,	আলা,	
palbongser,	পালবংসের,	পালবংশের,	
songasthatir,	সংগ্ষাঠির,	সংস্থাটির,	
ghurte,	ঘুর্তে,	ঘুরতে,	
geja,	গেজা,	গেজ,	
mette,	মেটে,	ম্যাট,	
rajtantrey,	রাজতন্ত্রে,	রাজতন্ত্রে,	
argho,	আরঘো,	অর্ঘ্য,	
sharansthal,	শরানসথল,	শরণস্থল,	
aanaan,	আনান,	আনান,	
cholchhee,	চলছছি,	চলছে,	
manober,	মানবের,	মানবের,	
rakhete,	রাখেতে,	রাখেতে,	
drissogoolote,	দৃষ্গগুলোতে,	দৃশ্যগুলোতে,	
inafarameshana,	ইনাফারেশন,	ইনফরমেশন,	
meropenemer,	মেরোপানেমের,	মেরোপেনেমের,	
jarmaniteo,	জারমানিতেও,	জার্মানিতেও,	
itostatah,	ইতস্তাথা,	ইতস্ততঃ,	
oitijje,	ঐতিহ্যে,	ঐতিহ্যে,	
mozdoor,	মজদুর,	মজদুর,	
pravura,	প্রভুরা,	প্রভুরা,	
daltagi,	ডাল্টাগি,	দলত্যাগী,	
monjooshree,	মঞ্জশুরী,	মঞ্জুশ্রী,	
horippur,	হরিপপুরের,	হরিপুর,	
rokibul,	রোিবুল,	রকিবুল,	
meshmeshya,	মেশমেশ্য,	মেশহমেশহিইয়া,	
choritrotakeo,	চরিত্রতাকেও,	চরিত্রটাকেও,	
registrikrito,	রেজিস্ট্রিক্ত,	রেজিস্ট্রীকৃত,	
dii,	দিয়,	দিই,	
uddhrito,	উদ্ধৃত,	উদ্ধৃত,	
myat,	ম্যাট,	ম্যাট,	
byepass,	ব্যাপাস,	বাইপাস,	
asif,	আসিফ,	আসিফ,	
armori,	আরমমি,	আরমোরি,	
dep,	ডিপ,	ডেপ,	
angshogrohon,	অংশগ্রহণ,	অংশগ্রহন,	
muktijuddhojato,	মুক্তিযুদ্ধোধাত,	মুক্তিযুদ্ধজাত,	
dhanyi,	ধনন্যী,	ধন্যি,	
antennal,	অ্যান্টেনন,	অ্যান্টেনাল,	
odeb,	ওদেব,	ওদেব,	
foxcon,	ফক্সকোন,	ফক্সকন,	
annanere,	আন্নানেরে,	অন্যানেরে,	
serveray,	সারভারে,	সার্ভারে,	
anubhutimalar,	অনুভূতিমালার,	অনুভূতিমালার,	
adorso,	আদরসস,	আর্দশ,	
bishshaasho,	বিশ্ষাশো,	বিশ্বাসও,	
danata,	দানাটা,	ডোনাট,	
autopromotioner,	অটোপ্রোমেশনের,	অটোপ্রমোশনের,	
oshtader,	অষ্টাদের,	ওস্তাদের,	
homshke,	হোমশকে,	হোমসকে,	
mulvitti,	মুলভিত্তি,	মূলভিত্তি,	
remission,	রিমিশন,	রিমিশন,	
timoothi,	তিমুথি,	টিমোথি,	
shootar,	শূতার,	শ্যুটার,	
heena,	হিনা,	হেনা,	
orbeet,	অরবিট,	অরবিট,	
esasiyetasa,	এসাইয়েটাসা,	এসোসিয়েটস,	
byatari,	ব্যতারি,	ব্যাটারী,	
flexta,	ফ্লেক্সটা,	ফ্লেক্সটা,	
musolmanera,	মুসলমানেরা,	মুসলমানেরা,	
shamuker,	শামুকের,	শামুকের,	
stana,	স্তানা,	স্টোন,	
stoonahenja,	স্তুনেনজ্জা,	স্টোনহেঞ্জ,	
cheento,	চিন্ত,	চিনতো,	
shem,	শেম,	সেম,	
madhukori,	মধুকরি,	মাধুকরী,	
firalem,	ফিরালেম,	ফিরালেম,	
samajik,	সমাজিক,	সামাজিক,	
lutherana,	লুথেরানা,	লুথেরান,	
apad,	আপাদ,	আপদ,	
welcome,	ওয়েকমে,	ওয়েলকাম,	
addabaj,	আদ্ডাবাজ,	আড্ডাবাজ,	
roktokhoron,	রক্তখরণ,	রক্তক্ষরণের,	
shit,	শিত,	শীত,	
harbare,	হারবারে,	হারবারে,	
tookror,	টুকরোর,	টুকরোর,	
reshmirekha,	রেশমিরেখা,	রেশমীরেখা,	
byaptikaler,	ব্যাপতিকালের,	ব্যাপ্তিকালের,	
heawy,	হিউভি,	হেভি,	
salapheeta,	সালাফিটা,	সালফেট,	
bite,	বিটে,	বাইট,	
tiger,	টিগের,	টাইগার,	
deaubande,	ডেউব্যান্ডে,	দেওবন্দে,	
gonesher,	গোেষের,	গণেশের,	
ayantarqatiqa,	আয়ন্ত্রকতিক,	অ্যান্টার্কটিকা,	
siddhante,	সিদ্ধান্তে,	সিদ্ধান্তে,	
sharoker,	শারকের,	স্মারকের,	
chirkoot,	চিরকুট,	চিরকুট,	
abikaul,	অবিকুল,	অবিকল,	
shkalarashhipa,	স্কালাষাশিপ,	স্কলারশিপ,	
bojiye,	বোজিয়ে,	বজিয়ে,	
prashikkhane,	প্রশিক্ষণে,	প্রশিক্ষণে,	
saria,	সারিয়া,	সরিয়া,	
longhan,	লংহান,	লংঘন,	
rakshanbhag,	রক্ষণভাগ,	রক্ষণভাগ,	
manushsoho,	মানুষসহ,	মানুষসহ,	
mandarbani,	মন্দরবানী,	মন্দারবাণী,	
probhuder,	প্রভুদের,	প্রভুদের,	
wrighter,	ভৃগটার,	রাইটের,	
corsin,	করসিন,	করসিন,	
vesselli,	ভেসেলি,	ভেসেলি,	
sachetanvabe,	সচেতনভাবে,	সচেতনভাবে,	
hizriite,	হিজরিতে,	হিজরীতে,	
europia,	ইউরোপিয়া,	ইউরোপিয়া,	
protibedokrao,	প্রতিবেদকরাও,	প্রতিবেদকরাও,	
flux,	ফ্লাক্স,	ফ্লাস্ক,	
dinifitian,	ডিনিফিয়ান,	ডেফিনেশন,	
daap,	ডাপ,	ড্যাপ,	
amiya,	আমিয়া,	অমিয়,	
ekatitto,	একাতিত্ব,	একাতিত্ব,	
bishaashke,	বিশাসকে,	বিশ্বাসকে,	
rupert,	রুপার্ট,	রুপার্ট,	
anchalgoolir,	অঞ্চলগুলির,	অঞ্চলগুলির,	
laatimer,	লাতিমের,	লাটিমের,	
durbhagya,	দুর্ভাগ্য,	দূর্ভাগ্য,	
wodka,	ওয়াডকা,	ভদকা,	
agomone,	আগমনে,	আগমনে,	
fastara,	ফাস্টারা,	ফস্টার,	
temone,	তেমোন,	তেমনই,	
aaps,	এপিএসএস,	এএপিএস,	
ashamarthita,	অশামর্থিতা,	অসমর্থিত,	
himsrot,	হিমস্রোট,	হিমস্রোত,	
cholochchitrake,	চলচ্চিত্রাকে,	চলচ্চিত্রকে,	
punorabortonte,	পুনরাবর্তন্তে,	পুনরাবর্তন্তে,	
sahab,	সাহাব,	সাহাব,	
palta,	পালতা,	পালটা,	
ispredsheet,	ইসপ্রেডশিত,	স্প্রেডশীট,	
ddheela,	ঢিলা,	ঢিলা,	
tottorat,	তত্তরাত,	তওরাত,	
lidars,	লিডার্স,	লিডার্স,	
nariider,	নারিদের,	নারীদের,	
miitar,	মিইতার,	মিত্র,	
title,	টিটলে,	টাইটেল,	
nimnosakkharkari,	নিম্নাসক্ষাকারী,	নিম্নস্বাক্ষরকারী,	
jamseder,	জামসেদের,	জামসেদের,	
badargaji,	বাদারগাজী,	বদরগাজী,	
romjaner,	রোমজানের,	রমযানের,	
veniser,	ভেনিসের,	ভেনিসের,	
aziboner,	আজিবনের,	আজীবনের,	
nazad,	নাজাদ,	নজদ,	
gamdan,	গ্যামডান,	গামদান,	
jeshh,	জেশ,	জেস,	
chhatrodiger,	ছাত্রদিগের,	ছাত্রদিগের,	
asbab,	আসিবাব,	আসবাব,	
bosben,	বসবেন,	বসবেন,	
polashir,	পলাশির,	পলাশীর,	
aalkatraa,	আলকাত্রা,	আলকাতরা,	
chiroharit,	চিরোহারিত,	চিরহরিৎ,	
simantarkkhibahinir,	সীমান্তক্রনিভাষীরীর,	সীমান্তরক্ষীবাহিনীর,	
kada,	কাদা,	কোডা,	
horidbar,	হরিদবার,	হরিদ্বার,	
armshtrong,	আর্মস্ট্রং,	আর্মস্ট্রং,	
husni,	হুসনি,	হুসনি,	
badaghat,	বাডঘাট,	বাদাঘাট,	
purbancoler,	পুরবান্লোকের,	পূর্বাঞ্চলের,	
nobotom,	নবতম,	নবতম,	
jansa,	জানসা,	জন্স,	
oichchheek,	ঐচ্ছিক,	ঐচ্ছিক,	
porobortii,	পরবর্তিই,	পরর্বতী,	
jontropatigulite,	যন্ত্রপাগুলিতে,	যন্ত্রপাতিগুলিতে,	
furio,	ফুরিও,	ফুরিও,	
byaboharkareer,	ব্যবহারকারীর,	ব্যবহারকারীর,	
nothibhukteer,	নথিভুক্তির,	নথিভুক্তির,	
bohudin,	বহুদিন,	বহুদিন,	
soinyo,	সৈন্য,	সৈন্য,	
xpose,	এক্সপোপে,	এক্সপোজ,	
chittronatyokar,	চিত্রন্যত্তকর,	চিত্রনাট্যকার,	
dembakreeti,	দেম্বকৃতি,	ডিম্বাকৃতি,	
daaun,	ডাউন,	ডাউন,	
vromonkaley,	ভ্রমণকালে,	ভ্রমণকালে,	
chakradhare,	চকরাধারে,	চক্রধরে,	
ganoporibahoner,	গণপরিবাহণের,	গণপরিবহনের,	
contemporary,	কন্টেমপ্রারি,	কন্টেম্পোরারি,	
bhotomulyoke,	ভতমুল্যকে,	ভোটমূল্যকে,	
omkar,	ওমকার,	ওঙ্কার,	
sikkhakbrinda,	শিক্ষাবৃন্দ,	শিক্ষকবৃন্দ,	
ramnathbabur,	রামনাথবাবুর,	রামনাথবাবুর,	
horeepur,	হরিপুর,	হরিপুর,	
palkee,	পালকি,	পাল্কি,	
nilkuthir,	নীলকুঠির,	নীলকুঠির,	
bonke,	বনকে,	বনকে,	
sima,	সিমা,	সীমা,	
dantahin,	দানতাহীন,	দন্তহীন,	
nowel,	নোয়েল,	নভেল,	
habshi,	হাবশি,	হাবশী,	
domonmulok,	দমনমুলক,	দমনমূলক,	
surke,	সুরকে,	সুরকে,	
anektai,	অনেকটাই,	অনেকটাই,	
chhedon,	ছেড়ন,	ছেদন,	
daakticketer,	ডাক্টিকটের,	ডাকটিকিটের,	
arifin,	আরিফিন,	আরিফিন,	
shukrabab,	শুক্রবাব,	শুক্রবাব,	
conservetion,	কনসারভেশন,	কনসারভেশন,	
sorsa,	সোরসা,	সোর্স,	
taalaal,	তালাল,	তালাল,	
sinaake,	সিনাকে,	সিনাকে,	
ranangane,	রানাঙ্গানে,	রণাঙ্গনে,	
inziniyarsa,	ইনজিনিয়ারসস,	ইঞ্জিনিয়ার্স,	
munim,	মুনিম,	মুনিম,	
utpotti,	উৎপত্টি,	উতপত্তি,	
byaboharkarike,	ব্যবহারকারীকে,	ব্যবহারকারীকে,	
maudelti,	মাউদেলটি,	মডেলটি,	
anhu,	আনহা,	আনহু,	
chalachchitroi,	চালচ্ছিত্রই,	চলচ্চিত্রই,	
nagorikra,	নাগরিকরা,	নাগরিকরা,	
dhangsantup,	ধাংসান্তূপ,	ধ্বংসন্তুপ,	
phutanta,	ফুটান্টা,	ফুটন্ত,	
dhamshrenite,	ধামশ্রেনিতে,	ধামশ্রেণীতে,	
deraa,	দেরি,	ডেরা,	
jund,	জান্ড,	জুন্দ,	
wilderske,	উইলডারসে,	উইল্ডার্সকে,	
dooburir,	দুবুরীর,	ডুবুরির,	
lajik,	লাজিক,	লজিক,	
taufiq,	তাউফিক,	তৌফিক,	
prrajanankaal,	প্রজানকাল,	প্রজননকাল,	
calabe,	ক্যালাবে,	চালাবে,	
chintamani,	চিন্তামানি,	চিন্তামনি,	
khelechen,	খেলেছেন,	খেলেছেন,	
pustir,	পুস্তির,	পুষ্টির,	
taroni,	তারোনি,	তরণী,	
samany,	সামানি,	সামান্য,	
sedikei,	সেদিকেই,	সেদিকেই,	
rayyaleti,	রয়়েলেতি,	রয়্যালটি,	
neelkamal,	নীলকমলল,	নীলকমল,	
maradeha,	মারাদেহা,	মরদেহ,	
spashtotai,	স্পাষ্টতায়,	স্পষ্টতই,	
ghatiti,	ঘটিটি,	ঘাঁটিটি,	
kathmandu,	কথ্মন্ডু,	কাঠমান্ডু,	
thyachar,	থিয়াচার,	থ্যাচার,	
vool,	ভুল,	উল,	
dolphiny,	ডলফিনি,	ডলফিনি,	
jotota,	জোতা,	যতোটা,	
smarak,	স্মারক,	স্মারক,	
peerry,	পিরি,	পেরি,	
durgotsabe,	দুর্গৎসাে,	দুর্গোৎসবে,	
graambaaseeder,	গ্রাম্বাসাইডার,	গ্রামবাসীদের,	
juboke,	যুবকে,	যুবকে,	
panchashjan,	পঞ্চশগান,	পঞ্চাশজন,	
somoodrotote,	সমাদ্রততে,	সমুদ্রতটে,	
anisa,	অনিসা,	আনিস,	
dara,	দারা,	দারা,	
ongshogrohoner,	অংশগ্রহণের,	অংশগ্রহনের,	
haripur,	হরিপুর,	হরিপুর,	
mehsus,	মেহিসাস,	মেহসুস,	
militarir,	মিলিতারীর,	মিলিটারির,	
gabinius,	গবিনিয়াস,	গাবিনিআস,	
prokolpow,	প্রকল্পু,	প্রকল্পও,	
shunani,	শুনানী,	শুনানী,	
soomita,	সুমিতা,	সুমিতা,	
peeth,	পিথ,	পীঠ,	
protiakromonei,	প্রতিয়াকর্মনেই,	প্রতিআক্রমণেই,	
hossne,	হোসনে,	হোসনে,	
neshnosh,	নেশ্নশ,	নেশনস,	
attacharito,	অত্তাচরিত,	অত্যাচারিত,	
colgirl,	কোলগার্ল,	কলগার্ল,	
dephinishion,	ডিফিনিশন,	ডেফিনেশন,	
bishnu,	বিষ্ণু,	বিষ্ণু,	
licensedhari,	লিইসেন্েধারী,	লাইসেন্সধারী,	
bojhey,	বোঝে,	বোঝে,	
bhejaano,	ভেজানো,	ভেজানো,	
volivoler,	ভলিভলের,	ভলিভলের,	
audiotike,	অডিওটিকে,	অডিওটিকে,	
graambashee,	গ্রাম্বাশি,	গ্রামবাসী,	
chakundite,	চাকুন্ডিতে,	চাকুন্দিতে,	
tep,	টেপ,	ট্যাপ,	
fastag,	ফাস্টাগ,	ফ্যাসট্যাগ,	
ujobekeestaner,	উজবেকিস্তানের,	উজবেকিস্তানের,	
prokolpogulikei,	প্রকল্পগুলিকেই,	প্রকল্পগুলিকেই,	
moddhyoshtho,	মধ্যশ্থ,	মধ্যস্থ,	
sanghitar,	সংহীতার,	সংহিতার,	
site,	সিটে,	সিটে,	
asommoti,	অসম্মতি,	অসম্মতি,	
bonshi,	বনশি,	বংশী,	
armeeniyana,	আর্মিনীয়ন,	আর্মেনিয়ান,	
byaboharkariyi,	ব্যবহারকারী,	ব্যবহারকারীই,	
milekhanek,	মিলেখানেক,	মাইলখানেক,	
paikgachha,	পাইকগাছা,	পাইকগাছা,	
deciliter,	ডিকিলিটের,	ডেসিলিটার,	
fitarsaho,	ফিতারসহ,	ফিতরসহ,	
icelands,	আইসেল্যান্স,	আইসল্যান্ডসহ,	
thechar,	থেচার,	থ্যাচার,	
suraaropito,	সুরাপরিপত,	সুরারোপিত,	
shamijir,	শামিজীর,	স্বামীজীর,	
probhur,	প্রভুর,	প্রভুর,	
boshoborti,	বশবর্তী,	বশবর্তী,	
shchalastik,	স্লালাস্টিক,	স্কলাস্টিক,	
musalmanderke,	মুসলমান্ডরকে,	মুসলমানদেরকে,	
seoul,	সেওল,	সোল,	
breakthrough,	ব্রেক্চুর্োচ,	ব্রেকথ্রু,	
phaltu,	ফাল্তু,	ফালতু,	
magar,	মাগার,	মাগার,	
modele,	মোদেলে,	মডেলে,	
review,	রিভিউ,	রিভিউও,	
chikitsar,	চিকিতসার,	চিকিত্সার,	
koota,	কুতা,	কোটা,	
nodiiteyi,	নোদিয়েই,	নদীতেই,	
dalee,	ডালি,	ডালে,	
vittiteo,	ভিত্টিতেও,	ভিত্তিতেও,	
faskari,	ফাসকারী,	ফাঁসকারী,	
elakasoho,	এলাকাসহ,	এলাকাসহ,	
ekbakye,	একবাক্যে,	একবাক্যে,	
chhooti,	ছুটি,	ছুটি,	
direectoratee,	ডিরিক্টররটিট,	ডিরেক্টরেট,	
shringge,	শ্রিঙ্গে,	শৃঙ্গে,	
bossoben,	বস্ববেন,	বসবেন,	
prokolpotike,	প্রকল্পতিকে,	প্রকল্পটিকে,	
uporzon,	উপর্জন,	উপার্জন,	
bisnukey,	বিসনুকে,	বিষ্ণুকে,	
naper,	নাপের,	ন্যাপের,	
korley,	করলে,	করলে,	
abti,	অবিটি,	আবতি,	
onucheeder,	অনুচিদের,	অনুচ্ছেদের,	
manushti,	মানুষ্টি,	মানুষটি,	
rajan,	রাজান,	রাজন,	
beatleser,	বিটলেসের,	বিটলসের,	
deobonde,	দেওবন্ডে,	দেওবন্দে,	
kourabe,	কৌরবে,	কৌরবে,	
teennis,	টিনিস,	টেনিস,	
tigmanshu,	তিগমানশু,	তিগ্মাংশু,	
safiha,	সাফিহা,	সাফিহা,	
baipass,	বাইপাস,	বাইপাস,	
prapokkey,	প্রাপক্কে,	প্রাপককে,	
akkhunno,	অক্ষুণ্য,	অক্ষুণ্ণ,	
bonobhumi,	বনভূমি,	বনভূমি,	
arg,	আর্গ,	আর্গ,	
faltu,	ফালতু,	ফালতু,	
chhooteete,	ছুটিতে,	ছুটিতে,	
bheenisa,	ভিনিসা,	ভেনিস,	
chalachchitra,	চালচচিত্র,	চলচ্চিত্র,	
graambasider,	গ্রাম্বাসীদের,	গ্রামবাসীদের,	
karir,	কারির,	কারীর,	
boikalyo,	বৈকাল্য,	বৈকল্য,	
baugey,	বাউগে,	বাগে,	
corymb,	করিম্ব,	করিম,	
tolemyr,	টোলমির,	টলেমির,	
aholya,	আহল্যা,	অহল্যা,	
ameettrakkhor,	অমিত্রাক্ষর,	অমিত্রাক্ষর,	
hugeke,	হুগেকে,	হিউজকে,	
pathanatak,	পাথানতাক,	পথনাটক,	
jibonnogor,	জীবন্গগর,	জীবননগর,	
sures,	সুরেস,	সুরেশ,	
utshahomulok,	উৎসাহমূলক,	উৎসাহমূলক,	
vushito,	ভুষিত,	ভূষিত,	
oindrila,	ঐন্দ্রিলা,	ঐন্দ্রিলা,	
seekkhaou,	সিক্াও,	শিক্ষাও,	
tapdei,	তাপদেই,	তাপড়েই,	
aholyar,	আহল্যার,	অহল্যার,	
cheef,	চিফ,	শেফ,	
sikkharrtheerao,	শিক্ষার্থীরাও,	শিক্ষার্থীরাও,	
aajeej,	আজিজ,	আজিজ,	
behrampurer,	বেহরামপুরের,	বহরমপুরের,	
disposes,	ডিস্পোস,	ডিসপোজেস,	
bopoon,	বোপুন,	বপন,	
bejiye,	বেজিয়ে,	বেজিয়ে,	
roopdaan,	রূপদান,	রুপদান,	
elaakaate,	এলাকাতে,	এলাকাতে,	
nodiitei,	নোড়িতেই,	নদীতেই,	
kleentoner,	ক্লিন্টনের,	ক্লিনটনের,	
provur,	প্রভুর,	প্রভুর,	
kuresher,	কুরেশের,	কুরেশের,	
harees,	হরিস,	হ্যারিস,	
jumlalancer,	জামলান্যান্সের,	জুমলাল্যান্সার,	
shoodhooi,	শুধোই,	শুধুই,	
abdoone,	আবদুনে,	আবদুন,	
transformaarer,	ট্রান্সফোরমায়ার,	ট্রান্সফরমারের,	
ikbaaler,	ইকবালের,	ইকবালের,	
dhyanastha,	ধ্যানস্থ,	ধ্যানস্থ,	
juktarashtrasaha,	যুক্তরত্রসহ,	যুক্তরাষ্ট্রসহ,	
tochhnochh,	তচ্ছো,	তছনছ,	
bhenise,	ভেনিসে,	ভেনিসে,	
vangley,	ভ্যাং্গলে,	ভাঙলে,	
masjidti,	মাসজিতটি,	মসজিদটি,	
laaishenshh,	লাইশেন্শ,	লাইসেন্স,	
daaktikit,	ডাক্তিকিত,	ডাকটিকিট,	
shikkhadikkhay,	শিক্ষাদিক্ষায়,	শিক্ষাদিক্ষায়,	
prakalpatike,	প্রকালপাটিকে,	প্রকল্পটিকে,	
monohputo,	মনোহপুত,	মনঃপুত,	
chalochchitraeei,	চালচচিত্রায়েই,	চলচ্চিত্রেই,	
pare,	পারে,	পাড়ে,	
bostubad,	বস্তুবাদ,	বস্তুবাদ,	
habol,	হাবল,	হাবোল,	
progresh,	প্রগ্রেশ,	প্রগ্রেস,	
matt,	ম্যাট,	ম্যাট,	
kirti,	কির্তি,	কীর্তি,	
atmabishvashi,	আত্মবিশাষী,	আত্মবিশ্বাসী,	
teta,	টেত,	টেটা,	
aamontrito,	আমন্ত্রিত,	আমন্ত্রিত,	
langhaner,	লাংহানের,	লংঘনের,	
laiseensee,	লেসেনসি,	লাইসেন্স,	
taderek,	তাদেরেক,	তাদেরেক,	
konroop,	কোনরূপ,	কোনরূপ,	
ganaparibahan,	গণপরিবাহন,	গণপরিবহন,	
shikshakbrinda,	শিক্ষাবৃন্দ,	শিক্ষকবৃন্দ,	
bishasey,	বিশাসে,	বিশ্বাসে,	
probeshan,	প্রবেশান,	প্রবেশন,	
gaujano,	গৌজানো,	গজানো,	
ponero,	পনেরও,	পনের,	
meridiane,	মেরিডিয়ানে,	মেরিডিয়ানে,	
bayshorkarikarone,	বাবর্ষিকরণেে,	বেসরকারিকরণ,	
upobasher,	উপবাশের,	উপবাসের,	
superheiroo,	সুপারহিরও,	সুপারহিরো,	
pratiyogita,	প্রতিয়গীতা,	প্রতিযোগীতা,	
niketon,	নিকেতন,	নিকেতন,	
abhijitda,	অভিজিতদা,	অভিজিতদা,	
boshoborty,	বশবর্তী,	বশবর্তী,	
ostad,	ওস্তাদ,	ওস্তাদ,	
somratra,	সম্রাত্র,	সম্রাটরা,	
soinyora,	সৈন্যারা,	সৈন্যরা,	
utkhaat,	উৎকাট,	উত্খাত,	
kobutorer,	কবুতরের,	কবুতরের,	
kathla,	কাঠলা,	কাঠলা,	
phiqsa,	ফিকসা,	ফিক্স,	
baaik,	বাইক,	বাইক,	
marry,	ম্যারি,	ম্যারি,	
prothar,	প্রথার,	প্রথার,	
akmato,	আকমাতো,	একমত,	
protijogitamulok,	প্রতিযোগিতামূলক,	প্রতিযোগীতামূলক,	
joki,	জোকি,	জকি,	
laagche,	লাগছে,	লাগছে,	
bhabanipur,	ভবানীপুর,	ভবানীপুর,	
torkarir,	তোরকারীর,	তরকারীর,	
romnar,	রোমনার,	রমনার,	
crashlands,	ক্র্যাশল্যান্ডসহ,	ক্র্যাশল্যান্ডস,	
graambasio,	গ্রাম্বাসিও,	গ্রামবাসীও,	
bajpa,	বাজপা,	বাজপা,	
komanera,	কমানেরা,	কমানেরা,	
oxite,	অক্সিতে,	অক্সাইট,	
grambaasi,	গ্রাম্বাসী,	গ্রামবাসী,	
eesa,	এইও,	আইএএস,	
udyem,	উদ্যেম,	উদ্যেম,	
ghaghat,	ঘাঘাট,	ঘাঘট,	
yathaarthabhaabe,	যাথার্থভাবে,	যথার্থভাবে,	
abheedhaaneek,	অভিধানীক,	অভিধানিক,	
delibhara,	দেলিভারা,	ডেলিভার,	
path,	পাথ,	পাথ,	
nathivukta,	নথিভুক্ত,	নথিভুক্ত,	
udvaboney,	উদ্ভাবনে,	উদ্ভাবনে,	
shilpojaat,	শিল্পজাত,	শিল্পজাত,	
aro,	আরো,	আরও,	
biplobi,	বিপ্লবি,	বিপ্লবী,	
bhromonkaale,	ভ্রমণকালে,	ভ্রমণকালে,	
ddebet,	ডেডেট,	ডিবেট,	
dera,	দেরা,	ডেরা,	
gandhiio,	গান্ধিও,	গান্ধীও,	
promodwara,	প্রমোদ্বারা,	প্রমদ্বারা,	
dibug,	দিবুগ,	ডিবাগ,	
sahojlovyotar,	সহলোভ্যতার,	সহজলভ্যতার,	
bhandti,	ভান্ডটি,	ভাণ্ডটি,	
atorkitey,	অতর্কিতে,	অতর্কিতে,	
mimgulor,	মিমগুলোর,	মিমগুলোর,	
maudelgulo,	মাউডেলগুলো,	মডেলগুলো,	
aaziz,	আজিজ,	আজিজ,	
souripurang,	সৌরীপূর্গ,	সৌরিপুরং,	
orhan,	ওরহান,	ওরহান,	
trabuco,	ট্রাবুকো,	ট্র্যাবুকো,	
langhangulir,	লাংহানগুলির,	লঙ্ঘনগুলির,	
ikboler,	ইকবলের,	ইকবলের,	
hosto,	হস্তো,	হস্ত,	
pray,	প্রয়া,	প্রায়,	
karecho,	কারেছো,	করেছ,	
bishwasho,	বিশ্বাশ,	বিশ্বাসও,	
suiza,	সুইজা,	সুইজা,	
bhujangta,	ভূজঙ্গত,	ভুজঙ্গটা,	
akheli,	আখেলী,	আখেলী,	
porbotmala,	পর্বতমালা,	পর্বতমালা,	
mookhomandoler,	মুখমাণ্ডলের,	মুখমণ্ডলের,	
tenishe,	তেনিশে,	টেনিসে,	
noitik,	নৈটিক,	নৈতিক,	
gejeted,	জেজেটেড,	গেজেটেড,	
miraqela,	মিরাকেলা,	মিরাকেল,	
shoreefer,	শরীফের,	শরিফের,	
qyapasula,	ক্যাপাসুলা,	ক্যাপসুল,	
jhijhi,	ঝিঝি,	ঝিঝি,	
societykey,	সোিযটেকে,	সোসাইটিকে,	
bulichev,	বুলিচেভ,	বুলিচেভ,	
chanoo,	চানু,	চানু,	
ishtone,	ইস্টনে,	স্টোন,	
kokeyin,	কোকেইন,	কোকেইন,	
khabarsoho,	খাবারসহ,	খাবারসহ,	
thaanobhi,	থানোভি,	থানভী,	
madhumati,	মধুমতি,	মধুমতী,	
poripake,	পরিপাকে,	পরিপাকে,	
semai,	সেমাই,	সেমাই,	
poripakey,	পরিপাকে,	পরিপাকে,	
engreziteo,	এনরজজিতেও,	ইংরেজিতেও,	
hamburgey,	হাযামবার্গে,	হামবুর্গে,	
onshogrohoner,	অংশগ্রহণের,	অংশগ্রহনের,	
shakankti,	শাকান্টটি,	শকাঙ্কটি,	
nili,	নীলি,	নিলি,	
masjidtir,	মাসজিত্তির,	মসজিদটির,	
rupantarer,	রূপান্তরের,	রুপান্তরের,	
avidur,	অভিদুর,	আভিদুর,	
adorsho,	আদর্শ,	আর্দশ,	
granthatyke,	গ্রানথাটিকে,	গ্রন্থটিকে,	
debdebier,	দেবদেবীয়ার,	দেবদেবীর,	
milayatane,	মিলায়ততে,	মিলায়তনে,	
jati,	জাতি,	যাতি,	
dharavahiker,	ধারাভাহীকের,	ধারাবাহিকের,	
artherer,	আর্থেরের,	আর্থারের,	
mailkhanek,	মাইলখানেক,	মাইলখানেক,	
oncoltike,	অনকলটিকে,	অঞ্চলটিকে,	
sepha,	সেফা,	শেফ,	
valobasen,	ভালোবাসেন,	ভালোবাসেন,	
schilling,	স্ক্লিং,	শিলিং,	
sahajlabhbhotar,	সহললভভভাতার,	সহজলভ্যতার,	
kanader,	কানাদের,	কণাদের,	
shiter,	শীতের,	শীতের,	
ekla,	একলা,	একলা,	
phormat,	ফরমাট,	ফরম্যাট,	
heerani,	হিরানী,	হিরানি,	
maktum,	মাকতুম,	মাকতুম,	
balaruma,	বালারুমা,	বলরুম,	
sazanor,	সাজানোর,	সাজানোর,	
yuro,	যুরো,	ইউরো,	
deefinision,	ডিফিনিশন,	ডেফিনেশন,	
duburir,	দুবুরীর,	ডুবুরির,	
uporoshtho,	উপর্ষ্ঠ,	উপরস্থ,	
baju,	বাজু,	বাজু,	
soommo,	সুম্মো,	সুমো,	
elakai,	এলাকাই,	এলাকাই,	
chhaikalo,	ছাইকালো,	ছাইকালো,	
lubitz,	লুবিৎজ,	লুবিৎজ,	
jomjamat,	জমজামাত,	জমজমাট,	
potka,	পটকা,	পটকা,	
ul,	ইউএলএ,	উল,	
nibirbhabe,	নিবিরভাবে,	নিবিরভাবে,	
oyebjin,	ওয়েবজিন,	ওয়েবজিন,	
pratisthasaho,	প্রতিষ্ঠাসহ,	প্রতিষ্ঠাসহ,	
drishyogulote,	দৃশ্যগুলোতে,	দৃশ্যগুলোতে,	
mohajote,	মহাজতে,	মহাজোট,	
digri,	ডিগ্রি,	ডিগ্রি,	
taffsherer,	তাঁফারের,	তাফসীরের,	
stonehenje,	স্তনেন্জ্যে,	স্টোনহেঞ্জ,	
khalid,	খালিদ,	খালিদ,	
asaktibandhan,	অস্ক্তিবন্ধন,	আসক্তিবন্ধন,	
creshcent,	ক্রেশেন্ট,	ক্রিসেন্ট,	
protectionism,	প্রোটিকশনিসম,	প্রোটেকশনিজম,	
lesense,	লেসেন্সে,	লাইসেন্স,	
sqalastiqa,	স্কালাস্টিক,	স্কলাস্টিক,	
sharifpur,	শরীফপুরের,	শরিফপুর,	
messengerer,	মেসেঙ্গারের,	মেসেঞ্জারের,	
bbiswashi,	বিবিশ্বাশী,	বিশ্বাসই,	
land,	ল্যান্ড,	ল্যান্ড,	
chhutee,	ছুটি,	ছুটি,	
bouddher,	বৌদ্ধের,	বৌদ্ধের,	
vandar,	ভান্দার,	ভাণ্ডার,	
unchuporjayer,	উঁচুপর্যায়ের,	উঁচুপর্যায়ের,	
dushtogone,	দুষ্টগণে,	দুষ্টগণে,	
orthanitike,	অর্থানীতিকে,	অর্থনীতিকে,	
balatkar,	বালাটকার,	বলাৎকার,	
venuser,	ভেনুসের,	ভেনাসের,	
siropa,	সিরোপা,	শিরোপা,	
sadeep,	সাদীপ,	সদীপ,	
rojapalaner,	রোজাপলনের,	রোজাপালনের,	
chhintayikari,	ছিন্তাইকারী,	ছিনতাইকারী,	
hol,	হোল,	হোল,	
gloria,	গ্লোরিয়া,	গ্লোরিয়া,	
bhandar,	ভান্দার,	ভাণ্ডার,	
chopol,	চপল,	চপল,	
porjotoker,	পর্যটকের,	পর্যটকের,	
nischitobhave,	নিশ্চিতভাভে,	নিশ্চিতভাবে,	
jonesh,	জনেশ,	জোন্স,	
mashtarsha,	মা্তর্ষ,	মাস্টার্স,	
balatarin,	বালাতারিন,	বালাতারিয়ান,	
kogake,	কোগাকে,	কোগাকে,	
choukato,	চৌকাত,	চৌকাত,	
turkyder,	টার্কিদের,	তুর্কিদের,	
osamarik,	ওসামারিক,	অসামরিক,	
ardasha,	আর্দশা,	আর্দশ,	
himchi,	হিমচি,	হিমচি,	
amanisa,	আমানিসা,	অমানিশা,	
shariba,	শরীবা,	শরিবা,	
drissotir,	দৃষ্টটির,	দৃশ্যটির,	
sanaktokaran,	সানাক্তকরণ,	সনাক্তকরণ,	
ramzaner,	রামজানের,	রমযানের,	
gej,	গেজ,	গেজ,	
jothartho,	যথার্থ,	যথার্থ,	
poroborti,	পরবর্তী,	পরর্বতী,	
dojo,	দজো,	ডোজো,	
mumtaj,	মুমতাজ,	মুমতাজ,	
byabostho,	ব্যবস্থ,	ব্যাবস্থা,	
female,	ফেমালে,	ফিমেল,	
mag,	ম্যাগ,	এমএজি,	
katbe,	কাতবে,	কাটবে,	
simaa,	সিমা,	সীমা,	
krom,	ক্রোম,	ক্রম,	
chapchap,	চাপচাপ,	চাপচাপ,	
sangbadmadhyamgulote,	সংবাদমাধ্যমুলোতে,	সংবাদমাধ্যমগুলোতে,	
talgach,	তালগাছ,	তালগাছ,	
osomorthito,	অসমর্থিত,	অসমর্থিত,	
dhos,	ধোস,	ধস,	
plator,	প্ল্যাটর,	প্লেটোর,	
taxikeo,	ট্যাক্সিকেও,	ট্যাক্সিকেও,	
desiseyer,	ডেসিসেয়ার,	ডিজিজের,	
dong,	ডোং,	ডং,	
encidablu,	এনসিডাবলু,	এনসিডাব্লু,	
cuti,	কুটি,	কিউটি,	
seekkharthirao,	শিক্ষার্থীরাও,	শিক্ষার্থীরাও,	
deh,	দেহ,	দেহ্,	
kheylechen,	খেয়েলছেন,	খেলেছেন,	
ghoorchen,	ঘুরছেন,	ঘুরেছেন,	
rastagulikeo,	রাস্তাগুলিকেও,	রাস্তাগুলিকেও,	
sikkhokder,	শিক্ষকদের,	শিক্ষকদের,	
chilona,	চিলোনা,	ছিলনা,	
shaddhi,	শাদ্ধি,	সাধ্বী,	
niroja,	নিরোজা,	নিরোজা,	
bishwaashshke,	বিশ্বাশকে,	বিশ্বাসকে,	
domone,	ডমনে,	দমনে,	
moonshi,	মুনশি,	মুন্সি,	
teenisa,	তিনিসা,	টেনিস,	
crucer,	ক্রাসার,	ক্রুশের,	
parking,	পার্কিং,	পার্কিং,	
niharkantibabu,	নিহারকান্তিবাবু,	নিহারকান্তিবাবু,	
nabayug,	নবয়াগু,	নবযুগ,	
pacbar,	পাকবার,	পাঁচবার,	
parabortee,	পারাবর্তী,	পরর্বতী,	
bosontokke,	বসন্তকে,	বসন্তকে,	
nopdnodir,	নওপন্দির,	নদনদীর,	
gostigulo,	গোস্তিগুলো,	গোষ্ঠীগুলো,	
bonvumi,	বনভুমি,	বনভূমি,	
bbiswasho,	বিবিশ্বাস,	বিশ্বাসও,	
dishani,	দিশানি,	দিশানি,	
madrasa,	মাদ্রাসা,	মাদ্রাসা,	
stona,	স্তোনা,	স্টোন,	
krishibigyani,	কৃষিবিজ্ঞানী,	কৃষিবিজ্ঞানী,	
query,	কোয়ারি,	কোয়েরি,	
grambaseer,	গ্রাম্বাসির,	গ্রামবাসীর,	
ashok,	আশকক,	আশোক,	
amontronkarider,	অমন্ত্রনকারীদের,	আমন্ত্রণকারীদের,	
pyor,	পিয়রোর,	পিওর,	
abanishankar,	অবনিশঙ্কর,	অবনিশংকর,	
sahinsatar,	সহিনসতার,	সহিংসতার,	
byabaharkareer,	ব্যবহারকারীর,	ব্যবহারকারীর,	
dharmiyabhabei,	ধর্মিভাবেই,	ধর্মীয়ভাবেই,	
lyaataa,	ল্যা,	ল্যাটা,	
uddhrita,	উদ্ধৃত,	উদ্ধৃত,	
lakkhero,	লক্ষেরও,	লক্ষেরও,	
sikkharthirao,	শিক্ষার্থীরাও,	শিক্ষার্থীরাও,	
marketing,	মার্কেটিং,	মার্কেটিং,	
punosthaner,	পুনস্থানের,	পুনঃস্থানের,	
nirgamon,	নিরগামন,	নির্গমন,	
pader,	পাদের,	প্যাডের,	
aashanka,	আশঙ্কা,	আশংকা,	
shho,	শো,	শো,	
homeser,	হোমেসের,	হোমসের,	
taunship,	তাউনশিপ,	টাউনশিপ,	
dhojovongo,	ধোজভঙ্গ,	ধ্বজভঙ্গ,	
harysoner,	হারিশনের,	হ্যারিসনের,	
sampadon,	সম্পাদন,	সম্পাদন,	
valobase,	ভালোবাসে,	ভালোবাসে,	
sarbhare,	সরভারে,	সার্ভারে,	
minilosar,	মিনিলোসার,	মিনিলোসার,	
harbur,	হারবুর,	হারবার,	
poschimey,	পশচিমে,	পশ্চিমে,	
chhadite,	ছড়িতে,	ছড়িতে,	
quary,	কোয়ারি,	কোয়েরি,	
shuri,	শুরি,	সুরি,	
vaphara,	ভাফারা,	বাফার,	
lutharen,	লুথারেন,	লুথেরান,	
hijritey,	হিজৃতে,	হিজরীতে,	
bhabaponno,	ভাবাপন্ন,	ভাবাপন্ন,	
zeland,	জেলাযান্ড,	জিল্যান্ড,	
katui,	কাটুই,	কাতুই,	
nimitte,	নিমিত্বে,	নিমিত্তে,	
shector,	শেক্টর,	সেক্টর,	
chalachchitrer,	চালচ্চিত্রের,	চলচ্চিত্রের,	
carzar,	কার্জার,	চার্জার,	
aabarte,	আবার্তে,	আবর্তে,	
manir,	মানির,	মনির,	
licencer,	লিইসেন্সের,	লাইসেন্সের,	
swajan,	স্বজন,	স্বজন,	
korimer,	করিমের,	করিমের,	
probeshkari,	প্রবেশকারী,	প্রবেশকারী,	
govindarajan,	গোবিন্দরাজন,	গোবিন্দরাজন,	
vugorvey,	ভুগরভিভ,	ভূগর্ভে,	
breqathru,	ব্রেক্থুরু,	ব্রেকথ্রু,	
vejjanno,	ভেজজান্ন,	ভেজানো,	
jeten,	জেটেন,	জেতেন,	
niropekshtar,	নিরপপেক্ষটার,	নিরপেক্ষতার,	
rekhapat,	রেখাপাত,	রেখাপাত,	
aosafur,	আওসাফুর,	আওশাফুর,	
kkhur,	খির,	ক্ষুর,	
dibya,	দিব্যা,	দিব্যা,	
meloonborroner,	মেলোজনবররণের,	মেলবোর্নের,	
toufik,	তুফিক,	তৌফিক,	
ghatla,	ঘাটলা,	ঘটল,	
chupani,	চুপানি,	চুপানি,	
jetam,	জেতাম,	যেতাম,	
soceitytey,	সোসিটিটে,	সোসাইটিতে,	
vittimul,	ভিত্তিমূল,	ভিত্তিমূল,	
seekkhokbrindo,	সিক্ষকবৃন্দ,	শিক্ষকবৃন্দ,	
yaq,	য়াক,	ইয়াক,	
eshiyetika,	এসিয়েটিকা,	এশিয়াটিক,	
aviyojan,	অভিযোজন,	অভিযোজন,	
rodney,	রোনে,	রেডনি,	
kanthar,	কাঁথর,	কাঁথার,	
bondira,	বন্দিরা,	বন্দীরা,	
hooldim,	হুল্ডিং,	হোল্ডিং,	
ghoomato,	ঘুমাতো,	ঘুমাতো,	
zozyota,	যোজ্যতা,	যোজ্যতা,	
zerusalem,	জেরুসালেম,	জেরুসালেম,	
siddhantei,	সিদ্ধান্তেই,	সিদ্ধান্তেই,	
beshirbhaagei,	বেশিরভাগেই,	বেশিরভাগেই,	
nirbaahe,	নির্বাহে,	নির্বাহে,	
rachonakal,	রচনাকাল,	রচনাকাল,	
transhapharma,	ট্রানসাফ্রমা,	ট্রান্সফর্ম,	
shiqara,	শিকারা,	শিকার,	
sarsa,	সারসা,	সোর্স,	
joubankal,	জৌবনকাল,	যৌবনকাল,	
directorate,	ডিরেক্টরেট,	ডিরেক্টরেট,	
taler,	তালের,	তালের,	
korkotkraantee,	কর্ককট্রান্টি,	কর্কটক্রান্তি,	
poorohitder,	পৌরহিতদের,	পুরোহিতদের,	
thailandsaho,	থাইলনন্ডসহ,	থাইল্যান্ডসহ,	
tookrote,	টুকরোতে,	টুকরোতে,	
korijachilen,	করিজাছিলেন,	করিযাছিলেন,	
madhobi,	মাধবী,	মাধবী,	
nirmalata,	নির্মলতা,	নির্মলতা,	
mardud,	মারদুদ,	মরদুদ,	
daqten,	ডাকতেন,	ডাকতেন,	
madhoori,	মাধুরি,	মাধুরী,	
khoka,	খোকা,	খোকা,	
michir,	মিচির,	মিচির,	
meshenjar,	মেশেঞ্জার,	মেসেঞ্জার,	
rananganey,	রানাঙ্গনে,	রণাঙ্গনে,	
bangobandhu,	বঙ্গবন্ধু,	বঙ্গবন্ধু,	
dormetori,	দর্মেতরি,	ডরমিটরি,	
hajirhat,	হাজিরহাট,	হাজিরহাট,	
khorsed,	খোরসেড,	খোরশেদ,	
muradke,	মুরাদকে,	মুরাদকে,	
shishu,	শিশু,	শিশু,	
orthonitir,	অর্থনীতির,	অর্থনীতির,	
baganoto,	বাগানত,	বাগানত,	
sursur,	সুরসুর,	সুরসুর,	
qaferderkey,	কাফেরদেরকে,	কাফেরদেরকে,	
antorbhuktimulak,	অন্তর্ভুকমূলক,	অন্তর্ভুক্তিমূলক,	
bhenicer,	ভেনিসের,	ভেনিসের,	
humner,	হুমের,	হামনার,	
shangsthaner,	শাংস্থানের,	সংস্থানের,	
konisttha,	কোনিস্থ,	কনিষ্ঠ,	
sangkulaan,	সংকুলান,	সংকুলান,	
bufer,	বুফের,	বাফার,	
norpholk,	নর্ফলক,	নরফোক,	
hood,	হুদ,	হুড,	
enginiiring,	এঞ্জিনিরিং,	ইঞ্জিনিয়ারিং,	
baire,	বাইরে,	বাইরে,	
durgotshob,	দুর্গতসভ,	দুর্গোৎসব,	
laaisens,	লেইসেন্স,	লাইসেন্স,	
pravritir,	প্রভৃতির,	প্রভৃতির,	
sayatana,	সায়তানা,	শয়তান,	
karmake,	করমকে,	কর্মকে,	
moomtaj,	মুমতজজ,	মুমতাজ,	
difinision,	ডিফিনিশন,	ডেফিনেশন,	
rijoor,	রিজুর,	রিজুর,	
emarjenshi,	এমরজেনশি,	এমার্জেন্সি,	
naitikatavodh,	নৈতিকাতাবোধ,	নৈতিকতাবোধ,	
babare,	বাবারে,	বাবারে,	
seramiks,	সেরামিকস,	সিরামিকস,	
manjushri,	মঞ্জুশ্রী,	মঞ্জুশ্রী,	
jyesttha,	জ্যাস্থ্থা,	জ্যেষ্ঠা,	
dibet,	দিবেত,	ডিবেট,	
sohojlovyotar,	সহলজ্যভততার,	সহজলভ্যতার,	
saifai,	সাইফাই,	সাইফাই,	
overholing,	ওভারহলিং,	ওভারহোলিং,	
forma,	ফরমা,	ফর্মা,	
bolatkar,	বলাটকার,	বলাৎকার,	
elaakaa,	এলাকা,	এলাকা,	
bornolikhon,	বর্ণলিখোন,	বর্ণলিখন,	
kiibord,	কিইবর্ড,	কীবোর্ড,	
omarader,	ওমারাদের,	ওমারাদের,	
porinoti,	পরিণতি,	পরিণতি,	
samley,	সামলে,	সামলে,	
edmiral,	এডমিরাল,	এডমিরাল,	
everestey,	এভারেস্টে,	এভারেস্টে,	
eekbalke,	একবালকে,	ইকবালকে,	
chhadura,	ছাদুরা,	ছাদুরা,	
malinga,	মালিঙ্গা,	মালিংগা,	
shasankorta,	শাসঙ্কররতা,	শাসনকর্তা,	
arekdol,	আরেকদল,	আরেকদল,	
suri,	সুরি,	সুরি,	
kutubuddinke,	কুতুবুদ্দিনকে,	কুতুবুদ্দিনকে,	
kalirkhal,	কলিরখাল,	কালিরখাল,	
kachhakaachhi,	কাচাকাচাছি,	কাছাকাছি,	
nisshongotake,	নিঃসংগততাকে,	নিঃসঙ্গতাকে,	
dhauto,	ধাওতো,	ধৌত,	
godamjato,	গোদামজাত,	গুদামজাত,	
asaciates,	অ্যাসিটেয়েট,	এসোসিয়েটস,	
refleks,	রেফলেক্স,	রিফ্লেক্স,	
ponthaar,	পন্থার,	পন্থার,	
chereche,	চেরেছে,	ছেড়েছে,	
thandabhabe,	থান্ডাভাবে,	ঠাণ্ডাভাবে,	
siddharther,	সিদ্ধার্থের,	সিদ্ধার্থের,	
bike,	বিকে,	বাইক,	
sangaskritipreme,	সংস্কৃতিপ্রেমে,	সংস্কৃতিপ্রেমে,	
sorting,	সর্টিং,	সর্টিং,	
pharmesigulote,	ফার্মিসেগুলোতে,	ফার্মেসীগুলোতে,	
sethai,	সেথাই,	সেথাই,	
srk,	স্রিএরকে,	শাহরুখ,	
mukharji,	মুখর্জি,	মুখার্জী,	
perry,	পেরি,	পেরি,	
eoki,	ইকি,	এওকি,	
jeebnagore,	জীবনগরে,	জীবননগর,	
barnis,	বার্নিস,	বার্নিশ,	
parther,	পার্থের,	পার্থের,	
jathartho,	যথার্থ,	যথার্থ,	
ashor,	আশর,	আসর,	
doorotomo,	দূরতম,	দূরতম,	
shansthaner,	শানস্থানের,	সংস্থানের,	
bhangle,	ভাংলে,	ভাঙলে,	
windos,	উইন্ডোস,	উইন্ডোস,	
itastata,	ইটাস্তা,	ইতস্তত,	
kinsha,	কিনশা,	কিংস,	
rajnaiteek,	রাজনৈতিক,	রাজনৈতীক,	
dhaleshorii,	ধলেশরী,	ধলেশ্বরী,	
utpatti,	উৎপত্টি,	উতপত্তি,	
sikarder,	সিকারদের,	শিকারদের,	
vetrillocuism,	ভেট্রিক্লোইজমস,	ভেট্রিলোকুইজম,	
indrakanan,	ইন্দ্রকানান,	ইন্দ্রকানন,	
dweepgoolotey,	ড্বিপগুলোতে,	দ্বীপগুলোতে,	
chahidapotrer,	চাহিদাপত্রের,	চাহিদাপত্রের,	
angibhutovabe,	অঙ্জীভূতভাবে,	অঙ্গীভূতভাবে,	
uchchotara,	উচ্চতারা,	উচ্চতর,	
iraner,	ইরানের,	ইরানের,	
vittio,	ভিট্টিও,	ভিত্তিও,	
khelaphate,	খেলাফাতে,	খেলাফতে,	
satarkabhabe,	সতরকাভাবে,	সতর্কভাবে,	
orbi,	অরবি,	ওরবি,	
prakalpoguli,	প্রকল্পগুলি,	প্রকল্পগুলি,	
vitti,	ভিত্তি,	ভিত্তিই,	
kumbhalnar,	কুম্ভলনর,	কুম্ভালনার,	
rohasyati,	রোহাস্ততি,	রহস্যটি,	
gatibege,	গতিবেগে,	গতিবেগে,	
raiji,	রাইজি,	রাইজি,	
udbhaboni,	উদ্ভাবনী,	উদ্ভাবনী,	
indra,	ইন্দ্রা,	ইন্দ্র,	
bondi,	বন্ডি,	বন্দী,	
bangalore,	বাঙ্গালোরে,	ব্যাঙ্গালুরে,	
hisabagyan,	হিসাব্জ্ঞান,	হিসাবজ্ঞান,	
teemothy,	তিমোথি,	টিমোথি,	
oncholsomuho,	অঞ্চলসমূহ,	অঞ্চলসমূহ,	
chandil,	চান্দিল,	চান্ডিল,	
bibecchyo,	বিবেচ্য,	বিবেচ্য,	
digreeke,	দিগ্রিকে,	ডিগ্রিকে,	
pratool,	প্রাতুল,	প্রতুল,	
shashtra,	শাষ্ট্র,	শাস্ত্র,	
lat,	লাত,	লাট,	
licenshe,	লিইসেন্শে,	লাইসেন্স,	
alimpiqa,	আলিমপিক,	অলিম্পিক,	
narsaari,	নরসারী,	নার্সারি,	
gopalrao,	গোপালরাও,	গোপালরাও,	
moshahidur,	মোশাহিদুর,	মোশাহিদুর,	
udbodhani,	উদ্বোধনী,	উদ্বোধনী,	
nagarikera,	নাগারীকেরা,	নাগরিকেরা,	
shabkam,	শাবকাম,	শবকাম,	
unchiyechilo,	উঁচিয়েছিল,	উঁচিয়েছিল,	
holding,	হোল্ডিং,	হোল্ডিং,	
rajshri,	রাজশ্রি,	রাজশ্রী,	
oncholgulir,	অঞ্চলগুলির,	অঞ্চলগুলির,	
phonekari,	ফোনেকারি,	ফোনকারী,	
bashoborty,	বাভর্তি,	বশবর্তী,	
bhabarlaler,	ভবররালের,	ভবরলালের,	
install,	ইনস্টাল,	ইন্সটল,	
jhumjhumita,	ঝুমঝুমিতা,	ঝুমঝুমিটা,	
binakar,	বিনাকার,	বিনাকার,	
antorvukta,	অ্যান্টভভুক্ত,	অন্তর্ভুক্ত,	
bhupal,	ভূপাল,	ভূপাল,	
bbiseshyer,	বিবিশেঞ্যের,	বিশেষ্যের,	
phuda,	ফুদা,	ফুড,	
nirobota,	নিরবতা,	নিরবতা,	
kuhelika,	কুহেলিকা,	কুহেলিকা,	
noiteek,	নৈটিক,	নৈতিক,	
segular,	সেগুলার,	সেগুলোর,	
upacharjo,	উপাচার্য,	উপাচার্য,	
prasadhani,	প্রসাধানি,	প্রসাধনী,	
nathibhuktir,	নথিভুক্তির,	নথিভুক্তির,	
francine,	ফ্রান্সিন,	ফ্রান্সিন,	
fotanor,	ফোটানোর,	ফোটানোর,	
sqalarashipa,	স্কললাশরীপা,	স্কলারশিপ,	
omanisa,	ওমানিসা,	অমানিশা,	
karore,	কারোর,	কারোর,	
bosturoi,	বস্তুরই,	বস্তুরই,	
jinsa,	জিনসা,	জিন্স,	
tecnokret,	টেকনক্রেট,	টেকনোক্র্যাট,	
brahmanera,	ব্রাহ্মণেরা,	ব্রাহ্মণেরা,	
iub,	আইবিবি,	আইইউবি,	
paripakey,	পরিপাকে,	পরিপাকে,	
uthhaane,	উঠানে,	উঠানে,	
sealvi,	সিলভি,	সিলভি,	
dharabahikvabe,	ধারাবাহিকভাবে,	ধারাবাহিকভাবে,	
kormopontha,	কর্মপন্থ,	কর্মপন্থা,	
inphormeshon,	ইনফর্মশশন,	ইনফরমেশন,	
weenis,	উইনিস,	ভেনিস,	
mozlis,	মজলিস,	মজলিশ,	
eporjonto,	এপরজন্ত,	এপর্যন্ত,	
mastarsa,	মাস্তারসা,	মাস্টার্স,	
shikshakrom,	শিক্ষাক্রম,	শিক্ষাক্রম,	
awatar,	অওয়াতার,	অবতার,	
aashtikotaa,	অষ্টিকোটা,	আস্তিকতা,	
shekarone,	শেকারণে,	সেকারণে,	
idipasha,	ইডিপাশা,	ইডিপাস,	
nodnodeer,	নদনদীর,	নদনদীর,	
jamkaalo,	জামকালো,	জমকালো,	
cn,	সিএনএন,	সিএন,	
shudhir,	শুধীর,	শুধীর,	
impaction,	ইমপ্যাকশন,	ইমপ্যাকশন,	
guzon,	গুজন,	গুজব,	
gazeetteed,	গজেটিট,	গেজেটেড,	
haridware,	হরিদ্বারে,	হরিদ্বারে,	
railliner,	রেললিনের,	রেললাইনের,	
satyaky,	সত্যাকী,	সাত্যকি,	
braqe,	ব্রাকে,	ব্রেক,	
nadike,	নাদিকে,	নদীকে,	
kidambi,	কিদাম্বি,	কিদম্বি,	
edaningkale,	এডানিংকালে,	ইদানীংকালে,	
taigara,	তাইগারা,	টাইগার,	
cena,	সেনা,	সিনা,	
dobhara,	দোভারা,	ডোভার,	
monur,	মনুর,	মনুর,	
sawam,	সায়াম,	সাওম,	
asamanyo,	অসম্ন্য,	অসামান্য,	
pathkrom,	পাঠক্রম,	পাঠক্রম,	
prabhritite,	প্রভ্বিতিতে,	প্রভৃতিতে,	
eshtonia,	এসতোনিয়া,	এস্তোনিয়া,	
augustine,	অগস্টিন,	অগাস্টিন,	
licencedhari,	লিইসেন্ডাারী,	লাইসেন্সধারী,	
konoroop,	কোনরূপ,	কোনরূপ,	
atibiplabi,	অতিবিপ্লাবী,	অতিবিপ্লবি,	
rasunkunchi,	রসুনকুঙ্চি,	রসুনকুঁচি,	
gaddaafee,	গ্যাডডেফ,	গাদ্দাফী,	
sanstha,	সাস্থ,	সংস্থা,	
registaner,	রেজিস্টানের,	রেগিস্তানের,	
expreshshion,	এক্সপ্রেশন,	এক্সপ্রেশন,	
dhanche,	ধাঁচে,	ধাঁচে,	
pooshteer,	পুষ্টির,	পুষ্টির,	
evereste,	এভারেস্টে,	এভারেস্টে,	
sombhobonaao,	সম্ভবনাও,	সম্ভবনাও,	
shnaipara,	শ্নাপর,	স্নাইপার,	
cholochchitraeeo,	চলচ্চিত্রাও,	চলচ্চিত্রেও,	
gandogol,	গণ্ডগোল,	গন্ডগোল,	
khoor,	খুর,	ক্ষুর,	
teestar,	টিস্টার,	তিস্তার,	
dinara,	দিনারা,	ডিনার,	
