sikkhakbrinda,	সিক্ষাকৃন্দ,	শিক্ষকবৃন্দ,	
bharpur,	ভারপুর,	ভরপুর,	
site,	সাইট,	সিটে,	
asamorik,	অসমাপিক,	অসামরিক,	
charger,	চার্গের,	চার্জার,	
gabhaaskar,	গভাস্যর,	গাভাস্কার,	
agomone,	আগমনে,	আগমনে,	
baipash,	বাইপাশ,	বাইপাস,	
patochitra,	পাঠীচাত্র,	পটচিত্র,	
nariider,	নারীদের,	নারীদের,	
footbalarra,	ফুটবলারা,	ফুটবলাররা,	
venus,	ভেনুস,	ভেনাস,	
adorso,	অ্যাডর্স,	আর্দশ,	
kortona,	কর্তনা,	করতনা,	
impaction,	ইমপপ্যানশন,	ইমপ্যাকশন,	
desiseyer,	ডেসিসিয়ের,	ডিজিজের,	
jandrel,	জানদ্রেল,	জাঁদরেল,	
iksaprishana,	ইক্সপ্রেশন,	এক্সপ্রেশন,	
shakankti,	শককান্তি,	শকাঙ্কটি,	
sethai,	সেথাই,	সেথাই,	
shikhbe,	শিখবে,	শিখবে,	
adorsho,	আদর্শ,	আর্দশ,	
abikaul,	আবিকাল,	অবিকল,	
himchi,	হিমচি,	হিমচি,	
niphelheim,	নিপেলিভেম,	নিফেলহেইম,	
omeettrakkhor,	অমেকপ্রক্ষর,	অমিত্রাক্ষর,	
nagorikra,	নাগোরীকরা,	নাগরিকরা,	
turky,	টার্ক,	তুর্কি,	
senabahineekey,	সেনাবাহিনয়কে,	সেনাবাহিনীকে,	
alpo,	অলপো,	অল্প,	
hisaber,	হিসাবের,	হিসাবের,	
vagini,	ভাগিনি,	ভগিনী,	
shattoki,	শত্তকি,	সাত্যকি,	
kidambi,	কিডাম্বি,	কিদম্বি,	
bidghootey,	বিদ্ঘতে,	বিদঘুটে,	
fol,	ফোল,	ফল,	
morathee,	মোরথে,	মরাঠি,	
atorkitey,	আতরকটিতে,	অতর্কিতে,	
nathibhuktir,	নথিভুক্তির,	নথিভুক্তির,	
apad,	অপডা,	আপদ,	
holuder,	হলুদের,	হলুদের,	
sthaponagulo,	স্থাপনাগুলো,	স্থাপনাগুলো,	
abti,	আবতি,	আবতি,	
shiter,	শিতের,	শীতের,	
nojder,	নজদের,	নজদের,	
ultrasonography,	উল্ট্রাস্রার্ফি,	আলট্রাসনোগ্রাফিও,	
toufiq,	টাফিক,	তৌফিক,	
motkey,	মোটকে,	মতকে,	
footbalarer,	ফুটবলারের,	ফুটবলারের,	
asovya,	অসভ্যও,	অসভ্য,	
mastarsa,	মাস্তারস,	মাস্টার্স,	
jeher,	জেহের,	জেহের,	
jamanataswarup,	জামাতা্বর্ববু,	জামানতস্বরূপ,	
marodeho,	মারোদোহে,	মরদেহ,	
milea,	মিলেয়,	মাইলে,	
ixprission,	ইক্সপ্রেশন,	এক্সপ্রেশন,	
pharn,	ফার্ন,	ফার্ন,	
vagni,	ভাগনি,	ভগ্নী,	
nothivuktir,	নথিবুক্তির,	নথিভুক্তির,	
aarke,	আরকে,	আরকে,	
kloud,	ক্লোউড,	ক্লাউড,	
alankorana,	আলোকগরন,	অলঙ্করণ,	
hetimganje,	হেটিংবাজে,	হেতিমগঞ্জে,	
ashiatic,	অশিয়াতিক,	এশিয়াটিক,	
bheenisa,	ভেনুসা,	ভেনিস,	
tiuning,	টিউনিং,	টিউনিং,	
niketaner,	নিকেতানের,	নিকেতনের,	
societytey,	সকিইটিিতে,	সোসাইটিতে,	
nischitobhabe,	নিশ্চিতভাবে,	নিশ্চিতভাবে,	
rushad,	রুশাদ,	রুশদ,	
jonosomaj,	জনসমমাজ,	জনসমাজ,	
alexandar,	আলেকজেন্ডার,	আলেকজান্ডার,	
bhyaatikaner,	ভ্যাটিকানের,	ভ্যাটিকানের,	
chirontan,	চিরন্তান,	চিরন্তন,	
tuleche,	তুলেছে,	তুলেছে,	
freekeh,	ফ্রিকে,	ফ্রিকেহ,	
asiatic,	অসিকিয়াক,	এশিয়াটিক,	
chalaabi,	চালাবি,	চালাবে,	
gaichhe,	গাইছে,	গাইছে,	
syfy,	সিক্সব,	সাইফাই,	
hitaishi,	হিতাইশি,	হিতৈষী,	
dokanei,	দোকানেই,	দোকানেই,	
bisnukey,	বিসনুকেে,	বিষ্ণুকে,	
deelibhara,	দেলিভরা,	ডেলিভার,	
hertj,	হেরটজ,	হার্জ,	
arke,	আরকে,	আরকে,	
govindarajan,	গোবিন্দ্বন,	গোবিন্দরাজন,	
mahafezkhanar,	মহাসেবচনার,	মহাফেজখানার,	
elaakati,	এলাকাটি,	এলাকাটি,	
johor,	জহুর,	জহর,	
talgachh,	তালগাছ,	তালগাছ,	
angkita,	অংকিতা,	অঙ্কিতা,	
liceensee,	লাইসেন্স,	লাইসেন্স,	
tanshree,	তাঁশেরে,	তানশ্রী,	
dhangsachchi,	ধাবংশ্চি,	ধ্বংসাচ্ছি,	
songbadmadhyomer,	সংবাদমাধ্যমের,	সংবাদমাধ্যমের,	
nodimatrik,	নদীমাত্রিক,	নদীমাতৃক,	
moomtaj,	মুমতাজ,	মুমতাজ,	
rubala,	রুবালা,	রুবল,	
kyatagorir,	ক্যাটাগরীর,	ক্যাটাগরির,	
amarjito,	অমর্জিত,	অমার্জিত,	
dokaangulotey,	দোকানগুলোতে,	দোকানগুলোতে,	
bishnu,	বিষ্ণু,	বিষ্ণু,	
lekhaksattwar,	লেখকসত্ত্বার,	লেখকসত্ত্বার,	
rena,	রেনা,	রেনো,	
nirabota,	নিরববতা,	নিরবতা,	
licencer,	লাইসেন্সের,	লাইসেন্সের,	
lendol,	লেন্ডল,	লেন্ডল,	
pustir,	পুস্তির,	পুষ্টির,	
probolshoktio,	প্রবচ্ছকিত,	প্রবলশক্তিও,	
shikshagato,	শিক্ষাগত,	শিক্ষাগত,	
plak,	প্ল্ক,	প্ল্যাক,	
samratra,	সামরত্র,	সম্রাটরা,	
kirke,	কীরকে,	কিরকে,	
sarbhaarti,	সর্ভররটি,	সার্ভারটি,	
rajbandi,	রাজবন্দি,	রাজবন্দী,	
aholya,	অহল্যা,	অহল্যা,	
nirmalata,	নির্মলতা,	নির্মলতা,	
digrir,	দিগ্রির,	ডিগ্রির,	
photanor,	ফটোনার,	ফোটানোর,	
baikalyo,	বাইকাল্য,	বৈকল্য,	
anusvara,	অনুস্বরা,	অনুস্বার,	
adhunikkaley,	আধুনিক্কাণে,	আধুনিককালে,	
modele,	মডেলে,	মডেলে,	
ashirbadatri,	অশির্বাদপত্রী,	আশীর্বাদাত্রী,	
khalidkay,	খলিদকাকা,	খালিদকে,	
nischoy,	নিশ্চয়,	নিশ্চয়,	
kathghera,	কাঠঘেরা,	কাঠঘেরা,	
deobonde,	দেওবন্ডে,	দেওবন্দে,	
fuss,	ফুস্স,	ফাস,	
mosjidsoho,	মসজিদসহ,	মসজিদসহ,	
mosjidtir,	মসজিদটির,	মসজিদটির,	
rushod,	রুশোদ,	রুশদ,	
kul,	কুল,	কুল,	
dong,	ডং,	ডং,	
bhenkates,	ভেঙ্কটে,	ভেঙ্কটেশ,	
hevy,	হেভি,	হেভি,	
arifin,	আরিশিন,	আরিফিন,	
jolaatonko,	জলাান্ক,	জলাতঙ্ক,	
plasse,	প্লাস,	প্লাসে,	
maaktoome,	মাকতোমে,	মাকতুম,	
ghotolen,	ঘটনেন,	ঘটলেন,	
gardeen,	গার্ডেন,	গার্ডেন,	
breqathru,	ব্রেকাার্,	ব্রেকথ্রু,	
drissotir,	দৃশস্তির,	দৃশ্যটির,	
karam,	কারম,	কেরাম,	
pichte,	পিচতে,	পিছতে,	
basakey,	বাসাকে,	বাসাকে,	
ashamarthita,	অশাগড়ৃত,	অসমর্থিত,	
elakai,	এলাকাই,	এলাকাই,	
onchalti,	অংখলিৎ,	অঞ্চলটি,	
banglota,	বাংলোটা,	বাংলোটা,	
commissionvogider,	কমিশনিকোলাদের,	কমিশনভোগীদের,	
hojurer,	হোজুরের,	হজুরের,	
arthanitike,	অর্থনীতিকে,	অর্থনীতিকে,	
akhandota,	আখণ্ডতা,	অখণ্ডতা,	
charukala,	চারুকলা,	চারুকলা,	
gabhaskaar,	গাভস্কার,	গাভাস্কার,	
gurmukh,	গুরমুখ,	গুরমুখ,	
rakkhanbhag,	রক্ষণভাগ,	রক্ষণভাগ,	
reliance,	রিলিজেয়েন্স,	রিলায়েন্স,	
grambaaseeder,	গ্রামবাস্যের,	গ্রামবাসীদের,	
ssahocorze,	সাকারক্মে,	সাহচর্যে,	
khiladirao,	খিলাদীরাও,	খিলাড়িরাও,	
shresthoshcho,	শ্রেষ্ঠস্চ,	শ্রেষ্ঠশ্চ,	
utkhaat,	উৎকাষত,	উত্খাত,	
shukrabab,	শুক্রবাব,	শুক্রবাব,	
rasunkunchi,	রাসুন্ুিছি,	রসুনকুঁচি,	
daakten,	ডাকতেন,	ডাকতেন,	
palashir,	পাাশির,	পলাশীর,	
ramnathbabur,	রামনন্থবাবুর,	রামনাথবাবুর,	
shroddhabihin,	শ্রদ্ধাবিহীন,	শ্রদ্ধাবিহীন,	
treebhuj,	ত্রিভুজ,	ত্রিভূজ,	
baibasthaar,	বৈষব্থার,	ব্যবস্থার,	
santaa,	সান্তা,	সান্তা,	
chikkingsasoho,	চিক্ষিণাগসহ,	চিকিংসাসহ,	
robot,	রোবোট,	রোবোট,	
kormoke,	কর্মকে,	কর্মকে,	
istoone,	ইস্তোলে,	স্টোন,	
uddhrito,	উদ্ধৃত,	উদ্ধৃত,	
hosbaleke,	হোসবালকে,	হোসবালেকে,	
kaansaat,	কানসাত,	কানসাট,	
rajan,	রাজান,	রাজন,	
banshite,	বাঁশিতে,	বাঁশিতে,	
shem,	শেম,	সেম,	
shtona,	স্তনা,	স্টোন,	
khude,	খুদে,	ক্ষুদে,	
boshoborti,	বশররবটি,	বশবর্তী,	
municipal,	মুনিপিকাল,	মিউনিসিপ্যাল,	
fevarite,	ফেভারিতে,	ফেভারিট,	
panchashjon,	পাঁচাশবন,	পঞ্চাশজন,	
nothibhukteer,	নথিভূক্তের,	নথিভুক্তির,	
sonaktokaran,	সোনাক্তকরণ,	সনাক্তকরণ,	
bhushito,	ভূষিত,	ভূষিত,	
purohitra,	পুরোহিত্র,	পুরোহিতরা,	
karmakarke,	কর্মকররকে,	কর্মকারকে,	
chirantan,	চিরান্তান,	চিরন্তন,	
alkatra,	অলযালকেটার,	আলকাতরা,	
bisnoo,	বিস্নও,	বিষ্ণু,	
dajhyo,	দাহযয়,	দাহ্য,	
taateo,	তাতেও,	তাতেও,	
ancholtike,	অঞ্চলটিকে,	অঞ্চলটিকে,	
kurdira,	কুর্দিরা,	কুর্দিরা,	
laesensh,	লেসেনস,	লাইসেন্স,	
anisa,	অনিসা,	আনিস,	
udor,	উড়ের,	উদর,	
sollallhu,	সোল্লালুহু,	সল্লাল্লাহু,	
hijrite,	হিজরিতে,	হিজরীতে,	
nirbahey,	নির্বাহে,	নির্বাহে,	
shektor,	শেক্তর,	সেক্টর,	
breakthrough,	বৃরিসথোরাং,	ব্রেকথ্রু,	
hupile,	হুপিলে,	হুপিলে,	
iqbalke,	ইকবালকে,	ইকবালকে,	
atmobonchito,	আত্মজন্ধিত,	আত্মবঞ্চিত,	
sbaajan,	সাতান,	স্বজন,	
maudelgulo,	মাউডেলগুলো,	মডেলগুলো,	
aqram,	আকরাম,	আকরাম,	
byabaharkarike,	ব্যবহারকারীকে,	ব্যবহারকারীকে,	
poriharsoho,	পরিবারসহ,	পরিহারসহ,	
urey,	উরে,	ইউরি,	
karmasampadon,	কর্মপম্পদণ,	কর্মসম্পাদন,	
liedtke,	লিডটিকে,	লইডটক,	
ashok,	আশক,	আশোক,	
rastagulikeo,	রাস্তাগুলিকেও,	রাস্তাগুলিকেও,	
achintyabhedaved,	অচিত্নাোভাব্যবেদ,	অচিন্ত্যভেদাভেদ,	
chalachchitro,	চাচাচ্ছিত্র,	চলচ্চিত্র,	
chadake,	চড়াকে,	চড়াকে,	
kkomandar,	ক্কানান্দার,	কমাণ্ডার,	
evereste,	ইভারেস্টে,	এভারেস্টে,	
ishton,	ইশতোন,	স্টোন,	
jaubankal,	যৌবনকাল,	যৌবনকাল,	
khoor,	খো়র,	ক্ষুর,	
shikshakrom,	শিক্ষাক্রম,	শিক্ষাক্রম,	
dinara,	দিনারা,	ডিনার,	
patrol,	পাতরোল,	পেট্রোল,	
graambaaseer,	গ্রামবাসের,	গ্রামবাসীর,	
bishhnu,	বিষ্ণু,	বিষ্ণু,	
ovinetar,	অভিযেতার,	অভিনেতার,	
phiqsa,	ফিক্সা,	ফিক্স,	
goshthiti,	গোষ্ঠিতি,	গোষ্ঠীটি,	
atwobishvashi,	অত্যািবাবীশ,	আত্মবিশ্বাসী,	
shakara,	শাকারা,	সাকার,	
michir,	মিছির,	মিচির,	
chhootochhuti,	ছোচাছুটি,	ছুটোছুটি,	
stana,	স্তানা,	স্টোন,	
pisach,	পিসাচ,	পিশাচ,	
shhashtra,	শাষ্ট্র,	শাস্ত্র,	
bhromonkaale,	ভ্রমণকালে,	ভ্রমণকালে,	
swarther,	স্বার্থের,	স্বার্থের,	
nationalser,	নাতিলেলসের,	ন্যাশনালসের,	
torikher,	তরিীখের,	তরিখের,	
baaiq,	বাইক,	বাইক,	
sealvi,	সিলভি,	সিলভি,	
purohitder,	পুরোহিতদের,	পুরোহিতদের,	
graambaaseeder,	গ্রামবাসদের,	গ্রামবাসীদের,	
engreziteo,	এনারিমিতেও,	ইংরেজিতেও,	
tottorat,	তত্ত্ত,	তওরাত,	
khilaphat,	খিলাপাট,	খিলাফত,	
prakare,	প্রকরে,	প্রকারে,	
pranidero,	প্রাণীদেরও,	প্রানীদেরও,	
jeebonnogor,	জীবনগণনর,	জীবননগর,	
pariyech,	পারিয়েছ,	পরিয়েছ,	
enamela,	এনামেলা,	এনামেল,	
umb,	উম্ব,	ইউএমবি,	
oncholshomuher,	অং্চমসমূহের,	অঞ্চলসমূহের,	
nutoner,	নুতনের,	নূতনের,	
alraji,	আলজাজি,	আলরাজী,	
lyandim,	ল্যান্ডিং,	ল্যান্ডিং,	
khoakshir,	খোয়াখ্ষুর,	খোয়াক্ষীর,	
abdi,	আবদি,	অব্দি,	
hosney,	হোস্ে,	হোসনে,	
torkarir,	তর্কারির,	তরকারীর,	
sthapanar,	স্থাপনার,	স্থাপনার,	
abodamaner,	অবদানামের,	অবদমনের,	
ray,	রেয়,	রায়,	
jocqey,	জোককে,	জকি,	
ghumachhe,	ঘুমাচ্ছে,	ঘুমাচ্ছে,	
madrasi,	মাদ্রাসি,	মাদ্রাজি,	
surakarder,	সুরকর্দের,	সুরকারদের,	
firozaa,	ফিরোজা,	ফিরোজা,	
injiniyarim,	ইনকিিিজারিম,	ইঞ্জিনিয়ারিং,	
shalook,	শালোক,	শালুক,	
transhapharma,	ত্রাণশপ্রমা,	ট্রান্সফর্ম,	
krus,	ক্রাস,	ক্রুশ,	
epiela,	এপিওয়ালা,	আইপিএল,	
sadbi,	সাদবি,	সাধ্বী,	
addabaj,	আদ্ডাবাজ,	আড্ডাবাজ,	
shanno,	শান্ন,	সান্নো,	
grushko,	গ্রুশকো,	গ্রুশকো,	
grotha,	গ্রোথা,	গ্রোথ,	
madhukori,	মাধুকরি,	মাধুকরী,	
kash,	কাশ,	কাস,	
zubokder,	যুবকদের,	যুবকদের,	
dep,	ডিপ,	ডেপ,	
bapokotor,	বাপোততর,	ব্যাপকতর,	
mekon,	মেকন,	মেকং,	
atwabishvashi,	অত্যািবাবীশ,	আত্মবিশ্বাসী,	
louhojato,	লৌহজতত,	লৌহজাত,	
behrampurer,	বেহরামপুরের,	বহরমপুরের,	
rajtantrey,	রাজনন্ত্রে,	রাজতন্ত্রে,	
crashlands,	ক্র্যাশন্যান্ডস,	ক্র্যাশল্যান্ডস,	
grootha,	গ্রোফা,	গ্রোথ,	
prapokkey,	প্রাপককে,	প্রাপককে,	
bouddha,	বৌদ্ধ,	বৌদ্ধ,	
rajdhani,	রাজধানি,	রাজধানি,	
tecno,	টেকনো,	টেকনো,	
ghoshito,	ঘোষিত,	ঘোষিত,	
popke,	পোপকে,	পোপকে,	
karim,	কারিম,	করিম,	
chhedon,	ছেদন,	ছেদন,	
bahubar,	বাহুবার,	বহুবার,	
ministara,	মিনিস্তরা,	মিনিস্টার,	
marketing,	মার্কেটিং,	মার্কেটিং,	
nanilalke,	নানীলালকে,	ননীলালকে,	
larson,	লার্সন,	লারসন,	
talgach,	তালগাছ,	তালগাছ,	
oboshore,	অবশরে,	অবসরে,	
koyekbare,	কয়েকপারে,	কয়েকবারে,	
bamon,	বামোন,	বামন,	
olympic,	অলিপ্লিক,	অলিম্পিক,	
postay,	পোস্টায়,	পোস্টে,	
directorate,	ডিরেক্টরেট,	ডিরেক্টরেট,	
dharmadasbabu,	ধর্মদাসবাবু,	ধর্মদাসবাবু,	
aamor,	আমোর,	আমর,	
devolapar,	দেবলাপার,	ডেভলপার,	
dharavahikbhabe,	ধারাবাহিকভাবে,	ধারাবাহিকভাবে,	
granada,	গ্রানাডা,	গ্র্যানাডা,	
bishshasho,	বিষ্কাষও,	বিশ্বাসও,	
rajotwo,	রাজোত্ব,	রাজত্ব,	
kram,	কারজ,	ক্রম,	
wishnu,	উইসনু,	বিষ্ণু,	
uponeesoder,	উপনেষদের,	উপনিষদের,	
salmanul,	সালমানুল,	সালমানুল,	
protectionism,	প্রোটকিসিসটিজম,	প্রোটেকশনিজম,	
vugoley,	ভুগলে,	ভূগোলে,	
matorom,	মাতরম,	মাতরম,	
ghomta,	ঘোমটা,	ঘোমটা,	
chiroharit,	চিরচরিত,	চিরহরিৎ,	
dhamshrenite,	ধামশেরেন্তে,	ধামশ্রেণীতে,	
lajik,	লাজিক,	লজিক,	
jathartho,	যথার্থ,	যথার্থ,	
harasta,	হারাস্তা,	হারাস্তা,	
uponishad,	উপনিষদ,	উপনিষদ,	
sikha,	সিখা,	শিখ,	
qulim,	কুলিম,	কুলিং,	
seconder,	সেকন্ডের,	সেকেন্ডের,	
peri,	পেরি,	পেরি,	
labonaaktotaar,	লাণণক্বতার,	লবণাক্ততার,	
manir,	মানির,	মনির,	
magrey,	ম্যাগ্রি,	ম্যাগ্রে,	
chal,	চাল,	চাল,	
fastara,	ফাস্টার,	ফস্টার,	
chokrantosoho,	চক্সাগরসসহ,	চক্রান্তসহ,	
toroonra,	তোরার্া,	তরুণরা,	
shomser,	শমসের,	সমশের,	
chalchhe,	চালছে,	চলছে,	
byabaharkaree,	ব্যবহারকারী,	ব্যবহারকারী,	
sikkharrtheerao,	শিক্ষার্থীরাও,	শিক্ষার্থীরাও,	
omanisa,	ওমানিসা,	অমানিশা,	
everestey,	ইভারেস্টি,	এভারেস্টে,	
kaathhaamaandu,	কথামানু্দ,	কাঠমান্ডু,	
suiti,	সুইটি,	সুইটি,	
oikhan,	ঐইখান,	ঐখান,	
vugorvey,	ভুগভ্রে,	ভূগর্ভে,	
sadeena,	সাদেনা,	সাডেন,	
safiin,	সাফিন,	সাফিন,	
cs,	সিএসএফ,	সিএস,	
anandamahale,	আনন্দমহলে,	আনন্দমহলে,	
eura,	ইউরা,	ইউরো,	
aviyojan,	অভিযোজন,	অভিযোজন,	
karir,	কারির,	কারীর,	
anyorup,	অন্যরূপ,	অন্যরূপ,	
ansareer,	আনসারের,	আনসারীর,	
monjurul,	মনজুরুল,	মনজুরুল,	
poripaker,	পরিপাকের,	পরিপাকের,	
ponero,	পনেরও,	পনের,	
headquartus,	হেডশাস্ট্রাস,	হেডকোয়ার্টাস,	
sommoteer,	সম্মতের,	সম্মতির,	
jins,	জিনস,	জিন্স,	
noiteekotar,	নৈতিকতার,	নৈতিকতার,	
debete,	দেবীতে,	ডিবেট,	
elakatike,	এলাটাটিকে,	এলাকাটিকে,	
biplabee,	বিপ্লবে,	বিপ্লবী,	
osthishondhi,	অস্থিস্ধি,	অস্থিসন্ধি,	
renoo,	রেনো,	রেনো,	
deh,	দেহ,	দেহ্,	
showtey,	শূপতে,	শোতে,	
chalochchitreer,	চাচ্চচ্ত্রের,	চলচ্চিত্রের,	
booksar,	বুকার,	বুক্সার,	
asociatis,	অ্যাসাসিটিসিস,	এসোসিয়েটস,	
ohalyar,	ওহল্যার,	অহল্যার,	
donat,	দোনাত,	ডোনাট,	
spredashiita,	স্প্রেডশিিট,	স্প্রেডশীট,	
harbur,	হারবুর,	হারবার,	
thakeni,	থাকেনি,	থাকেনি,	
sangaskritipreme,	সংস্কৃতিকেরমে,	সংস্কৃতিপ্রেমে,	
minister,	মিনিস্টের,	মিনিস্টার,	
booroon,	বুউরন,	বোরন,	
muhurtati,	মুহুর্কতি,	মুহুর্তটি,	
sukumaree,	সুকুমারে,	সুকুমারী,	
cholochchitrai,	চলচ্চিত্র,	চলচ্চিত্রই,	
shrichaitanyadev,	শ্রীচৈতন্ত্বব,	শ্রীচৈতন্যদেব,	
sahooseekotar,	সহকেয়তার,	সাহসিকতার,	
tigmanshu,	তিগমানুষ,	তিগ্মাংশু,	
flirt,	ফ্লির্ট,	ফ্লার্ট,	
bidhirnityang,	বিধিরিন্ত্ত্,	বিধির্নিত্যং,	
joubanbatee,	যৌবনবতে,	যৌবনবতী,	
ovidhaner,	অভিধানের,	অভিধানের,	
chandrimaa,	চাঁদ্রমাণি,	চন্দ্রিমা,	
cheento,	চেন্টো,	চিনতো,	
keu,	কোউ,	কেউ,	
anchalgulir,	অঞ্চলগুলির,	অঞ্চলগুলির,	
shansthaner,	শানস্থানের,	সংস্থানের,	
kanader,	কানাদের,	কণাদের,	
blacker,	ব্ল্যাকার,	ব্ল্যাকের,	
musolmanera,	মুসলমানেরা,	মুসলমানেরা,	
punosthaner,	পুনস্থানের,	পুনঃস্থানের,	
saamaanya,	সামান্য,	সামান্য,	
khelaphate,	খেলাধাটে,	খেলাফতে,	
rejidens,	রেজিসেন্স,	রেসিডেন্স,	
unchuporjayer,	উনচুবর্ণাকের,	উঁচুপর্যায়ের,	
sushposhtolikhito,	সুষ্ট্ৈলচচিত,	সুষ্পষ্টলিখিত,	
semai,	সেমাই,	সেমাই,	
bapio,	বাপিও,	বাপিও,	
iub,	আইবি,	আইইউবি,	
brake,	ব্রাকে,	ব্রেক,	
byaktikegreptar,	ব্যক্তিপ্রেমত্্ত্ব,	ব্যক্তিকেগ্রেপ্তার,	
overholing,	ওভারহিলিং,	ওভারহোলিং,	
glanio,	গ্লানিও,	গ্লানিও,	
bbosonto,	ব্যজস্ত,	বসন্ত,	
narishwar,	নারীশ্বর,	নারীশ্বরের,	
beshyasdone,	বেশ্যাস্ডনে,	বেশ্যাসদনে,	
pet,	পেট,	পেত,	
machhti,	মাছটি,	মাছটি,	
kalirkhal,	কালিরখাল,	কালিরখাল,	
srk,	এ্সিআর,	শাহরুখ,	
kanthar,	কান্থার,	কাঁথার,	
bhejaano,	ভেজানো,	ভেজানো,	
uthe,	উঠে,	উঠে,	
chargar,	চারগার,	চার্জার,	
dii,	দিয়ে,	দিই,	
iuro,	আইওরো,	ইউরো,	
jwar,	জ্বের,	জ্বর,	
elakaatite,	এলাকাটিতে,	এলাকাটিকে,	
daaoon,	দাওন,	ডাউন,	
ongshogrohoner,	অংশগ্রহণের,	অংশগ্রহনের,	
rashider,	রািদের,	রশিদের,	
dheke,	ধেকে,	ঢেকে,	
mukhomandoler,	মুখোমন্ডলের,	মুখমণ্ডলের,	
kinenni,	কিনেননি,	কিনেননি,	
proshtutkarok,	প্রশ্থুতকারক,	প্রস্তুতকারক,	
ujobekeestan,	উজেজেস্ক্তন,	উজবেকিস্তান,	
aakabar,	আকাবার,	আকাবার,	
collaborators,	কলাব্টেটরস্স,	কলাবরেটরস,	
bossonte,	বসন্তে,	বসন্তে,	
ekroop,	একর্ব,	একরূপ,	
parka,	পারকা,	পার্ক,	
poorohitra,	পুরোহিত্র,	পুরোহিতরা,	
bohoodin,	বহনীন,	বহুদিন,	
teennis,	টেনিস,	টেনিস,	
fatakesto,	ফতোস্টি,	ফাটাকেষ্ট,	
procharona,	প্রচারণা,	প্রচারণা,	
kani,	কানি,	কানি,	
balithubar,	বালিুাবার,	বালিথুবার,	
nartana,	নর্তনা,	নর্টন,	
durtomo,	দুর্তোমো,	দূরতম,	
bunot,	বুনোত,	বুনট,	
boudher,	বৌধের,	বৌদ্ধের,	
bhotomulyoke,	ভোটমূল্যকে,	ভোটমূল্যকে,	
amontronkarider,	অমন্ত্রণকারীদের,	আমন্ত্রণকারীদের,	
graambashee,	গ্রামবাশে,	গ্রামবাসী,	
durgotsab,	দুর্গোৎসব,	দুর্গোৎসব,	
mekong,	মেকং,	মেকং,	
inphormeshon,	ইন্সমোরেশন,	ইনফরমেশন,	
hozot,	হজম,	হজত,	
dabliudabliui,	দাবিলাবালগদদির,	ডাব্লিউডাব্লিউই,	
samle,	স্যামলে,	সামলে,	
ganochin,	গণচিন,	গণচীন,	
nazranar,	নজরানার,	নাজরানার,	
pratijogider,	প্রতিযোগীদের,	প্রতিযোগীদের,	
taims,	টাইমস,	টাইমস্,	
anchalsaho,	অঞ্চলসহ,	অঞ্চলসহ,	
khaaneker,	খানেকের,	খানেকের,	
sotorkobhabey,	সতরকাভাবে,	সতর্কভাবে,	
pohnpeic,	পোজপেলিক,	ফোনপেইক,	
kanasarabheeshana,	কনকাভরেশন,	কনসারভেশন,	
konflict,	কনফ্লিক্ট,	কনফ্লিক্ট,	
durgatsob,	দুর্গাত্ব,	দুর্গোৎসব,	
abheedhaaneeck,	অভিচানকে,	অভিধানিক,	
prity,	প্রিতি,	প্রিটি,	
prabhritite,	প্রভৃতিতে,	প্রভৃতিতে,	
dhos,	ধোস,	ধস,	
bulichev,	বুলিভেভ,	বুলিচেভ,	
soundorjotakei,	সৌন্দর্যতাকে,	সৌন্দর্যটাকেই,	
dhila,	ধীলা,	ঢিলা,	
qyantana,	ক্যান্টানা,	ক্যান্টন,	
basermick,	বাসেমরিক,	বেসারমিক,	
sonaicha,	সোনাইচা,	সোনাইচা,	
zerusalem,	জেরুফালেম,	জেরুসালেম,	
ap,	এপি,	আপ,	
echhti,	এছটি,	এছটি,	
bbosben,	বিজবেসন,	বসবেন,	
ekbakye,	একবাকে,	একবাক্যে,	
vushi,	ভুষি,	ভুষি,	
jomoker,	জমকের,	জমকের,	
naazee,	নাজে,	নাত্সি,	
cloring,	ক্লোরিং,	ক্লোরিং,	
chhadite,	ছাড়িতে,	ছড়িতে,	
besirvagei,	বেসিরবাজেই,	বেশিরভাগেই,	
phutanta,	ফুটান্ত,	ফুটন্ত,	
habshi,	হাবশি,	হাবশী,	
rohinibabu,	রোহিনবাবু,	রোহিনীবাবু,	
nirbachakder,	নির্বাচকদের,	নির্বাচকদের,	
mugdha,	মুগ্ধ,	মুগ্ধ,	
protijogiitamulok,	প্রতিযোগিতামূলক,	প্রতিযোগীতামূলক,	
shilpajata,	শিল্পতজা,	শিল্পজাত,	
ponjikar,	পঞ্জিকার,	পঞ্জিকার,	
chaudhurider,	চৌধুরীদের,	চৌধুরীদের,	
bhenise,	ভেনিসে,	ভেনিসে,	
chaudhurio,	চৌডুরিও,	চৌধুরীও,	
monchostho,	মঞ্চতস্,	মঞ্চস্থ,	
jolbe,	জলবে,	জ্বলবে,	
jalarong,	জালালারন,	জলরঙ,	
byathapather,	ব্যথাপথের,	ব্যথাপথের,	
kruser,	ক্রুসের,	ক্রুশের,	
lahano,	লাহানো,	লাহানো,	
juboksoho,	যুবকসহ,	যুবকসহ,	
halding,	হালদিং,	হোল্ডিং,	
juktorastrer,	যুক্তসর্ত্রের,	যুক্তরাষ্ট্রের,	
hondooras,	হন্ডোরাস,	হন্ডুরাস,	
choddo,	চৈদ্দো,	চোদ্দো,	
sqalarashipa,	স্কলাররূপা,	স্কলারশিপ,	
tiger,	টিগের,	টাইগার,	
uter,	উটের,	উটের,	
kaley,	কালে,	কালে,	
muktilav,	মুক্তিলাব,	মুক্তিলাভ,	
nopdnodir,	নপ্দনদির,	নদনদীর,	
mele,	মেলে,	মাইল,	
rijoor,	রিজোর,	রিজুর,	
shorifer,	শরিফের,	শরিফের,	
tongaa,	টঙ্গা,	টোঙ্গা,	
biplobi,	বিপ্লবি,	বিপ্লবী,	
bharotchilo,	ভারতখিল,	ভারতছিল,	
biswashi,	বিশ্বষী,	বিশ্বাসী,	
snehban,	স্নেহবান,	স্নেহবান,	
munim,	মুনিম,	মুনিম,	
raunanganey,	রণনঙ্গনে,	রণাঙ্গনে,	
iraner,	ইরানের,	ইরানের,	
chilona,	চিলোনা,	ছিলনা,	
somraatra,	সোমরাত্র,	সম্রাটরা,	
rachonakal,	রচনাকাল,	রচনাকাল,	
panchadadu,	পঞ্চদাদু,	পঞ্চাদাদু,	
spashtotai,	স্পষ্টটাই,	স্পষ্টতই,	
alimpiqa,	আলিমকিরা,	অলিম্পিক,	
dharavassokar,	ধারাবস্যার,	ধারাভাষ্যকার,	
hood,	হাদ,	হুড,	
boiragirhat,	বৈরাগীরহাট,	বৈরাগিরহাট,	
armashtram,	আর্মশ্ট্রম,	আর্মস্ট্রং,	
nothibhukta,	নথিভুক্ত,	নথিভুক্ত,	
mutar,	মুতার,	মুতার,	
tarkareer,	তা্কারের,	তরকারীর,	
sudrishya,	সুদ্রিষ্য,	সুদৃশ্য,	
chalochchitreei,	চাচ্চচিত্রেই,	চলচ্চিত্রেই,	
brekthrough,	বৃরিস্টার্গ,	ব্রেকথ্রু,	
cena,	সেনা,	সিনা,	
khonjena,	খোঁজেনা,	খোঁজেনা,	
projanankal,	প্রজানা্কাল,	প্রজননকাল,	
tookror,	তুকরয়োর,	টুকরোর,	
udbhaboni,	উদ্ভাবনী,	উদ্ভাবনী,	
abhidhanick,	অভিধানকক,	অভিধানিক,	
whole,	হোলে,	হোল,	
sookkho,	সুক্ষ,	সুক্ষ্ম,	
mooney,	মুনয়ে,	মুনে,	
tyap,	টাপি,	ট্যাপ,	
akmato,	আকমাত,	একমত,	
seguloi,	সেগুলোই,	সেগুলোই,	
kantojir,	কান্তজীর,	কান্তজির,	
myat,	ম্যাট,	ম্যাট,	
edipass,	এডিপাস,	ইডিপাস,	
utsahi,	উৎসাহী,	উৎসাহী,	
ekoirokom,	একজেপইপ,	একইরকম,	
concerter,	কনসারটটার,	কানসাটের,	
chereche,	চেরেছে,	ছেড়েছে,	
karu,	কারু,	কারু,	
nirikhe,	নিরিখে,	নিরিখ,	
kalakushalir,	কালকৌশলীর,	কলাকুশলীর,	
karuna,	করুনা,	করুণা,	
elaakaa,	এলাকা,	এলাকা,	
obosorer,	অবসরের,	অবসরের,	
sallallahu,	সাল্লালুলাহু,	সল্লাল্লাহু,	
taffsherer,	তফসেরের,	তাফসীরের,	
khudrokar,	ক্ষুদ্রকার,	ক্ষুদ্রকার,	
shrabosty,	শ্রবস্ত,	শ্রাবস্তী,	
shift,	শিফট,	শিফট,	
baffer,	বাফার,	বাফার,	
attacharito,	অত্থচরিত,	অত্যাচারিত,	
salafeta,	সালাফেতা,	সালফেট,	
ummool,	উম্মল,	উম্মুল,	
ishter,	ইশতের,	ইস্টের,	
venice,	ভেনিসে,	ভেনিস,	
aaps,	এপিএসএস,	এএপিএস,	
dipankar,	দিপানকর,	দিপঙ্কর,	
nirgoon,	নিরগোন,	নির্গুণ,	
blacq,	ব্ল্যাক,	ব্ল্যাক,	
detik,	দেটিক,	দেতিক,	
sures,	সুরেস,	সুরেশ,	
abhiyojan,	অভিযোজন,	অভিযোজন,	
rajtantra,	রাজনন্ত্র,	রাজতন্ত্র,	
neutrinoo,	নিউট্রিনো,	নিউট্রিনো,	
chakundite,	চাকুন্ডিতে,	চাকুন্দিতে,	
bihar,	বিহার,	বিহার,	
satjaner,	সাতজনের,	সাতজনের,	
parkasa,	পারকাসা,	পার্কস,	
ujbekistaner,	উজবেকিস্তানের,	উজবেকিস্তানের,	
refleks,	রিফ্লেস,	রিফ্লেক্স,	
kajangale,	কাজকঙ্গলে,	কজঙ্গলে,	
ghaghat,	ঘাঘাট,	ঘাঘট,	
dapadpi,	দপপপ্ি,	দাপাদপি,	
purushika,	পুরুষিকা,	পুরুষিকা,	
shamshere,	শমশেরে,	শমসের,	
zakharovar,	যখাবারা,	জাখারোভার,	
ernad,	এর্নাদ,	এরনাড,	
gronthowo,	গ্রন্থওয়,	গ্রন্থও,	
nathivukta,	নথিবিদ্ত,	নথিভুক্ত,	
bhaangchur,	ভাংশুর,	ভাংচুর,	
uporzon,	উপর্য,	উপার্জন,	
manush,	মানুষ,	মানুষ,	
noditei,	নদীতেই,	নদীতেই,	
shikkharrthirao,	শিক্ষার্থীরাও,	শিক্ষার্থীরাও,	
daqten,	ডাকতেন,	ডাকতেন,	
jaunotar,	যৌনতার,	যৌনতার,	
sima,	সিমা,	সীমা,	
kobulennechha,	কবুলনন্নেছা,	কবুলেন্নেছা,	
promothesh,	প্রমতেশ,	প্রমথেশ,	
aaireshe,	আইরেশে,	আইরেসে,	
phareeksa,	ফােেস্,	ফরেক্স,	
magar,	মাগার,	মাগার,	
foxcon,	ফক্সজন,	ফক্সকন,	
deefinishion,	ডিফিশিশন,	ডেফিনেশন,	
edic,	এডিক,	এডিক,	
ekshoti,	একশোটি,	একশোটি,	
marpit,	মারপিট,	মারপিট,	
orbi,	অরবি,	ওরবি,	
attorkite,	অত্তকৃতে,	অতর্কিতে,	
protistha,	প্রতিষ্ঠা,	প্রতিষ্টা,	
sarbhare,	সরভারে,	সার্ভারে,	
dobhaar,	দোভার,	ডোভার,	
cuti,	কুতি,	কিউটি,	
jor,	জরর,	জ্বর,	
relance,	রিলেন্স,	রিলায়েন্স,	
rayyalati,	রেইয়ালটি,	রয়্যালটি,	
asantosh,	অসন্তসহ,	অসন্তোষ,	
bsnleu,	বিএসএএএএএসএস,	বিএসএনএলইইউ,	
brahmanera,	ব্রহ্মেণেরা,	ব্রাহ্মণেরা,	
bonobhumi,	বনহুমী,	বনভূমি,	
kuttake,	কুট্টাকে,	কুত্তাকে,	
dharmiyabhabei,	ধর্মীবিভাবেই,	ধর্মীয়ভাবেই,	
sahittopritite,	সাহিত্যদ্রতিতে,	সাহিত্যপ্রীতিতে,	
dhalur,	ধলুর,	ঢালুর,	
horipur,	হরিপুর,	হরিপুর,	
chandanara,	চন্দনরা,	চন্দনারা,	
kinto,	কিন্ত,	কিনত,	
ekla,	একলা,	একলা,	
murad,	মুরাদ,	মুরাদ,	
tecnokret,	টেকনোক্রি,	টেকনোক্র্যাট,	
nodiitei,	নদীটেই,	নদীতেই,	
tooku,	টুকু,	টুকু,	
azaan,	আজান,	আজান,	
cheenja,	চেয়ান,	চেঞ্জ,	
gandhiir,	গান্ধির,	গান্ধীর,	
byaboharkareer,	ব্যবহারকারের,	ব্যবহারকারীর,	
shashtra,	শাস্ত্র,	শাস্ত্র,	
shpredshiit,	স্পিথিরিস্ট,	স্প্রেডশীট,	
karima,	কারিমা,	করিম,	
sedikei,	সেদিকেই,	সেদিকেই,	
monroe,	মন্োর,	মনেরোর,	
diniphition,	ডিনিথিটেশন,	ডেফিনেশন,	
maladabha,	মালাাাহা,	মলদোভা,	
aansaareer,	আনসারের,	আনসারীর,	
bisheshshyo,	বিশেষ্য,	বিশেষ্য,	
dembakreeti,	দেম্ব্ক্তি,	ডিম্বাকৃতি,	
sector,	সেক্টর,	সেক্টর,	
nirvachaker,	নির্বাচকের,	নির্বাচকের,	
jeten,	জেতেন,	জেতেন,	
bboponer,	বায়োপনের,	বপনের,	
zommu,	জোমমু,	জম্মু,	
mandape,	মান্দাপে,	মন্ডপে,	
indra,	ইন্দ্রা,	ইন্দ্র,	
ispredsheet,	ইস্টারফ্রিট,	স্প্রেডশীট,	
juboke,	যুবকে,	যুবকে,	
ala,	আলা,	আলা,	
zarniz,	জার্নিজ,	জারনিজ,	
antarctica,	অন্ত্রাক্তাও,	অ্যান্টার্কটিকার,	
siddhantei,	সিদ্ধান্তেই,	সিদ্ধান্তেই,	
phutbolarder,	ফুটবলাদের,	ফুটবলারদের,	
osomorthito,	অসমর্থিত,	অসমর্থিত,	
laishensha,	লাইসেনশা,	লাইসেন্স,	
meghacchonno,	মেঘাচ্ছন্ন,	মেঘাচ্ছন্ন,	
shlok,	শ্লক,	শ্লোক,	
bulan,	বুলান,	বুলান,	
ganakantha,	গণকান্থ,	গণকণ্ঠ,	
blogarra,	ব্লোগাররা,	ব্লগাররা,	
chuti,	চুটি,	ছুটি,	
karmazog,	কারমযোগ,	কর্মযোগ,	
mozlis,	মজলিস,	মজলিশ,	
vaticaner,	ভাতিকানের,	ভ্যাটিকানের,	
disni,	ডিস্নি,	ডিজনী,	
shkalarashhipa,	স্কলারুভাব,	স্কলারশিপ,	
modhumotii,	মধুমতিও,	মধুমতী,	
mukhomandal,	মুখমন্ডল,	মুখমণ্ডল,	
michhilti,	মিছিলটি,	মিছিলটি,	
societykey,	সকিইটটিকে,	সোসাইটিকে,	
shucharita,	শুচরিত,	সুচরিতা,	
jonoshongjog,	জনশঙ্গম,	জনসংযোগ,	
vorkendra,	ভর্ক্নেডা,	ভরকেন্দ্র,	
shaahaabiike,	শাহাবাবীকে,	সাহাবীকে,	
oxfordey,	অক্সোডার্ডে,	অক্সফোর্ডে,	
aditisaha,	আদিতাসিহা,	অদিতিসহ,	
gandhariir,	গান্ধারীর,	গান্ধারীর,	
kadam,	কাদম,	কদম,	
gostigulo,	গোস্টগুলো,	গোষ্ঠীগুলো,	
deenes,	দীনেস,	দীনেশ,	
asabhya,	অসহ্য,	অসভ্য,	
chalochchitrogulor,	চলচ্চিত্রগুলোর,	চলচ্চিত্রগুলোর,	
bhimsen,	ভীমসেন,	ভীমসেন,	
brittakarey,	বৃত্তকারী,	বৃত্তাকারে,	
satarkokari,	সতর্ককারী,	সতর্ককারী,	
rajshri,	রাজশিরী,	রাজশ্রী,	
noitikota,	নৈতিকতা,	নৈতিকতা,	
queri,	কুয়ারি,	কোয়েরি,	
eucalyptus,	ইউকমপ্রিটাস,	ইউক্যালিপ্টাস,	
drishyogulote,	দৃশ্যগুলোতে,	দৃশ্যগুলোতে,	
rockibul,	রককিবুল,	রকিবুল,	
sayatana,	সায়তন,	শয়তান,	
uqeliptas,	ইউকেলোপ্সিট,	ইউক্যালিপ্টাস,	
nimnosakkharkari,	নিম্নসরকক্ষকারী,	নিম্নস্বাক্ষরকারী,	
malinga,	মালিঙ্গা,	মালিংগা,	
contemporary,	কনটেমপারেরো,	কন্টেম্পোরারি,	
suri,	সুরী,	সুরি,	
dhani,	ধনি,	ধানি,	
difinision,	ডিফিশন,	ডেফিনেশন,	
veenis,	ভিনিস,	ভেনিস,	
dharabahikotitey,	ধারাবাহিকতিতে,	ধারাবাহিকটিতে,	
shommotir,	শম্মতীর,	সম্মতির,	
windo,	উইন্ডো,	উইন্ডো,	
indro,	ইন্দ্রো,	ইন্দ্র,	
salmaner,	সালমানের,	সালমানের,	
steena,	স্টিনা,	স্টেন,	
tistar,	তিস্তার,	তিস্তার,	
patishapta,	পািশদপত,	পাটিসাপটা,	
grambaasi,	গ্রামবাসী,	গ্রামবাসী,	
shringgo,	শ্রিংগো,	শৃঙ্গ,	
breel,	বিআরএল,	ব্রিল,	
sweety,	স্টিট,	সুইটি,	
qonfliqt,	কনফ্লিট,	কনফ্লিক্ট,	
chakrapani,	চক্রপানি,	চক্রপানী,	
daakticketer,	ডাকতিকেত্তের,	ডাকটিকিটের,	
rahi,	রাহি,	রাহী,	
prrajanankaal,	প্রাোণকল্যাল,	প্রজননকাল,	
tikta,	তিকটা,	তিক্ত,	
bhangchur,	ভাংচুর,	ভাংচুর,	
oblivion,	অব্লিভিন,	অবলিভিয়ন,	
sahocorje,	সহকর্মে,	সাহচর্যে,	
soheensotar,	সোহেন্ততার,	সহিংসতার,	
hunine,	হুনিন,	হুনাইন,	
khudhartara,	ক্ষুধার্তারা,	ক্ষুধার্তরা,	
mesenjjar,	মেসেনজাজার,	মেসেঞ্জার,	
rakkhanvag,	রক্ষণযোগ,	রক্ষণভাগ,	
shchalastic,	স্কোলাস্টিক,	স্কলাস্টিক,	
chalachchitrer,	চাচাচ্চিত্রের,	চলচ্চিত্রের,	
temanti,	তেমন্তি,	তেমনটি,	
bangalore,	বাঙ্গালরে,	ব্যাঙ্গালুরে,	
vabuk,	ভবুক,	ভাবুক,	
batikromshalee,	বাতিক্ষারকমলে,	ব্যতিক্রমধর্মী,	
rayyaleti,	রেইয়ালটি,	রয়্যালটি,	
mukhmondole,	মুখমন্ডলে,	মুখমণ্ডলে,	
plaiin,	প্লেইিন,	প্লেন,	
feemalee,	ফেমালে,	ফিমেল,	
jonesh,	জনেস,	জোন্স,	
chaalaabi,	চালাবি,	চালাবে,	
sangsakti,	সংস্কটি,	সংসক্তি,	
ispreedshiit,	ইস্টারশ্রিস্ট,	স্প্রেডশীট,	
kuronir,	কুরোনির,	কুরনীর,	
ghuznavi,	ঘুজনাভি,	গজনভি,	
byke,	ব্যাকে,	বাইক,	
ganochien,	গণচিছেন,	গণচীন,	
augustine,	অগাস্তিনে,	অগাস্টিন,	
agomoney,	আগমনে,	আগমনে,	
pharmesigulote,	ফার্মেসিগুলোতে,	ফার্মেসীগুলোতে,	
hool,	হোল,	হুল,	
oncholsomuho,	অং্চবমূহ,	অঞ্চলসমূহ,	
gej,	গেজ,	গেজ,	
meropenemer,	মেরোপেনেমের,	মেরোপেনেমের,	
reshmirekha,	রেশমিরেখা,	রেশমীরেখা,	
srabosty,	স্নাসক্ট,	শ্রাবস্তী,	
yak,	যাক,	ইয়াক,	
dola,	দোলা,	দলা,	
farhetin,	ফারহেতিন,	ফারহেতিন,	
ched,	চেদ,	ছেদ,	
udyem,	উড্যেম,	উদ্যেম,	
pinglateo,	পিনলাতেও,	পিংলাতেও,	
mail,	মাইল,	মাইল,	
niropekkho,	নিরপক্ষ,	নিরপেক্ষ,	
paikgachha,	পাইক্কাছা,	পাইকগাছা,	
samley,	সমমেলে,	সামলে,	
ganjana,	গঞ্জনা,	গঞ্জনা,	
kheylechen,	খেয়েংছেন,	খেলেছেন,	
bhogni,	ভগগনি,	ভগ্নী,	
obosore,	অবসরে,	অবসরে,	
drishyogulotey,	দৃশ্যগুলোতে,	দৃশ্যগুলোতে,	
rahshahi,	রহমাহী,	রাহশাহী,	
turkeyder,	তুর্কেকের,	তুর্কিদের,	
chalochchitro,	চাচ্চচিত্র,	চলচ্চিত্র,	
transformaarer,	ট্রান্সপোরারের,	ট্রান্সফরমারের,	
jesh,	জেষ,	জেস,	
swairacharibirodhi,	স্বৈরাারিবিরোধী,	স্বৈরাচারীবিরোধী,	
ispredsiit,	ইস্টারপিস্টি,	স্প্রেডশীট,	
myari,	ম্যারি,	ম্যারি,	
dakteekiter,	ডাকদেকটির,	ডাকটিকিটের,	
sikarer,	সিকারের,	শিকারের,	
ghamta,	ঘামটা,	ঘোমটা,	
esprito,	এসপিরিত,	এস্পিরিটো,	
nirarthak,	নিরা্থারি,	নিরর্থক,	
taderek,	তাদেরেক,	তাদেরেক,	
hafej,	হাফেজ,	হাফেয,	
orhan,	ওরহান,	ওরহান,	
capshule,	ক্যাপশুল,	ক্যাপসুল,	
khagen,	খাগেন,	খগেন,	
gemske,	গেমসকে,	জেমসকে,	
ekbai,	একবাই,	একবাই,	
nodimaatrik,	নদীমাত্রিক,	নদীমাতৃক,	
saifullahil,	সাইফুল্লাহিল,	সাইফুল্লাহিল,	
kiuti,	কিউটি,	কিউটি,	
messengerer,	মেসেনেনের,	মেসেঞ্জারের,	
homshke,	হোমসকে,	হোমসকে,	
kurdider,	কুর্দিদের,	কুর্দিদের,	
skirt,	স্কার্ট,	স্কার্ট,	
kalnir,	কালনির,	কালনীর,	
spredsheet,	স্পারশেট,	স্প্রেডশীট,	
ashociatesh,	অসোিকাষ্থ,	এসোসিয়েটস,	
sip,	সিপ,	শিপ,	
obdi,	অব্দি,	অব্দি,	
procharjontrogulo,	প্রচার্র্তমগুলো,	প্রচারযন্ত্রগুলো,	
ingrejra,	ইংরেজরা,	ইংরেজরা,	
parkin,	পারকিন,	পার্কিং,	
holdim,	হোল্ডিং,	হোল্ডিং,	
musalmani,	মুসলমানি,	মুসলমানই,	
bhorkendra,	ভোরকেন্দ্র,	ভরকেন্দ্র,	
aosafur,	আওসাফুরের,	আওশাফুর,	
zoubankal,	যৌবনকাল,	যৌবনকাল,	
amiretus,	অমিরিতাস,	এমিরেটাস,	
bongsho,	বংশো,	বংশ,	
sten,	স্টিন,	স্টেন,	
kiandi,	কিয়েন্ডি,	ক্যান্ডি,	
ajeejer,	আজেজের,	আজিজের,	
mahasava,	মাহাসাব,	মহাসভা,	
bornanukrome,	বর্ণনাসির্মে,	বর্নানুক্রমে,	
middleton,	মিডলটন,	মিডলটন,	
ul,	উলল,	উল,	
mulbhitti,	মুলভিত্তি,	মূলভিত্তি,	
ashonkai,	অশঙ্কাই,	আশঙ্কাই,	
dimbacriti,	দিম্বাকৃত,	ডিম্বাকৃতি,	
alaoler,	অ্যালালের,	আলাওলের,	
ganoporibahon,	গণপরিবহণ,	গণপরিবহন,	
omkar,	ওমকার,	ওঙ্কার,	
moshahidur,	মোশাহিদুর,	মোশাহিদুর,	
champa,	চাম্পা,	চাঁপা,	
cholchhe,	চলচে,	চলছে,	
chokhwala,	চোখকালা,	চোখওয়ালা,	
hights,	হাইটস,	হাইটস,	
gazipur,	গাজিপুর,	গাজিপুর,	
souripurang,	সৌরীপুরাং,	সৌরিপুরং,	
hoteltee,	হোটেলটে,	হোটেলটি,	
rakim,	রাকিম,	রাকিম,	
bibader,	বিবাদের,	বিবাদের,	
elgoridom,	এলকোরিিম,	এলগরিদম,	
chikitshar,	চিকিৎসার,	চিকিত্সার,	
path,	পাথ,	পাথ,	
dharavahiker,	ধারাবাহিকের,	ধারাবাহিকের,	
hossne,	হোস্ে,	হোসনে,	
touraat,	তৌরাত,	তওরাত,	
shilpikuler,	শিল্পীসুলের,	শিল্পীকুলের,	
jounotar,	যৌনতার,	যৌনতার,	
volapuk,	ভোলাপুক,	ভোলাপুক,	
sahinsatar,	সহিনস্তার,	সহিংসতার,	
chotogolper,	চটকোম্যের,	ছোটগল্পের,	
kaande,	কান্ডে,	কাণ্ডে,	
nachar,	নাচর,	নাচার,	
sarboshokteeman,	সার্বশ্বত্যগণ,	সর্বশক্তিমান,	
bandi,	বা্দি,	বন্দী,	
ghoomato,	ঘোমাতো,	ঘুমাতো,	
pronoti,	প্রণীত,	প্রণতি,	
chhayi,	ছাই়ি,	ছাই,	
tinhazar,	তিনহাজার,	তিনহাজার,	
palbongser,	পালবনসের,	পালবংশের,	
alonkaran,	আলঙ্করণ,	অলঙ্করণ,	
pader,	পাদের,	প্যাডের,	
rilayensha,	রিলাইসেনহা,	রিলায়েন্স,	
upobaasee,	উপবাসে,	উপবাসী,	
buddhitii,	বুদ্ধিটিই,	বুদ্ধিটিই,	
autopromotioner,	অটোপ্রোপ্লনের,	অটোপ্রমোশনের,	
bike,	বিকে,	বাইক,	
serup,	সেরুপ,	সেরূপ,	
juakhelar,	জুয়াছেলার,	জুয়াখেলার,	
parqa,	পারকা,	পার্ক,	
khalid,	খালিদ,	খালিদ,	
bondhukey,	বন্ধুককে,	বন্ধুকে,	
yucalyptus,	যুয়াকলেটপাস,	ইউক্যালিপ্টাস,	
sompadonkaree,	সম্পাদননারকে,	সম্পাদনকারী,	
murali,	মুরালি,	মুরলী,	
probeshkari,	প্রবেশকারী,	প্রবেশকারী,	
gandhike,	গান্ধকে,	গান্ধীকে,	
dito,	দিতো,	দিতো,	
rohosyo,	রোহস্য,	রহস্য,	
aakaabaar,	আকাবার,	আকাবার,	
prothati,	প্রথাটি,	প্রথাটি,	
parking,	পার্কিং,	পার্কিং,	
ghotleyo,	ঘটলেও,	ঘটলেও,	
beshirbhaagei,	বেশীরভাগেই,	বেশিরভাগেই,	
kathmandute,	কাঠমানুত্তে,	কাঠমান্ডুতে,	
jalbe,	জলবে,	জ্বলবে,	
byabosthar,	ব্যবস্থার,	ব্যাবস্থার,	
samany,	সামানী,	সামান্য,	
uthhaane,	উঠানে,	উঠানে,	
kutubuddinke,	কুটুবুদ্দিনকে,	কুতুবুদ্দিনকে,	
disposes,	ডিসপোরস,	ডিসপোজেস,	
perry,	পেরি,	পেরি,	
turista,	তুরিস্তা,	টুরিস্ট,	
okritokarjo,	অকৃত্যরোজো,	অকৃতকার্য,	
tasminer,	তাসমিনের,	তাসমিনের,	
dijmarescu,	ডিজ্রামেকাস,	দিজমার্সাকু,	
lutherana,	লুথেরান,	লুথেরান,	
bangulzai,	বাঙগুলিকা,	বঙ্গুলিজাই,	
bollov,	বলমলভ,	বল্লভ,	
taufiq,	তাফিক,	তৌফিক,	
manjushri,	মঞ্জুখির,	মঞ্জুশ্রী,	
faltu,	ফাল্টু,	ফালতু,	
suraaropito,	সুরারপিত,	সুরারোপিত,	
parinati,	পরিণীত,	পরিণতি,	
salchak,	সালখাক,	সালচাক,	
thabai,	থাবাই,	থাবাই,	
artherer,	আর্থেরের,	আর্থারের,	
bikargrosto,	বিকারগ্রস্ত,	বিকারগ্রস্ত,	
janosamaj,	জনসমাজ,	জনসমাজ,	
shten,	স্টেন,	স্টেন,	
oncholgulir,	অংশগুলিলির,	অঞ্চলগুলির,	
bosano,	বসননো,	বসানো,	
choudhurike,	চৌধুরীকে,	চৌধুরীকে,	
elaakate,	এলাটাতে,	এলাকাতে,	
roy,	রোয়,	রায়,	
baaik,	বাইক,	বাইক,	
pothnirdeshona,	পথপিন্দেশনা,	পথনির্দেশনা,	
temonbhabe,	তেমোনভাবে,	তেমনভাবে,	
chaka,	চাকা,	চাকা,	
mahbunur,	মাহবুর,	মাহবুনুর,	
bipajjanak,	বিপাজকাকা,	বিপজ্জনক,	
gaandaas,	গণ্ডাস,	জ্ঞানদাস,	
vedanta,	বেদান্ত,	বেদান্ত,	
schilling,	স্কিলিং,	শিলিং,	
nothibhukto,	নথিভুক্ত,	নথিভুক্ত,	
olpo,	অল্পো,	অল্প,	
pratiyogitar,	প্রতিকলীতার,	প্রতিযোগীতার,	
venkates,	ভেঙ্কটে,	ভেঙ্কটেশ,	
prosadhani,	প্রসাধনী,	প্রসাধনী,	
parther,	পার্থের,	পার্থের,	
churger,	চার্গের,	চার্জের,	
mirina,	মিরিনা,	মিরিনা,	
barrageke,	বারেজকে,	ব্যারেজকে,	
obosan,	অবসান,	অবসান,	
soleel,	সোলে,	সলিল,	
infarmatian,	ইনফরমেশন,	ইনফরমেশন,	
bandhan,	বাঁধান,	বাঁধন,	
suraaropeeto,	সুরারোপেতো,	সুরারোপিত,	
pravura,	প্রবুরা,	প্রভুরা,	
chomski,	চমকি,	চমস্কি,	
byaboharkariyi,	ব্যবহারকারিরী,	ব্যবহারকারীই,	
bondishalatei,	বন্দিষালততেই,	বন্দিশালাতেই,	
sahojlovyotar,	সাহযযোগ্যতার,	সহজলভ্যতার,	
madhuri,	মধুরি,	মাধুরী,	
rakhete,	রাখেতে,	রাখেতে,	
rajnoitik,	রাজনৈতিক,	রাজনৈতীক,	
bikromei,	বিক্রমেই,	বিক্রমেই,	
phormat,	ফরম্মাট,	ফরম্যাট,	
cheess,	চিস,	চেস,	
taitela,	তাইতেলা,	টাইটেল,	
stonehenje,	স্টোনওয়াজে,	স্টোনহেঞ্জ,	
nichupattir,	নিচূপাত্তির,	নিচুপট্টির,	
osamanno,	ওসামান্য,	অসামান্য,	
dosha,	দোশা,	দোসা,	
swadesh,	স্বদেশ,	স্বদেশ,	
fibergulote,	ফাইব্রগুলোতে,	ফাইবারগুলোতে,	
prokalpagulo,	প্রকল্পগুলো,	প্রকল্পগুলো,	
bhabotarini,	ভবতরীণী,	ভবতারিণী,	
nagorikke,	নাগরিককে,	নাগরিককে,	
shhow,	শোয়ার,	শো,	
uponeeshod,	উপনেষদ,	উপনিষদ,	
baait,	বাইত,	বাইট,	
jotsna,	জোৎস্না,	জ্যোৎস্না,	
byaboharkarike,	ব্যবহারকারীকে,	ব্যবহারকারীকে,	
wodka,	ওয়াক,	ভদকা,	
vushito,	ভুষিত,	ভূষিত,	
lettere,	লেট্রে,	লেটারে,	
nirmolotaa,	নির্মলতাও,	নির্মলতা,	
elakasoho,	এলাকাসহ,	এলাকাসহ,	
maudelti,	মডেলটি,	মডেলটি,	
dumaa,	দুমাই,	দুমা,	
jemy,	জেমি,	জেমি,	
damodar,	দামোদার,	দামদর,	
graambasi,	গ্রামবাসি,	গ্রামবাসী,	
gananatyo,	গণনাত্য,	গণনাট্য,	
konroop,	কোঁপো,	কোনরূপ,	
teentir,	টেনটির,	তিনটির,	
chhuteer,	ছুটের,	ছুটির,	
veniser,	ভেনিসের,	ভেনিসের,	
brindabane,	বৃন্দাবানে,	বৃন্দাবনে,	
aashtikotaa,	আশ্বিকতা,	আস্তিকতা,	
obharbhiu,	ওভারভূষী,	ওভারভিউ,	
satarkatar,	সতর্কর,	সতর্কতার,	
uparjoner,	উপার্জনের,	উপার্জনের,	
ganohotyake,	গণহত্যকে,	গণহত্যাকে,	
shhikara,	শিকারা,	শিকার,	
bairer,	বাইরের,	বাইরের,	
iling,	ইলিং,	ইলিং,	
shite,	শীতে,	শীতে,	
sheshdinti,	শেষটিনটি,	শেষদিনটি,	
songrahak,	সংগ্রাক,	সংগ্রাহক,	
darjiling,	দার্জিলিং,	দার্জিলিং,	
bhutbhut,	ভূতভুত,	ভুটভুট,	
bidyadanke,	বিদ্যানানকে,	বিদ্যাদানকে,	
baptics,	ব্যাপটিক্স,	ব্যাপটিকস,	
anchalgoolir,	অ্যাঙ্াালিকোলের,	অঞ্চলগুলির,	
kortam,	করততাম,	করতাম,	
onupater,	অনুপতের,	অনুপাতের,	
bhangle,	ভাংলে,	ভাঙলে,	
highcommissionay,	হাইল্লাসানিনিনিয়া,	হাইকমিশনে,	
oitijjha,	ঐতিহ্যা,	ঐতিহ্য,	
rotheen,	রোথেন,	রথীন,	
poste,	পোস্টে,	পোষ্টে,	
matis,	মাতিস,	ম্যাটিস,	
boudhher,	বৌধের,	বৌদ্ধের,	
feroza,	ফেরোজা,	ফিরোজা,	
kanshat,	কাঁথাত,	কানসাট,	
chaloke,	চালোকে,	চালকে,	
torunosomriddho,	তরুণসমৃদ্ধ,	তরুণসমৃদ্ধ,	
faaj,	ফজজ,	ফাজ,	
manober,	মানবের,	মানবের,	
eesosiyeetasa,	ইইসোটিযিয়াস,	এসোসিয়েটস,	
shekender,	শেখেন্দার,	সেকেন্ডের,	
poriikkhateo,	পরীক্ষাতেও,	পরীক্ষাতেও,	
deejeejer,	দেবেজের,	ডিজিজের,	
muchi,	মুচি,	মুচি,	
plate,	প্লেট,	প্লেটে,	
rata,	রাতা,	রত,	
soinyo,	সৈন্য,	সৈন্য,	
swajan,	স্বজন,	স্বজন,	
niemond,	নিয়েন্দ,	নিমন্ড,	
drissoke,	ড্রিসকে,	দৃশ্যকে,	
abhidhaner,	অভিধানের,	অভিধানের,	
sikkhagata,	সিক্ষাগত,	শিক্ষাগত,	
cholochchitro,	চলচ্চিত্র,	চলচ্চিত্র,	
deefinision,	ডিফিশন,	ডেফিনেশন,	
paolasthi,	পাওলসইথি,	পাওলাসথি,	
somraatder,	সম্রত্যের,	সম্রাটদের,	
ganosachetanata,	গণসচেনতা,	গণসচেতনতা,	
dristiheen,	দৃষ্টিহীন,	দৃষ্টিহীন,	
rohosyoti,	রোহস্তিত,	রহস্যটি,	
mookhomandoler,	মচনলাদকনের,	মুখমণ্ডলের,	
gaphiloti,	গািলিত,	গাফিলতি,	
bayshorkarikarone,	বায়স্রারকারীগণে,	বেসরকারিকরণ,	
muchlima,	মুছলিমা,	মুছলিমা,	
nabatarange,	নবতর্মা,	নবতরঙ্গে,	
nagorikderkey,	নাগরিকদেরকে,	নাগরিকদেরকে,	
neelkamal,	নীল্কল,	নীলকমল,	
dhanyi,	ধনরি,	ধন্যি,	
koruna,	কোরুনা,	করুণা,	
kourabe,	কৌরাবে,	কৌরবে,	
aairees,	আইযার্স,	আইরিস,	
bijepi,	বিজেপি,	বিজেপি,	
byabaharkareer,	ব্যবহারকারের,	ব্যবহারকারীর,	
cheerokoomari,	চেরনাজারী,	চিরকুমারী,	
phising,	ফিসিং,	ফিসিং,	
orunima,	ওরুমিমা,	অরুণিমা,	
bonnopran,	বন্যপ্রাণ,	বন্যপ্রাণ,	
guha,	গুহা,	গোহ,	
scholarship,	স্কলারশিপ,	স্কলারশিপ,	
kod,	কোড,	কোড,	
shourshe,	শৌর্শে,	সোর্স,	
toptoshele,	তপ্দশীল,	তপ্তশেলে,	
narsaari,	নরসারি,	নার্সারি,	
korley,	করলে,	করলে,	
licenshe,	লাইসেনশে,	লাইসেন্স,	
sakshatkarer,	সাক্ষাতারের,	সাক্ষাৎকারের,	
taroni,	তারনি,	তরণী,	
upbrazillian,	উপবারজিলিয়াং,	আপব্রাজিলিয়ান,	
yatharthabhabe,	যথাপ্থভাবে,	যথার্থভাবে,	
indrani,	ইন্দ্রনী,	ইন্দ্রাণী,	
sohojlovyotar,	সহজ্যব্যতার,	সহজলভ্যতার,	
karmake,	কারমাকে,	কর্মকে,	
marry,	মার্র,	ম্যারি,	
dwijenbabuder,	দ্বিজেন্দুবাবের,	দ্বিজেনবাবুদের,	
krishibigyani,	কৃষিবিজ্ঞানী,	কৃষিবিজ্ঞানী,	
aansareer,	আনসারের,	আনসারীর,	
ghoorchen,	ঘোচ্ছেন,	ঘুরেছেন,	
prijon,	প্রাজন,	প্রিজন,	
graambasio,	গ্রামবাসিও,	গ্রামবাসীও,	
beam,	বিআইএম,	বিম,	
jewellery,	জেয়াঁেরি,	জুয়েলারির,	
utpotti,	উৎপপ্তি,	উতপত্তি,	
akai,	আকাই,	একাই,	
kokeyin,	কোকেইন,	কোকেইন,	
daacktickete,	ডাকেনকেটিতে,	ডাকটিকিটে,	
doorotomo,	দূরতম,	দূরতম,	
emiratas,	এমিরেতাস,	এমিরেটাস,	
shuri,	শুরি,	সুরি,	
deputee,	দেপুতেই,	ডেপুটি,	
ashankai,	আশঙকাই,	আশঙ্কাই,	
vortuki,	ভর্তুকি,	ভর্তুকি,	
mimgulor,	মিমগুলোর,	মিমগুলোর,	
protijogi,	প্রতিযোগী,	প্রতিযোগী,	
madrasake,	মাদ্রাসাকে,	মাদ্রাসাকে,	
dojo,	দোজো,	ডোজো,	
elakatikay,	এলাকাতিকাই,	এলাকাটিকে,	
mandope,	ম্যান্ডপে,	মন্ডপে,	
moorali,	মূরালি,	মুরলী,	
varma,	ভার্মা,	ভার্মা,	
poste,	পোস্টে,	পোস্টে,	
dharabahikvabe,	ধারাবাহিকভাবে,	ধারাবাহিকভাবে,	
laaisheesh,	লাইশেস,	লাইসেন্স,	
akkhunno,	আক্ষুন্ন,	অক্ষুণ্ণ,	
landing,	ল্যান্ডিং,	ল্যান্ডিং,	
daaktikit,	দাকদিকটি,	ডাকটিকিট,	
ipl,	আইএলএল,	আইপিএল,	
shtonehenge,	স্টনেিেন,	স্টোনহেঞ্জ,	
bhromoner,	ভ্রমণের,	ভ্রমণের,	
yuroo,	য়ুরো,	ইউরো,	
ostheesandhi,	অস্টেশন্ধ,	অস্থিসন্ধি,	
sachetanvabe,	সচেতনভাবে,	সচেতনভাবে,	
rakshanbhag,	রক্ষণভাগ,	রক্ষণভাগ,	
neelfamarir,	নীলমামারের,	নীলফামারীর,	
jolrang,	জলগাং,	জলরঙ,	
bisheshshyer,	বিশেষকেের,	বিশেষ্যের,	
qaro,	কারো,	কারো,	
temone,	তেমনে,	তেমনই,	
mosharroph,	মোশার্ফ,	মশাররফ,	
seekkhaou,	সীক্ষাসও,	শিক্ষাও,	
hakone,	হাকনে,	হাকোনে,	
teoyana,	তেই়ানা,	তাইওয়ান,	
cholchhee,	চলচে,	চলছে,	
shikare,	শিকারে,	শিকারে,	
mozdur,	মজদুর,	মজদুর,	
sqirt,	স্কার্ট,	স্কার্ট,	
fasi,	ফাসি,	ফাঁসী,	
alpakichudin,	অলপাকিশশন,	অল্পকিছুদিন,	
ramachandranke,	রামাচন্দ্রনকে,	রামাচন্দ্রনকে,	
asovyo,	অসভ্য,	অসভ্য,	
dipgulote,	ডিপগুলোতে,	দ্বীপগুলোতে,	
gondogol,	গণ্ডগোল,	গন্ডগোল,	
peshto,	পেষ্টো,	পেষ্ট,	
atmabishvashi,	আত্মবিশিবসহ,	আত্মবিশ্বাসী,	
lampot,	ল্যাম্পট,	লম্পট,	
pettern,	পেটার্ন,	প্যাটার্ন,	
ebhara,	এবারা,	এভার,	
daebug,	দাবুল,	ডিবাগ,	
ghurte,	ঘুরতে,	ঘুরতে,	
abheedhaneek,	অভিভানের,	অভিধানিক,	
obhijojan,	অভিযোজন,	অভিযোজন,	
jontropatigulite,	যন্ত্রপাতিগুলিতে,	যন্ত্রপাতিগুলিতে,	
romjaner,	রোম্বানের,	রমযানের,	
prakalpatike,	প্রকল্পনাটিকে,	প্রকল্পটিকে,	
poriskoron,	পরিস্করণ,	পরিষ্করণ,	
onshogrohoner,	অংশগ্রহণের,	অংশগ্রহনের,	
uchchotara,	উচ্চতারা,	উচ্চতর,	
horash,	হোরশ,	হোরাস,	
dhanak,	ধানক,	ধানক,	
conflikt,	কনফ্লিট,	কনফ্লিক্ট,	
saifai,	সাইফাই,	সাইফাই,	
batikromee,	বাতিক্রমে,	ব্যতিক্রমী,	
militarir,	মিলিটারীর,	মিলিটারির,	
idyi,	আইডি,	আইডিই,	
provritike,	প্রবৃতিকে,	প্রভৃতিকে,	
nakkal,	নাককল,	নক্কল,	
samoshtigato,	সমোক্তিনত,	সমষ্টিগত,	
prasadhoner,	প্রসাধনের,	প্রসাধনের,	
gaddaafee,	গাদ্ডাফে,	গাদ্দাফী,	
suisharke,	সুইশারকে,	সুইশারকে,	
monohputo,	মনোধপু,	মনঃপুত,	
yuro,	য়ুরো,	ইউরো,	
aporishodhito,	অপরিশোধিত,	অপরিশোধিত,	
miraqela,	মিরাকেল,	মিরাকেল,	
bujhechhila,	বুঝেছিল,	বুঝেছিল,	
sectore,	সেক্টরে,	সেক্টরে,	
dalip,	দালিপ,	দালিপ,	
dijijer,	দিজিজের,	ডিজিজের,	
porbotmala,	পর্বতমালা,	পর্বতমালা,	
senabahinio,	সেনাবাহিনীও,	সেনাবাহিনীও,	
moushumei,	মৌশুমেই,	মৌসুমেই,	
metropolitan,	মেট্রোপেশন,	মেট্রোপলিটন,	
nirikho,	নিরিখো,	নিরিখ,	
oncoleo,	অঙ্কলেও,	অঞ্চলেও,	
sarboporee,	সর্বপরে,	সর্বোপরী,	
bhumija,	ভূমিজা,	ভূমিজ,	
padee,	পাদে,	পাড়ে,	
bhenasha,	ভেনাশা,	ভেনাস,	
bbiswasho,	বিষ্বিসহ,	বিশ্বাসও,	
sthaponagulor,	স্থাপনাগুলোর,	স্থাপনাগুলোর,	
taunsheep,	তাউনশেভ,	টাউনশিপ,	
poscater,	পোস্টটের,	পশ্চাতের,	
nyata,	ন্যাট,	ম্যাট,	
protizogii,	প্রতিযোগী,	প্রতিযোগী,	
vange,	ভ্যাঙ্গে,	ভাঙ্গে,	
atmira,	আত্মীরা,	আত্মীরা,	
mausumeo,	মওসুমেও,	মৌসুমেও,	
ajeem,	আজেম,	আজিম,	
drissogoolote,	ড্রিসঙ্গলোতে,	দৃশ্যগুলোতে,	
naabyota,	নব্যতা,	নাব্যতা,	
ponchasjon,	পঞ্চাসজন,	পঞ্চাশজন,	
aasar,	আসার,	আসর,	
bhenom,	ভেনোম,	ভেনম,	
siddhantoo,	সিদ্ধান্ত,	সিদ্ধান্তও,	
nirvachokder,	নির্বাচকদের,	নির্বাচকদের,	
raiialati,	রাইয়ালিটি,	রয়্যালটি,	
protisthar,	প্রতিষ্ঠার,	প্রতিষ্ঠার,	
prokolpogulikei,	প্রকল্পনগুলিকেই,	প্রকল্পগুলিকেই,	
jaatti,	যাত্তি,	জাতটি,	
taronee,	তারণী,	তরণী,	
uddharkarmirai,	উদ্ধারকারির্াই,	উদ্ধারকর্মীরাই,	
ahalyar,	অহল্যার,	অহল্যার,	
balatarin,	বালাতারিন,	বালাতারিয়ান,	
amittrakkhor,	অমিত্রাক্ষেক,	অমিত্রাক্ষর,	
asommoti,	অসম্মতি,	অসম্মতি,	
angshogrohon,	অংশগ্রহণ,	অংশগ্রহন,	
maailey,	মাইলে,	মাইলে,	
hert,	হের্ট,	হার্ট,	
qarqa,	কার্কা,	কার্ক,	
kaale,	কালে,	কালে,	
notti,	নট্টি,	নোটটি,	
chakti,	চাকতি,	চাকতি,	
show,	শোয়,	শো,	
modhyekar,	মধ্যেকার,	মধ্যেকার,	
keyboarder,	কেব্বোর্ডের,	কীবোর্ডের,	
pabo,	পাবো,	পাব,	
swadhinotatukui,	স্বাধীনতাটুকুই,	স্বাধীনতাটুকুই,	
query,	কুয়ার,	কোয়েরি,	
pratijogira,	প্রতিগাজীরা,	প্রতিযোগীরা,	
bhagnekeo,	ভাগনেকেও,	ভাগ্নেকেও,	
aborto,	অবর্ত,	আবর্ত,	
miley,	মিলে,	মিলে,	
debdebie,	দেবদেবীই,	দেবদেবী,	
gore,	গোরে,	গোর,	
surke,	সুরকে,	সুরকে,	
brixfield,	ব্রিকসেলফি,	ব্রিক্সফিল্ড,	
sondhisthaponer,	সন্ঠিস্থাপনের,	সন্ধিস্থাপনের,	
sumeeta,	সুমেতা,	সুমিতা,	
bisheshya,	বিষেষ্য,	বিশেষ্য,	
ogovir,	অগভীর,	অগভীর,	
karmoi,	কারমো,	কর্মই,	
suhasini,	সুহাইনি,	সুহাসিনী,	
baju,	বাজু,	বাজু,	
neker,	নেকের,	নেকের,	
rojapalaner,	রোজাপালালের,	রোজাপালনের,	
selim,	সেলিম,	সেলিম,	
saarbharti,	সার্ভারটি,	সার্ভারটি,	
teta,	তেত,	টেটা,	
tatey,	তাতে,	তাতে,	
gandhiio,	গান্ধিয়,	গান্ধীও,	
chorban,	চোরবান,	চর্বন,	
purple,	পূর্পলে,	পার্পেল,	
logotype,	লোগোটিপ,	লোগোটাইপ,	
sthapanatir,	স্থাপানাটির,	স্থাপনাটির,	
langhoner,	লাঞ্চনের,	লংঘনের,	
milton,	মিলতন,	মিলটন,	
dokaanei,	দোকানেই,	দোকানেই,	
qor,	কোর,	কর,	
srichoitonnodeb,	শ্রীচৈতন্তব্ব,	শ্রীচৈতন্যদেব,	
pyaleshtainer,	প্ওলেশকাটনের,	প্যালেস্টাইনের,	
bojhao,	বোঝাও,	বোঝাও,	
fake,	ফাক,	ফাকে,	
difinishian,	ডিফিশিশিয়ান,	ডেফিনেশন,	
militaryr,	মিলিটারীর,	মিলিটারির,	
safiha,	সাফিহা,	সাফিহা,	
itostatah,	ইতসস্থা,	ইতস্ততঃ,	
bisheshyo,	বিশেষ্য,	বিশেষ্য,	
mukhomondoler,	মুখোনমদলের,	মুখমণ্ডলের,	
choritrotakeo,	চরিত্রতাকেও,	চরিত্রটাকেও,	
lyaanding,	ল্যান্ডিং,	ল্যান্ডিং,	
habsi,	হাবসি,	হাবশী,	
soteciety,	সোটেকেটি,	সোসাইটিতে,	
vaabnake,	ভাবনাকে,	ভাবনাকে,	
greenald,	গ্রিনাড্ড,	গ্রিনল্ড,	
shikara,	শিকারা,	শিকার,	
konisttha,	কোনিস্তথা,	কনিষ্ঠ,	
ruby,	রুব্,	রুবী,	
baipass,	বাইপাস,	বাইপাস,	
byepass,	বিয়াপাস,	বাইপাস,	
goolen,	গোয়েন,	গুলেন,	
notey,	নটে,	নোটে,	
elakatir,	এলাকাটির,	এলাকাটির,	
jhamala,	ঝামালা,	ঝামালা,	
potka,	পটকা,	পটকা,	
vobobibhuti,	ভবুবিভূত,	ভববিভূতি,	
avisongson,	অ্িাইনসন,	অভিশংসন,	
plato,	প্লাটো,	প্লেটো,	
moshzidtike,	মোশজিদেটিকে,	মসজিদটিকে,	
primoo,	প্রিয়োও,	প্রিমো,	
chaanoo,	চানোয়,	চানু,	
hoil,	হোল,	হইল,	
kogake,	কোগাকে,	কোগাকে,	
nomo,	নমু,	নমো,	
uporitoler,	উপরিতলের,	উপরিতলের,	
madhobeer,	মাধবের,	মাধবীর,	
uporitaley,	উপরিতালে,	উপরিতলে,	
bohorompurer,	বহরামপুরের,	বহরমপুরের,	
towraat,	তোয়ারাত,	তওরাত,	
bahati,	বাহাটি,	বাহাতি,	
comoros,	কমোরোস,	কোমোরোস,	
ghoor,	ঘুর,	ঘুর,	
jomjamat,	জম্মাজত,	জমজমাট,	
manushgulor,	মানুষগুলোর,	মানুষগুলোর,	
udbhaboney,	উদ্ভববনে,	উদ্ভাবনে,	
neemeetto,	নিমেত,	নিমিত্ত,	
batsmanei,	বাযাটসম্যানে,	ব্যাটসম্যানই,	
neemitte,	নিমিত্তে,	নিমিত্তে,	
orthisoho,	অর্থিসহ,	অর্থিসহ,	
sarder,	সারদের,	সরদার,	
probondhobhittik,	প্রবন্ধনীত্তিক,	প্রবন্ধভিত্তিক,	
poscime,	পশ্চিমে,	পশ্চিমে,	
yaq,	যাক,	ইয়াক,	
manushsoho,	মানুষসহ,	মানুষসহ,	
drishi,	দৃশি,	দৃশ্যই,	
kumbhalnar,	কুম্ভাল্ার,	কুম্ভালনার,	
bandhubhaabaapanna,	বন্ধুভাবপা্য,	বন্ধুভাবাপন্ন,	
pratisthanik,	প্রতিষ্ঠানিক,	প্রাতিষ্ঠানিক,	
neshadrabyer,	নেশাদ্রব্যের,	নেশাদ্রব্যের,	
madaspushto,	মাদকপুষ্ট,	মদদপুষ্ট,	
arthonitite,	অর্থনীতিতে,	অর্থনীতিতে,	
punorabortonte,	পুনরাবর্তন্তে,	পুনরাবর্তন্তে,	
furio,	ফুরিও,	ফুরিও,	
taigara,	তাইগারা,	টাইগার,	
parikhar,	পরিিখার,	পরিখার,	
pranibigyani,	প্রাণীবিজ্ঞানী,	প্রাণীবিজ্ঞানী,	
mitrata,	মিত্রটা,	মিত্রতা,	
graminphonor,	গ্রামিণভোগেরও,	গ্রামীণফোনর,	
shikhaboudi,	শিখাবুদ,	শিখাবৌদি,	
miraclee,	মিরাকলে,	মিরাকেল,	
romantik,	রোমাট্িক,	রোমান্টিক,	
alaul,	আলাল,	আলাওল,	
poripakey,	পরিপাকে,	পরিপাকে,	
makhno,	মাখনো,	মাখনো,	
gavaskar,	গাভস্কার,	গাভাস্কার,	
sheets,	শীডস,	শীটস,	
mausumer,	মওসুমের,	মৌসুমের,	
batikromi,	বাতিক্রমি,	ব্যতিক্রমী,	
upobasee,	উপবাসে,	উপবাসী,	
shit,	শিট,	শীত,	
prokolpoti,	প্রকল্পটি,	প্রকল্পটি,	
shasonamoleri,	শাসনাবরীর,	শাসনামলেরই,	
direectoratee,	ডিরেক্টরেট,	ডিরেক্টরেট,	
deares,	ডেয়ার্স,	ডিআরএস,	
ase,	আসে,	আসে,	
distibutor,	ডিস্টিবুটর,	ডিস্টিবিউটারের,	
arasie,	আরাসিয়ে,	আরসিএ,	
jakatke,	জাকাতকে,	যাকাতকে,	
nabayug,	নবায়ুল,	নবযুগ,	
jansa,	জানসা,	জন্স,	
dhonni,	ধনননি,	ধন্যি,	
choshon,	চোষণ,	চোষণ,	
bouddher,	বৌদ্ধের,	বৌদ্ধের,	
awrbit,	আরিিরিব,	অরবিট,	
prokolpotike,	প্রকল্পটিকে,	প্রকল্পটিকে,	
lirikti,	লিরিক্তি,	লিরিকটি,	
ostad,	অস্তাদ,	ওস্তাদ,	
goteehin,	গোটেহীন,	গতিহীন,	
kazianis,	কাজিয়ানিস,	কাজানিস,	
sausagee,	সৌগাগে,	সসেজ,	
carzar,	কার্জার,	চার্জার,	
sithilota,	সিথিলতা,	শিথিলতা,	
chaalkee,	চালকে,	চালকে,	
shabkam,	শাব্বাজ,	শবকাম,	
bachhaikrito,	বছরাকৃতি,	বাছাইকৃত,	
saom,	সাওম,	সাওম,	
oedipus,	ওডিপিস,	ইডিপাস,	
sponsorshipe,	স্পন্সরর্ভে,	স্পন্সরশীপে,	
gopalrao,	গোপালরাও,	গোপালরাও,	
bhabanir,	ভবননীর,	ভবানীর,	
bhabaaponno,	ভাবাপন্ন,	ভাবাপন্ন,	
lopjonito,	লোপকোজিত,	লোপজনিত,	
shector,	শেকটোর,	সেক্টর,	
upobaashee,	উপবাষে,	উপবাসী,	
elakaai,	এলাকাই,	এলাকাই,	
mozdoor,	মজদুর,	মজদুর,	
nischitvabe,	নিশ্চিতভাবে,	নিশ্চিতভাবে,	
asif,	আসিফ,	আসিফ,	
sausage,	সৌগাগে,	সসেজ,	
ceramicer,	সেরামিকের,	সিরামিকের,	
qarpeta,	কার্পেট,	কার্পেট,	
jeebnagore,	জীবপাগে,	জীবননগর,	
prachirer,	প্রাচীরের,	প্রাচিরের,	
mach,	মাচ,	মাছ,	
rachanakal,	রচনাকাল,	রচনাকাল,	
akten,	আকতেন,	অকটেন,	
naneer,	নানের,	নানীর,	
welcome,	বিলসকোম,	ওয়েলকাম,	
totokson,	টোটোক্সন,	ততক্ষন,	
mast,	মাস্ট,	মাস্ত,	
phokser,	ফককসের,	ফক্সের,	
jarmaniteo,	জারমনিতেও,	জার্মানিতেও,	
agora,	আগোরা,	আগোরা,	
chanoo,	চানো,	চানু,	
toxoid,	টক্সডি,	টক্সয়েড,	
peeth,	পীথ,	পীঠ,	
torkareer,	তর্কারের,	তরকারীর,	
dip,	ডিপ,	দীপ,	
prajanankal,	প্রজনকল্ল,	প্রজননকাল,	
vabaponno,	ভাবাপন্ন,	ভাবাপন্ন,	
nodnodeer,	নদ্দরের,	নদনদীর,	
spreedashita,	স্প্রেডশিট,	স্প্রেডশীট,	
mohajote,	মহাজতে,	মহাজোট,	
lotharan,	লোথারান,	লুথেরান,	
mukhomandaler,	মুখমা্ডলের,	মুখমণ্ডলের,	
gyandaas,	জ্ঞানদাস,	জ্ঞানদাস,	
pleeta,	পিরেট,	প্লেট,	
neshnosh,	নেশনূষ,	নেশনস,	
somsher,	সমমশের,	সমশের,	
jani,	জানী,	জনি,	
graambaaseeo,	গ্রামবাসেও,	গ্রামবাসীও,	
dhhaloor,	ঢালোর,	ঢালুর,	
aprasangikbhabei,	অপ্রসাগিনিকভাবে,	অপ্রাসঙ্গিকভাবেই,	
lagto,	লাগতো,	লাগতো,	
byaktigotovabeo,	ব্যক্তিগতভাবেও,	ব্যাক্তিগতভাবেও,	
shikh,	শিখ,	শিখ,	
jyesthaa,	জ্যেষ্টা,	জ্যেষ্ঠা,	
bikretaara,	বিক্রেতারা,	বিক্রেতারা,	
shho,	ঝোহ,	শো,	
subade,	সুবাদে,	সুবাদে,	
niurolaji,	নিউরোলাজি,	নিউরোলজি,	
dai,	দাই,	ডে,	
foxer,	ফক্সের,	ফক্সের,	
komanera,	কোমানেরা,	কমানেরা,	
lidars,	লিডার্স,	লিডার্স,	
juktorashtreo,	যুক্তসর্ষ্ট্রেও,	যুক্তরাষ্ট্রেও,	
hamburgey,	হাম্বুর্গে,	হামবুর্গে,	
shniper,	শ্রীমের,	স্নাইপার,	
kathla,	কাতলা,	কাঠলা,	
kanasharabheshhana,	কননাভর্ষণ,	কনসারভেশন,	
kisti,	কিস্তি,	কিস্তি,	
metropalitana,	মেট্রোপালিটানা,	মেট্রোপলিটন,	
croak,	ক্রয়ক,	ক্রোক,	
madrasa,	মাদ্রাসা,	মাদ্রাসা,	
karore,	কাররে,	কারোর,	
gronther,	গ্রন্থার,	গ্রন্থের,	
oitijhyotike,	ঐতিহ্যটিকে,	ঐতিহ্যটিকে,	
gobeshonar,	গবেষণার,	গবেষনার,	
bhenus,	ভেনুস,	ভেনাস,	
kharavel,	খারাবেল,	খারবেল,	
marmaraa,	মারমারায়,	মারমারা,	
mase,	মাসে,	মাসে,	
tahorir,	তাহরীর,	তাহরীর,	
addhattikotar,	আদ্ধতিযতত্বর,	আধ্যাত্মিকতার,	
siddhanter,	সিদ্ধান্তের,	সিদ্ধান্তের,	
ghoomachhilo,	ঘোয়াছিল,	ঘুমাচ্ছিল,	
nagorikkey,	নাগরিককে,	নাগরিককে,	
adhunikkale,	আধুনিক্কালে,	আধুনিককালে,	
unchiyechilo,	উঁচিয়েছিল,	উঁচিয়েছিল,	
boner,	বনের,	বনের,	
makong,	মাকং,	মেকং,	
myathiou,	ম্যাথিউ,	ম্যাথিউ,	
codee,	কোড,	কোডে,	
vittimul,	ভিত্তিমূল,	ভিত্তিমূল,	
besur,	বেসুর,	বেসুর,	
sutir,	সুতির,	সুতির,	
battery,	ব্যাটারি,	ব্যাটারী,	
khuizza,	খুইজ্জা,	খুইজ্জা,	
daakteekite,	দাকদেকটিতে,	ডাকটিকিটে,	
ghumachchila,	ঘুমাচ্ছিলা,	ঘুমাচ্ছিল,	
chalachchitrei,	চালাচ্চিত্রেই,	চলচ্চিত্রেই,	
tawnship,	তাঁশনিপ,	টাউনশিপ,	
seekkharthirao,	সীক্ষার্থীরাও,	শিক্ষার্থীরাও,	
scholastik,	স্কুলস্তিক,	স্কলাস্টিক,	
nachiketa,	নাচকেতা,	নচিকেতা,	
sangbadmadhyome,	সংবাদমধ্যমে,	সংবাদমাধ্যমে,	
esasiyetasa,	এসাসিটেটিয়াস,	এসোসিয়েটস,	
raagee,	রাগে,	রাগী,	
khanabale,	খানাবালে,	খানাবলে,	
irana,	ইরাানা,	ইরান,	
gagee,	গাগে,	গেজ,	
giitikobitar,	গীতিকাভিতার,	গীতিকবিতার,	
bopoon,	বোপন,	বপন,	
licensedhari,	লাইসেন্সধারী,	লাইসেন্সধারী,	
paroner,	পারণের,	পারণের,	
salphat,	সালধাট,	সালফেট,	
licensin,	লাইসেনসন,	লাইসেন্সিং,	
kalenga,	কােঙ্গা,	কালেঙ্গা,	
firoze,	ফিরোজে,	ফিরোজ,	
shchalastik,	স্কলাফাটির,	স্কলাস্টিক,	
panchbar,	পাঞ্চবার,	পাঁচবার,	
taufik,	তাফিক,	তৌফিক,	
hooq,	হাক,	হুক,	
wictor,	উইকটটর,	ভিক্টর,	
bosturoi,	বস্তুরই,	বস্তুরই,	
morodeho,	মরদেহ,	মরদেহ,	
planeti,	প্লেজিটি,	প্লেনটি,	
catholicbad,	ক্যাথলিবদাদ,	ক্যাথলিকবাদ,	
karecho,	করেছো,	করেছ,	
rajtantro,	রাজনযত্র,	রাজতন্ত্র,	
aranyani,	অরণ্যাণী,	অরণ্যানী,	
sohinsotar,	সোহিন্যতার,	সহিংসতার,	
patininda,	পাতিনন্দি,	পতিনিন্দ,	
karmojog,	কার্যোগ,	কর্মযোগ,	
manjushree,	মঞ্জুররে,	মঞ্জুশ্রী,	
teenej,	টেনেংজ,	টিনেজ,	
dephinishion,	দেফিচিনিন,	ডেফিনেশন,	
peerry,	পিরি,	পেরি,	
mandondo,	মানডনোড,	মানদণ্ড,	
tookrote,	তুক্োতে,	টুকরোতে,	
bhyatikaner,	ভ্যাটিকানের,	ভ্যাটিকানের,	
songasthatir,	সংস্কাাটির,	সংস্থাটির,	
carlosh,	কার্লোশ,	কার্লোস,	
oswasteekor,	অস্টবসেটকের,	অস্বস্তিকর,	
backflipe,	ব্যাকসেলাপে,	ব্যাকফ্লিপে,	
bii,	বিয়ে,	বি,	
akreetokarjo,	অক্রেকোপ্র্য,	অকৃতকার্য,	
noditir,	নোডিটির,	নদীটির,	
norpholk,	নর্ফোজি,	নরফোক,	
sobaiderke,	সোবাইদেরকে,	সবাইদেরকে,	
ajuhat,	অজুহাত,	অজুহাত,	
shikkhakram,	শিক্ষাক্রম,	শিক্ষাক্রম,	
rakkhandurga,	রক্ষণীূর্গ,	রক্ষণদুর্গ,	
lishenshe,	লিশেন্সে,	লাইসেন্স,	
dharmantor,	ধর্মন্তর,	ধর্মান্তর,	
popaike,	পপাইকে,	পপাইকে,	
niknayman,	নিকন্ম্যান,	নিকনেইমান,	
bolechile,	বলেছিলে,	বলেছিলে,	
samaptir,	সমাদ্তির,	সমাপ্তির,	
garora,	গারোরা,	গারোরা,	
armshtrong,	আর্মে্থার্গ,	আর্মস্ট্রং,	
songkoloney,	সংকলকে,	সংকলনে,	
birishiritey,	বিরিশিরীতে,	বিরিশিরিতে,	
annanere,	আন্নানীরে,	অন্যানেরে,	
mmehonoti,	মেলেিনোট,	মেহনতি,	
hyaloyin,	হ্যালিওন,	হ্যালোইন,	
muradke,	মুরাদকে,	মুরাদকে,	
bujhtepari,	বুঝতেপারী,	বুঝতেপারি,	
tateo,	তাতেও,	তাতেও,	
tikto,	তিক্ত,	তিক্ত,	
domone,	ডোমোন,	দমনে,	
torunra,	তরুণরা,	তরুণরা,	
dibya,	দিব্য,	দিব্যা,	
shrimoti,	শ্রীমতি,	শ্রীমতি,	
vejjanno,	ভেজ্ঞান্ন,	ভেজানো,	
sachetonvabe,	সচেতনভাবে,	সচেতনভাবে,	
shudden,	শাডডেন,	সাডেন,	
mookhomaundoler,	মছনবসদলের,	মুখমণ্ডলের,	
jonmobhumitir,	জন্মভুমিতির,	জন্মভূমিটির,	
bhebechili,	ভেবেছিলি,	ভেবেছিলি,	
nirbaahe,	নির্বাহে,	নির্বাহে,	
laishenshim,	লাইসেনশিম,	লাইসেন্সিং,	
gabinius,	গাবিনিয়াস,	গাবিনিআস,	
duburir,	দুবুরির,	ডুবুরির,	
parshwer,	পারশ্যের,	পার্শ্বের,	
shoriph,	শরীপ,	শরিফ,	
satan,	সাতান,	শয়তান,	
matrirup,	মাতৃরূপ,	মাতৃরূপ,	
prokar,	প্রকার,	প্রকার,	
nishad,	নিশাদ,	নিষাদ,	
krimlin,	কৃঞ্লিন,	ক্রিমলিন,	
eigulor,	এইগুলোর,	এইগুলোর,	
dishani,	ডিশানি,	দিশানি,	
purbancoler,	পূর্বকল্যের,	পূর্বাঞ্চলের,	
yathaarthabhaabe,	যথাপ্থভাবে,	যথার্থভাবে,	
saver,	স্ভের,	সেভার,	
chalochchitraeer,	চাচ্চিত্রদের,	চলচ্চিত্রের,	
saras,	সারাস,	সরস,	
bosontoke,	বসন্তকে,	বসন্তকে,	
jacksoner,	জ্যাকসনের,	জ্যাকসনের,	
dokaangoolote,	দোকালগোলোতে,	দোকানগুলোতে,	
shahabike,	শাহাবীকে,	সাহাবীকে,	
okkhorke,	অক্ষরকে,	অক্ষরকে,	
residence,	রেসিডেন্স,	রেসিডেন্স,	
sombhobonaao,	সম্ভোননাও,	সম্ভবনাও,	
songbadmadhyame,	সংবাদমধ্যমে,	সংবাদমাধ্যমে,	
vins,	ভিনস,	ভিন্স,	
bohudin,	বহুদিন,	বহুদিন,	
raghubar,	রঘুবার,	রঘুবীর,	
ekjoge,	একযোগে,	একযোগে,	
akkharkey,	আক্ষারকে,	অক্ষরকে,	
pleta,	প্লেট,	প্লেটো,	
chalachchitrotike,	চালাচ্চিত্রটিকে,	চলচ্চিত্রটিকে,	
skolastik,	স্কোলস্টির,	স্কলাস্টিক,	
naabbota,	নব্বতা,	নাব্যতা,	
carbus,	কারবুস,	কারবাস,	
brail,	ব্রেইল,	ব্রেইল,	
alexanderke,	আলেক্সেন্দ্রকে,	আলেকজান্ডারকে,	
browser,	ব্রকসের,	ব্রাউজার,	
kodorer,	কদরের,	কদরের,	
segulo,	সেগুলো,	সেগুলো,	
azijer,	আজিজের,	আজিজের,	
rudiger,	রুদিগের,	রুদিগের,	
nutunotto,	নুতুনো্ত,	নতুনত্ব,	
kareer,	কারের,	কারীর,	
mathews,	ম্যাথেওস,	ম্যাথিউস,	
shikshagata,	শিক্ষাগত,	শিক্ষাগত,	
gudamjat,	গুড়ামত,	গুদামজাত,	
bitertrate,	বিতেরপত্রে,	বাইটারট্রেট,	
mane,	মানে,	মানে,	
jonomukhi,	জনমুখী,	জনমুখী,	
obdee,	ওবদে,	অব্দি,	
rupert,	রুপের্ত,	রুপার্ট,	
jibnagore,	জীবনাগরে,	জীবননগর,	
brindaboney,	বৃন্দাবনে,	বৃন্দাবনে,	
bishashke,	বিষাষকে,	বিশ্বাসকে,	
hosto,	হোস্টো,	হস্ত,	
chalachchitra,	চাচ্চচিত্র,	চলচ্চিত্র,	
samratder,	সাম্রতের,	সম্রাটদের,	
philipiner,	ফিলিপিনের,	ফিলিপাইনের,	
senabahinikey,	সেনাবাহিনীকে,	সেনাবাহিনীকে,	
mawdeel,	মাতেল,	মডেল,	
masjidti,	মসজজিতি,	মসজিদটি,	
bojhe,	বোঝে,	বোঝে,	
bagdad,	বাগদাদ,	বাগদাদে,	
panthar,	পান্থার,	পন্থার,	
chhaikalo,	ছাইকালো,	ছাইকালো,	
balakarak,	বালাকাক,	বলকারক,	
mukhoshdharir,	মুখোষধারীর,	মুখোশধারীর,	
falak,	ফালাক,	ফলক,	
sahittekder,	সাহিত্যকদের,	সাহিত্যেকদের,	
korijachilen,	করিযাখিলেন,	করিযাছিলেন,	
kei,	কেই,	কেই,	
klaud,	ক্লুড,	ক্লাউড,	
hurricane,	হুরিকানে,	হ্যারিকেন,	
ghurechen,	ঘুরেছেন,	ঘুরেছেন,	
cheef,	চিফ,	শেফ,	
dhandu,	ধন্দু,	ধন্দু,	
youth,	য়থ,	ইয়ুথ,	
rinobodh,	ঋণবোধ,	ঋণবোধ,	
setikey,	সেতিকে,	সেটিকে,	
bhabanipur,	ভবানীপুর,	ভবানীপুর,	
soource,	সোরসি,	সোর্স,	
mulyayonsapekkhe,	মূল্যাকসমক্ষেপে,	মূল্যায়নসাপেক্ষে,	
laishensh,	লাইসেন,	লাইসেন্স,	
ekatitto,	একাতিত্ব,	একাতিত্ব,	
bhoolapuka,	ভোলাপুকা,	ভোলাপুক,	
bhalobasar,	ভালোবাসার,	ভালোবাসার,	
bishnoo,	বিষ্ণু,	বিষ্ণু,	
apolokbhabe,	অপলব্ষাবে,	অপলকভাবে,	
maarmaader,	মারমাদের,	মারমাদের,	
durgatsabe,	দুর্গতসববে,	দুর্গোৎসবে,	
bishesyo,	বিষেষ্য,	বিশেষ্য,	
sumitrar,	সুমিত্রার,	সুমিত্রার,	
lutharen,	লুথারেন,	লুথেরান,	
mitro,	মিত্র,	মিত্র,	
zubokra,	যুবকরা,	যুবকরা,	
hindutirtha,	হিন্দুরিথাথ,	হিন্দুতীর্থ,	
chakradhare,	চক্রধারে,	চক্রধরে,	
taunasipa,	তৌনসীপা,	টাউনশিপ,	
goora,	গুরা,	গোর,	
saria,	সারিয়া,	সরিয়া,	
byatikrami,	ব্যতিক্রমী,	ব্যতিক্রমী,	
bharotiyotar,	ভারতীয়তার,	ভারতীয়তার,	
grauth,	গ্রাউস,	গ্রোথ,	
shatokeo,	শাতোকেও,	শতকেও,	
uporoshtho,	উপরস্থ,	উপরস্থ,	
konnoder,	কোন্ডদের,	কন্যদের,	
shipley,	শিপলি,	শিপলে,	
shilver,	শিল্যের,	সিলভার,	
elbamtite,	এলবানজিতে,	এলবামটিতে,	
kotibondhe,	কোিবন্ধে,	কটিবন্ধে,	
taatey,	তাতে,	তাতে,	
fulkapi,	ফুলকাপি,	ফুলকপি,	
sharifpur,	শরিফপুর,	শরিফপুর,	
thanvi,	থানবি,	থানভী,	
jonoikaa,	জনৈকায়,	জনৈকা,	
dei,	দেই,	দিই,	
siitei,	সিইতেই,	শীতেই,	
kaaferder,	কাফেরদের,	কাফেরদের,	
dhadhiye,	ধাধিয়ে,	ধাধিয়ে,	
eshiyetika,	এশিয়েটিক,	এশিয়াটিক,	
kormokarer,	কর্মকারের,	কর্মকারের,	
somratra,	সোমরত্র,	সম্রাটরা,	
fokskon,	ফককসন,	ফক্সকন,	
oxforde,	অক্সোডার্ড,	অক্সফোর্ডে,	
jamaanor,	জামালোনোর,	জমানোর,	
byabostho,	ব্যবস্থ,	ব্যাবস্থা,	
indrakanan,	ইন্দ্রকাণ,	ইন্দ্রকানন,	
erokomer,	এরোজনের,	এরকমের,	
orthoneeti,	অর্থনেতি,	অর্থনীতির,	
chhanada,	ছানাডা,	ছানাদা,	
remakri,	রিমার্কি,	রেমাক্রী,	
bhabatarini,	ভবাতরীণী,	ভবতারিণী,	
byapoktor,	ব্যাপকত্র,	ব্যাপকতর,	
dipon,	ডিপন,	দীপন,	
bagicha,	বাগিচা,	বাগিচা,	
talaa,	তালা,	তালা,	
baire,	বাইরে,	বাইরে,	
bhabarlaler,	ভাবলললরের,	ভবরলালের,	
gitikobita,	গীতিকাবিতা,	গীতিকবিতা,	
chowdhurir,	চোচুরির,	চৌধুরীর,	
anagarikra,	অনাগেরীকা,	অনাগরিকরা,	
rabo,	রববো,	রব,	
harishankar,	হরিশনকর,	হরিশংকর,	
bizito,	বিজিত,	বিজিত,	
teestar,	তীস্তার,	তিস্তার,	
chitronattakar,	চিত্রনাট্যকর,	চিত্রনাট্যকার,	
gandogol,	গণ্ডগোল,	গন্ডগোল,	
remission,	রেমিসন,	রিমিশন,	
uparjon,	উপার্জন,	উপার্জন,	
seniar,	সেনিয়ার,	সিনিয়র,	
orgho,	অর্ঘ,	অর্ঘ্য,	
labonaktatar,	লাণণক্বতার,	লবণাক্ততার,	
kagbeni,	কাগবেনি,	কাগবেনি,	
cbi,	সিবিআই,	সিবিআই,	
teliha,	তেলিহা,	তেলিহা,	
vaibon,	ভাইবং,	ভাইবোন,	
aashanka,	আশানক,	আশংকা,	
sosoa,	সোসোয়া,	শশা,	
aalaa,	আলা,	আলা,	
phutonta,	ফুটোন্ট,	ফুটন্ত,	
purbanchaler,	পূর্বচালেের,	পূর্বাঞ্চলের,	
songkulan,	সংসুনার,	সংকুলান,	
serveray,	সার্ভারা,	সার্ভারে,	
taalaal,	তালাল,	তালাল,	
jontrangshogulor,	যন্ত্রাঙ্গুুলোর,	যন্ত্রাংশগুলোর,	
neerbahe,	নির্বাহে,	নির্বাহে,	
rajnaiteek,	রাজনৈতিক,	রাজনৈতীক,	
huk,	হুক,	হুক,	
tanu,	তানু,	তনু,	
laga,	লাগা,	লগ,	
veenish,	ভিনিশ,	ভেনিস,	
nutan,	নুতান,	নূতন,	
arshie,	আর্সি,	আরসিএ,	
edmeeral,	এড্রেলা,	এডমিরাল,	
prarthitao,	প্রার্থীতাও,	প্রার্থীতাও,	
dewaben,	দেওয়াবেন,	দেওয়াবেন,	
teemothi,	তিমোথি,	টিমোথি,	
keyu,	কেউু,	কেউ,	
dhaleshorii,	ধলেশিরই,	ধলেশ্বরী,	
ikboler,	ইকবলের,	ইকবলের,	
sharif,	শরীফ,	শরিফ,	
edseler,	এডসেলের,	এডসেলের,	
amor,	আমোর,	আমর,	
mmadhuri,	ম্যূূধী,	মাধুরী,	
bhenicer,	ভেনিকের,	ভেনিসের,	
medilek,	মেডিলেক,	মেডিলেক,	
difinisian,	ডিফিশিয়ান,	ডেফিনেশন,	
karaa,	কারা,	কারো,	
horidwar,	হরিদ্বার,	হরিদ্বার,	
sift,	সিফট,	শিফট,	
ahalya,	অহল্যা,	অহল্যা,	
prakalpagulor,	প্রকল্পগুলোর,	প্রকল্পগুলোর,	
vabnakey,	ভাবনাকে,	ভাবনাকে,	
kuhelika,	কুহেলাকা,	কুহেলিকা,	
skolarsip,	স্কোারফিপ,	স্কলারশিপ,	
sookumari,	সুকুমারি,	সুকুমারী,	
elakaasoho,	এলাকাসহ,	এলাকাসহ,	
ramzaner,	রামজানের,	রমযানের,	
shurugulo,	শুরুগুলো,	শুরুগুলো,	
toroonraa,	তোরনররা,	তরুণরা,	
prottokkhovabe,	প্রত্যক্ষবাবে,	প্রত্যক্ষভাবে,	
elakaate,	এলাকাতে,	এলাকাতে,	
kramp,	ক্রাম্প,	ক্র্যাম্প,	
bonshi,	বনশী,	বংশী,	
pachchi,	পাচচি,	পাচ্ছি,	
shithilata,	শীথিলতা,	শিথিলতা,	
bhramapraban,	ভ্রমণরূপনা,	ভ্রমপ্রবণ,	
ispredseet,	ইস্টারফের্ট,	স্প্রেডশীট,	
fansi,	ফান্স,	ফাঁসী,	
munsi,	মুন্সি,	মুন্সী,	
panchasjan,	পঞ্চসজান,	পঞ্চাশজন,	
sanaktakaran,	সনাকটকরণ,	সনাক্তকরণ,	
jackey,	জ্যাক,	জকি,	
quata,	কুইতা,	কোটা,	
porjotoker,	পর্যটকের,	পর্যটকের,	
jerusalemer,	জেরুফালেমের,	জেরুজালেমের,	
teemothy,	তেমথ,	টিমোথি,	
shatoke,	শাতকে,	শতকে,	
geographics,	জিওগ্রাফিক্স,	জিওগ্রাফিকস,	
sahozlabhbhatar,	সহম্যভযবতার,	সহজলভ্যতার,	
hingsar,	হীংসার,	হিংসার,	
shansthagulo,	শঙ্কটগুলো,	সংস্থাগুলো,	
jontrototto,	যন্ত্রদূত্ত,	যন্ত্রতত্ত্ব,	
cxt,	সিটিএসটি,	সিএক্সটি,	
drissogulote,	দৃক্যগুলোতে,	দৃশ্যগুলোতে,	
daap,	দাপ,	ড্যাপ,	
rakhtokkharone,	রক্তচ্ষারণে,	রক্তক্ষরণে,	
chikitsanirbhar,	চিকিৎসারির্ভর,	চিকিৎসানির্ভর,	
bisnuke,	বিসনুকে,	বিষ্ণুকে,	
ponthaar,	পন্থার,	পন্থার,	
bhoutikeshu,	ভৌতিশেষু,	ভৌতিকেষু,	
shasankarta,	শাসনকর্তা,	শাসনকর্তা,	
hena,	হেনা,	হেনা,	
tirmijii,	তির্জিমি,	তিরমিজি,	
vault,	ভেল্ট,	ভল্ট,	
gazetted,	গেজেট্টেড,	গেজেটেড,	
dokkhinangsho,	দক্ষিণাংশ,	দক্ষিণাংশ,	
roktokhoron,	রক্তকরণ,	রক্তক্ষরণের,	
brookoleen,	ব্রুকললন,	ব্রুকলিন,	
shikkhartheerao,	শিক্ষার্থীরাও,	শিক্ষার্থীরাও,	
bojhey,	বোঝে,	বোঝে,	
taposgoner,	তাপসগণের,	তাপসগণের,	
janar,	জানার,	জানার,	
nathivookteer,	নথিবেক্ত্বের,	নথিভুক্তির,	
shainyader,	শৈন্যাদের,	সৈন্যদের,	
janamukhi,	জানুমুখী,	জনমুখী,	
smarak,	স্মারক,	স্মারক,	
promodwara,	প্রমোদপরা,	প্রমদ্বারা,	
jommu,	জম্মু,	জম্মু,	
tarunra,	তরুণরা,	তরুণরা,	
qarlosa,	কার্লসা,	কার্লোস,	
ciima,	সিয়ামা,	সীমা,	
saabyastha,	সাব্যতস্থ,	সাব্যস্থ,	
munshiji,	মুন্সিজি,	মুনশীজি,	
koreempoor,	করেলনোর,	করিমপুর,	
bibecchyo,	বিবেকচয়,	বিবেচ্য,	
shhepha,	শেফা,	শেফ,	
laaishheshh,	লাইশেশ,	লাইসেন্স,	
sikarder,	সিকারদের,	শিকারদের,	
kiibord,	কিউবর্ড,	কীবোর্ড,	
sobrakamer,	সব্রাকমের,	সবরকমের,	
huka,	হুকা,	হুক,	
alpa,	আলপা,	অল্প,	
dakticket,	ডাকতিয়েত,	ডাকটিকিট,	
residensa,	রেসিডেন্স,	রেসিডেন্স,	
satarkabhabey,	সতরককভাবে,	সতর্কভাবে,	
stona,	স্তনা,	স্টোন,	
eshtonia,	এসতানিয়া,	এস্তোনিয়া,	
sabrakamer,	সব্রা্জের,	সবরকমের,	
poorohitder,	পুরহহিটদের,	পুরোহিতদের,	
suchonakal,	সূচকালাল,	সূচনাকাল,	
proo,	প্রো,	প্রো,	
delibhara,	দেলিহারা,	ডেলিভার,	
taunship,	তাউশশিপ,	টাউনশিপ,	
ashor,	আশোর,	আসর,	
kadakhonchar,	কদ়াখাচচর,	কাদাখোঁচার,	
laaishenshh,	লাইসেনসহ,	লাইসেন্স,	
janagononar,	জননাগানার,	জনগণনার,	
raagei,	রাগেই,	রাগেই,	
prothakey,	প্রথাকে,	প্রথাকে,	
ghumacchilo,	ঘুমাচ্ছিল,	ঘুমাচ্ছিল,	
shahjapur,	শাহজাপুর,	শাহজাপুর,	
mercial,	মার্সিয়াল,	মার্শিয়াল,	
ghenshei,	ঘেঁশেই,	ঘেঁষেই,	
madhumati,	মধুমতি,	মধুমতী,	
sahajlabhbhotar,	সহবলযভত্তর,	সহজলভ্যতার,	
emerjency,	এমেরজেন্সি,	এমার্জেন্সি,	
lyataa,	ল্যা,	ল্যাটা,	
madhoboir,	মাধবুর,	মাধবীর,	
langhangulir,	লংশগুলির,	লঙ্ঘনগুলির,	
ingreziteo,	ইংরেজিতেও,	ইংরেজিতেও,	
markeetim,	মার্কেটিম,	মার্কেটিং,	
hooldim,	হোল্ডিম,	হোল্ডিং,	
taholo,	তহলো,	তাহলো,	
shringa,	শ্রিংগা,	শৃঙ্গ,	
himsrot,	হিমস্রোত,	হিমস্রোত,	
sanstha,	সংস্থ,	সংস্থা,	
protiakromonei,	প্রতিয়াজ্যরেণে,	প্রতিআক্রমণেই,	
ajijer,	আজিজের,	আজিজের,	
kampita,	কম্পিতা,	কম্পিত,	
ukeliptas,	ইউকেলোপ্সিট,	ইউক্যালিপ্টাস,	
jerusaleme,	জেরুফামেম,	জেরুসালেমে,	
neerbahi,	নিরবাহী,	নির্বাহি,	
nehle,	নেহলে,	নেহলে,	
riazuddin,	রিয়াজ্দ্দিন,	রিয়াজউদ্দীন,	
janghu,	জাংশু,	জঙ্ঘু,	
ponera,	পোনেরা,	পনের,	
shasheja,	শাশেজা,	সসেজ,	
manob,	মানব,	মানব,	
gondhe,	গন্্ধে,	গন্ধে,	
ajibooner,	অজিবোলের,	আজীবনের,	
ancholgoolir,	অ্যাঙ্কোলিলের,	অঞ্চলগুলির,	
antorvuktimulak,	অন্তর্বিকীতামূলক,	অন্তর্ভুক্তিমূলক,	
ramantic,	রামনটিক,	রোমান্টিক,	
siramikasa,	সিরামিসাসা,	সিরামিকস,	
chalochchitraeei,	চাচ্চচিত্রদেই,	চলচ্চিত্রেই,	
abdoone,	আবদুনে,	আবদুন,	
ghotaibe,	ঘটাবেই,	ঘটাইবে,	
daltyagi,	দাল্টজিগ,	দলত্যাগী,	
nirbachokder,	নির্বাচকদের,	নির্বাচকদের,	
bodna,	বদনা,	বদনা,	
kaamij,	কামিজ,	কামিজ,	
ajij,	আজিজ,	আজিজ,	
armeenian,	আর্েনিয়ান,	আর্মেনিয়ান,	
dibi,	দিবি,	দিবি,	
hepatetisa,	হেপাটেটিয়া,	হেপাটাইটিস,	
teter,	টেটের,	টেটের,	
dologuloo,	দলগুলোয়,	দলগুলোও,	
simons,	সিমোন্স,	সিমন্স,	
nick,	নিক,	নিক্,	
shaater,	সাতের,	শ্যুটার,	
grontho,	গ্রন্থ,	গ্রন্থ,	
sinaake,	সিনাকে,	সিনাকে,	
teksuser,	তেকসকুরের,	টেক্সাসের,	
oitijje,	ঐতিয্জে,	ঐতিহ্যে,	
pratishthanik,	প্রতিষ্ঠানিক,	প্রাতিষ্ঠানিক,	
jeelyaand,	জিল্ডান্ড,	জিল্যান্ড,	
maunchostho,	মঞ্চথস্থ,	মঞ্চস্থ,	
krush,	ক্রুশ,	ক্রুশ,	
deqe,	ডেকে,	ডেকে,	
gandhikey,	গান্ধীকে,	গান্ধীকে,	
bhittiti,	ভিত্তিটি,	ভিত্তিটি,	
sylvi,	সিলভি,	সিলভি,	
eporzonto,	ইপরজন্ত,	এপর্যন্ত,	
lokhindorer,	লকিষণ্ডের,	লখিন্দরের,	
dweepgoolotey,	দ্বীপলোতে,	দ্বীপগুলোতে,	
chaiten,	চৈতেন,	চাইতেন,	
kode,	কোদে,	কোড,	
chalai,	চালাই,	চালাবে,	
samaveshke,	সমাবেশকে,	সমাবেশকে,	
tukrowti,	টুকরোি,	টুকরোটি,	
proteemar,	প্রোটমার,	প্রতিমার,	
chintakarma,	চিন্তাকর্ম,	চিন্তাকর্ম,	
timathi,	তিমাথি,	টিমোথি,	
fongli,	ফোনলি,	ফংলি,	
expreshshion,	এক্সপ্রেশশন,	এক্সপ্রেশন,	
jamjomat,	জামোজামত,	জমজমাট,	
ganosochetonota,	গণসচেনতা,	গণসচেতনতা,	
tintir,	তিনটির,	তিনটির,	
sudrissho,	সুদৃষ্,	সুদৃশ্য,	
lakshmir,	লক্ষ্মীর,	লক্ষ্মীর,	
hydrological,	হাইড্রোলজিক্যাল,	হাইড্রোলজিক্যাল,	
nazad,	নাজাদ,	নাজাদ,	
mukhya,	মুখ্যা,	মুখ্য,	
dhaanche,	ধাঁছে,	ধাঁচে,	
associatis,	অ্যাসাকিটিসিস,	এসোসিয়েটস,	
hazat,	হাজাত,	হজত,	
tapdei,	তাপদেই,	তাপড়েই,	
angsogrohone,	অংশগ্রহণে,	অংশগ্রহনের,	
rajendracholer,	রাজেন্দ্রছলের,	রাজেন্দ্রচোলের,	
ghoomachhe,	ঘোয়াচ্ছে,	ঘুমাচ্ছে,	
dibate,	দিবাতে,	ডিবেট,	
neerbachoker,	নির্বাচকের,	নির্বাচকের,	
postac,	পোস্টাক,	পোস্টকে,	
ji,	জি,	জি,	
coons,	কনস,	কুনস,	
pathkrom,	পাঠক্রম,	পাঠক্রম,	
shikshakbrindo,	শিক্ষাকৃৃন্দ,	শিক্ষকবৃন্দ,	
bhageri,	ভাগেরি,	ভাগেরই,	
simantarkkhibahinir,	সীমান্তরিবিজ্ঞানির,	সীমান্তরক্ষীবাহিনীর,	
bitlaser,	বিটলাসের,	বিটলসের,	
baarnish,	বার্নিশ,	বার্নিশ,	
achintopurer,	আচিত্তরপুরের,	অচিন্তপুরের,	
digreeke,	দিগ্রেকে,	ডিগ্রিকে,	
pratista,	প্রতিস্তা,	প্রতিষ্টা,	
dwipke,	দ্বীপকে,	দ্বীপকে,	
kekru,	কেকরু,	কেকরু,	
vogno,	ভগন,	ভগ্ন,	
oitijhya,	ঐতিহ্য,	ঐতিহ্য,	
loombinee,	লম্বিনে,	লুম্বিনী,	
nilfamarir,	নীলমামপরির,	নীলফামারীর,	
nili,	নীলির,	নিলি,	
bedantodhormo,	বেদন্তরোধম,	বেদান্তধর্ম,	
khali,	খালি,	খালি,	
jyaqasana,	জ্যাকসন,	জ্যাকসন,	
hitokor,	হিতোকোর,	হিতকর,	
gajetted,	গেজেট্টেড,	গেজেটেড,	
naraphoka,	নারাধক,	নরফোক,	
kraim,	ক্রেম,	ক্রাইম,	
binee,	বিনে,	বেনি,	
shangkulaan,	শানকুলাং,	সংকুলান,	
haitasha,	হাইতাশা,	হাইটস,	
turisht,	তুরিস্ট,	টুরিস্ট,	
ancholgoolote,	অঞ্চলগলিতে,	অঞ্চলগুলোতে,	
jamkaalo,	যামকালো,	জমকালো,	
sithilotar,	সিথিলতার,	শিথিলতার,	
ardasho,	আরদাসহ,	আর্দশ,	
shangsthatikey,	শঙ্খনটিকে,	সংস্থাটিকে,	
zoojyota,	জোয়াজ্য,	যোজ্যতা,	
societyke,	সকিইটকে,	সোসাইটিকে,	
kuldip,	কুলদিপ,	কুলদীপ,	
forex,	ফোরেক্স,	ফরেক্স,	
kinsha,	কিনশা,	কিংস,	
si,	সি,	এসআই,	
borendroke,	বোেেন্দ্রকে,	বরেন্দ্রকে,	
akram,	আকররম,	আকরাম,	
husni,	হুসনি,	হুসনি,	
proshtotto,	প্রশ্যত্ত,	প্রস্ত্তত,	
nibobondhonkrito,	নিবর্ধকত্তিত,	নিববন্ধনকৃত,	
saqara,	সাকারা,	সাকার,	
quary,	কোয়ার্,	কোয়েরি,	
harees,	হারেস,	হ্যারিস,	
guzon,	গুজন,	গুজব,	
dhyanastha,	ধ্যানস্থ,	ধ্যানস্থ,	
paripakey,	পারিপাকে,	পরিপাকে,	
byabosthar,	ব্যবস্থার,	ব্যবস্থার,	
shishupalgarh,	শিশুপাল্চা,	শিশুপালগড়ে,	
karadandey,	কারাদণ্ডে,	কারাদণ্ডে,	
aamontrito,	আমন্ত্রিত,	আমন্ত্রিত,	
engrejer,	এংরেজের,	ইংরেজের,	
gonesher,	গনেসের,	গণেশের,	
kormopontha,	কর্মপন্থা,	কর্মপন্থা,	
badhamuktovabe,	বাধাগুবত্ববে,	বাধামুক্তভাবে,	
bishwaashshke,	বিশ্বকেশকে,	বিশ্বাসকে,	
kaleo,	কালেও,	কালেও,	
bolvodro,	বলদপপো,	বলভদ্র,	
pyetarna,	পাইতার্ন,	প্যাটার্ন,	
krusher,	ক্রুশের,	ক্রুশের,	
bosben,	বসবেন,	বসবেন,	
bhuushito,	ভুষিতই,	ভূষিত,	
gaichey,	গাইছে,	গাইছে,	
gara,	গারা,	গোর,	
sahab,	সাহাব,	সাহাব,	
welaqama,	বিলাকাজ,	ওয়েলকাম,	
biphal,	বিধল,	বিফল,	
protibedokrao,	প্রতিবেদকরাও,	প্রতিবেদকরাও,	
lobbytey,	লবভেটি,	লবিতে,	
varote,	ভারতো,	ভারতে,	
laiseensee,	লাইসেন্স,	লাইসেন্স,	
shikhra,	শিখরা,	শিখরা,	
byomkesh,	ব্যগসেষ,	ব্যোমকেশ,	
badaghat,	বাদাঘাট,	বাদাঘাট,	
byboshthar,	ব্যবস্থার,	ব্যাবস্থার,	
bardhitansh,	বর্্তিদান,	বর্ধিতাংশ,	
macbeth,	ম্যাকবেথ,	ম্যাকবেথ,	
review,	রেভিইর,	রিভিউও,	
toler,	তোলের,	তালের,	
nuhas,	নুহাস,	নুহাশ,	
drissoteer,	ড্রিস্টের,	দৃশ্যটির,	
sthapona,	স্থাপনা,	স্থাপনা,	
crucer,	ক্রুসের,	ক্রুশের,	
daktikit,	দাকদিকটি,	ডাকটিকিট,	
qyapasula,	ক্যাপাকুলা,	ক্যাপসুল,	
dakkhinkare,	দক্ষিণকারী,	দক্ষিণকরে,	
vittiteo,	ভিত্তিতেও,	ভিত্তিতেও,	
barnis,	বা্নিস,	বার্নিশ,	
poddhotitei,	পদ্ধতিতেই,	পদ্ধতিতেই,	
footballerra,	ফুটবলারেরা,	ফুটবলাররা,	
jens,	জেন্স,	জিন্স,	
ganoporibahoner,	গণপরিবাচনের,	গণপরিবহনের,	
khanonkaj,	খননকাজ,	খননকাজ,	
kalki,	কালকি,	কালকি,	
sharansthal,	শরসষ্থাল,	শরণস্থল,	
uttor,	উত্তর,	উওর,	
bachai,	বাচাই,	বাছাই,	
narsinghomgulor,	নার্সিংকগুলোর,	নার্সিংহোমগুলোর,	
eduardo,	এডুর্য়াড,	এডুয়ার্দো,	
shekarone,	শেকারণে,	সেকারণে,	
sipa,	সিপা,	শিপ,	
bokul,	বোকুল,	বকুল,	
scholastic,	স্কুলাস্টিক,	স্কলাস্টিক,	
tookrokey,	তুক্করকে,	টুকরোকে,	
registrikrito,	রেজিস্ট্রিকৃত,	রেজিস্ট্রীকৃত,	
basaalt,	বাসালট,	ব্যাসল্ট,	
catholicder,	ক্যাথোলিকদের,	ক্যাথলিকদের,	
phood,	ফুি,	ফুড,	
toufik,	টাফিক,	তৌফিক,	
dantahin,	দন্তাহীন,	দন্তহীন,	
bondira,	বন্দিরা,	বন্দীরা,	
scholars,	স্কেলার্স,	স্কলার্স,	
planea,	প্ল্যানে,	প্লেনে,	
geja,	গেজা,	গেজ,	
gratha,	গ্রাথ,	গ্রোথ,	
shasonkarta,	শাসনকর্তা,	শাসনকর্তা,	
sofie,	সফিি,	সোফি,	
timoothi,	তিমোথি,	টিমোথি,	
maudelder,	মুদেলদের,	মডেলদের,	
digree,	দিগ্রে,	ডিগ্রি,	
ship,	শিপ,	শিপ,	
eoki,	ইইকি,	এওকি,	
steeit,	স্টিট,	স্টেইট,	
kings,	কিংস,	কিংস,	
madhabi,	মাধবী,	মাধবী,	
sathik,	সাথিক,	সঠিক,	
udbodhani,	উদ্যোধনী,	উদ্বোধনী,	
bbiswashke,	বিশ্বেসকে,	বিশ্বাসকে,	
musallati,	মুসল্লতী,	মুসল্লাটি,	
joones,	জুনেস,	জোন্স,	
trenda,	ট্রেন্ড,	ট্রেন্ড,	
granthatyke,	গ্র্যান্ডকেটকে,	গ্রন্থটিকে,	
shekarmani,	শেকারমণি,	শেকরমানি,	
mukharji,	মুখর্জী,	মুখার্জী,	
shahanara,	শাহানারা,	শাহানারা,	
edaningkale,	এডিনাঙ্গলে,	ইদানীংকালে,	
onker,	অঙ্কের,	ওঙ্কার,	
shukraanoo,	শুক্রনও,	শুক্রানু,	
nabatamo,	নবতামো,	নবতম,	
avidur,	অভিদুর,	আভিদুর,	
basab,	বাসাব,	বাসাব,	
shahoshikatar,	শাহসিকতার,	সাহসিকতার,	
nirmankaaj,	নির্মাণকম,	নির্মাণকাজ,	
bosonte,	বসন্তে,	বসন্তে,	
nagorikra,	নাগোরীকরা,	নাগরিকেরা,	
danaqana,	দানাকানা,	ডানকান,	
saraiki,	সরাাকি,	সরাইকি,	
tep,	টিপ,	ট্যাপ,	
proshadhoner,	প্রশাধনের,	প্রসাধনের,	
dianes,	দায়েনাক্স,	ডিএনএস,	
masjidtir,	মাসজিদিতির,	মসজিদটির,	
siqh,	সিখ,	শিখ,	
prachando,	প্রচান্ড,	প্রচণ্ড,	
vittio,	ভিত্তিও,	ভিত্তিও,	
sokkhomotabriddhi,	সক্ষতামর্বিবোধী,	সক্ষমতাবৃদ্ধি,	
peethey,	পীথে,	পীঠে,	
kamti,	কামটি,	কমতি,	
cholocchitrer,	চলচ্চিত্রের,	চলচ্চিত্রের,	
valobase,	ভালোবাসে,	ভালোবাসে,	
erajyobasi,	এরাজবাসী,	এরাজ্যবাসী,	
bisshas,	বিশ্ষাস,	বিশ্বাস,	
baugey,	বাউজে,	বাগে,	
khitkar,	খিতকার,	ক্ষিতকর,	
spancer,	স্প্যান্সের,	স্পেন্সার,	
baieq,	বাই়েক,	বাইক,	
paira,	পাওরা,	পাইরা,	
torkarite,	তরকারিতে,	তরকারিতে,	
muhuriganj,	মুহুরীগঞ্জ,	মুহুরীগঞ্জ,	
parqim,	পার্িিজ,	পার্কিং,	
zaire,	জুয়র,	জাইরে,	
khalidke,	খালিদকে,	খালিদকে,	
chahidapotrer,	চাহিদাপত্রের,	চাহিদাপত্রের,	
bajpa,	বাজপা,	বাজপা,	
durarohini,	দুরারোহিনী,	দুরারোহিণী,	
teman,	তেমান,	তেমন,	
harza,	হারজা,	হার্জ,	
kosambir,	কোমাম্বীর,	কোসাম্বীর,	
pitiler,	পিতিলের,	পিটিলের,	
swasthohinotay,	স্বাস্থ্যহীনতায়,	স্বাস্থ্যহীনতায়,	
akhhunno,	অখুন্ন,	অক্ষুণ্ণ,	
sangkalanti,	সংকটলটি,	সংকলনটি,	
fiksing,	ফিকশিং,	ফিক্সিং,	
uddhrita,	উদ্ধৃত,	উদ্ধৃত,	
nyeta,	নিইটা,	ম্যাট,	
santoshpore,	সন্ত্রশপে,	সন্তোষপুর,	
mercedes,	মার্সেস,	মার্সেডেস,	
inapharameshana,	ইনাপমেশন,	ইনফরমেশন,	
graambaashio,	গ্রামবাশিও,	গ্রামবাসীও,	
dreeshtiheen,	দ্বিপেেহীন,	দৃষ্টিহীন,	
plator,	প্লাটো,	প্লেটোর,	
ancholsomuho,	অঞ্চলসমূহ,	অঞ্চলসমূহ,	
soommo,	সুয়োম,	সুমো,	
corymb,	করলেমি,	করিম,	
aaeerese,	আইরেসে,	আইরেসে,	
tunaita,	তুনাই়াতা,	টুনাইট,	
thyachara,	থাচাচার,	থ্যাচার,	
suparichiti,	সুপারিঘিটি,	সুপরিচিতি,	
masto,	মাস্টো,	মাস্ত,	
chapchap,	চাপচাপ,	চাপচাপ,	
lendal,	লেন্ডাল,	লেন্ডল,	
shotodha,	শতধধা,	শতধা,	
bakhyateet,	বাখ্যাতেট,	ব্যাখ্যাতীত,	
mesenjarer,	মেসেনাজারের,	মেসেঞ্জারের,	
uparzoner,	উপার্জনের,	উপার্জনের,	
chupani,	চুপানি,	চুপানি,	
lutheerana,	লুথেরান,	লুথেরান,	
oncholke,	অংচকে,	অঞ্চলকে,	
shubhag,	শুভাগ,	শুভাগ,	
bagdadii,	বাগদাদি,	বাগদাদী,	
bangobandhu,	বঙ্গবন্ধুই,	বঙ্গবন্ধু,	
teoner,	টেওনির,	টিওনার,	
swastir,	স্বস্তির,	স্বস্তির,	
sumoo,	সুমোয়ো,	সুমো,	
lubitz,	লুবিৎজ,	লুবিৎজ,	
mankisundar,	মানকিসুন্দর,	মানকিসুন্দর,	
bhupal,	ভুপাল,	ভূপাল,	
byatari,	ব্যাটারী,	ব্যাটারী,	
maradeha,	মারেদহ,	মরদেহ,	
bejiye,	বেজিয়ে,	বেজিয়ে,	
ghatiti,	ঘাটিটি,	ঘাঁটিটি,	
prasadhoni,	প্রসাধনী,	প্রসাধনী,	
baasaate,	বাসাতে,	বাসাতে,	
osommotite,	অসম্মতিতে,	অসম্মতি,	
yanqee,	যানকে,	ইয়াংকি,	
elaaka,	এলাকা,	এলাকা,	
codeti,	কোডেট,	কোডটি,	
tigmanshu,	তিগমানুষ,	তিগমংশু,	
deil,	দেইল,	ডেইল,	
charban,	চারবান,	চর্বন,	
fooloo,	ফুলো,	পোলো,	
postar,	পোস্টার,	পোস্টের,	
agaldar,	আগালদার,	আগলদার,	
airish,	আইরিশ,	আইরিস,	
khelechen,	খেলেছেন,	খেলেছেন,	
probhritike,	প্রভৃতিকে,	প্রভৃতিকে,	
ritesh,	রিটেশ,	রিতেশ,	
gujab,	গুজাব,	গুজব,	
foks,	ফকক্স,	ফক্স,	
kobutorer,	কবুতরের,	কবুতরের,	
chhotogolper,	ছোটগল্পের,	ছোটগল্পের,	
seramiks,	সেরামিক্স,	সিরামিকস,	
paab,	পাব,	পাব,	
canservatian,	ক্যান্সারভিনে,	কনসারভেশন,	
oshtader,	অস্টাদের,	ওস্তাদের,	
bijito,	বিজিত,	বিজিত,	
ragei,	রাগেই,	রাগেই,	
rifleksa,	রিক্লেস্কা,	রিফ্লেক্স,	
laat,	লাট,	লাট,	
chheher,	ছেহের,	ছেহের,	
icelands,	আইসেন্যান্ডস,	আইসল্যান্ডসহ,	
scholarsip,	স্কলারবিপ,	স্কলারশিপ,	
hari,	হারি,	হরি,	
chikitsar,	চিকিতসার,	চিকিত্সার,	
chirkoot,	চিরকত,	চিরকুট,	
mishal,	মিশাল,	মিশাল,	
orthonitir,	অর্ধনীতির,	অর্থনীতির,	
manushe,	মানুষে,	মানুষে,	
eshtoniya,	এসতনিয়া,	এস্তোনিয়া,	
pulivendla,	পুলিভেন্ডলা,	পুলিভেন্ডলা,	
aro,	আরু,	আরও,	
diznee,	দিজনে,	ডিজনী,	
probhur,	প্রভুর,	প্রভুর,	
vesselli,	ভেসেলি,	ভেসেলি,	
gonjona,	গন্যোনা,	গঞ্জনা,	
dada,	দাদা,	দাদা,	
prime,	প্রাইম,	প্রাইম,	
mononiitoder,	মনোনীতিয়ের,	মনোনীতদের,	
biplabeer,	বিপ্লবের,	বিপ্লবীর,	
rajbondir,	রাজবন্দির,	রাজবন্দীর,	
chalachchitroi,	চাচ্চচিত্রই,	চলচ্চিত্রই,	
pyatarne,	প্যাটারেনে,	প্যাটার্নে,	
krom,	ক্রম,	ক্রম,	
ekirokom,	একিকর্ম,	একইরকম,	
vezano,	ভেজানো,	ভেজানো,	
mag,	মাগ,	এমএজি,	
remacri,	রিমাক্রি,	রেমাক্রী,	
prasadhani,	প্রসাধনী,	প্রসাধনী,	
heart,	হেয়ার্ট,	হার্ট,	
ashamorthito,	অশাগর্ভিত,	অসমর্থিত,	
nutaner,	নুতানের,	নূতনের,	
marmader,	মারমাদের,	মারমাদের,	
qirq,	কির্ক,	কার্ক,	
rajpur,	রাজপুর,	রাজপুর,	
bayii,	বায়িি,	বাঈ,	
satarkakari,	সতর্ককারী,	সতর্ককারী,	
abosare,	অবসারে,	অবসরে,	
eekbalke,	ইই্ভালকে,	ইকবালকে,	
batistambhatike,	বাতিস্মানভাতিকে,	বাতিস্তম্ভটিকে,	
qrisenta,	ক্রিসেন্টা,	ক্রিসেন্ট,	
kaferder,	কাফেরদের,	কাফেরদের,	
maailkhanek,	মাইলখানেক,	মাইলখানেক,	
falasrutite,	ফালাকপুরিতে,	ফলশ্রুতিতে,	
chaaktir,	চাকতির,	চাকতির,	
becha,	বেচ,	বেচা,	
titarer,	তিতারের,	তিতারের,	
gejetade,	গেজেটাড,	গেজেটেড,	
artilary,	আর্তিলারি,	আর্টিলারি,	
helly,	হেলল,	হিলি,	
karmokarke,	কারমযকারকে,	কর্মকারকে,	
riphleksa,	রিপলেসা,	রিফ্লেক্স,	
baibosthaar,	বৈষস্থার,	ব্যবস্থার,	
monchosthol,	মঞ্চস্থল,	মঞ্চস্থল,	
onucheeder,	অনুচেদের,	অনুচ্ছেদের,	
mangolic,	ম্যানগোলিক,	মাঙ্গলিক,	
paner,	পানের,	পানের,	
abheedhanik,	অভিধানক,	অভিধানিক,	
gandagol,	গানডাগোল,	গন্ডগোল,	
chouhate,	চৌহাতে,	চৌহাটে,	
phund,	ফুন্ড,	ফান্ড,	
jaandrel,	যানদ্রেল,	জাঁদরেল,	
teamothy,	তেওমথ,	টিমোথি,	
shikshakbrinda,	শিক্ষাকৃন্দ,	শিক্ষকবৃন্দ,	
fasir,	ফাসির,	ফাসীর,	
chalochchitraeeo,	চাচ্চচিত্রদেও,	চলচ্চিত্রেও,	
lutharan,	লুথারান,	লুথেরান,	
eokee,	ইইকে,	এওকি,	
atarkitey,	আতারকিতে,	অতর্কিতে,	
bisshonath,	বিশ্ণনাথ,	বিশ্বনাথ,	
lavta,	লাভৎা,	লাভটা,	
dalee,	দালি,	ডালে,	
gingbhalobasen,	গিন্াভালসোলন,	গিংভালোবাসেন,	
ebham,	এভাম,	ইভিএম,	
minishtarer,	মিনিশতারের,	মিনিস্টারের,	
ramolino,	রামলীনো,	রামোলিনো,	
firth,	ফিরথ,	ফার্থ,	
bisshasyi,	বিশ্বাস্য,	বিশ্বাসই,	
chenza,	চেঞ্জা,	চেঞ্জ,	
stoonahenja,	স্টনোচেছমা,	স্টোনহেঞ্জ,	
dekaner,	দেকানের,	দেকানের,	
samyuktha,	সামুক্তথা,	সামিউক্তা,	
hames,	হেমেস,	হোমস,	
prosadhoni,	প্রসাধনী,	প্রসাধনী,	
pooshteer,	পুষ্টার,	পুষ্টির,	
mumtazer,	মুম্বাগের,	মুমতাজের,	
metrikoleshana,	মেটৃকাংশন,	মেট্রিকোলেশন,	
futote,	ফুটোতে,	ফুটোতে,	
bhujangta,	ভুজন্ত,	ভুজঙ্গটা,	
aanaan,	আনাান,	আনান,	
adhyattikota,	অধ্যা্যকিত,	আধ্যাত্মিকতা,	
directorete,	ডিরেক্টরিতে,	ডিরেক্টরেট,	
mithener,	মিথেনের,	মিথেনের,	
arekdol,	আরেকডোল,	আরেকদল,	
addata,	আদ্াডা,	আড্ডাটা,	
tigre,	তিগরে,	টাইগার,	
shajano,	শাজানো,	সাজানো,	
thandabhabe,	থানডাহাবে,	ঠাণ্ডাভাবে,	
masjidsaho,	মসজিদসহ,	মসজিদসহ,	
hajeerhatt,	হাজেরহাট,	হাজিরহাট,	
ansarir,	আনসারির,	আনসারীর,	
dakter,	ডাকতের,	ডাকতের,	
hizrite,	হিজরিতে,	হিজরীতে,	
patengar,	পাযাটেঙ্গার,	পতেঙ্গার,	
debate,	দেবাতে,	ডিবেট,	
zeeland,	জিলান্দ,	জিল্যান্ড,	
akheli,	আছেলি,	আখেলী,	
korimer,	করিমের,	করিমের,	
dakshinangsho,	দক্ষিণাংশ,	দক্ষিণাংশ,	
kolkarkhana,	কোলকরনহানা,	কলকারখানা,	
muradkey,	মুরাদকে,	মুরাদকে,	
capsul,	ক্যাপসুল,	ক্যাপসুল,	
cheekitshar,	চেফিতশার,	চিকিত্সার,	
puroheetder,	পুরোহেটদের,	পুরোহিতদের,	
guzober,	গুজোভের,	গুজবের,	
doorger,	ডুর্গের,	দুর্গের,	
audioguloke,	অডিওকগুলোকে,	অডিওগুলোকে,	
andra,	আন্দ্রা,	আন্ড্রা,	
ancholsaha,	আঞ্চলসহ,	অঞ্চলসহ,	
mataram,	মাতারাম,	মাতরম,	
engrejra,	এংরেজরা,	ইংরেজরা,	
ingrezeeteo,	ইংরেজিতেও,	ইংরেজিতেও,	
naazi,	নাজি,	নাত্সি,	
hul,	হুল,	হুল,	
alaol,	আলালো,	আলাওল,	
sikkhokder,	সিক্ষকদের,	শিক্ষকদের,	
dholeshwari,	ধলেশ্বরী,	ধলেশ্বরী,	
tenishe,	তেনিশে,	টেনিসে,	
nagorikota,	নাগরিকতা,	নাগরিকতা,	
thailand,	থাইলান্ড,	থাইল্যান্ড,	
nadnadeer,	নদ্দাদের,	নদনদীর,	
annimated,	অ্যানিমেটেড,	এনিমেটেড,	
bhandti,	ভাণদিত,	ভাণ্ডটি,	
abhidhaaner,	অভিধানের,	অভিধানের,	
pinogbagke,	পিনোগ্যাজকে,	পিনগবাগকে,	
beatleser,	বিটলিসের,	বিটলসের,	
mile,	মিলে,	মিলে,	
eenameela,	ইইনােলা,	এনামেল,	
daaktikite,	দাকদিকিতে,	ডাকটিকিটে,	
gorjon,	গর্ন,	গর্জন,	
votar,	ভোটার,	ভোটার,	
jeshh,	জেশে,	জেস,	
degreeo,	দেগ্রেও,	ডিগ্রিও,	
prakar,	প্রকার,	প্রকার,	
teunar,	তেউনার,	টিউনার,	
jubokti,	যুবক্তি,	যুবকটি,	
jotharthovabey,	যথাপ্ষতাবে,	যথার্থভাবে,	
ongkush,	অংশুখ,	অংকুশ,	
scuvi,	স্কুভি,	স্কুভি,	
mochlekha,	মোচেছা,	মোছলেখা,	
nek,	নেক,	নেক,	
hastamathun,	হস্তসমূত,	হস্তমথুন,	
nirbaho,	নির্বাহ,	নির্বাহ,	
pacbar,	পাকবার,	পাঁচবার,	
hukar,	হুকার,	হুকার,	
lambi,	লাম্বি,	লম্বি,	
satarkabhabe,	সতরককভাবে,	সতর্কভাবে,	
ganonanatto,	গণতানত্ব,	গণনাট্য,	
elaakaati,	এলাকাটি,	এলাকাটি,	
vitti,	ভিত্তি,	ভিত্তিই,	
cocaine,	কোচেইন,	কোকেইন,	
audiotike,	অডিটিকে,	অডিওটিকে,	
diiptii,	ডিয়েত্টি,	ডেপুটি,	
konoroop,	কোণোভ,	কোনরূপ,	
shoori,	শূরী,	সুরি,	
tophaat,	তোফাত,	তফাৎ,	
sardar,	সরদার,	সরদার,	
idipasha,	ইদিপাসা,	ইডিপাস,	
gunje,	গুঞ্জে,	গুঁজে,	
ivil,	ইভিল,	ইভিল,	
grambaashi,	গ্রামবাশী,	গ্রামবাসী,	
groundta,	গ্রন্ন্ট,	গ্রাউন্ডটা,	
vodqa,	ভোকক,	ভদকা,	
eeksapreeshana,	ইফ্সাপ্রেশন,	এক্সপ্রেশন,	
bethikata,	বেথিকতা,	বেঠিকতা,	
maadla,	মাইদলা,	মাদলা,	
palteche,	পাল্টেছে,	পাল্টেছে,	
fostar,	ফসস্তার,	ফস্টার,	
emarjenshi,	এমারজিনশি,	এমার্জেন্সি,	
adhyatmik,	অধ্যাতিমক,	আধ্যাত্মিক,	
harja,	হারজা,	হার্জ,	
nichols,	নিকোলস,	নিকলস,	
eupheike,	ইউথেইকে,	ইউফেইকে,	
nothivukta,	নথিবুক্ত,	নথিভুক্ত,	
hol,	হোল,	হোল,	
korimpur,	করিমপুরের,	করিমপুর,	
baharamporer,	বাহারাম্পরের,	বহরমপুরের,	
landin,	ল্যান্ডিন,	ল্যান্ডিং,	
platform,	প্ল্যাটফর্ম,	প্লাটফর্ম,	
vromonkaley,	ভ্রোনকলানকে,	ভ্রমণকালে,	
somraat,	সম্রাত,	সম্রাট,	
america,	অমেরিকা,	আমেরিকা,	
bharatey,	ভারতে,	ভারতে,	
ateetkale,	আ্যাটেল,	অতীতকালে,	
jini,	জিনি,	যিনি,	
dufresne,	ডাকফের্ন,	ডুফরেস্ন,	
reetesh,	রিপেশ,	রিতেশ,	
porizoner,	পরিজনের,	পরিজনের,	
redcrosser,	রেডক্রেসের,	রেডক্রসের,	
sangharshik,	সংঘর্ষিক,	সাংঘর্ষিক,	
omarader,	ওমারাদের,	ওমারাদের,	
plusey,	প্লুসে,	প্লাসে,	
moushum,	মৌশুম,	মৌসুম,	
sahozlabhbhotar,	সহম্যভোধতার,	সহজলভ্যতার,	
upobasher,	উপবাষের,	উপবাসের,	
somoibo,	সমভভবো,	সমৈব,	
provur,	প্রবুর,	প্রভুর,	
gaddaphii,	গডদ্ধাপি,	গাদ্দাফী,	
bohudeen,	বহুদেন,	বহুদিন,	
lagchhe,	লাগছে,	লাগছে,	
longhan,	লংহান,	লংঘন,	
chamski,	চাসেসি,	চমস্কি,	
chitlar,	চিতলার,	চিতলার,	
cheerontan,	চেরনন্তান,	চিরন্তন,	
nariderke,	নারীদেরকে,	নারিদেরকে,	
mitrota,	মিত্রোতা,	মিত্রতা,	
golimodhye,	গোলিমধ্যে,	গলিমধ্যে,	
shommoteer,	শম্মতের,	সম্মতির,	
dhache,	ধাচে,	ধাঁচে,	
munot,	মুনোত,	মুনোট,	
hariner,	হারিনের,	হরিণের,	
laicenshe,	লাইসেন্স,	লাইসেন্স,	
daraider,	দারাদের,	দরাইদের,	
canflikt,	ক্যানলেইটট,	কনফ্লিক্ট,	
chakurijibirao,	চাকুরিজীবিরাও,	চাকুরীজীবীরাও,	
chopol,	চপল,	চপল,	
faase,	ফ্যাসে,	ফাঁসে,	
arthurer,	আর্থুরের,	আর্থারের,	
janoganonar,	জননোগানার,	জনগণনার,	
samajikatar,	সমযাজিকাতার,	সামাজিকতার,	
vvimsenn,	ভিভিএমএসএিএন,	ভীমসেন,	
shikkharthirao,	শিক্ষার্থীরাও,	শিক্ষার্থীরাও,	
dupleks,	ডুপ্লেস,	ডুপ্লে,	
bodhir,	বোধির,	বধির,	
hillse,	হিলসে,	হিলসে,	
bojiye,	বোজিয়ে,	বজিয়ে,	
naagaalyand,	নাগালকান্দ,	নাগাল্যান্ড,	
tochhnochh,	তন্ধচ,	তছনছ,	
oyebjin,	ওয়েবিিন,	ওয়েবজিন,	
nothiboddho,	নথিবদ্ধ,	নথিবদ্ধ,	
blasterke,	ব্ল্যাক্টরী,	ব্লাস্টারকে,	
ramchander,	রামচন্দের,	রামচন্দরের,	
ujobekeestaner,	উজয়েবেস্তানের,	উজবেকিস্তানের,	
utpatti,	উৎপাত্তি,	উতপত্তি,	
ayumi,	আই়ুমি,	আয়ুমি,	
elakatay,	এলাকাটায়,	এলাকাতে,	
dienes,	ডায়েনিস,	ডিএনএস,	
tarkale,	তারকালে,	তারকালে,	
jibanto,	জীবান্ত,	জীবন্ত,	
neemeette,	নিমেতে,	নিমিত্তে,	
kartona,	কর্তনা,	করতনা,	
mandarbani,	মন্ডরাজি,	মন্দারবাণী,	
annorup,	অন্নরূপ,	অন্যরূপ,	
samanwitovabe,	সমমা্তিতভাবে,	সমন্বিতভাবে,	
kholdhular,	খোলধুলার,	খোলধূলার,	
uddhritto,	উদ্ধৃব্ত,	উদ্ধৃত,	
antorvukta,	অন্তর্যুক্ত,	অন্তর্ভুক্ত,	
dibug,	দিবুগ,	ডিবাগ,	
oswastikor,	অস্বস্তিতকর,	অস্বস্তিকর,	
poketchorder,	পকেষ্টদের,	পকেটচরদের,	
toki,	টোকি,	তকি,	
firoza,	ফিরোজা,	ফিরোজা,	
duio,	দুয়ো,	দুইও,	
deefinition,	ডিফিশনেশন,	ডেফিনেশন,	
susamo,	সুসামো,	সুসম,	
meloonborroner,	মেলোব্রোরণের,	মেলবোর্নের,	
abhidhaaneeck,	অভিধানকেক,	অভিধানিক,	
colgirl,	কলিগ্রিল,	কলগার্ল,	
windows,	উইন্ডোাস,	উইন্ডোস,	
aakkaash,	আক্কাশ,	আককাস,	
orrgho,	অর্ঘ,	অর্ঘ্য,	
muktijuddhojato,	মুক্তিযুদ্ধমতো,	মুক্তিযুদ্ধজাত,	
olympik,	অলিম্পিক,	অলিম্পিক,	
orthanitike,	অর্থনীতিকে,	অর্থনীতিকে,	
mitrer,	মিত্রের,	মিত্রের,	
danab,	দানব,	দানব,	
gaujano,	গাউজানো,	গজানো,	
jones,	জনেস,	জোন্স,	
balatkar,	বালাত্কর,	বলাৎকার,	
shumo,	শুমো,	সুমো,	
degree,	দেগরে,	ডিগ্রি,	
manoharpur,	মনোহরপুর,	মনোহরপুর,	
niropekshtar,	নিরাদেশ্বতর,	নিরপেক্ষতার,	
dayitta,	দায়িত্ত,	দায়িত্ব,	
calabe,	কালাবে,	চালাবে,	
amanisa,	আমানিসা,	অমানিশা,	
ekghare,	একঘরে,	একঘরে,	
mangoleek,	ম্যাঙ্গলকে,	মাঙ্গলিক,	
onurbar,	অনুর্বার,	অনুর্বর,	
lat,	লটি,	লাট,	
shuperheiro,	শুপারহিরোর,	সুপারহিরো,	
laiseensim,	লাইসেনসম,	লাইসেন্সিং,	
nariderke,	নারীদেরকে,	নারীদেরকে,	
dankaan,	দাঙ্কান,	ডানকান,	
peterke,	পেটারকে,	পিটারকে,	
uindos,	উইন্ডোস,	উইন্ডোস,	
daqop,	দাকোপ,	দাকোপ,	
bojata,	বোজাত,	বোজাটা,	
ponchaasjon,	পঞ্চাস্বন,	পঞ্চাশজন,	
harris,	হ্যারিস,	হ্যারিস,	
terlarang,	তেরলাাাং,	তেরলারং,	
vangley,	ভ্যানলি,	ভাঙলে,	
protijogitamulok,	প্রতিযোগিতামূলক,	প্রতিযোগীতামূলক,	
huqa,	হুকা,	হুক,	
haris,	হারিস,	হ্যারিস,	
milekhanek,	মিলেখানেক,	মাইলখানেক,	
nirbahi,	নির্বাহী,	নির্বাহি,	
gronthao,	গ্রন্থাও,	গ্রন্থও,	
pancbaar,	পাঁকাবর,	পাঁচবার,	
grambaseer,	গ্রামবাসের,	গ্রামবাসীর,	
bupher,	বুফের,	বাফার,	
protijogii,	প্রতিযোগী,	প্রতিযোগী,	
beauby,	বিউি,	বিউবি,	
samanyai,	সামান্যই,	সামান্যই,	
madelim,	মাডেলিম,	মডেলিং,	
pingna,	পিংমা,	পিংনা,	
kayed,	কায়েদ,	কায়েদ,	
sepha,	সেপা,	শেফ,	
ragee,	রাগে,	রাগী,	
mahibur,	মািবুর,	মহিবুর,	
suparichito,	সুপারিচিত,	সুপরিচিত,	
ganaparibahan,	গণপরিবাহন,	গণপরিবহন,	
female,	ফেমালে,	ফিমেল,	
ekbakke,	একবাককে,	একবাক্যে,	
majdur,	মজদুর,	মজদুর,	
onchalgulir,	অংশালিগুলির,	অঞ্চলগুলির,	
drabyatah,	দ্রব্যাতা,	দ্রব্যতঃ,	
deilee,	দেইলি,	ডেইলি,	
sqolastiq,	স্কুলস্তিক,	স্কলাস্টিক,	
ooporoshtho,	অপরস্থ,	উপরস্থ,	
liaodong,	লিওয়ালং,	লিয়াওদং,	
chhatrodiger,	ছাত্রদিগের,	ছাত্রদিগের,	
balabhadra,	বালাহাদ্রা,	বলভদ্র,	
sheetke,	শীয়কে,	শীতকে,	
scoore,	স্কের,	স্কোর,	
chhon,	ছোন,	ছোঁ,	
naitikatavodh,	নৈতিকতাবোধ,	নৈতিকতাবোধ,	
firalem,	ফিরামেম,	ফিরালেম,	
jaruri,	জারুরি,	জরূরী,	
shuchonakal,	শুচকাকাল,	সূচনাকাল,	
hughkey,	হুগকে,	হিউজকে,	
chetanagoto,	চেতানাগত,	চেতনাগত,	
nikate,	নিকাতে,	নিকটে,	
cholechi,	চলেছি,	চলেছি,	
prothar,	প্রথার,	প্রথার,	
chhutir,	ছুটির,	ছুটির,	
mukhabandha,	মুখাবন্ধ,	মুখবন্ধ,	
zonsa,	যোনস,	জোন্স,	
pharanyeta,	ফরর্ন্ডেত,	ফরম্যাট,	
konruup,	কনসুবপ,	কোনরূপ,	
cholochchitraeeo,	চলচ্চিত্রকেও,	চলচ্চিত্রেও,	
durgatsober,	দুর্গতস্বের,	দুর্গোৎসবে,	
katateo,	কাতাতেও,	কাটাতেও,	
akatwa,	আকাত্মা,	একাত্ব,	
jerushalema,	জেরুশালেমা,	জেরুসালেম,	
irish,	ইরিশ,	আইরিস,	
armeeniyana,	আর্েনিয়ান,	আর্মেনিয়ান,	
bhaandar,	ভাণ্ডার,	ভাণ্ডার,	
shrabasti,	শ্রাবস্তি,	শ্রাবস্তী,	
mexicoteo,	মেক্সিকোট,	মেক্সিকোতেও,	
dagmukta,	দগ্ুক্ত,	দাগমুক্ত,	
sumi,	সুমি,	সুমি,	
everage,	ইভারেজ,	এভারেজ,	
osoborno,	অসবর্ণ,	অসবর্ণ,	
corsin,	করসিন,	করসিন,	
shapad,	শাপাদ,	শ্বাপদ,	
marketin,	মার্কেটিন,	মার্কেটিং,	
mujuru,	মুজুরু,	মুজুরু,	
deenesh,	দীনেশ,	দীনেশ,	
elakatite,	এলাকাটিতে,	এলাকাটিকে,	
chalochchitrei,	চাচ্চচিত্রেই,	চলচ্চিত্রেই,	
bishwaashshoi,	বিশ্বকোষই,	বিশ্বাসই,	
barbadoj,	বারবাবন,	বার্বাডোজ,	
sthapanagulor,	স্থাপানগুলোর,	স্থাপনাগুলোর,	
assaciates,	অ্যাসাস্টেস,	এসোসিয়েটস,	
hugheke,	হুগেকে,	হিউজকে,	
leaders,	লিডার্স,	লিডার্স,	
siqhar,	সিচার,	শিকার,	
sampadon,	সামপাদদ,	সম্পাদন,	
awatar,	আওয়াটার,	অবতার,	
informetion,	ইনফরমেশন,	ইনফরমেশন,	
protishtan,	প্রতিষ্টান,	প্রতিষ্টান,	
bangladesh,	বাংলাদেশ,	বঙ্গালাদেস,	
plack,	প্ল্ক,	প্ল্যাক,	
tukroti,	তুকরতি,	টুকরোটি,	
sombhobonao,	সম্ভোবনাও,	সম্ভবনাও,	
reflex,	রিফ্লেক্স,	রিফ্লেক্স,	
musabbirul,	মুসাফবারুল,	মুসাব্বিরুল,	
qaferderkey,	কাফারদেরকে,	কাফেরদেরকে,	
supreetira,	স্ক্রেটিরা,	সুপ্রীতিরা,	
samajik,	সামাজিক,	সামাজিক,	
shringey,	শ্ঙ্গে,	শৃঙ্গে,	
francine,	ফ্রাঙ্কিন,	ফ্রান্সিন,	
aachhis,	আছিন্স,	আছিস,	
mashtarsha,	মাষ্টারস,	মাস্টার্স,	
koordider,	কোর্ডিদের,	কুর্দিদের,	
bhaibon,	ভাইবন,	ভাইবোন,	
folleni,	ফোলেন,	ফলেনি,	
protishta,	প্রতিষ্টা,	প্রতিষ্টা,	
tintikey,	তিনটিকে,	তিনটিকে,	
tuni,	তুনী,	টুনি,	
durbhagya,	দুর্ভাগ্য,	দূর্ভাগ্য,	
sheshardhe,	শেষার্ধে,	শেষার্ধে,	
bahjya,	বাহজোয়া,	বাহ্য,	
innahu,	ইন্নাহু,	ইন্নাহু,	
oncholtee,	অংখলতে,	অঞ্চলটি,	
jotinkey,	জটিনকে,	যতীনকে,	
keui,	কেউ,	কেউই,	
maryir,	মার্ির,	ম্যারির,	
nirvaha,	নির্বাহা,	নির্বাহ,	
emarjensi,	এমারজেন্সি,	এমার্জেন্সি,	
sangbadmadhyamgulote,	সংবাদমাধ্যমগুলোতে,	সংবাদমাধ্যমগুলোতে,	
kraanti,	ক্রানটি,	ক্রান্তি,	
bandra,	বান্দ্রা,	বন্দীরা,	
dera,	দীরা,	ডেরা,	
panchashjan,	পঞ্চশস্বান,	পঞ্চাশজন,	
juktarashtrasaha,	যুক্তস্তারসহ,	যুক্তরাষ্ট্রসহ,	
lebina,	লেবিনা,	লেবিনা,	
dokan,	দোকান,	দোকান,	
saalsa,	সালসা,	সালসা,	
ikbaaler,	ইকবালের,	ইকবালের,	
upbasher,	উপবাশের,	উপবাসের,	
thailandshoho,	থাইলান্ডসহ,	থাইল্যান্ডসহ,	
jati,	জাতি,	যাতি,	
sobrakomer,	সব্রা্জের,	সবরকমের,	
barder,	বার্ডার,	বার্ডের,	
somonwitobhabey,	সমম্বিকভাবেই,	সমন্বিতভাবে,	
sambatsarkal,	সম্বাস্বকাল,	সম্বৎসরকাল,	
dormroome,	দর্মগ্রে,	ডর্মরুমে,	
bondiira,	বন্দিরার,	বন্দীরা,	
niroja,	নিরোজা,	নিরোজা,	
umedpoor,	উমেদরের,	উমেদপুর,	
pracharanamulak,	প্রচানামূলক,	প্রচারণামূলক,	
distance,	ডিসট্যান্স,	ডিসট্যান্স,	
casper,	ক্যাসপার,	ক্যাসপার,	
shrabostee,	শ্রাবস্তে,	শ্রাবস্তী,	
niketon,	নিকেতন,	নিকেতন,	
rokibul,	রকিবুল,	রকিবুল,	
musalmanderke,	মুসলমার্েদকে,	মুসলমানদেরকে,	
supplenza,	সাপোলেমম,	সাপলেঞ্জা,	
bowie,	বোয়েই,	বওই,	
nisshongotake,	নিঃশন্যাতকে,	নিঃসঙ্গতাকে,	
lyaandeeng,	ল্যান্ডেল,	ল্যান্ডিং,	
murader,	মুরাদের,	মুরাদের,	
nirmol,	নির্মল,	নির্মল,	
weelcomee,	উইলোভেন,	ওয়েলকাম,	
machkabar,	মাছকাবার,	মাচকাবার,	
eukalyptus,	ইউকমলপিস্টাস,	ইউক্যালিপ্টাস,	
sarjur,	সারজুর,	সরযূর,	
hilser,	হিলসের,	হিলসের,	
saoum,	সাই়ম,	সাওম,	
farna,	ফর্ন,	ফার্ন,	
uposhthit,	উপস্থিত,	উপস্থিত,	
gaaddafee,	গাদ্ডাফে,	গাদ্দাফী,	
simaa,	সিমাই,	সীমা,	
literacy,	লাটেরাকি,	লিটারেসি,	
kleentoner,	ক্লেনটনের,	ক্লিনটনের,	
kindom,	কিন্দোম,	কিংডম,	
korle,	করলে,	করলে,	
change,	চাঙ্গে,	চেঞ্জ,	
narbur,	নারবুর,	নরবুর,	
golghare,	গোলঘরে,	গোলঘরে,	
encidablu,	এনসিডাইলাফ,	এনসিডাব্লু,	
poderthobid,	পদের্থবিদ,	পদার্থবিদ,	
oiteejye,	ঐতেজ্যে,	ঐতিহ্যে,	
as,	এসিএস,	অস,	
horas,	হোরাস,	হোরাস,	
suraropito,	সুরাতিপত,	সুরারোপিত,	
toranganj,	তোরাঙ্গম,	তোরাবগঞ্জ,	
daybhager,	দয়ভাগের,	দায়ভাগের,	
ghotol,	ঘটল,	ঘটল,	
manushera,	মনুষেরা,	মানুষেরা,	
treend,	ট্রেন্ড,	ট্রেন্ড,	
chhutochhuti,	ছুটোছুটি,	ছুটোছুটি,	
dwibidho,	দ্বিবিধ,	দ্বিবিধ,	
melborrone,	মেলবোর্ন,	মেলবোর্নে,	
manatmulak,	মানাতুুল্,	মানতমূলক,	
saarbhaarti,	সার্ভরটি,	সার্ভারটি,	
proteemake,	প্রতেমাকে,	প্রতিমাকে,	
ghotleo,	ঘটলেও,	ঘটলেও,	
superheiroo,	সুপারহিরোরো,	সুপারহিরো,	
scorey,	স্কোর,	স্কোরে,	
rohasyer,	রোহাস্যের,	রহস্যের,	
manohputa,	মননুষতা,	মনঃপুত,	
gaje,	গজে,	গেজ,	
antarbhutto,	অন্তর্ভূত্ত,	অন্তর্ভুক্ত,	
sayanaida,	সায়নাদ,	সায়ানাইড,	
zerusalem,	জেরুফালেম,	জেরুজালেম,	
restuarant,	রেস্টুরেন্ট,	রেষ্টুরেন্ট,	
hizriite,	হিজরিতে,	হিজরীতে,	
basaake,	বাসাকে,	বাসাকে,	
dhauto,	ধাত,	ধৌত,	
poschimey,	পশ্চিমে,	পশ্চিমে,	
yaak,	যাক,	ইয়াক,	
sossar,	সোসার,	সকার,	
sumita,	সুমিত,	সুমিতা,	
bo,	বোয়,	বু,	
seoul,	সেইল,	সোল,	
sportstar,	স্পোর্টসেটার,	স্পোর্টসস্টার,	
amanisha,	আমানিসহ,	অমানিশা,	
bhittitei,	ভিত্তিতেই,	ভিত্তিতেই,	
srisri,	শ্রীশ্রি,	শ্রীশ্রী,	
ghomtaa,	ঘোমটাই,	ঘোমটা,	
manibhaijaner,	মানহাবাবানের,	মণিভাইজানের,	
title,	টিটলে,	টাইটেল,	
sahachke,	সহচেকে,	সাহাচকে,	
saseza,	সাসেজা,	সসেজ,	
birmuktijoddhagan,	বীর্ণুতিত্বাধ্যগণ,	বীরমুক্তিযোদ্ধাগণ,	
manab,	মানব,	মানব,	
shandra,	শান্দ্রা,	শান্দ্রার,	
torunderke,	তরুণদেরকে,	তরুণদেরকে,	
asaktibandhan,	অসত্তিকাহীন,	আসক্তিবন্ধন,	
masjidsaha,	মসজিদসহ,	মসজিদসহ,	
siddhantoke,	সিদ্ধান্তকে,	সিদ্ধান্তকে,	
heavy,	হেভি,	হেভি,	
parijaner,	পারিজনের,	পরিজনের,	
kanuner,	কানুনের,	কানুনের,	
somabeshti,	সমাবেশটি,	সমাবেশটি,	
homeser,	হোমেসের,	হোমসের,	
israelbahini,	ইস্বাবিবাহিনী,	ইস্রায়েলবাহিনী,	
durlabhatwang,	দুর্লভাবতং,	দুর্লভত্বং,	
otyacharito,	অত্যচারিত,	অত্যাচারিত,	
vince,	ভিনকে,	ভিন্স,	
shamshernagar,	শমশেশনেরা,	শমশেরনগর,	
udvaboney,	উদ্ববনেযে,	উদ্ভাবনে,	
ratishilatai,	রতিশালতায়,	রতিশীলতায়,	
abosan,	অবসান,	অবসান,	
cinematographar,	সিনেমাতগ্রাফার,	সিনেমাটোগ্রাফার,	
militarite,	মিলিটারিতে,	মিলিটারিতে,	
ankanshilpe,	অঙ্কা্ষেপণে,	অঙ্কনশিল্পে,	
sainyader,	সৈন্যাদের,	সৈন্যদের,	
konorup,	কোণোপু,	কোনরূপ,	
confliqt,	কনফ্লিট,	কনফ্লিক্ট,	
flux,	ফ্ল্যাক্স,	ফ্লাস্ক,	
koyeeri,	কয়েরি,	কোয়েরি,	
nathivookto,	নথিবত্ত্ব,	নথিভুক্ত,	
dighol,	দিঘোল,	দীঘল,	
korimkey,	করিমকে,	করিমকে,	
orthobochorke,	অর্থবছরকে,	অর্থবছরকে,	
sangosrobomukto,	সংস্কূরমুক্ত,	সংস্রবমুক্ত,	
priseflex,	প্রাইভেল্েক্স,	প্রাইজফ্লেক্স,	
caroline,	ক্যারোলিন,	ক্যরোলিন,	
chiraharit,	চিরাহারিত,	চিরহরিৎ,	
lakkhero,	লক্ষেরও,	লক্ষেরও,	
nirikh,	নিরিখ,	নিরিখ,	
temonvabe,	তেমন্ভাবে,	তেমনভাবে,	
vetrillocuism,	ভেট্রিলিকযাসমম,	ভেট্রিলোকুইজম,	
saramukhe,	সারামুখে,	সারামুখে,	
rajnikant,	রাজনিকান্ত,	রাজনীকান্ত,	
adhikartai,	অধিকারতাই,	অধিকর্তাই,	
kaia,	কাওয়া,	কায়া,	
jhanjra,	ঝাঁজরা,	ঝাঁজরা,	
rajyabhogi,	রাজ্যভোগী,	রাজ্যভোগী,	
mandanda,	মানডন্ডা,	মানদণ্ড,	
danakana,	দানাকানা,	ডানকান,	
diibug,	দিয়েগু,	ডিবাগ,	
barack,	বারাক্ক,	বারাক,	
mukhbondho,	মুখবো্ধ,	মুখবন্ধ,	
mayily,	মায়িলে,	মাইলি,	
naper,	নাপের,	ন্যাপের,	
groth,	গ্রোথ,	গ্রোথ,	
hattey,	হ্যাটে,	হাঁটতে,	
pratijogitamulak,	প্রতিযোগিতামূলক,	প্রতিযোগীতামূলক,	
mousumeo,	মৌসুমেও,	মৌসুমেও,	
faskari,	ফাসকারি,	ফাঁসকারী,	
dhrubaker,	ধ্রুবাকের,	ধ্রুবকের,	
armstronz,	আর্মস্ট্রিম,	আর্মস্ট্রং,	
obhaarbhiu,	ওভারভীউ,	ওভারভিউ,	
meghachchanno,	মেঘনচ্ছন্ন,	মেঘাচ্ছন্ন,	
jyaqa,	জ্যাক,	জ্যাক,	
zohns,	জোহনস,	জন্স,	
adarsho,	আদর্শ,	আর্দশ,	
pratisthasaho,	প্রতিস্থাসহ,	প্রতিষ্ঠাসহ,	
bonvumi,	বনবুমি,	বনভূমি,	
dinar,	দিনার,	ডিনার,	
oporishodhito,	অপরিশোধিত,	অপরিশোধিত,	
pretty,	প্রেটটি,	প্রিটি,	
saqara,	সাকারা,	সকার,	
laaisensh,	লাইসেন্স,	লাইসেন্স,	
mumtaz,	মুমতাজ,	মুমতাজ,	
weenis,	উইনিস,	ভেনিস,	
freelancerra,	ফ্রীলেন্সাররা,	ফ্রিল্যান্সাররা,	
benojir,	বেনোজির,	বেনজীর,	
binakar,	বিনাকার,	বিনাকার,	
adbhanced,	আ্যাডভান্ডেক,	অ্যাডভান্সড,	
jounatar,	যৌনতার,	যৌনতার,	
babare,	বাবারে,	বাবারে,	
kyatgarite,	ক্যাটগারিতে,	ক্যাটগারিতে,	
gajano,	গজন,	গজানো,	
transapharma,	ট্রান্সপরমা,	ট্রান্সফর্ম,	
majlishpur,	মজলিশপুর,	মজলিশপুর,	
vandar,	ভান্ডার,	ভাণ্ডার,	
salsa,	সালসা,	সালসা,	
sursur,	সুরসুর,	সুরসুর,	
abhidhaanic,	অভিধানক,	অভিধানিক,	
nederlande,	নেদারল্যান্ডে,	নেদারল্যান্ডে,	
konar,	কোনার,	কণার,	
aembed,	আমবেড,	এম্বেড,	
duhsthanostho,	দুঃসংগ্থস্থ,	দুঃস্থানস্থ,	
siraju,	সিরাজু,	সিরাজু,	
shiqara,	শিকারা,	শিকার,	
ceramiksh,	সেরামিক্স,	সিরামিকস,	
rajashri,	রাজশরী,	রাজশ্রী,	
seshardhe,	সেষার্ধে,	শেষার্ধে,	
opohoron,	অপহরণ,	অপহরন,	
bosante,	বসন্তে,	বসন্তে,	
asamonjasyopurno,	অসামঞ্জ্যপ্রূর্ণ,	অসামঞ্জস্যপূর্ণ,	
fotanor,	ফোটানোর,	ফোটানোর,	
prokolpogulor,	প্রকল্পগুলোর,	প্রকল্পগুলোর,	
gobeshokgon,	গবেষণযন,	গবেষকগণ,	
besirbhaagi,	বেসিরভাগী,	বেশিরভাগই,	
futonta,	ফুটোন্ট,	ফুটন্ত,	
supparak,	সুপ্পারক,	সুপ্পারক,	
eporjonto,	এপরজনত,	এপর্যন্ত,	
aziboner,	আজিবনের,	আজীবনের,	
fising,	ফিসিং,	ফিসিং,	
jolrong,	জলগং,	জলরঙ,	
prodiiper,	প্রদিপের,	প্রদীপের,	
pouchute,	পৌছুতে,	পৌঁছুতে,	
munjur,	মুঞ্জুর,	মুনজুর,	
dooburir,	দসুরীর,	ডুবুরির,	
somoodrotote,	সমর্পত্তে,	সমুদ্রতটে,	
eexpreession,	ইই্পারেসন,	এক্সপ্রেশন,	
raiji,	রাইজি,	রাইজি,	
jibonnogor,	জীবনগণনর,	জীবননগর,	
sqalastiqa,	স্কুলস্তককা,	স্কলাস্টিক,	
hisabagyan,	হিসাবাজ্ঞান,	হিসাবজ্ঞান,	
blyaka,	ব্ল্যাক,	ব্ল্যাক,	
odeb,	ওডেব,	ওদেব,	
subader,	সুবাদের,	সুবাদে,	
fitarsaho,	ফিতারসহ,	ফিতরসহ,	
bashoborty,	বাশববর্ত,	বশবর্তী,	
fud,	ফুদ,	ফুড,	
janmat,	জানমত,	জন্মাত,	
shardotsobei,	শারততস্বদে,	শারদোৎসবেই,	
chhadura,	ছদুরা,	ছাদুরা,	
miitar,	মিয়াতার,	মিত্র,	
fishing,	ফিশিং,	ফিসিং,	
nadike,	নাীদে,	নদীকে,	
kormobuddhite,	কর্মবুদ্ধিতে,	কর্মবুদ্ধিতে,	
inziniyarsa,	ইনসিিনিয়ারাস,	ইঞ্জিনিয়ার্স,	
dadar,	দাদার,	দাদার,	
bhardwaj,	ভরদ্যাজ,	ভরদ্বাজ,	
landey,	ল্যান্ডে,	ল্যান্ডে,	
monzushree,	মন্জুরশ্যে,	মঞ্জুশ্রী,	
kailashrao,	কৈলাশ্রাও,	কৈলাশরাও,	
parabortee,	পারারার্তে,	পরর্বতী,	
sikara,	সিকারা,	শিকার,	
bosantake,	বসন্তকে,	বসন্তকে,	
kk,	কেএস,	কেকে,	
bornolikhon,	বর্ণনিচ্ন,	বর্ণলিখন,	
shilpojaat,	শিল্পকাত,	শিল্পজাত,	
aalkaatra,	আলযালকোটার,	আলকাতরা,	
siima,	সিমা,	সীমা,	
mugdal,	মুগডাল,	মুগডাল,	
direqtareta,	দিরেক্টরটা,	ডিরেক্টরেট,	
land,	ল্যান্ড,	ল্যান্ড,	
jatotaa,	যাতোয়া,	যতোটা,	
jitpur,	জিতপুরের,	জিতপুরের,	
ucchosito,	উচ্চস্তি,	উচ্ছসিত,	
dushtogone,	দুষ্টগণে,	দুষ্টগণে,	
abadamoner,	আবাদমনের,	অবদমনের,	
andon,	আন্দন,	আন্দোন,	
koordira,	কোর্দিরা,	কুর্দিরা,	
jaistho,	জাইস্থ,	জ্যৈষ্ঠ,	
gotihin,	গতিহীন,	গতিহীন,	
bamni,	বামনি,	বামনী,	
eevil,	ইভিল,	ইভিল,	
sobchey,	সবচেই,	সবচে,	
senabahineeow,	সেনাবাহিনেরও,	সেনাবাহিনীও,	
rajbandir,	রাজবন্দির,	রাজবন্দীর,	
podarthobidder,	পদার্থবিদদের,	পদার্থবিদদের,	
chongar,	চোঙ্গার,	চোঙ্গার,	
digri,	দিগরি,	ডিগ্রি,	
kayartara,	কায়াত্রা,	কোয়ার্টার,	
shikkhadikkhay,	শিক্ষাবিদ্যায়,	শিক্ষাদিক্ষায়,	
mentither,	মেন্টিথের,	মেনটিথের,	
chhutochhooti,	ছুটোখইটি,	ছুটোছুটি,	
bedanta,	বেদান্ত,	বেদান্ত,	
templet,	টেম্পলেট,	টেম্পলেট,	
akkaas,	আক্কাস,	আককাস,	
akeeb,	আকেব,	আকিব,	
mokhmoley,	মোখলোলে,	মখমলে,	
stagecraft,	স্টেগমেট্ফ্ট,	স্টেজক্রাফট,	
vool,	ভেল,	উল,	
beem,	বিই,	বিম,	
graambaashee,	গ্রামবাশেয়ে,	গ্রামবাসী,	
ukeliptash,	উকেলাপ্তুহ,	ইউক্যালিপ্টাস,	
kathmandu,	কথঠমান্ডু,	কাঠমান্ডু,	
fanse,	ফান্স,	ফাঁসে,	
samajeek,	সমজেক,	সামাজিক,	
kayech,	কয়েছ,	কায়েছ,	
hastantar,	হস্তানতার,	হস্তান্তর,	
tokeo,	টকেও,	টোকেও,	
kadapaker,	কাদাপাকের,	কড়াপাকের,	
dhaleshwari,	ধলেশ্বরী,	ধলেশ্বরী,	
pragreesa,	প্রোগ্রেসা,	প্রগ্রেস,	
motabolombira,	মতাবলম্বরীা,	মতাবলম্বীরা,	
acrolect,	অ্যাক্রোনেট,	অ্যাক্রোলেক্ট,	
haridware,	হরিদ্বারে,	হরিদ্বারে,	
tahalo,	তাহালো,	তাহলো,	
jegulur,	জেগুলুর,	যেগুলুর,	
aajeej,	আজেজ,	আজিজ,	
machgulo,	মাছগুলো,	মাছগুলো,	
vobanipur,	ভবানীপুর,	ভবানীপুর,	
dara,	দারা,	দারা,	
byaboharkarie,	ব্যবহারকারী,	ব্যবহারকারীই,	
vishnuu,	বিষ্ণু,	বিষ্ণু,	
houzgulite,	হাউজগুলিতে,	হাউজগুলিতে,	
dibet,	দিবেত,	ডিবেট,	
pleena,	প্লেন,	প্লেন,	
sampadoner,	সম্পাদনের,	সম্পাদনের,	
bone,	বনে,	বনে,	
sambhabonao,	সাম্ভাবনাও,	সম্ভবনাও,	
shudhui,	শুধুই,	শুধুই,	
chintamani,	চিন্তামণি,	চিন্তামনি,	
vaisoho,	ভাইসহ,	ভাইসহ,	
chowdhuryke,	চোচুরকে,	চৌধুরীকে,	
atighataner,	অতিঘানানের,	অতিঘটনের,	
krema,	ক্রেমা,	ক্রাইম,	
bossoben,	বসবেন,	বসবেন,	
noteti,	নটটিটি,	নোটটি,	
madhuree,	মাধররে,	মাধুরী,	
vaphara,	ভাপারা,	বাফার,	
dhwajbhango,	ধ্বাহ্যগ্য,	ধ্বজভঙ্গ,	
bbiswash,	বিশ্বিসাহ,	বিশ্বাস,	
domonmulok,	ডমন্মুলক,	দমনমূলক,	
hypar,	হাইপার,	হাইপার,	
sangbadmadhyomgulote,	সংবাদমাধ্যমগুলোতে,	সংবাদমাধ্যমগুলোতে,	
neck,	নেক,	নেক,	
podotyagsongkranto,	পদত্যসংক্রাক্ত,	পদত্যাগসংক্রান্ত,	
bedey,	বেদে,	বেদে,	
jhalkanite,	ঝালকানিতে,	ঝলকানীতে,	
amburi,	আম্বুরি,	আম্বুরি,	
daktickete,	ডাকতিক্তিতে,	ডাকটিকিটে,	
ghatla,	ঘাটলা,	ঘটল,	
antennal,	আন্তেনাল,	অ্যান্টেনাল,	
nirmankarmisaha,	নির্মাননির্মাসহ,	নির্মাণকর্মীসহ,	
dikpal,	ডিকপাল,	দিকপাল,	
hijritey,	হিজরিতে,	হিজরীতে,	
mohit,	মোিত,	মুহিত,	
qaferder,	কাফারদের,	কাফেরদের,	
byabaharkariderke,	ব্যবহারকারীদেরকে,	ব্যবহারকারীদেরকে,	
babona,	বাবোনা,	বাবনা,	
manushti,	মনুষ্টি,	মানুষটি,	
charpanch,	চারপাঁচ,	চারপাঁচ,	
joisttho,	জয়স্থ,	জ্যৈষ্ঠ,	
goonoman,	গনোমান,	গুণমান,	
oncholeo,	অঞ্চলেও,	অঞ্চলেও,	
hoteltite,	হোটেলটিতে,	হোটেলটিতে,	
ceramicsh,	সেরামিশ,	সিরামিকস,	
rilayensa,	রিলায়েন্স,	রিলায়েন্স,	
rezidence,	রেজিকেন্স,	রেসিডেন্স,	
ahong,	আহং,	অহং,	
bhogiroth,	ভগগীরথ,	ভগীরথ,	
tricksguli,	ট্রিক্কগুলি,	ট্রিকসগুলি,	
gyada,	জ্যাদা,	গ্যাদা,	
uzobekeestaan,	উজয়েবাসস্তান,	উজবেকিস্তান,	
ramantika,	রমণকিতক,	রোমান্টিক,	
reejideencee,	রিজিনেন্সকে,	রেসিডেন্স,	
kaloniir,	কালনীর,	কালনীর,	
meshenjar,	মেশেনজার,	মেসেঞ্জার,	
natshi,	নাতশি,	নাত্সি,	
pujit,	পুজিত,	পুজিত,	
avetar,	আভেটের,	অবতার,	
daayitto,	দায়িত্ব,	দায়িত্ব,	
bastubad,	বাস্তুবাদ,	বস্তুবাদ,	
godamjato,	গোদামগাতো,	গুদামজাত,	
khorsed,	খোরসেদ,	খোরশেদ,	
gronthoti,	গ্রন্থতি,	গ্রন্থটি,	
parisankhanvid,	পরিসংখ্যানবিদ,	পরিসংখ্যানবিদ,	
katbe,	কাতবে,	কাটবে,	
farid,	ফারিদ,	ফরিদ,	
porobortii,	পরবর্তী,	পরর্বতী,	
jotota,	যততা,	যতোটা,	
boshoborty,	বশভক্ত,	বশবর্তী,	
kkhur,	খ্রু,	ক্ষুর,	
azin,	আজিন,	আজিন,	
shibraj,	শিবরাজ,	শিবরাজ,	
ganaporibahaner,	গণপরিবাচনের,	গণপরিবহনের,	
palkee,	পালকে,	পাল্কি,	
pratiyogita,	প্রতিকীগত,	প্রতিযোগীতা,	
akkheperi,	আক্ষেপেরই,	আক্ষেপেরই,	
shunani,	শুনানি,	শুনানী,	
definition,	ডিফিশনেশন,	ডেফিনেশন,	
nilkuthir,	নীলকুঠির,	নীলকুঠির,	
palbongsher,	পালবংশের,	পালবংশের,	
jamjamat,	জামামাজাত,	জমজমাট,	
dhojovongo,	ধজবল্য,	ধ্বজভঙ্গ,	
sompadon,	সম্পাদন,	সম্পাদন,	
tata,	তাতা,	তাতা,	
cn,	সিএনএ,	সিএন,	
kaathhmaandute,	কাঠমান্ডুতে,	কাঠমান্ডুতে,	
mah,	মাহ,	মাহে,	
biswashi,	বিশ্বষী,	বিশ্বাসই,	
roopdan,	রূপডান,	রুপদান,	
philo,	ফাইলো,	ফিলো,	
sohokari,	সোহাকারী,	সহকারী,	
rubidiyaam,	রুবিদিনাম,	রুবিডিয়াম,	
shoreefpur,	শরীপপুর,	শরিফপুর,	
manobikotao,	মানবিকতাও,	মানবিকতাও,	
horippur,	হরিপপুর,	হরিপুর,	
bibechyo,	বিবেচ্য,	বিবেচ্য,	
dormetori,	দর্মেতরি,	ডরমিটরি,	
doorotaumo,	দূরতমূ,	দূরতম,	
chhuteete,	ছুটেতে,	ছুটিতে,	
bonvumitey,	বনবুমিতেই,	বনভূমিতে,	
pooshti,	পুষ্টি,	পুষ্টি,	
habathu,	হববুথু,	হাবাথু,	
average,	আভারেজ,	এভারেজ,	
uthaney,	উঠানে,	উঠানে,	
drissogulo,	ড্রিগঙ্গুলো,	দৃশ্যগুলো,	
ganoparibahaner,	গণপরিবাচনের,	গণপরিবহনের,	
streegon,	স্ট্রীগন,	স্ত্রীগণ,	
chrystal,	ক্রিস্টাল,	ক্রাইস্টাল,	
mathieu,	ম্যাথিউ,	ম্যাথিউ,	
favorite,	ফাভারিতে,	ফেভারিট,	
breq,	ব্রেক,	ব্রেক,	
antercticker,	অ্যান্টার্সটিটের,	অ্যান্টার্কটিকের,	
kada,	কাদা,	কোডা,	
lungiti,	লুংগিটি,	লুঙ্গিটি,	
akkelpure,	আক্রেনিপুরে,	আক্কেলপুরে,	
kichudinpar,	কিছুদিনপার,	কিছুদিনপর,	
shrabastee,	শ্রাসস্তে,	শ্রাবস্তী,	
choukato,	চৌকাতো,	চৌকাত,	
heelser,	হেলসের,	হিলসের,	
shishu,	শিশু,	শিশু,	
mythological,	ম্যাচামাজিল্,	মাইথলজিকাল,	
carlo,	কার্লো,	কার্লো,	
asaciates,	অ্যাসাসিসেটস,	এসোসিয়েটস,	
thaii,	থাইই,	থাই,	
phuda,	ফুদ়া,	ফুড,	
bodhukeo,	বোধুকেও,	বধুকেও,	
debdebyr,	দেবদেববর,	দেবদেবীর,	
karmosansthan,	কর্মসংস্থান,	কর্মসংস্থান,	
gejeted,	গেজেটেড,	গেজেটেড,	
kaatbey,	কাটবে,	কাটবে,	
hijri,	হিজরি,	হিজরী,	
aasirbaad,	আসিরবাদী,	আশির্বাদ,	
afrazuler,	আফরাজুলের,	আফরাজুলের,	
somosto,	সমস্ত,	সমস্ত,	
laatimer,	লাতিমের,	লাটিমের,	
shatan,	শতন,	শয়তান,	
hundai,	হুন্ডাই,	হুন্দাই,	
sbajan,	সাতান,	স্বজন,	
kormyi,	কর্মী,	কর্মই,	
playtey,	প্লাযাকে,	প্লেটে,	
rekhapat,	রেখাপাত,	রেখাপাত,	
otyacharer,	অত্যাচারের,	অত্যাচারের,	
nirapattamulok,	নিরাপত্তামূলক,	নিরাপত্তামূলক,	
utsahamulak,	উৎসাহমূলক,	উৎসাহমূলক,	
neshnos,	নেশনওস,	নেশনস,	
pyore,	প্যারে,	পিওর,	
polashir,	পোলাশির,	পলাশীর,	
quota,	কুওতা,	কোটা,	
sanaktokaron,	সনকো্টকরণ,	সনাক্তকরণ,	
torutoler,	তরুটলের,	তরুতলের,	
shommotite,	শম্মতিতে,	সম্মতিতে,	
harbore,	হার্বরে,	হারবারে,	
cheentaikaree,	চেন্তাইকারী,	ছিনতাইকারী,	
gabeshonar,	গবেষণার,	গবেষনার,	
nirmolota,	নির্মলতা,	নির্মলতা,	
debholopar,	দেবভামার,	ডেভলপার,	
batom,	বাতম,	বাটম,	
rupantarer,	রূপান্তরের,	রুপান্তরের,	
masjidke,	মাসজিদকে,	মসজিদকে,	
ardasha,	অর্দশা,	আর্দশ,	
registaner,	রেজিস্টাইনের,	রেগিস্তানের,	
nikela,	নিকেলা,	নিকেল,	
kantajir,	কান্তজির,	কান্তজির,	
choson,	চোসন,	চোষণ,	
bouddho,	বৌদ্ধ,	বৌদ্ধ,	
oitijjo,	ঐতিয্য,	ঐতিহ্য,	
nimitte,	নিমিত্তে,	নিমিত্তে,	
bhalobaas,	ভালোবাস,	ভালোবাসা,	
arashie,	আরাষীয়,	আরসিএ,	
mette,	মেটি,	ম্যাট,	
dadapur,	দাদাপুর,	দাদাপুর,	
dubureer,	দুবুরের,	ডুবুরির,	
jaaygata,	জায়গা,	জায়গাটা,	
moreecha,	মোরেছা,	মরিচা,	
nowel,	নোয়াইল,	নভেল,	
nanir,	নানির,	নানীর,	
naobihar,	নাববহার,	নৌবিহার,	
dorun,	দোরুন,	দরুণ,	
shiulijhra,	শিউলিঝ্রা,	শিউলিঝরা,	
sangbadmadhyame,	সংবাদমধ্যমে,	সংবাদমাধ্যমে,	
cholochchitrer,	চলচ্চিত্রের,	চলচ্চিত্রের,	
plate,	প্লেট,	প্লেট,	
gaziipur,	গাজিবুর,	গাজীপুর,	
ddheela,	ঢেলা,	ঢিলা,	
bajhyo,	বাঝ্য,	বাহ্য,	
kaalaam,	কালম,	কালাম,	
oncolsoho,	অঙ্কোষ্চ,	অঞ্চলসহ,	
rca,	আরএিএ,	আরসিএ,	
aakaabar,	আকাবার,	আকাবার,	
bongshokey,	বংশকে,	বংশকে,	
kormoi,	কর্মই,	কর্মই,	
jyesttha,	জ্যেষ্ঠা,	জ্যেষ্ঠা,	
fakhrul,	ফখরুল,	ফাখরুল,	
gloria,	গ্লোরিয়া,	গ্লোরিয়া,	
institutione,	ইনস্টিসশনে,	ইনস্টিটিউশনে,	
hajirhat,	হাজিরহাট,	হাজিরহাট,	
jaanar,	জানার,	জানার,	
suparharo,	সুপারহারো,	সুপারহিরো,	
hughes,	হুউেেস,	হিউজেস,	
sadeep,	সাদেপ,	সদীপ,	
vaider,	ভাইদের,	ভাইদের,	
bandhano,	বাঁধাও,	বাঁধানো,	
ghumunoi,	ঘুমুনোই,	ঘুমুনোই,	
byaptikaler,	ব্যাপতিকালের,	ব্যাপ্তিকালের,	
hariken,	হারিকেন,	হ্যারিকেন,	
jiland,	জিলান্দ,	জিল্যান্ড,	
ralf,	রেলফ,	রালফ,	
sorting,	সর্টিং,	সর্টিং,	
baet,	বাইত,	বাইট,	
gamdan,	গেমদান,	গামদান,	
nirobota,	নিরবতা,	নিরবতা,	
tokee,	টকে,	তকি,	
modyer,	মোদয়ের,	মদ্যের,	
biprodas,	বিপ্রদাস,	বিপ্রদাস,	
prithibir,	পৃথিবীর,	পৃথবীর,	
grambaasheeo,	গ্রামবাশেও,	গ্রামবাসীও,	
soceitytey,	সুকেয়াটিতে,	সোসাইটিতে,	
ganesh,	গনেশ,	গণেশ,	
jamarate,	জামারাতে,	জামারাতে,	
antarctica,	অন্ত্রাক্তাও,	অ্যান্টার্কটিকা,	
ekok,	একক,	একক,	
difinishion,	ডিফিশনশন,	ডেফিনেশন,	
torabganj,	তোরাজ্বাম,	তোরাবগঞ্জ,	
lagche,	লাগছে,	লাগছে,	
turbine,	তুরবিন,	টারবাইন,	
shangkalonti,	শঙ্কটলিত,	সংকলনটি,	
shef,	শেফ,	শেফ,	
krisenter,	ক্রিসেন্টের,	ক্রিসেন্টের,	
thyachar,	থাচার,	থ্যাচার,	
phartha,	ফার্থ,	ফার্থ,	
melbourner,	মেলবোর্নের,	মেলবোর্নের,	
kuresher,	কুরেশের,	কুরেশের,	
heawy,	হীয়া,	হেভি,	
soketgulor,	সকেসগুলোর,	সকেটগুলোর,	
quartar,	কোয়ার্টার,	কোয়ার্টার,	
jhonkar,	ঝোঁকার,	ঝঙ্কার,	
sangasthagulo,	সংস্থাগুলো,	সংস্থাগুলো,	
beshakbar,	বেশাকবার,	বেশকবার,	
choudry,	চৈত্র,	চৌধুরী,	
bonorajite,	বনবাজিতে,	বনরাজিতে,	
notikotar,	নটিকতার,	নৈতিকতার,	
zerusalemer,	জেরুসালেমের,	জেরুজালেমের,	
gyandas,	জ্ঞানদাস,	জ্ঞানদাস,	
bhramarotsab,	ভ্রমবর্তব,	ভ্রমরোৎসব,	
saatzoner,	সাতজনের,	সাতজনের,	
rajtontro,	রাজনযত্র,	রাজতন্ত্র,	
gujob,	গুজোব,	গুজব,	
meshintao,	মেশিনটাও,	মেশিনটাও,	
tennis,	টেনিস,	টেনিস,	
dipke,	ডিপকে,	দ্বীপকে,	
gandharir,	গান্ধারির,	গান্ধারীর,	
tachnach,	তাঁচচ্ছ,	তছনছ,	
byaboharkari,	ব্যবহারকারী,	ব্যবহারকারী,	
chhooti,	ছোতি,	ছুটি,	
inafarameshana,	ইনারামেশন,	ইনফরমেশন,	
muhaiminer,	মুহাইনিগের,	মুহাইমিনের,	
shringge,	শ্ঙ্গি,	শৃঙ্গে,	
pravritir,	প্রাবৃতির,	প্রভৃতির,	
engrezder,	এংরেজদের,	ইংরেজদের,	
dorgah,	দর্গা,	দরগাহ,	
ruptan,	রূপতান,	রূপটান,	
heepatitis,	হিপাটিটুস,	হেপাটাইটিস,	
russad,	রুসাদ,	রুশদ,	
khargosher,	খাগগোষের,	খরগোসের,	
sanghitar,	সঙ্ঘিতার,	সংহিতার,	
duryogamoyee,	দুর্যোগ্যাে,	দুর্যোগময়ী,	
tonoo,	তোনো,	তনু,	
ghamtaa,	ঘামটা,	ঘোমটা,	
greep,	গ্রিপ,	গ্রিপ,	
shomostigoto,	শমমস্তিনত,	সমষ্টিগত,	
bonnypran,	বন্যপ্রাণ,	বন্যপ্রাণ,	
bishaashke,	বিষাষকে,	বিশ্বাসকে,	
soolke,	সুলকে,	শুল্কে,	
suiza,	সুয়াজা,	সুইজা,	
anyarup,	অন্যরূপ,	অন্যরূপ,	
pratisthanikvabe,	প্রতিষ্ঠানিকভাবে,	প্রাতিষ্ঠানিকভাবে,	
daaun,	ডাউন,	ডাউন,	
akpashe,	আকপাশে,	একপাশে,	
mukhobondho,	মুখোবন্ধ,	মুখবন্ধ,	
armori,	আর্মরি,	আরমোরি,	
khamotagulor,	ক্ষমতাগুলোর,	ক্ষমতাগুলোর,	
mirakela,	মিরাকেল,	মিরাকেল,	
adwanced,	অ্যাডভান্ডেক,	অ্যাডভান্সড,	
olympicer,	অলিমিপিসের,	অলিম্পিকের,	
chilahaati,	চিলাহাটি,	চিলাহাটি,	
ajeeboner,	আজেজেনের,	আজীবনের,	
orbit,	অরবিট,	অরবিট,	
aarik,	আরিক,	আরিক,	
protizogiita,	প্রতিযোগীতা,	প্রতিযোগীতা,	
jothartho,	যথার্থ,	যথার্থ,	
nirdesika,	নির্দেশীকা,	নির্দেশিকা,	
konistho,	কনিষ্ঠ,	কনিষ্ঠ,	
agamane,	আগামানে,	আগমনে,	
aalkatraa,	আলযালকোটারা,	আলকাতরা,	
stander,	স্ট্যান্ডের,	স্ট্যাণ্ডের,	
sorano,	সোরানো,	সরানো,	
rakhtokkharoner,	রক্তচ্ষকরণের,	রক্তক্ষরণের,	
deebug,	দেবুগ,	ডিবাগ,	
vabook,	ভাবক,	ভাবুক,	
beetloser,	বিটলুর,	বিটলসের,	
heze,	হেজে,	হেজ,	
bodhirota,	বোধিরাটা,	বধিরতা,	
rahee,	রাহে,	রাহী,	
adhyatmikata,	অধ্যানিমক্তা,	আধ্যাত্মিকতা,	
shamuker,	শামুকের,	শামুকের,	
bbiswashi,	বিশ্বিসাষ,	বিশ্বাসই,	
jinsa,	জিনসা,	জিন্স,	
pretti,	প্রেত্তি,	প্রিটি,	
poripake,	পরিপাকে,	পরিপাকে,	
uindoos,	উইন্ডোস,	উইন্ডোস,	
gotirodh,	গতিরোধ,	গতিরোধ,	
balokarak,	বালককার,	বলকারক,	
firti,	ফিরটি,	ফিরতি,	
beila,	বেইলা,	বেইলা,	
fatakasto,	ফতোসাস্ত,	ফাটাকেষ্ট,	
jahangirbad,	জাহাঙ্গীরাবিদ,	জাহাঙ্গীরবাদ,	
madhnagar,	মাধনগর,	মাধনগরের,	
antarvuktimulak,	অন্তর্বাতীতমূলক,	অন্তর্ভুক্তিমূলক,	
wagadada,	ওয়াবাদা,	বাগদাদ,	
spenser,	স্পেযান্সের,	স্পেন্সার,	
swatantrata,	স্বাতন্ত্র্য,	স্বতন্ত্রতা,	
siit,	সিয়েট,	শীত,	
bhaisaho,	ভাইসহ,	ভাইসহ,	
abhidhaanick,	অভিধানকক,	অভিধানিক,	
cinemapremider,	সিনেমার্রেমীদের,	সিনেমাপ্রেমীদের,	
satyaky,	সত্যকক,	সাত্যকি,	
oindrila,	ঐন্দ্রিলা,	ঐন্দ্রিলা,	
sarsa,	সার্স,	সোর্স,	
meridiane,	মেরিডিয়ানে,	মেরিডিয়ানে,	
chilahatee,	চিলাহাতে,	চিলাহাটি,	
nibondhocheler,	নিবন্ধচেলের,	নিবন্ধছেলের,	
gorrer,	গোরের,	গোরের,	
lettar,	লেট্তার,	লেটার,	
bondhuvabaponyo,	বন্ধুবাপনাজয়,	বন্ধুভাবাপন্ন,	
dhormoprobortokder,	ধর্মপ্রত্রদের,	ধর্মপ্রবর্তকদের,	
shaddhi,	শাদ্ধি,	সাধ্বী,	
udbhabaney,	উদ্ভববনেই,	উদ্ভাবনে,	
bhogno,	ভগন,	ভগ্ন,	
ajuhath,	অজুহা,	অজুহাত,	
fatkabazare,	ফত্কাবাজারে,	ফাটকাবাজারে,	
ponchashjon,	পঞ্চাশবন,	পঞ্চাশজন,	
songkolonti,	সংকটলটি,	সংকলনটি,	
jorury,	জরুরি,	জরূরী,	
chyeta,	চৈইা,	চ্যাট,	
prarthonakokkher,	প্রার্থনাকক্ষের,	প্রার্থনাকক্ষের,	
shahurgulor,	শহিগুলোর,	শহুরগুলোর,	
summer,	সুম্মের,	সামার,	
shudhir,	শুধির,	শুধীর,	
taxikeo,	ট্যাক্সিকেও,	ট্যাক্সিকেও,	
ayantarqatiqa,	আয়ন্ত্তকতারী,	অ্যান্টার্কটিকা,	
romancha,	রোমাঞ্চ,	রোমাঞ্চ,	
tyapa,	টাইপা,	ট্যাপ,	
gosthike,	গোষ্ঠিকে,	গোষ্ঠীকে,	
danata,	দানাটা,	ডোনাট,	
sahojatprobritti,	সহবর্তৃত্বৃত,	সহজাতপ্রবৃত্তি,	
gaj,	গ্যাজ,	গেজ,	
bairey,	বাইরে,	বাইরে,	
tolemyr,	টলেম্বার,	টলেমির,	
nirgamon,	নির্মাণ,	নির্গমন,	
mehsus,	মেহসুস,	মেহসুস,	
drishyer,	দৃশ্যের,	দৃশ্যের,	
volivoler,	ভলিভোলের,	ভলিভলের,	
arthonitir,	অর্থনীতির,	অর্থনীতির,	
parikha,	পরিখা,	পরিখার,	
waal,	ওয়াল,	উল,	
gatibege,	গতিবেগে,	গতিবেগে,	
karlei,	কারলেই,	করলেই,	
puding,	পুদীং,	পুডিং,	
bhimsenkei,	ভীমসেনকেই,	ভীমসেনকেই,	
dharavahik,	ধারাভাখী,	ধারাবাহিক,	
rudroke,	রুদ্রকে,	রুদ্রকে,	
madhoori,	মাধরি,	মাধুরী,	
bosoben,	বসবেন,	বসবেন,	
teenisa,	তেনিসা,	টেনিস,	
onkush,	অনকুশ,	অংকুশ,	
maila,	মাইলা,	মাইল,	
nagarikera,	নাগারিকেরা,	নাগরিকেরা,	
bishwasho,	বিশ্বষ্,	বিশ্বাসও,	
karadando,	কারাদণ্ড,	কারাদণ্ড,	
soorsa,	সূর্,	সোর্স,	
kooshumba,	কোশুম্বা,	কুশুম্বা,	
taap,	তাপ,	ট্যাপ,	
peeri,	পীরি,	পেরি,	
yura,	য়উরা,	ইউরো,	
damakalkarmirao,	দাকরক্রমিকাও,	দমকলকর্মীরাও,	
unitgulo,	ইউনিটগুলো,	ইউনিটগুলো,	
vogiroth,	ভোগীরথ,	ভগীরথ,	
nirbahe,	নির্বাহে,	নির্বাহে,	
ekspression,	এক্সপেরেশন,	এক্সপ্রেশন,	
nisader,	নিসাদের,	নিষাদের,	
angibhutovabe,	অঙ্গিভুক্তবে,	অঙ্গীভূতভাবে,	
anchalo,	আঁচালো,	অঞ্চলও,	
sontoshpur,	সন্তোরপুর,	সন্তোষপুর,	
talaal,	তালাল,	তালাল,	
deool,	দেওল,	দেউল,	
recondishon,	রেকনডিশন,	রিকন্ডিশন,	
amiya,	অমিয়া,	অমিয়,	
ovarview,	ওভাবভারির,	ওভারভিউ,	
edmiral,	এডগিরাল,	এডমিরাল,	
tinage,	তিনাজে,	টিনেজ,	
andamana,	আন্দামানা,	আন্দামান,	
shoreefer,	শরেেফ,	শরিফের,	
raia,	রাওয়া,	রায়,	
matthews,	ম্যাথেস,	ম্যাথিউস,	
stoic,	স্টিক,	স্টোয়িক,	
elakayi,	এলাকায়ি,	এলাকাই,	
nirgomon,	নির্মণ,	নির্গমন,	
tetela,	টেটেলা,	টাইটেল,	
forma,	ফরমা,	ফর্মা,	
horidbar,	হরিদ্বার,	হরিদ্বার,	
booponer,	বুপনের,	বপনের,	
deraa,	দেরা,	ডেরা,	
modelgulo,	মডেলগুলো,	মডেলগুলো,	
nobotom,	নবন্ট,	নবতম,	
songasthatike,	সংস্থাটিকে,	সংস্থাটিকে,	
install,	ইন্সট্যাল,	ইন্সটল,	
tukroke,	টুকরোকে,	টুকরোকে,	
ved,	ভেড,	বেদ,	
bm,	বিএমএম,	বিএম,	
purborekorde,	পূর্বর্রদদে,	পূর্বরেকর্ডে,	
oisamoyer,	ঐশাময়ের,	ঐসময়ের,	
abheedhanic,	অভিধানক,	অভিধানিক,	
aieesha,	আইইশ,	আইএএস,	
mulor,	মুলোর,	মুলোর,	
dovaar,	দোভার,	ডোভার,	
bufer,	বুফার,	বাফার,	
jamseder,	জামসেদের,	জামসেদের,	
megacaldera,	মেগাপেল্ডার,	মেগাক্যাল্ডেরা,	
somonnitobhabe,	সমমন্তিতভাবে,	সমন্বিতভাবে,	
arsie,	আরসি,	আরসিএ,	
protisthan,	প্রতিষ্ঠান,	প্রতিষ্টান,	
hitlere,	হিটলারে,	হিটলারে,	
porishongkhanbid,	পরিচংখ্যম্বী,	পরিসংখ্যানবিদ,	
sobche,	সবচে,	সবচে,	
shatodha,	শততধা,	শতধা,	
durotamo,	দূরতম,	দূরতম,	
ekoghore,	একঘরে,	একঘরে,	
niharkantibabu,	নিহার্তীন্তবাবু,	নিহারকান্তিবাবু,	
chaudhuriyo,	চৌধুরিও,	চৌধুরীও,	
hank,	হ্যাংক,	হাঙ্ক,	
bonsho,	বংশো,	বংশ,	
chandrima,	চাঁদ্রমাম,	চন্দ্রিমা,	
bhikkharthe,	ভিক্ষার্থে,	ভিক্ষার্থে,	
swartho,	স্বার্থ,	স্বার্থ,	
rinattak,	রণতত্কক,	ঋনাত্মক,	
manabmaner,	মানবনানের,	মানবমনের,	
bhagno,	ভাগনো,	ভগ্ন,	
aflatoxin,	অ্যাকাউন্টিন,	আ্যফ্ল্যাটক্সিন,	
baganoto,	বাগানোত,	বাগানত,	
liseensee,	লাইসেনসে,	লাইসেন্স,	
dai,	দাই,	দিই,	
evaner,	ইভেনের,	ইভানের,	
rajotta,	রাজোক্তা,	রাজত্ব,	
thailandsaho,	থাইলান্ডাসহ,	থাইল্যান্ডসহ,	
gasthi,	গাস্থি,	গোষ্ঠী,	
langhaner,	লাঞ্ানের,	লংঘনের,	
sarollo,	সরোল্লো,	সারল্য,	
kichutei,	কিছুতেই,	কিছুতেই,	
aswasteekor,	অস্বস্তেকর,	অস্বস্তিকর,	
harbare,	হররাবরে,	হারবারে,	
sikkhakromer,	সিক্ষাক্রমের,	শিক্ষাক্রমের,	
grooth,	গ্রোথ,	গ্রোথ,	
dipti,	দিপটি,	ডেপুটি,	
jokkher,	যক্ষের,	যক্ষের,	
qraima,	ক্রেমা,	ক্রাইম,	
dorneca,	দর্নেকা,	ডরনেকা,	
durgotshob,	দুর্গস্্ব,	দুর্গোৎসব,	
nibeditar,	নিবেদাতির,	নিবেদিতার,	
bisshaskey,	বিষ্বস্কে,	বিশ্বাসকে,	
dolphiny,	দলফিনি,	ডলফিনি,	
suchanakal,	সূচকালাল,	সূচনাকাল,	
jansha,	জান্স,	জন্স,	
roopmatro,	রূপমাত্র,	রূপমাত্র,	
nikote,	নিকতে,	নিকটে,	
dakten,	ডাকতেন,	ডাকতেন,	
heena,	হীনা,	হেনা,	
basturoi,	বাস্তুরই,	বস্তুরই,	
courtcaser,	কোর্টস্সের,	কোর্টকেসের,	
mukhamandoler,	মুখামণ্ডলের,	মুখমণ্ডলের,	
duple,	ডুপলে,	ডুপ্লে,	
cholochchitratike,	চলচ্চিত্রটিকে,	চলচ্চিত্রটিকে,	
lendl,	লেন্ডেল,	লেন্ডল,	
ghoshanapatratio,	ঘোষণাপত্রটি,	ঘোষণাপত্রটিও,	
asbab,	আসবাব,	আসবাব,	
grambasheeo,	গ্রামবাশেও,	গ্রামবাসীও,	
foreks,	ফোরেস,	ফরেক্স,	
dormitory,	দর্মিতরি,	ডরমিটরি,	
hoonayin,	হুনাইয়ন,	হুনাইন,	
abhirupbabuke,	অভিরূপবাবুকে,	অভিরূপবাবুকে,	
fimela,	ফাইমলা,	ফিমেল,	
aarmstrong,	আর্মস্ট্রং,	আর্মস্ট্রং,	
aziza,	আজিজা,	আজিজা,	
makame,	মাকামে,	মাকামে,	
tolemy,	টলেমি,	টলেমির,	
kushumba,	কুশুম্ব,	কুশুম্বা,	
starker,	স্টার্কের,	স্টার্কের,	
sthapanagulo,	স্থাপনাগুলো,	স্থাপনাগুলো,	
mumtaj,	মুম্তাজ,	মুমতাজ,	
gazeetteed,	গেজাটেড,	গেজেটেড,	
ooipokar,	উপাকার,	উইপোকার,	
conflict,	কনফ্লিক্ট,	কনফ্লিক্ট,	
ovidhanik,	অভিধানিক,	অভিধানিক,	
ekghore,	একঘরে,	একঘরে,	
nischitobhave,	নিশ্চিতভাবে,	নিশ্চিতভাবে,	
jacksonke,	জ্যাকসনকে,	জ্যাকসনকে,	
vobani,	ভবানী,	ভবানী,	
sulfatee,	সুলফাতে,	সালফেট,	
goodamjato,	গুড়াম্বতো,	গুদামজাত,	
artore,	আর্তরে,	আর্টরে,	
sucre,	সুক্রে,	সাকার,	
jonee,	জনে,	জনি,	
silabhara,	সিলাভারা,	সিলভার,	
proshikkhane,	প্রশিক্ষণে,	প্রশিক্ষণে,	
dolu,	দলু,	ডলু,	
sexperter,	সেক্সপার্টের,	সেক্সপার্টের,	
udbodhaney,	উদ্বোধনে,	উদ্বোধনে,	
pare,	পারে,	পাড়ে,	
chasee,	চাষে,	চেস,	
doneta,	দোনেট,	ডোনাট,	
saranor,	সারানোর,	সরানোর,	
conservetion,	কনজারভেশন,	কনসারভেশন,	
station,	স্ট্যাটিন,	ষ্টেশন,	
sharoker,	শারোকের,	স্মারকের,	
gafeeloti,	গ্যাফেলিটো,	গাফিলতি,	
pakhtunistan,	পাখপুসিস্তান,	পাখতুনিস্তান,	
agomonke,	আগনমকে,	আগমনকে,	
reshidensha,	রেশিদন্স,	রেসিডেন্স,	
seo,	সেও,	সেও,	
qonflict,	কনফ্লিক্ট,	কনফ্লিক্ট,	
anektai,	আনেকটাই,	অনেকটাই,	
chopal,	চোপাল,	চপল,	
bhowanipur,	ভোয়ানিপুর,	ভবানীপুর,	
rajtontre,	রাজনন্ত্রে,	রাজতন্ত্রে,	
rohasyati,	রোহাস্তিত,	রহস্যটি,	
nothivukto,	নথিভুক্ত,	নথিভুক্ত,	
boiporiityen,	বৈয়পিততয়ের,	বৈপরীত্যেন,	
logic,	লজিক,	লজিক,	
jipiusamriddha,	জিপিসামন্দরীভা,	জিপিউসমৃদ্ধ,	
trabuco,	ট্র্যাবোকি,	ট্র্যাবুকো,	
foolkopi,	ফুলকপি,	ফুলকপি,	
enginiiring,	এনজিরিইজিং,	ইঞ্জিনিয়ারিং,	
ekekrokom,	একেক্রজন,	একেকরকম,	
suhayeler,	সুহাইয়েন,	সুহায়েলের,	
armshtronj,	আর্মেথস্রম,	আর্মস্ট্রং,	
karpeter,	কারপেটের,	কার্পেটের,	
bipradas,	বিপ্রাদাস,	বিপ্রদাস,	
moddhyoshtho,	মধ্যস্থ,	মধ্যস্থ,	
totokhon,	ততকোষণ,	ততক্ষন,	
nottee,	নটটে,	নোটটি,	
heteler,	হেটেলের,	হেটেলের,	
aizulke,	আইজুলকে,	আইজুলকে,	
suparahiro,	সুপারোহিরো,	সুপারহিরো,	
megh,	মেঘ,	মেঘ,	
fastag,	ফাস্টাগ,	ফ্যাসট্যাগ,	
qlauda,	ক্লুউডা,	ক্লাউড,	
kaash,	কাশ,	কাস,	
meloonborrone,	মেলোর্রোজনে,	মেলবোর্নে,	
hafsa,	হাফা,	হাফসা,	
azimpur,	আজিমপুরের,	আজিমপুর,	
choopi,	চৈপি,	চুপি,	
yukeliptash,	যুকেলেবপুথা,	ইউক্যালিপ্টাস,	
baman,	বামান,	বামন,	
peengna,	পিংমা,	পিংনা,	
ronodeep,	রোনবড,	রণদীপ,	
minilosar,	মিনিগাসার,	মিনিলোসার,	
sadadyarao,	সদদদাররাও,	সদদ্যরাও,	
paadee,	পাদে,	পাড়ে,	
samajikotar,	সমযাজিকতার,	সামাজিকতার,	
harysoner,	হার্শনের,	হ্যারিসনের,	
antorbhuktimulak,	অন্তর্ভাবীতিমূলক,	অন্তর্ভুক্তিমূলক,	
madraser,	মাদ্রাসের,	মাদ্রাজের,	
thechar,	থেচার,	থ্যাচার,	
nodiiteyi,	নদীটিয়ে,	নদীতেই,	
auttacharer,	অট্রাচায়ার,	অত্যাচারের,	
kanshater,	কাঁথাতের,	কানসাটের,	
sawam,	সাযাম,	সাওম,	
slatgulor,	স্ল্যাকগুলোর,	স্ল্যাটগুলোর,	
aholyar,	অহল্যার,	অহল্যার,	
generalissimo,	জেনেরুলেশনম,	জেনারেলিসিমো,	
godabari,	গোদাবারি,	গোদাবরী,	
rananganey,	রণনঙ্গাযে,	রণাঙ্গনে,	
deep,	দীপ,	দীপ,	
pleto,	প্লেটো,	প্লেটো,	
bage,	বাগে,	বাগে,	
europia,	ইউরোপিয়া,	ইউরোপিয়া,	
manbe,	মানবে,	মানবে,	
tennys,	টেনেস,	টেনিস,	
kale,	কালে,	কালে,	
bibhinno,	বিভিন্ন,	বিভন্ন,	
nathivukteer,	নথিবিস্তের,	নথিভুক্তির,	
chat,	চাত,	চ্যাট,	
pyor,	প্যার,	পিওর,	
rajyotiro,	রাজকৈতর,	রাজ্যটিরও,	
giitikobita,	গীতিকাবিতা,	গীতিকবিতা,	
bisshasi,	বিশ্ষষি,	বিশ্বাসী,	
magical,	ম্যাজিকাল,	ম্যাজিকাল,	
moonshi,	মনশি,	মুন্সি,	
patjata,	পাটজাতা,	পাটজাত,	
elaakaate,	এলাকাতে,	এলাকাতে,	
uporitale,	উপরিতালে,	উপরিতলে,	
mitroder,	মিত্রদের,	মিত্রদের,	
kompeeto,	কম্পটে,	কম্পিত,	
amorendro,	আমরেন্দ্র,	অমরেন্দ্র,	
jatata,	জাতাটা,	যতোটা,	
kanar,	কানার,	কণার,	
fand,	ফ্যান্ড,	ফান্ড,	
badargaji,	বদরগাজী,	বদরগাজী,	
neermol,	নার্মোল,	নির্মল,	
modelkey,	মডেলকে,	মডেলকে,	
flexta,	ফ্লেক্সটা,	ফ্লেক্সটা,	
sinakey,	সিনাকে,	সিনাকে,	
nosihote,	নসিহতে,	নসিহতে,	
phaltu,	ফলতু,	ফালতু,	
rahee,	রাহে,	রাহি,	
tomader,	তোমাদের,	তোমাদের,	
kabutorer,	কবুতরের,	কবুতরের,	
graambasheeo,	গ্রামবাশেও,	গ্রামবাসীও,	
balaruma,	বালারুমা,	বলরুম,	
graambasider,	গ্রামবাসীদের,	গ্রামবাসীদের,	
sarajibonbyapi,	সরোবিজীর্যব্ব,	সারাজীবনব্যাপী,	
ddebet,	ডিডেক,	ডিবেট,	
saralya,	সরল্লা,	সারল্য,	
alumni,	আলুম্নি,	অ্যালমনি,	
mulyabriddhikale,	মূল্যবৃদ্ধিকালে,	মূল্যবৃদ্ধিকালে,	
licencedhari,	লাইসেন্াধিরও,	লাইসেন্সধারী,	
monur,	মনুর,	মনুর,	
boikolyo,	বৈকল্য,	বৈকল্য,	
oojbekistan,	ওজবেস্ট্যান্ট,	উজবেকিস্তান,	
chhuti,	ছুটি,	ছুটি,	
shilbar,	শিলবার,	সিলভার,	
monzooshree,	মন্যজ্রী,	মঞ্জুশ্রী,	
bhugol,	ভূগল,	ভূগোল,	
doula,	দৌল়ালা,	দৌলা,	
abanishankar,	আবনিষণকর,	অবনিশংকর,	
mohajot,	মহাজত,	মহাজোট,	
utotoro,	উতরত,	উততর,	
turbiner,	তুরবিনের,	টারবাইনের,	
chhintayikari,	ছিনতাইকাকিরি,	ছিনতাইকারী,	
enjineers,	এনসিইন্র্স,	ইঞ্জিনিয়ার্স,	
fanding,	ফ্যান্ডিং,	ফান্ডিং,	
maktum,	মাকতুম,	মাকতুম,	
nirbaaho,	নির্বাহ,	নির্বাহ,	
thare,	থারে,	থরে,	
anubhutimalar,	অনুভূতিমালার,	অনুভূতিমালার,	
chorchita,	চর্ছিতা,	চর্চিত,	
times,	টাইমেস,	টাইমস্,	
shootar,	শুতার,	শ্যুটার,	
bishasey,	বিষাসে,	বিশ্বাসে,	
laaisens,	লাইসেন্স,	লাইসেন্স,	
japanostho,	জাপানস্থ,	জাপানস্থ,	
themeke,	থেমেকে,	থিমকে,	
laps,	ল্যাপস,	ল্যাপস,	
turkamena,	তুর্কামেনা,	তুর্কমেন,	
dalnata,	দালনাটা,	ডালনাটা,	
cloudbook,	ক্লোসবিক,	ক্লাউডবুক,	
pack,	প্কাক,	প্ল্যাক,	
ghatleo,	ঘাটলেও,	ঘটলেও,	
madhabike,	মাধবীকে,	মাধবীকে,	
ruble,	রুবল,	রুবল,	
parjotaker,	পার্যতাকের,	পর্যটকের,	
horiddare,	হরিদ্রদে,	হরিদ্বারে,	
kalkarkhana,	কলককরনান,	কলকারখানা,	
abheedhaaneek,	অভিভানের,	অভিধানিক,	
sheepha,	শেপা,	শেফ,	
camerapersoner,	ক্যামেরাপারসনের,	ক্যামেরাপার্সনের,	
akhandata,	আখণ্ডতা,	অখণ্ডতা,	
naubom,	নওবম,	নবম,	
dubaate,	দুবাতে,	ডুবাতে,	
matt,	মাযাট,	ম্যাট,	
saainyo,	সৈন্য,	সৈন্য,	
carloos,	কারলোোো,	কার্লোস,	
mojdur,	মজদুর,	মজদুর,	
bhabaponno,	ভাবপপনন,	ভাবাপন্ন,	
dombhoke,	দমমভকে,	দম্ভকে,	
kaalki,	কালকি,	কালকি,	
tukrote,	তুকরোটে,	টুকরোতে,	
sheekar,	শেকার,	শিকার,	
chhooteete,	ছোটেতে,	ছুটিতে,	
horiddar,	হরিদদার,	হরিদ্বার,	
khoka,	খোকা,	খোকা,	
prokolpow,	প্রকল্পই,	প্রকল্পও,	
poddhotiteyi,	পদ্ধতিতেই,	পদ্ধতিতেই,	
ronangane,	রোনাঙ্গানে,	রণাঙ্গনে,	
turkyder,	টার্কেকের,	তুর্কিদের,	
arg,	আরগ,	আর্গ,	
monjooshree,	মন্্রযয়েরের,	মঞ্জুশ্রী,	
mohammadi,	মোহাম্মদি,	মুহাম্মদী,	
romnar,	রোমনার,	রমনার,	
deputi,	দেপুটি,	ডেপুটি,	
mardud,	মারদুদ,	মরদুদ,	
aniyantrita,	অনির্ঞ্য়িত,	অনিয়ন্ত্রিত,	
alsaar,	আলসার,	আলসার,	
moresbai,	মোরেশবাসী,	মোরেসবাই,	
cheekitsar,	চেফিতসর,	চিকিত্সার,	
siropa,	সিরোপা,	শিরোপা,	
karaponner,	কারাপণ্যের,	কারাপণ্যের,	
eesa,	ইইসা,	আইএএস,	
shasyadi,	শাস্দাদি,	শস্যাদি,	
nabotom,	নাবত,	নবতম,	
mahakabi,	মহাকাবি,	মহাকবি,	
joumana,	জৌমান,	জুমানা,	
said,	সাইদ,	সাইদ,	
chatrorai,	চা্ররই,	ছাত্ররাই,	
probhura,	প্রভুরা,	প্রভুরা,	
assexe,	অ্যাসেক্সে,	অ্যাসেক্সে,	
shasankorta,	শাসনকর্তা,	শাসনকর্তা,	
phakay,	ফাকা,	ফাকে,	
shulfate,	শুলফাতে,	সালফেট,	
premo,	প্রেমও,	প্রিমো,	
roopdaan,	রূপদান,	রুপদান,	
jhijhi,	ঝিঝি,	ঝিঝি,	
cantan,	ক্যান্টান,	ক্যান্টন,	
toching,	তোচিং,	টোচিং,	
laaz,	লাজ,	লাজ,	
taranee,	তারানে,	তরণী,	
rudrasagar,	রুদ্রসানার,	রুদ্রসাগরের,	
rubidium,	রুবিদিমু,	রুবিডিয়াম,	
madhobi,	মাধবী,	মাধবী,	
votarer,	ভোটারের,	ভোটারের,	
kaferderke,	কাফেরদেরকে,	কাফেরদেরকে,	
chet,	চেত,	চ্যাট,	
nothivookta,	নথিবয়ত,	নথিভুক্ত,	
phonekari,	ফোনেকরি,	ফোনকারী,	
ooipoka,	উপাকা,	উইপোকা,	
zeland,	জেলান্দ,	জিল্যান্ড,	
prangulo,	প্রাণগুলো,	প্রানগুলো,	
baarbadoj,	বারবাবন,	বার্বাডোজ,	
providere,	প্রবিদের,	প্রভাইডারে,	
edaning,	এডানিং,	ইদানিং,	
akhando,	আখণ্ড,	অখন্ড,	
dacope,	ডাকোপে,	দাকোপ,	
kingsh,	কিংশেশ,	কিংস,	
proboleme,	প্রবলেমে,	প্রবলেমে,	
hansasya,	হাঁসায়া,	হংসস্য,	
sooya,	সুয়া,	সোয়া,	
baibosthar,	বৈষস্থতার,	ব্যবস্থার,	
transform,	ট্রান্সফরম,	ট্রান্সফর্ম,	
dharmee,	ধর্মে,	ধর্মী,	
crime,	ক্রাইম,	ক্রাইম,	
kormokarke,	কর্মকারকে,	কর্মকারকে,	
motke,	মোটকে,	মতকে,	
antarctika,	অন্ত্রাক্তিকা,	অ্যান্টার্কটিকা,	
krisenta,	ক্রিসেন্টা,	ক্রিসেন্ট,	
ishahak,	ইশাখাক,	ইসাহাক,	
steen,	স্টিন,	স্টেন,	
madeling,	মাদেলিং,	মডেলিং,	
felto,	ফেল্টো,	ফেলত,	
bojhaao,	বোঝাও,	বোঝাও,	
foloshrutite,	ফলহক্তিতে,	ফলশ্রুতিতে,	
kyathlik,	ক্যাচলিক,	ক্যাথলিক,	
deliver,	ডেলিভার,	ডেলিভার,	
jatinkey,	জাতিনকে,	যতীনকে,	
ranangone,	রণনঙ্গে,	রণাঙ্গনে,	
perri,	পেরি,	পেরি,	
zerusaleme,	জেরুসালেমে,	জেরুসালেমে,	
pachak,	পাচাক,	পাচক,	
pathanirdeshona,	পাঠীনার্ডেশন,	পথনির্দেশনা,	
prosadhoner,	প্রসাধনের,	প্রসাধনের,	
mukhyo,	মুখ্য,	মুখ্য,	
songasthaner,	সংস্থানের,	সংস্থানের,	
venush,	ভেনুশ,	ভেনাস,	
meshmeshya,	মেশমেশ্য,	মেশহমেশহিইয়া,	
soomita,	সুয়েতা,	সুমিতা,	
nogore,	নগরে,	নগরে,	
soundarja,	সৌন্দর্য্য,	সৌর্ন্দয্য,	
doltyagi,	দলতনগাগী,	দলত্যাগী,	
chapal,	চাপাল,	চপল,	
poschime,	পশ্চিমে,	পশ্চিমে,	
directarate,	দিরেক্টরেট,	ডিরেক্টরেট,	
habol,	হাবোল,	হাবোল,	
jeebanjapon,	জীবনার্পন,	জীবনযাপন,	
upobashii,	উপবাষিই,	উপবাসী,	
konagoolo,	কোনাগোলো,	কণাগুলো,	
deputy,	দিপুটি,	ডেপুটি,	
spredasita,	স্পেরাস্িয়াত,	স্প্রেডশীট,	
jaadrel,	যাদ্রেল,	জাঁদরেল,	
bipti,	বিপ্তি,	বিপ্তি,	
kinsa,	কিনসা,	কিংস,	
jund,	জুন্ড,	জুন্দ,	
baarnis,	বারনিস,	বার্নিশ,	
chirkut,	চিরসুট,	চিরকুট,	
chinito,	চিনিতো,	চিনতো,	
windos,	উইন্ডোস,	উইন্ডোস,	
braqe,	ব্রাকে,	ব্রেক,	
doobate,	দৈবতে,	ডুবাতে,	
hock,	হক্স,	হুক,	
paste,	পাস্টে,	পেষ্ট,	
jeshtha,	জেষ্ট,	জ্যেষ্ঠা,	
dakope,	দাকোপে,	দাকোপ,	
palta,	পালটা,	পালটা,	
duiekdiner,	দুইজ্কিনের,	দুইএকদিনের,	
pluck,	প্লাক,	প্ল্যাক,	
probeshan,	প্রবেশান,	প্রবেশন,	
niutrino,	নিউট্রিনো,	নিউট্রিনো,	
protyokkhovabey,	প্রত্যক্ষব্যায়ে,	প্রত্যক্ষভাবে,	
argead,	আর্েড,	আর্জিদ,	
dhormokorme,	ধর্মক্রমে,	ধর্মকর্মে,	
chemjong,	চেমকং,	চেমজং,	
jumlalancer,	জুমলালানেের,	জুমলাল্যান্সার,	
sangram,	সংগ্রাম,	সঙ্গ্রাম,	
pray,	প্রায়,	প্রায়,	
shcholastic,	স্কুলাস্টিক,	স্কলাস্টিক,	
billaho,	বিলালাহ,	বিল্লাহ,	
gonona,	গোনোনা,	গননা,	
kamla,	কামলা,	কামলা,	
bonbhumi,	বন্ভুমী,	বনভূমি,	
koomarir,	কোয়ারীর,	কুমারীর,	
ateetkaale,	আ্যাটেল্কে,	অতীতকালে,	
aatto,	আটিত,	আত্ম,	
anchalei,	আঁচালেই,	অঞ্চলেই,	
kushakhali,	কুশাখালি,	কুশাখালি,	
satarka,	সাতারক,	সতর্ক,	
upacharjo,	উপাখর্য,	উপাচার্য,	
cholochchitrake,	চলচ্চিত্রকে,	চলচ্চিত্রকে,	
progresh,	প্রোগ্রেশ,	প্রগ্রেস,	
sommotitey,	সম্মতিতে,	সম্মতিতে,	
lambaate,	ল্যাম্বাটে,	লম্বাটে,	
bikretara,	বিক্রেতারা,	বিক্রেতারা,	
existing,	এক্সিকিং,	এক্সিসটিং,	
krechi,	ক্রেচি,	করেছি,	
amarika,	আমারিকা,	আমেরিকা,	
abdan,	আবদান,	আব্দান,	
abeganuvutir,	অবেগিমাতুটুর,	আবেগানুভূতির,	
debdebier,	দেবদেবীর,	দেবদেবীর,	
poribahokotto,	পরিবাহকত্ব,	পরিবাহকত্ব,	
sazanor,	সাজানোর,	সাজানোর,	
sangkulaan,	সংকুলনা,	সংকুলান,	
grambaashio,	গ্রামবাশিও,	গ্রামবাসীও,	
saptahokal,	সপ্তাখাল,	সপ্তাহকাল,	
siddhanto,	সিদ্ধান্ত,	সিদ্ধান্তও,	
sthitiko,	স্থিতিকো,	স্থিতিকো,	
caramiks,	ক্যারামিক্স,	সিরামিকস,	
korush,	করুশ,	ক্রুশ,	
jerusalema,	জেরুফালেমা,	জেরুসালেম,	
bbiseshyer,	বিসিস্কের,	বিশেষ্যের,	
standards,	স্ট্যান্ডার্ডস,	স্টান্ডার্ডস,	
saurce,	সার্স,	সোর্স,	
survative,	সারভাটাইব,	সারভেটিভ,	
ajibon,	অজিজন,	আজীবন,	
emargency,	এমারজেন্সি,	এমার্জেন্সি,	
ceramiker,	সেরামিকের,	সিরামিকের,	
gajiipur,	গাজিবপুর,	গাজীপুর,	
thaanobhi,	থানাভি,	থানভী,	
oichchheek,	ঐচ্ছেক,	ঐচ্ছিক,	
kommandar,	কোম্ানদর,	কমাণ্ডার,	
cholochchitra,	চলচ্চিত্র,	চলচ্চিত্র,	
bokahoke,	বোকাহকে,	বকাহকে,	
with,	উইথ,	ভিত,	
deepan,	দীপান,	দীপন,	
remacry,	রিমার্কি,	রেমাক্রী,	
brittakar,	বৃত্তকার,	বৃত্তাকার,	
bostubad,	বস্তুবাদ,	বস্তুবাদ,	
dharabahikbhabe,	ধারাবাহিকভাবে,	ধারাবাহিকভাবে,	
jhumjhumita,	ঝুমঝুমিতা,	ঝুমঝুমিটা,	
seebiai,	সেবিয়াই,	সিবিআই,	
bhandar,	ভাণ্ডার,	ভাণ্ডার,	
oncholshomuh,	অং্চবমূহ,	অঞ্চলসমূহ,	
koro,	কোরো,	করো,	
grahoksebai,	গ্রাহকসেবায়,	গ্রাহকসেবায়,	
setike,	সেতিকে,	সেটিকে,	
shfingtar,	শিপলতার,	স্ফিংটার,	
jahara,	জাহারা,	যাহরা,	
byan,	ব্যান,	ব্যাং,	
bibadey,	বিবাদে,	বিবাদে,	
pathanatak,	পাঠানাটাক,	পথনাটক,	
dekhso,	দেখসো,	দেখসো,	
maner,	মানের,	মানে,	
maail,	মাইল,	মাইল,	
orbeet,	অরবেট,	অরবিট,	
mukherjee,	মুখের্ে,	মুখার্জী,	
probhuder,	প্রভুদের,	প্রভুদের,	
nanabornobishishto,	নানারোবনিশিষ্ট,	নানাবর্ণবিশিষ্ট,	
amar,	আমার,	আমর,	
pakistanira,	পাকিস্তানিরা,	পাকিস্তানীরা,	
hugeke,	হুগেকে,	হিউজকে,	
hadisti,	হাদিসটি,	হাদিসটি,	
kandy,	কান্ডি,	ক্যান্ডি,	
panda,	পাণ্ডা,	পান্ডে,	
dharabahiktite,	ধারাবাহিকটিতে,	ধারাবাহিকটিতে,	
sorsa,	সোরস,	সোর্স,	
nibirbhabe,	নিবির্ভাবে,	নিবিরভাবে,	
uddhritir,	উদ্ধৃতির,	উদ্ধৃতির,	
mulvitti,	মুলভিত্তি,	মূলভিত্তি,	
ishtone,	ইস্তনে,	স্টোন,	
hoondayi,	হুন্ডাই়ে,	হুন্দাই,	
borkhastokritora,	বরখাস্ত্রিকতার,	বরখাস্তকৃতরা,	
stanahenja,	স্তনাাচ্য,	স্টোনহেঞ্জ,	
parisankhanbid,	পরিসংখ্যানবিদ,	পরিসংখ্যানবিদ,	
bodhirta,	বোধির্তা,	বধিরতা,	
amudey,	অমুদে,	আমুদে,	
euqalyptus,	ইউকমলপিস্টাস,	ইউক্যালিপ্টাস,	
laesens,	লেযেন্স,	লাইসেন্স,	
victor,	ভিক্টর,	ভিক্টর,	
chandil,	চানদিল,	চান্ডিল,	
prashikkhane,	প্রশিক্ষণে,	প্রশিক্ষণে,	
oncoltike,	অঙ্কটিকে,	অঞ্চলটিকে,	
spredshiit,	স্প্রেডশিট,	স্প্রেডশীট,	
soomitrar,	সুমেত্রার,	সুমিত্রার,	
norfolk,	নরফোন,	নরফোক,	
bonke,	বনকে,	বনকে,	
udvabani,	উদ্বববনী,	উদ্ভাবনী,	
plainey,	প্লেইন,	প্লেনে,	
parswer,	পারসেবের,	পার্শ্বের,	
poroborti,	পরবর্তী,	পরর্বতী,	
shektore,	শেকটরে,	সেক্টরে,	
naajii,	নাজিয়,	নাত্সি,	
spredashita,	স্প্রেডশাটি,	স্প্রেডশীট,	
superheroo,	সুপারহিরো,	সুপারহিরো,	
kharar,	খারার,	খরার,	
bim,	বিম,	বিম,	
chai,	চাই,	ছাই,	
bishshaasho,	বিষ্কসহ,	বিশ্বাসও,	
mekapgulo,	মেকাপগুলো,	মেকআপগুলো,	
firozapure,	ফিরোজাপুরে,	ফিরোজাপুরে,	
kaalengaa,	কালেনগা,	কালেঙ্গা,	
pachattar,	পাচাত্তর,	পাচাত্তার,	
smarok,	স্মারক,	স্মারক,	
anutpadanshil,	অনুপ্তানুল্ল,	অনুৎপাদনশীল,	
patigoniter,	পাটিগোনিতের,	পাটিগণিতের,	
mmadhukkori,	ম্যাূচকরি,	মাধুকরী,	
gonohotyakey,	গণঅতক্যকে,	গণহত্যাকে,	
sikkharthirao,	শিক্ষার্থীরাও,	শিক্ষার্থীরাও,	
deaubande,	দেউবান্ডে,	দেওবন্দে,	
phox,	ফোক্স,	ফক্স,	
girilal,	গিরিলাল,	গিরিলাল,	
zozyota,	যোজ্যতা,	যোজ্যতা,	
chikittsar,	চিকিৎসাসর,	চিকিত্সার,	
rodney,	রোডনে,	রেডনি,	
jhimochchilo,	ঝিমোচছিল,	ঝিমোচ্ছিলো,	
rahimed,	রািমেদ,	রহিমেদ,	
gobeshana,	গবেষণা,	গবেষনা,	
osamarik,	ওসামারিক,	অসামরিক,	
saazano,	সাজানো,	সাজানো,	
pacchi,	পাচ্ছি,	পাচ্ছি,	
nirgaman,	নির্মাণ,	নির্গমন,	
atmiyasulabh,	আত্মিকাসমূভ,	আত্মীয়সুলভ,	
milekhaanek,	মিলেখানেক,	মাইলখানেক,	
aakkas,	আক্কাস,	আককাস,	
byomkes,	ব্যামসেস,	ব্যোমকেশ,	
holding,	হোল্ডিং,	হোল্ডিং,	
machsoho,	মাছসহ,	মাছসহ,	
tantubayer,	তন্তুবায়ের,	তন্তুবায়ের,	
gannaprakasham,	গন্ডারারসম্মম,	গন্নাপ্রকাশম,	
seekkhokbrindo,	সীক্ষোর্কজন্,	শিক্ষকবৃন্দ,	
bhittow,	ভিট্টো,	ভিত্তিও,	
dhanche,	ধাঁেে,	ধাঁচে,	
ponchaashjon,	পঞ্চাশবন,	পঞ্চাশজন,	
serology,	সেরোমলং,	সেরোলজি,	
gasthii,	গাস্থিয়,	গোষ্ঠীই,	
ekhate,	এখাতে,	একহাতে,	
brekethru,	ব্রেকেটপু,	ব্রেকথ্রু,	
siddhante,	সিদ্ধান্তে,	সিদ্ধান্তে,	
byaboharkarir,	ব্যবহারকারীর,	ব্যবহারকারীর,	
sanghar,	সং্গর,	সংহার,	
deeares,	দীরেস,	ডিআরএস,	
monir,	মনির,	মনির,	
dorgaaho,	দর্গাও,	দরগাহ,	
kottar,	কোট্তার,	কট্টর,	
chinto,	চিন্ত,	চিনতো,	
valobasen,	ভালোবাসেন,	ভালোবাসেন,	
themekey,	থেমেকে,	থিমকে,	
chittronatyokar,	চিত্ততান্তরকার,	চিত্রনাট্যকার,	
latsaheb,	লাতসাহেব,	লাটসাহেব,	
ameettrakkhor,	আমেকপ্রাাহকর,	অমিত্রাক্ষর,	
oxite,	অক্সিতে,	অক্সাইট,	
ranangane,	রণনঙ্গানে,	রণাঙ্গনে,	
chhooteer,	ছোটের,	ছুটির,	
osthisondhi,	অস্থিস্নিধ,	অস্থিসন্ধি,	
townshhip,	তুনশিপ,	টাউনশিপ,	
noiteek,	নৈতেক,	নৈতিক,	
aireshe,	আইরেশে,	আইরেসে,	
humira,	হুমিরা,	হুমিরা,	
shloker,	শ্লোকের,	শ্লোকের,	
senior,	সেনিয়র,	সিনিয়র,	
hepatitis,	হেপাটিটিস,	হেপাটাইটিস,	
internship,	ইন্ট্রনিিপ,	ইন্টার্নশিপ,	
heerani,	হিরানী,	হিরানি,	
marri,	মারির,	ম্যারি,	
rashedul,	রাশেদুল,	রাশিদুল,	
atibiplabi,	অতিবিক্লিপি,	অতিবিপ্লবি,	
khaschandpur,	খাশ্ান্দপুর,	খাসচাঁদপুর,	
moshjidke,	মোশজিদকে,	মসজিদকে,	
abarte,	অবর্তে,	আবর্তে,	
afzol,	আফজোল,	আফজল,	
kusumeshu,	কুসুমেষু,	কুসুমেষু,	
xpose,	এপ্সে,	এক্সপোজ,	
chire,	চিরে,	চিরে,	
shingping,	শিংপিং,	শিংপিং,	
venisey,	ভেনিসে,	ভেনিসে,	
sanaktokaran,	সনকো্টকরণ,	সনাক্তকরণ,	
seeramiks,	সেরামিকস,	সিরামিকস,	
ganokantha,	গণকাঁঠা,	গণকণ্ঠ,	
boikalyo,	বৈকালযয়,	বৈকল্য,	
piulir,	পিউলির,	পিউলির,	
protinito,	প্রতিনিত,	প্রতিনিত,	
romarder,	রোমারদের,	রোমারদের,	
porirshoder,	পরিদ্রোদের,	পরির্ষদের,	
cathalic,	ক্যাথালিক,	ক্যাথলিক,	
wedanta,	ওয়াটন,	বেদান্ত,	
protul,	প্রতিল,	প্রতুল,	
helloin,	হেল্লোন,	হ্যালোইন,	
abhijitda,	অভিজিতবা,	অভিজিতদা,	
asthishondhi,	অস্থিসন্ধি,	অস্থিসন্ধি,	
soinyora,	সৈন্যরা,	সৈন্যরা,	
buth,	বুথ,	বুথ,	
chalachchitroke,	চালাচ্চেত্রীকে,	চলচ্চিত্রকে,	
darji,	দার্জি,	দরজি,	
ekatto,	একাত্ত,	একাত্ব,	
prakalpoguli,	প্রকল্পগুলি,	প্রকল্পগুলি,	
aaziz,	আজিজ,	আজিজ,	
dajjha,	দাজহা,	দাহ্য,	
accountdharira,	অক্সোনিচারিরা,	একাউন্টধারীরা,	
kakhnoba,	কাখমাব,	কখনওবা,	
highcomissione,	হাইসনিসমিন,	হাইকমিশনে,	
sangitanusthane,	সঙ্গীতসুষ্ঠানে,	সঙ্গীতানুষ্ঠানে,	
khappar,	খপপপার,	খপ্পর,	
ahmed,	আহমেদ,	আহামদ,	
hosne,	হোস্ে,	হোসনে,	
aabarte,	আবর্তে,	আবর্তে,	
bajite,	বাজিতে,	বাজিতে,	
nabyata,	নব্যতা,	নাব্যতা,	
karecho,	করেছো,	করেছো,	
bane,	বানে,	বনে,	
graambaasheeo,	গ্রামবাশেও,	গ্রামবাসীও,	
qara,	কারা,	কর,	
dobhara,	ডোভারা,	ডোভার,	
avinetar,	অভিনেতার,	অভিনেতার,	
shitei,	শিতেই,	শীতেই,	
ashanka,	আশাঙ্কা,	আশংকা,	
esoosiyetasa,	এসবিযুযুয়েস,	এসোসিয়েটস,	
anhu,	আনু,	আনহু,	
trutimatra,	ত্রুতিমাত্র,	ত্রুটিমাত্র,	
jothon,	যথন,	যথন,	
nepchooner,	নেপচোলের,	নেপচুনের,	
daltagi,	দালতাগি,	দলত্যাগী,	
porinoti,	পরিণীত,	পরিণতি,	
daaradaa,	দারাদা,	দারদা,	
brojomohun,	ব্রজহমহুন,	ব্রোজোমোহন,	
wilderske,	উইল্ডার্সকে,	উইল্ডার্সকে,	
parq,	পার্ক,	পার্ক,	
utshahomulok,	উৎসভূমূলক,	উৎসাহমূলক,	
orthanitir,	অর্ধনীতির,	অর্থনীতির,	
mojlish,	মজলিশ,	মজলিশ,	
soommita,	সুমমিতা,	সুমিতা,	
bosontokke,	বসন্তকে,	বসন্তকে,	
creshcent,	ক্রেসেেন্ট,	ক্রিসেন্ট,	
dhhaabi,	ঢাবি,	ঢাবি,	
argho,	আরঘো,	অর্ঘ্য,	
bite,	বিতে,	বাইট,	
borlen,	বরললন,	বরলেন,	
suporichita,	সুপরিচিতা,	সুপরিচিত,	
dabarer,	দাবারের,	দাবারের,	
video,	ভিদেও,	ভিডিয়োও,	
planey,	প্ল্যানে,	প্লেনে,	
parishram,	পরিশ্রম,	পরিশ্রম,	
aairish,	আয়ারিস,	আইরিস,	
khuliechilam,	খুলিয়েছিলাম,	খুলিয়েছিলাম,	
palestine,	পালেস্তিনে,	প্যালেস্টাইনে,	
asovarno,	অসযাপোর্ন,	অসবর্ণ,	
bhittimul,	ভিত্তিমূল,	ভিত্তিমূল,	
qanasarabheshana,	কানাপারেশন,	কনসারভেশন,	
gate,	গাতে,	গ্যেটে,	
milayatane,	মিলায়তনে,	মিলায়তনে,	
joubankal,	যৌবনকাল,	যৌবনকাল,	
choudhursoho,	চৌধুরসহ,	চৌধুরসহ,	
byabaharkareederke,	ব্যবহারকারীদেরকে,	ব্যবহারকারীদেরকে,	
johny,	জোহনি,	জনি,	
akpaase,	আকপাসে,	একপাশে,	
laagche,	লাগছে,	লাগছে,	
protijogiider,	প্রতিযোগিদের,	প্রতিযোগীদের,	
gobeshakgon,	গবেষণকগণ,	গবেষকগণ,	
chalake,	চালাকে,	চালকে,	
shoodhooi,	শৈথই,	শুধুই,	
telakucha,	তেলাকুচা,	তেলাকুচা,	
shamijir,	শামীজির,	স্বামীজীর,	
debeting,	ডেবেটিং,	ডিবেটিং,	
noitik,	নৈতিক,	নৈতিক,	
khabarsoho,	খাবারসহ,	খাবারসহ,	
turkii,	তুর্কি,	তুর্কি,	
deciliter,	ডিসিলিটের,	ডেসিলিটার,	
carlos,	কার্লোস,	কার্লোস,	
judge,	জু,	জাজ,	
kade,	কাদে,	কোড,	
joki,	জোক,	জকি,	
aatmobishwasi,	আত্মবিশ্বাসী,	আত্মবিশ্বাসী,	
shakar,	শাকার,	সকার,	
ghetu,	ঘেটু,	ঘেটু,	
koota,	কোয়া,	কোটা,	
haripur,	হরিপুর,	হরিপুর,	
itastata,	ইতস্ততা,	ইতস্তত,	
kachhakaachhi,	কচাাখাছি,	কাছাকাছি,	
dala,	দালা,	দলা,	
anusthane,	অনুষ্ঠানে,	অনুষ্ঠানে,	
qredita,	ক্রেডিটা,	ক্রেডিট,	
humner,	হামনার,	হামনার,	
swostir,	স্বস্তির,	স্বস্তির,	
spreadshiit,	স্প্রেডশিট,	স্প্রেডশীট,	
beekaargrasta,	বেকারগ্রস্ত,	বিকারগ্রস্ত,	
aakik,	আকিক,	আকিক,	
aamoode,	আমোদে,	আমুদে,	
dhyana,	ধ্যানা,	ধ্যান,	
dinifitian,	ডিনিফিয়েশন,	ডেফিনেশন,	
maritimer,	মেরিটেইমের,	মেরিটাইমের,	
asamanyo,	অসমমন্য,	অসামান্য,	
duuma,	দুয়াম,	দুমা,	
safin,	সাফিন,	সাফিন,	
zeebonto,	জীবন্ত,	জীবন্ত,	
dhanijomite,	ধনিযোগিতে,	ধানিজমিতে,	
capsule,	ক্যাপসুলে,	ক্যাপ্সুল,	
salapheeta,	সালাহেত,	সালফেট,	
venuser,	ভেনুসের,	ভেনাসের,	
zibonnogor,	জীবনগণনর,	জীবননগর,	
bondi,	বন্দি,	বন্দী,	
ramonar,	রামোনার,	রমনার,	
navaratri,	নবরত্রী,	নবরাত্রি,	
shnaipara,	শ্বেরা,	স্নাইপার,	
prosadhaner,	প্রসাধনের,	প্রসাধনের,	
nobotomo,	নবনত,	নবতম,	
marathi,	মারাথি,	মরাঠি,	
bulano,	বুলানো,	বুলান,	
maley,	মালয়ে,	মালে,	
mukhomandaley,	মুখলম্ডলে,	মুখমণ্ডলে,	
pnouchute,	পৌঁছুতে,	পৌঁছুতে,	
sharthe,	শার্থে,	স্বার্থে,	
vimsen,	ভিইসেন,	ভীমসেন,	
taler,	তালের,	তালের,	
black,	ব্ল্যাক,	ব্ল্যাক,	
kanasarabhesana,	কনকাভরেণণ,	কনসারভেশন,	
bade,	বাদে,	বাদে,	
sangkoolan,	সংকোলন,	সংকুলান,	
geejeeteeda,	গেভেটা,	গেজেটেড,	
dooburira,	দসুরিরা,	ডুবুরিরা,	
jaanachhe,	যানাঞ্চে,	জানাচ্ছে,	
dhangsantup,	ধনসংসুত্ব,	ধ্বংসন্তুপ,	
juddhahato,	যুদ্ধাহাত,	যুদ্ধাহত,	
ghumachche,	ঘুমাচ্ছে,	ঘুমাচ্ছে,	
nazad,	নাজাদ,	নজদ,	
bhiktara,	ভিকটারা,	ভিক্টর,	
doloo,	দলল,	ডলু,	
segular,	সেগুলার,	সেগুলোর,	
torabgonj,	তোরা্বঞ্জ,	তোরাবগঞ্জ,	
tiunara,	তিউনারা,	টিউনার,	
veemsen,	ভিভসেন,	ভীমসেন,	
phiksim,	ফিকশিম,	ফিক্সিং,	
bolatkar,	বলাটকর,	বলাৎকার,	
elahabade,	এলাহাবাদে,	এলাহাবাদে,	
lisense,	লাইসেন্স,	লাইসেন্স,	
kuthibarike,	কুঠিবারীকে,	কুঠিবাড়ীকে,	
rokkhonabekkhoner,	রক্ষণভঙ্ষেখনের,	রক্ষণাবেক্ষণের,	
pushtee,	পুষ্টে,	পুষ্টি,	
kirti,	কীর্তি,	কীর্তি,	
phiksa,	ফিক্সা,	ফিক্স,	
keuoi,	কেইওও,	কেউই,	
chetanagato,	চেতনাগত,	চেতনাগত,	
pujito,	পুজিত,	পুজিত,	
paramartha,	পরমরর্থ,	পরমার্থ,	
sanghatakder,	সংখ্যাতের,	সংঘটকদের,	
shariba,	শরিবা,	শরিবা,	
cooda,	কুদা,	কোডা,	
jetam,	জেতাম,	যেতাম,	
homsher,	হোমশের,	হোমসের,	
lyaataa,	লাওদা,	ল্যাটা,	
pillai,	পিল্লাই,	পিল্লাই,	
bikargrasta,	বিকারগ্রস্ত,	বিকারগ্রস্ত,	
jakso,	জাক্সো,	যক্ষ,	
zesa,	জেসা,	জেস,	
monzeele,	মনজেলে,	মঞ্জিলে,	
pradoshik,	প্রদোশিক,	প্রাদশিক,	
siddharther,	সিদ্ধার্থের,	সিদ্ধার্থের,	
railliner,	রেললিনের,	রেললাইনের,	
bolbo,	বলবো,	বলবো,	
shangsthaner,	শাংস্থানের,	সংস্থানের,	
samashtike,	সমমশটিকে,	সমষ্টিকে,	
premoronge,	প্রেমরোঙ্গে,	প্রেমরঙে,	
erythrian,	এরিথ্রিয়ান,	এরিথ্রিয়ান,	
nabbata,	নব্বতা,	নাব্যতা,	
durgotsabe,	দুর্গোৎসবে,	দুর্গোৎসবে,	
jatinke,	জাতিনকে,	যতীনকে,	
mumtajer,	মুমতাজের,	মুমতাজের,	
bee,	বীই,	বি,	
soori,	সুরি,	সুরি,	
chhutee,	ছুটে,	ছুটি,	
srivatsalakshanang,	শ্রীবৎস্যালস্নাং,	শ্রীবৎসলক্ষণং,	
muradpur,	মুরাদপুরের,	মুরাদপুর,	
aagera,	আগেরা,	আগোরা,	
pratool,	প্রোটোল,	প্রতুল,	
atak,	আটাক,	আটক,	
shiropar,	শিরোপার,	শিরোপার,	
besooro,	বেসরো,	বেসুর,	
bhadaka,	ভাদাকা,	ভদকা,	
sahapathike,	সাহাতথীকে,	সহপাঠীকে,	
bifol,	বিফল,	বিফল,	
katui,	কাটুই,	কাতুই,	
lesense,	লেসেন্স,	লাইসেন্স,	
sommotite,	সম্মতিতে,	সম্মতিতে,	
mailkhanek,	মাইলখানেক,	মাইলখানেক,	
seqtara,	সেকটারা,	সেক্টর,	
anichchi,	অনিচ্ছি,	আনিচ্ছি,	
katiusha,	কাতিসহ,	কাতিউশা,	
shahidputra,	সহিদপুত্র,	শহীদপুত্র,	
akar,	আকার,	একার,	
wrighter,	ভ্রোথের,	রাইটের,	
horeepur,	হরেপুর,	হরিপুর,	
pothon,	পথন,	পঠন,	
korkotkraantee,	করকরেকান্ত্রে,	কর্কটক্রান্তি,	
kheshar,	খেশার,	খেশার,	
brittakare,	বৃত্তকরে,	বৃত্তাকারে,	
