windows,	উইন্ডোাস,	উইন্ডোস,	
mag,	ম্যাগ,	এমএজি,	
lettere,	লেটারে,	লেটারে,	
path,	পাঁথ,	পাথ,	
macbeth,	ম্যাকবেট,	ম্যাকবেথ,	
cocaine,	কোকাইন,	কোকেইন,	
dibet,	দিবেত,	ডিবেট,	
kramp,	ক্রাযাম্প,	ক্র্যাম্প,	
utsahamulak,	উৎসাহমূলক,	উৎসাহমূলক,	
homsher,	হোমশের,	হোমসের,	
bizito,	বিজিত,	বিজিত,	
shootar,	সুতার,	শ্যুটার,	
oitijhyotike,	ঐতিহ্যটিকে,	ঐতিহ্যটিকে,	
jegulur,	যাগুলুর,	যেগুলুর,	
aalkaatra,	আলকাত্র,	আলকাতরা,	
postac,	পোস্টাক,	পোস্টকে,	
gaddaafee,	গাদ্বাফী,	গাদ্দাফী,	
madhuri,	মধুরি,	মাধুরী,	
prakare,	প্রকারে,	প্রকারে,	
ashor,	আশর,	আসর,	
kadapaker,	কাড়াকার,	কড়াপাকের,	
porjotoker,	পর্যটকের,	পর্যটকের,	
lidars,	লিডারস,	লিডার্স,	
masjidsaho,	মসজিদসহ,	মসজিদসহ,	
sten,	স্টেন,	স্টেন,	
ankanshilpe,	অঙ্কনশীল্পে,	অঙ্কনশিল্পে,	
drishyogulote,	দৃশ্যগুলোতে,	দৃশ্যগুলোতে,	
shrabasti,	শ্রাবস্তি,	শ্রাবস্তী,	
taufiq,	টাফিক,	তৌফিক,	
emerjency,	ইমারজজেন্সি,	এমার্জেন্সি,	
abosare,	অবসারে,	অবসরে,	
teta,	টেট,	টেটা,	
shem,	শেম,	সেম,	
dhalur,	ধালুর,	ঢালুর,	
songasthaner,	সংস্থানের,	সংস্থানের,	
popke,	পপকে,	পোপকে,	
elakatikay,	এলাকাটিকা,	এলাকাটিকে,	
farna,	ফার্না,	ফার্ন,	
choshon,	চোষণ,	চোষণ,	
angibhutovabe,	অঙ্গিভূতভাবে,	অঙ্গীভূতভাবে,	
prothati,	প্রথাটি,	প্রথাটি,	
kaloniir,	কালোনীর,	কালনীর,	
hukar,	হুকার,	হুকার,	
ponchasjon,	পঞ্চাসজন,	পঞ্চাশজন,	
qyantana,	ক্যান্তন,	ক্যান্টন,	
soinyora,	সৈন্যরা,	সৈন্যরা,	
obosore,	অবসরে,	অবসরে,	
somonwitobhabey,	সমন্বতিবাবে,	সমন্বিতভাবে,	
godabari,	গোদাবারি,	গোদাবরী,	
noitik,	নৈতিক,	নৈতিক,	
maudelgulo,	মাউডেলগুলো,	মডেলগুলো,	
elahabade,	এলাহাবাদে,	এলাহাবাদে,	
durlabhatwang,	দূর্যাত্্ং,	দুর্লভত্বং,	
jonomukhi,	জনমুখী,	জনমুখী,	
ajijer,	আজিজের,	আজিজের,	
kiandi,	কিয়ান্দি,	ক্যান্ডি,	
pathkrom,	পাঠক্রম,	পাঠক্রম,	
jatinkey,	জাতিনকে,	যতীনকে,	
nanir,	নানির,	নানীর,	
shasonamoleri,	শাসনামলেরই,	শাসনামলেরই,	
dakter,	ডাক্তের,	ডাকতের,	
bolvodro,	বলভোর্ড,	বলভদ্র,	
tolemyr,	টলামির,	টলেমির,	
samle,	সামলে,	সামলে,	
mythological,	মাইথোজজিক্যাল,	মাইথলজিকাল,	
ekbai,	একবাই,	একবাই,	
monroe,	মনোর,	মনেরোর,	
vandar,	ভান্ডার,	ভাণ্ডার,	
tigmanshu,	তিগমানশু,	তিগ্মাংশু,	
chetanagoto,	চেতানগত,	চেতনাগত,	
zerusalemer,	জেরুসালেমের,	জেরুজালেমের,	
narishwar,	নারীশ্বর,	নারীশ্বরের,	
wodka,	ওয়াডকা,	ভদকা,	
malinga,	মালিঙ্গা,	মালিংগা,	
uparjon,	উপারজন,	উপার্জন,	
kalkarkhana,	কলকর্খনা,	কলকারখানা,	
teentir,	টেনটির,	তিনটির,	
habathu,	হাবাথু,	হাবাথু,	
sulfatee,	সুলফাতে,	সালফেট,	
basaake,	বাসাকে,	বাসাকে,	
nirgamon,	নির্গামন,	নির্গমন,	
souripurang,	সৌরীপূর্ণ,	সৌরিপুরং,	
monzeele,	মনজেলি,	মঞ্জিলে,	
fevarite,	ফেভারিতে,	ফেভারিট,	
bosantake,	বসন্তাকে,	বসন্তকে,	
bosontoke,	বসন্তকে,	বসন্তকে,	
gananatyo,	গণনাত্য,	গণনাট্য,	
shakara,	শাকারা,	সাকার,	
bim,	বিম,	বিম,	
kanasarabheeshana,	কনারারীভাণ,	কনসারভেশন,	
juddhahato,	যুদ্ধাহাত,	যুদ্ধাহত,	
beshirbhaagei,	বেশীরভাগেই,	বেশিরভাগেই,	
heelser,	হিলসের,	হিলসের,	
punosthaner,	পুনস্থানের,	পুনঃস্থানের,	
hariner,	হরিণের,	হরিণের,	
jaandrel,	যা্্দ্রেল,	জাঁদরেল,	
ostad,	ওস্তাদ,	ওস্তাদ,	
elakaatite,	এলাকাতিতে,	এলাকাটিকে,	
poddhotitei,	পদ্ধতিতেই,	পদ্ধতিতেই,	
chetanagato,	চেতনাগত,	চেতনাগত,	
gujab,	গুজাব,	গুজব,	
lyaandeeng,	ল্যাডিং,	ল্যান্ডিং,	
highcomissione,	হাইকমোপিনেন,	হাইকমিশনে,	
eesosiyeetasa,	ইসসিয়েসা,	এসোসিয়েটস,	
salmanul,	সালমানুল,	সালমানুল,	
sharoker,	শররকের,	স্মারকের,	
bisshas,	বিশ্বাস,	বিশ্বাস,	
prasadhoni,	প্রসাধনী,	প্রসাধনী,	
gandharir,	গান্ধারীর,	গান্ধারীর,	
kazianis,	কাজিয়ানিস,	কাজানিস,	
kaale,	কালে,	কালে,	
kormoke,	কর্মকে,	কর্মকে,	
madaspushto,	মাদসপুষ্ট,	মদদপুষ্ট,	
korimkey,	করিমকে,	করিমকে,	
poscater,	পস্কাটের,	পশ্চাতের,	
amontronkarider,	অমন্ত্রণকারীদের,	আমন্ত্রণকারীদের,	
lebina,	লেবিনা,	লেবিনা,	
pooshteer,	পুষ্টির,	পুষ্টির,	
bojhao,	বোঝাও,	বোঝাও,	
habol,	হাবল,	হাবোল,	
soteciety,	সোটেসিটি,	সোসাইটিতে,	
pleta,	প্লেটা,	প্লেটো,	
mukhomandal,	মুখমননাল,	মুখমণ্ডল,	
bone,	বনে,	বনে,	
dushtogone,	দুষ্টগণে,	দুষ্টগণে,	
doorotaumo,	দূরোতুমো,	দূরতম,	
hughes,	হুঘেস,	হিউজেস,	
korijachilen,	করিযাছিলেন,	করিযাছিলেন,	
neermol,	নির্মোল,	নির্মল,	
gronthoti,	গ্রন্থতি,	গ্রন্থটি,	
niharkantibabu,	নীহারকান্তবাবু,	নিহারকান্তিবাবু,	
kortam,	কর্তাম,	করতাম,	
bongshokey,	বংশকে,	বংশকে,	
informetion,	ইনফরমেশন,	ইনফরমেশন,	
notti,	নটি,	নোটটি,	
deool,	দেওল,	দেউল,	
hock,	হক্ক,	হুক,	
magical,	ম্যাগিকাল,	ম্যাজিকাল,	
bharatey,	ভারতে,	ভারতে,	
doltyagi,	দলত্যাগী,	দলত্যাগী,	
tookrokey,	টুকরকে,	টুকরোকে,	
prangulo,	প্রাণগুলো,	প্রানগুলো,	
raagei,	রাগেই,	রাগেই,	
jetam,	জেতাম,	যেতাম,	
fostar,	ফোস্টার,	ফস্টার,	
aatto,	আতিতিও,	আত্ম,	
abdan,	আবদান,	আব্দান,	
sobrakomer,	সব্রাকমের,	সবরকমের,	
bishnu,	বিষ্ণু,	বিষ্ণু,	
jansa,	জানসা,	জন্স,	
tomader,	তোমাদের,	তোমাদের,	
bondishalatei,	বন্দীশালাতেই,	বন্দিশালাতেই,	
danaqana,	দানাকানা,	ডানকান,	
bandhano,	বাঁধানো,	বাঁধানো,	
aamor,	আমোর,	আমর,	
starker,	স্টারককের,	স্টার্কের,	
dupleks,	ডাপলেক্স,	ডুপ্লে,	
breq,	ব্রেক,	ব্রেক,	
zibonnogor,	জীবন্যগর,	জীবননগর,	
ala,	আলা,	আলা,	
setikey,	সেতিকে,	সেটিকে,	
rayyaleti,	রায়য়লীতে,	রয়্যালটি,	
bornolikhon,	বর্ণলিখন,	বর্ণলিখন,	
eporjonto,	এপর্নত্ব,	এপর্যন্ত,	
aajeej,	আজিজ,	আজিজ,	
aakaabaar,	আকাবার,	আকাবার,	
brookoleen,	ব্রুকলিন,	ব্রুকলিন,	
aviyojan,	অভিযোজন,	অভিযোজন,	
apad,	আপাদ,	আপদ,	
hosto,	হস্ত,	হস্ত,	
lavta,	লাভটা,	লাভটা,	
irana,	ইরানা,	ইরান,	
tasminer,	তাসমিনের,	তাসমিনের,	
haitasha,	হাইতাশা,	হাইটস,	
smarak,	স্মারক,	স্মারক,	
vromonkaley,	ভ্রমণকালে,	ভ্রমণকালে,	
ekla,	একলা,	একলা,	
manushera,	মননুষেরা,	মানুষেরা,	
manushe,	মানুষে,	মানুষে,	
shekender,	সেকেন্ডের,	সেকেন্ডের,	
oncoleo,	অঙ্কোল,	অঞ্চলেও,	
sangosrobomukto,	সংস্রবমমুক্ত,	সংস্রবমুক্ত,	
oswastikor,	অস্বাসটিকর,	অস্বস্তিকর,	
conflict,	কনফ্লিক্ট,	কনফ্লিক্ট,	
omanisa,	ওমানিসা,	অমানিশা,	
graambaaseeo,	গ্রামবাসেও,	গ্রামবাসীও,	
furio,	ফুরিও,	ফুরিও,	
mmadhuri,	ম্মাধুরি,	মাধুরী,	
tatey,	তাতে,	তাতে,	
nili,	নীলি,	নিলি,	
firti,	ফিরটি,	ফিরতি,	
taatey,	তাতে,	তাতে,	
thaanobhi,	থানোভি,	থানভী,	
jakso,	জাকসো,	যক্ষ,	
rajtantro,	রাজতন্ত্র,	রাজতন্ত্র,	
shchalastik,	স্কালাস্তিক,	স্কলাস্টিক,	
megacaldera,	মেগাকাল্ডারা,	মেগাক্যাল্ডেরা,	
ekghare,	একঘরে,	একঘরে,	
abhidhaaner,	অভিধানের,	অভিধানের,	
direectoratee,	ডিরিক্রটিতে,	ডিরেক্টরেট,	
madhumati,	মধুমতি,	মধুমতী,	
thailand,	থাইল্যান্ড,	থাইল্যান্ড,	
sealvi,	সিল্ভি,	সিলভি,	
chinito,	চিনিতো,	চিনতো,	
bajpa,	বজপা,	বাজপা,	
milton,	মিল্টন,	মিলটন,	
votar,	ভোটার,	ভোটার,	
suchanakal,	সুচনাকাল,	সূচনাকাল,	
barack,	বারাক,	বারাক,	
shuchonakal,	শুচোনকাল,	সূচনাকাল,	
artilary,	আর্টিলারি,	আর্টিলারি,	
shunani,	শুনানি,	শুনানী,	
raghubar,	রঘুবার,	রঘুবীর,	
ghumunoi,	ঘুমুনোই,	ঘুমুনোই,	
sayatana,	সায়তানা,	শয়তান,	
jeher,	জেহের,	জেহের,	
akpaase,	আক্পাসে,	একপাশে,	
armeenian,	আর্মিনিয়ান,	আর্মেনিয়ান,	
hizrite,	হিজরিতে,	হিজরীতে,	
machhti,	মাছটি,	মাছটি,	
kharavel,	খরাভেল,	খারবেল,	
postar,	পোস্তার,	পোস্টের,	
suparichito,	সুপারিচিত,	সুপরিচিত,	
ingreziteo,	ইংরেজিতেও,	ইংরেজিতেও,	
patininda,	পতিনিন্দ,	পতিনিন্দ,	
koomarir,	কুমারীর,	কুমারীর,	
kathla,	কাঠলা,	কাঠলা,	
eura,	ইউরা,	ইউরো,	
welaqama,	ওয়েকামা,	ওয়েলকাম,	
gaandaas,	গা্ডাস,	জ্ঞানদাস,	
meloonborrone,	মেলুবনরররেণ,	মেলবোর্নে,	
karmokarke,	কর্মকারকে,	কর্মকারকে,	
nazranar,	নাজরানার,	নাজরানার,	
rokibul,	রকিবুল,	রকিবুল,	
cooda,	কোডা,	কোডা,	
doobate,	দুবাতে,	ডুবাতে,	
siddhantoke,	সিদ্ধান্তকে,	সিদ্ধান্তকে,	
booroon,	বুরুন,	বোরন,	
rubala,	রুবালা,	রুবল,	
brekethru,	ব্রেকেথরু,	ব্রেকথ্রু,	
karmoi,	কারমোই,	কর্মই,	
songkoloney,	সংকলনে,	সংকলনে,	
kayed,	কায়েদ,	কায়েদ,	
chadake,	চড়াকে,	চড়াকে,	
tirmijii,	তিরমিজি,	তিরমিজি,	
upobaashee,	উপবাশী,	উপবাসী,	
protectionism,	প্রটেক্টিনিজম,	প্রোটেকশনিজম,	
bhebechili,	ভেবেছিলি,	ভেবেছিলি,	
niutrino,	নিউট্রিনো,	নিউট্রিনো,	
prithibir,	পৃথিবীর,	পৃথবীর,	
welcome,	ওয়েলকোম,	ওয়েলকাম,	
toufiq,	টাফিক,	তৌফিক,	
bhaibon,	ভাইবন,	ভাইবোন,	
somraatder,	সম্রাটদের,	সম্রাটদের,	
pravritir,	প্রবৃতির,	প্রভৃতির,	
noteti,	নটেটি,	নোটটি,	
sahachke,	সাহাককে,	সাহাচকে,	
soolke,	সুলকে,	শুল্কে,	
suiti,	সুইটি,	সুইটি,	
rupantarer,	রুপান্তরের,	রুপান্তরের,	
rohasyer,	রহস্যের,	রহস্যের,	
kodorer,	কদরের,	কদরের,	
serveray,	সার্ভেরেয়া,	সার্ভারে,	
abanishankar,	অবনীশঙ্কর,	অবনিশংকর,	
bohoodin,	বহিদ,	বহুদিন,	
vabnakey,	ভাবনাকে,	ভাবনাকে,	
bolbo,	বলবো,	বলবো,	
laesensh,	লাইসেন্স,	লাইসেন্স,	
ispredsiit,	ইসপ্রেডবিট,	স্প্রেডশীট,	
flexta,	ফ্লেক্সটা,	ফ্লেক্সটা,	
santaa,	সান্তাও,	সান্তা,	
wedanta,	ওয়েডান্টা,	বেদান্ত,	
zeebonto,	জীবন্ত,	জীবন্ত,	
billaho,	বিল্লাহ,	বিল্লাহ,	
sontoshpur,	সন্তোষপুর,	সন্তোষপুর,	
saqara,	সাকারা,	সাকার,	
jhalkanite,	ঝলকানিতে,	ঝলকানীতে,	
digri,	ডিগ্রি,	ডিগ্রি,	
ghotaibe,	ঘটাইবে,	ঘটাইবে,	
dhangsantup,	ধ্বংসা্তুপ,	ধ্বংসন্তুপ,	
stanahenja,	স্তনহেন্যা,	স্টোনহেঞ্জ,	
veenish,	ভিনিশ,	ভেনিস,	
sardar,	সরদদার,	সরদার,	
jhumjhumita,	ঝুমঝুমিতা,	ঝুমঝুমিটা,	
roopmatro,	রুপমাত্র,	রূপমাত্র,	
nothivukta,	নথিভুক্ত,	নথিভুক্ত,	
ganakantha,	গণকন্ঠ,	গণকণ্ঠ,	
dakteekiter,	ডাক্তিকীতের,	ডাকটিকিটের,	
dweepgoolotey,	দ্বীপগুলিতে,	দ্বীপগুলোতে,	
arashie,	আরাশিয়ে,	আরসিএ,	
rajyabhogi,	রাজ্যভোগী,	রাজ্যভোগী,	
thabai,	থাবাই,	থাবাই,	
felto,	ফেল্টো,	ফেলত,	
ateetkale,	অতীতকালে,	অতীতকালে,	
taigara,	টাইগার,	টাইগার,	
ganochien,	গণছিয়েন,	গণচীন,	
mulyayonsapekkhe,	মূল্যায়সপক্ষেকে,	মূল্যায়নসাপেক্ষে,	
qrisenta,	ক্রিসেন্ট,	ক্রিসেন্ট,	
cheekitsar,	চিকিৎসার,	চিকিত্সার,	
trabuco,	ট্র্যাবুকো,	ট্র্যাবুকো,	
shikshagato,	শিক্ষাগত,	শিক্ষাগত,	
bisshaskey,	বিশ্বাসকে,	বিশ্বাসকে,	
xpose,	ক্যাপ্সো,	এক্সপোজ,	
chirontan,	চিরন্তান,	চিরন্তন,	
encidablu,	এনসিডাবলু,	এনসিডাব্লু,	
chakradhare,	চক্রধরে,	চক্রধরে,	
shariba,	শরিবা,	শরিবা,	
aditisaha,	আদিতিসহ,	অদিতিসহ,	
militarite,	মিলিটারিতে,	মিলিটারিতে,	
aabarte,	আবার্তে,	আবর্তে,	
byomkes,	ব্যম্কেস,	ব্যোমকেশ,	
assaciates,	অ্যাসিয়েটেস,	এসোসিয়েটস,	
tawnship,	টানশীপ,	টাউনশিপ,	
sangasthagulo,	সংস্থাগুলো,	সংস্থাগুলো,	
ramonar,	রামনার,	রমনার,	
mitrer,	মিত্রের,	মিত্রের,	
ghoor,	ঘুর,	ঘুর,	
kode,	কোড়ে,	কোড,	
somraatra,	সম্রাত্র,	সম্রাটরা,	
uthaney,	উঠনেই,	উঠানে,	
purborekorde,	পূর্বরেকর্ডে,	পূর্বরেকর্ডে,	
bonke,	বনকে,	বনকে,	
venkates,	ভেন্কটেস,	ভেঙ্কটেশ,	
dharavahikbhabe,	ধারাবাচিভাবে,	ধারাবাহিকভাবে,	
philo,	ফিল,	ফিলো,	
saom,	সেয়,	সাওম,	
ghotol,	ঘটল,	ঘটল,	
bayii,	বাইই,	বাঈ,	
qaferderkey,	কাফারদেরকে,	কাফেরদেরকে,	
balatarin,	বালাতারিন,	বালাতারিয়ান,	
parikha,	পরিখা,	পরিখার,	
byabosthar,	ব্যবস্থার,	ব্যবস্থার,	
bhittiti,	ভিত্তিটি,	ভিত্তিটি,	
swostir,	স্বস্তির,	স্বস্তির,	
tarunra,	তরুণরা,	তরুণরা,	
orhan,	ওরহান,	ওরহান,	
sorsa,	সররাসা,	সোর্স,	
review,	রিভিয়া,	রিভিউও,	
khamotagulor,	ক্ষমতাগুলোর,	ক্ষমতাগুলোর,	
bibechyo,	বিবেচ্য,	বিবেচ্য,	
banshite,	বাঁশিতে,	বাঁশিতে,	
tyapa,	ট্যাপ,	ট্যাপ,	
sombhobonao,	সম্ভবনাও,	সম্ভবনাও,	
angshogrohon,	অংশগ্রহণ,	অংশগ্রহন,	
boikolyo,	বৈকল্য,	বৈকল্য,	
aansareer,	আঁসারীর,	আনসারীর,	
bejiye,	বেজিয়ে,	বেজিয়ে,	
nariderke,	নারীদেরকে,	নারিদেরকে,	
deenesh,	দেনেশ,	দীনেশ,	
thailandsaho,	থাইলান্ডাসহ,	থাইল্যান্ডসহ,	
ddebet,	দিবেত,	ডিবেট,	
morodeho,	মরদেহ,	মরদেহ,	
gronthao,	গ্রন্থাও,	গ্রন্থও,	
qara,	কারা,	কর,	
magrey,	ম্যাগ্রে,	ম্যাগ্রে,	
venush,	ভেনুশ,	ভেনাস,	
feemalee,	ফিমালি,	ফিমেল,	
jothartho,	যথার্থ,	যথার্থ,	
shasankarta,	শাসনকর্তা,	শাসনকর্তা,	
degreeo,	ডিগ্রিও,	ডিগ্রিও,	
poribahokotto,	পরিবাহকত্ত,	পরিবাহকত্ব,	
edaningkale,	এদাননকালে,	ইদানীংকালে,	
neshnosh,	নেশনোশ,	নেশনস,	
guzon,	গুজন,	গুজব,	
nirdesika,	নির্দেশিকা,	নির্দেশিকা,	
bhutbhut,	ভূতভুত,	ভুটভুট,	
aizulke,	আইজুলকে,	আইজুলকে,	
talaal,	তালাল,	তালাল,	
daacktickete,	ড্যাক্টিককেটে,	ডাকটিকিটে,	
akar,	আকার,	একার,	
krusher,	ক্রুশের,	ক্রুশের,	
ghamtaa,	ঘামটা,	ঘোমটা,	
mesenjjar,	মেসেনজাজার,	মেসেঞ্জার,	
prokolpogulikei,	প্রকল্পগুলিকেই,	প্রকল্পগুলিকেই,	
boiporiityen,	বৈপরিত্যেন,	বৈপরীত্যেন,	
makhno,	মাখনো,	মাখনো,	
hurricane,	হ্রিরিকেন,	হ্যারিকেন,	
debdebyr,	দেবদেবীর,	দেবদেবীর,	
saarbhaarti,	সরর্বতী,	সার্ভারটি,	
sommotite,	সম্মতিতে,	সম্মতিতে,	
diniphition,	ডিনিফিটন,	ডেফিনেশন,	
gostigulo,	গোস্টিগুলো,	গোষ্ঠীগুলো,	
nirmankarmisaha,	নির্মাণখারামী,	নির্মাণকর্মীসহ,	
vesselli,	ভেসেলি,	ভেসেলি,	
nojder,	নজদের,	নজদের,	
bhandti,	ভাণ্ডটি,	ভাণ্ডটি,	
sorano,	সোরানো,	সরানো,	
saamaanya,	সমা্য,	সামান্য,	
onchalti,	অনচালটি,	অঞ্চলটি,	
francine,	ফ্রান্সিন,	ফ্রান্সিন,	
folleni,	ফলেনি,	ফলেনি,	
chhotogolper,	ছোটগল্পের,	ছোটগল্পের,	
jokkher,	যক্ষের,	যক্ষের,	
licencedhari,	লাইসেন্সভারী,	লাইসেন্সধারী,	
kada,	কাদা,	কোডা,	
breel,	ব্রিল,	ব্রিল,	
temonvabe,	তেমনভাবে,	তেমনভাবে,	
saifullahil,	সৈফুল্লাহিল,	সাইফুল্লাহিল,	
terlarang,	টেরলারং,	তেরলারং,	
bonbhumi,	বনভুমি,	বনভূমি,	
gandhikey,	গান্ধিকে,	গান্ধীকে,	
bbiswashi,	ব্বিবশাসী,	বিশ্বাসই,	
prapokkey,	প্রপাক্যে,	প্রাপককে,	
enamela,	এনামেলা,	এনামেল,	
mataram,	মাতারাম,	মাতরম,	
rachanakal,	রচনাকাল,	রচনাকাল,	
debete,	দেবেতে,	ডিবেট,	
aanaan,	আআনান,	আনান,	
bhabaponno,	ভবপান্য,	ভাবাপন্ন,	
zesa,	জিসা,	জেস,	
sushposhtolikhito,	সুষ্পষ্টিিলিত,	সুষ্পষ্টলিখিত,	
ixprission,	এক্সপ্রিশন,	এক্সপ্রেশন,	
sthapona,	স্থাপনা,	স্থাপনা,	
hafsa,	হাফসা,	হাফসা,	
seebiai,	সিবিয়াই,	সিবিআই,	
raiialati,	রাইওয়ালাটি,	রয়্যালটি,	
grambaseer,	গ্রামবাসীর,	গ্রামবাসীর,	
shommotite,	সম্মতিতে,	সম্মতিতে,	
suparichiti,	সুপারিচিতি,	সুপরিচিতি,	
cuti,	কুটি,	কিউটি,	
teestar,	টিস্টার,	তিস্তার,	
tateo,	তাতেও,	তাতেও,	
sanghitar,	সংহিতার,	সংহিতার,	
maunchostho,	মঞঁচস্থ,	মঞ্চস্থ,	
choudhursoho,	চৌধুরসহ,	চৌধুরসহ,	
site,	সিট,	সিটে,	
lagchhe,	লাঘছে,	লাগছে,	
lutharan,	লুথারন,	লুথেরান,	
lendal,	লেন্ডাল,	লেন্ডল,	
serup,	সেরুপ,	সেরূপ,	
sahojlovyotar,	সহজলভোযতার,	সহজলভ্যতার,	
suraropito,	সুরারপিত,	সুরারোপিত,	
rata,	রট,	রত,	
uchchotara,	উচ্চতারা,	উচ্চতর,	
bhenom,	ভেনম,	ভেনম,	
utkhaat,	উৎকাাত,	উত্খাত,	
pushtee,	পুষ্টি,	পুষ্টি,	
digrir,	ডিগ্রির,	ডিগ্রির,	
sangharshik,	সংঘর্ষিক,	সাংঘর্ষিক,	
dephinishion,	ডেফিশনশন,	ডেফিনেশন,	
gazeetteed,	গেজিটিটেড,	গেজেটেড,	
soceitytey,	সোকেটটাইজ,	সোসাইটিতে,	
byke,	বিইইকে,	বাইক,	
guha,	গুহা,	গোহ,	
parther,	পার্থের,	পার্থের,	
koro,	করো,	করো,	
musalmanderke,	মুসলমানদেরকে,	মুসলমানদেরকে,	
distibutor,	ডিস্তিবুতর,	ডিস্টিবিউটারের,	
kaathhaamaandu,	কাঠমান্ডু,	কাঠমান্ডু,	
parinati,	পরিণাটি,	পরিণতি,	
chhatrodiger,	ছাত্রদীগের,	ছাত্রদিগের,	
ramnathbabur,	রামনাথবাবুর,	রামনাথবাবুর,	
dhamshrenite,	ধামশ্রেণীতে,	ধামশ্রেণীতে,	
kaleo,	কালেও,	কালেও,	
orunima,	অরুণিমা,	অরুণিমা,	
rajbondir,	রাজবন্দির,	রাজবন্দীর,	
grontho,	গ্রন্থ,	গ্রন্থ,	
nilkuthir,	নীলকুঠির,	নীলকুঠির,	
dhanche,	ধানছে,	ধাঁচে,	
dijijer,	দিজিজের,	ডিজিজের,	
minister,	মিনিস্টের,	মিনিস্টার,	
gandhiio,	গান্ধিয়,	গান্ধীও,	
khuizza,	খুইজ্জা,	খুইজ্জা,	
sector,	সেক্টর,	সেক্টর,	
khanonkaj,	খননকাজ,	খননকাজ,	
mukhamandoler,	মুখমন্ডলের,	মুখমণ্ডলের,	
abdi,	আবদি,	অব্দি,	
bodhirota,	বোধিরতা,	বধিরতা,	
roktokhoron,	রক্তচরণ,	রক্তক্ষরণের,	
boudher,	বৌধের,	বৌদ্ধের,	
aflatoxin,	আফলাটেক্সিন,	আ্যফ্ল্যাটক্সিন,	
oedipus,	ওডিপাস,	ইডিপাস,	
jontrototto,	যন্ত্রতত্ত্ব,	যন্ত্রতত্ত্ব,	
palbongsher,	পালবংশের,	পালবংশের,	
artherer,	আর্থেরের,	আর্থারের,	
spancer,	স্প্যান্সের,	স্পেন্সার,	
ashonkai,	আশঙ্কাই,	আশঙ্কাই,	
arsie,	আরসসি,	আরসিএ,	
siramikasa,	সিরামিকাসা,	সিরামিকস,	
tottorat,	তত্ত্রাত,	তওরাত,	
shudden,	শুদ্দেন,	সাডেন,	
chhuteete,	ছুটিতে,	ছুটিতে,	
ahalya,	অহল্যা,	অহল্যা,	
avetar,	আভেতার,	অবতার,	
bohudeen,	বহুদীন,	বহুদিন,	
mausumeo,	মৌসুমেও,	মৌসুমেও,	
noditir,	নদীটির,	নদীটির,	
saifai,	সাইফাই,	সাইফাই,	
bhadaka,	ভাদাকা,	ভদকা,	
shattoki,	সাত্যকী,	সাত্যকি,	
haris,	হারিস,	হ্যারিস,	
qonflict,	কনফ্লিক্ট,	কনফ্লিক্ট,	
shoodhooi,	সুধুই,	শুধুই,	
raunanganey,	রৌনাঙ্গনে,	রণাঙ্গনে,	
chouhate,	চৌহাতে,	চৌহাটে,	
harasta,	হারাস্তা,	হারাস্তা,	
monir,	মনির,	মনির,	
afrazuler,	আফরাজুলের,	আফরাজুলের,	
karim,	কারিম,	করিম,	
nakkal,	নাককল,	নক্কল,	
ghoshanapatratio,	ঘোষণাপত্রটিও,	ঘোষণাপত্রটিও,	
shikshagata,	শিক্ষাতা,	শিক্ষাগত,	
chalachchitroke,	চালচ্চিত্রকে,	চলচ্চিত্রকে,	
panthar,	পানথথার,	পন্থার,	
mugdal,	মুগদাল,	মুগডাল,	
armori,	আরমোরি,	আরমোরি,	
jotharthovabey,	যথার্থভাবে,	যথার্থভাবে,	
societytey,	সোশিটেই,	সোসাইটিতে,	
standards,	স্ট্যাণ্ডার্ডসহ,	স্টান্ডার্ডস,	
kaferder,	কাফেরদের,	কাফেরদের,	
oitijjo,	ঐতিহ্য,	ঐতিহ্য,	
ernad,	এরনাদ,	এরনাড,	
silabhara,	সিলাভরা,	সিলভার,	
hijri,	হিজরি,	হিজরী,	
churger,	চার্গের,	চার্জের,	
temone,	টেমনে,	তেমনই,	
darji,	দার্জি,	দরজি,	
prokolpoti,	প্রকল্পটি,	প্রকল্পটি,	
jaanachhe,	যানাছ্ছে,	জানাচ্ছে,	
caroline,	ক্যারোলিন,	ক্যরোলিন,	
parka,	পারকা,	পার্ক,	
dhonni,	ধন্নি,	ধন্যি,	
riphleksa,	রিফলেকস,	রিফ্লেক্স,	
nothibhukto,	নথিভুক্ত,	নথিভুক্ত,	
peerry,	পিরি,	পেরি,	
torabganj,	তরাববাঞ্জ,	তোরাবগঞ্জ,	
sawam,	সাওয়াম,	সাওম,	
ched,	চেদ,	ছেদ,	
prashikkhane,	প্রাশিক্ষণে,	প্রশিক্ষণে,	
megh,	মেঘ,	মেঘ,	
nosihote,	নসিহতে,	নসিহতে,	
ghotleyo,	ঘটললেও,	ঘটলেও,	
conservetion,	কনজারভেশন,	কনসারভেশন,	
lyaanding,	ল্যান্ডিং,	ল্যান্ডিং,	
sabrakamer,	সবরাকমের,	সবরকমের,	
gronthowo,	গ্রন্থও,	গ্রন্থও,	
bolatkar,	বলাটকর,	বলাৎকার,	
amanisa,	আমানিসা,	অমানিশা,	
meropenemer,	মেরোপেনামের,	মেরোপেনেমের,	
danab,	দানাব,	দানব,	
foxer,	ফক্সের,	ফক্সের,	
buth,	বুথ,	বুথ,	
abhidhaanick,	অভিধানিক,	অভিধানিক,	
ovidhaner,	অভিধানের,	অভিধানের,	
protishta,	প্রতিষ্টা,	প্রতিষ্টা,	
bbiswashke,	বিবিশ্বাসকে,	বিশ্বাসকে,	
osoborno,	অসবর্ণ,	অসবর্ণ,	
tennis,	টেনিস,	টেনিস,	
gore,	গোর,	গোর,	
kormoi,	কর্মই,	কর্মই,	
modele,	মডেলে,	মডেলে,	
saqara,	সাকারা,	সকার,	
upacharjo,	উপাচার্য,	উপাচার্য,	
uddhritir,	উদ্ধৃতির,	উদ্ধৃতির,	
dibya,	দিব্য,	দিব্যা,	
joubanbatee,	যৌবনবাতে,	যৌবনবতী,	
cheekitshar,	চিকিৎশার,	চিকিত্সার,	
aqram,	আকরাম,	আকরাম,	
mumtaz,	মুমতাজ,	মুমতাজ,	
bisheshyo,	বিশেষ্য,	বিশেষ্য,	
chhutochhooti,	ছুটোছুটি,	ছুটোছুটি,	
argho,	অর্ঘ,	অর্ঘ্য,	
bikromei,	বিক্রমেই,	বিক্রমেই,	
ummool,	উম্মুল,	উম্মুল,	
rakhete,	রাখেতে,	রাখেতে,	
spenser,	স্পেন্সের,	স্পেন্সার,	
makame,	মাকামে,	মাকামে,	
sangbadmadhyome,	সংবাদমাধ্যমে,	সংবাদমাধ্যমে,	
basaalt,	ব্যাসাল্ট,	ব্যাসল্ট,	
gabhaskaar,	গাভসকার,	গাভাস্কার,	
nodimaatrik,	নদীমাতার্ক,	নদীমাতৃক,	
shangkulaan,	সঙ্কুলান,	সংকুলান,	
ponchashjon,	পঞ্চাশজন,	পঞ্চাশজন,	
cholochchitraeeo,	চলচ্চিত্রাওেও,	চলচ্চিত্রেও,	
chaudhurio,	চৌধুরিও,	চৌধুরীও,	
kani,	কানি,	কানি,	
rajtontre,	রাজতন্ত্রে,	রাজতন্ত্রে,	
jiland,	জিল্যান্ড,	জিল্যান্ড,	
goshthiti,	গোষ্ঠিটি,	গোষ্ঠীটি,	
naobihar,	নাওবিহার,	নৌবিহার,	
harees,	হারিস,	হ্যারিস,	
oxforde,	অক্সফোর্ডে,	অক্সফোর্ডে,	
akhandata,	অখণ্ডটা,	অখণ্ডতা,	
senabahineeow,	সেনাবাহিনী,	সেনাবাহিনীও,	
samajikatar,	সমজীকতার,	সামাজিকতার,	
sambatsarkal,	সম্বাসতরকাল,	সম্বৎসরকাল,	
suporichita,	সুপরিচিত,	সুপরিচিত,	
dong,	ডং,	ডং,	
pharn,	ফর্ন,	ফার্ন,	
dooburira,	ডুবুরিরা,	ডুবুরিরা,	
faskari,	ফাসকারী,	ফাঁসকারী,	
dhhaabi,	ঢাবি,	ঢাবি,	
rajtantra,	রাজতন্ত্র,	রাজতন্ত্র,	
zommu,	জম্মু,	জম্মু,	
venice,	ভেনিসে,	ভেনিস,	
minishtarer,	মিনিস্তারের,	মিনিস্টারের,	
arthanitike,	অর্থনীতিকে,	অর্থনীতিকে,	
dwipke,	দ্বিপকে,	দ্বীপকে,	
laishensh,	লাইশেশ,	লাইসেন্স,	
shatodha,	শাতোধা,	শতধা,	
tarkale,	তারকালে,	তারকালে,	
labonaaktotaar,	লবণাকততবতার,	লবণাক্ততার,	
vaisoho,	ভাইসহ,	ভাইসহ,	
pariyech,	পারিয়েছ,	পরিয়েছ,	
kandy,	কান্ডি,	ক্যান্ডি,	
pillai,	পিল্লাই,	পিল্লাই,	
satarkokari,	সাতরককারী,	সতর্ককারী,	
sausagee,	সৌজসে,	সসেজ,	
poderthobid,	পদের্থবিদ,	পদার্থবিদ,	
meghachchanno,	মেঘাচ্ছান্ন,	মেঘাচ্ছন্ন,	
seekkhaou,	শিক্ষাও,	শিক্ষাও,	
aamontrito,	আমন্ত্রিত,	আমন্ত্রিত,	
jocqey,	জককি,	জকি,	
turbiner,	তুরবিনের,	টারবাইনের,	
fatkabazare,	ফাককাবাজারে,	ফাটকাবাজারে,	
tahorir,	তাহরীর,	তাহরীর,	
abodamaner,	অবদামানের,	অবদমনের,	
kormokarke,	কর্মকারকে,	কর্মকারকে,	
udvaboney,	উদ্ভাবনে,	উদ্ভাবনে,	
shainyader,	শৈন্যাদের,	সৈন্যদের,	
jakatke,	জাকাতকে,	যাকাতকে,	
cholchhee,	চলছি,	চলছে,	
ceramiksh,	সিরামিক্স,	সিরামিকস,	
paira,	পাইরা,	পাইরা,	
sikarder,	সিকারদের,	শিকারদের,	
satarkabhabe,	সতর্কভাবে,	সতর্কভাবে,	
rashedul,	রাশেদুল,	রাশিদুল,	
geographics,	জিগ্রাফিক্স,	জিওগ্রাফিকস,	
kormyi,	কর্মই,	কর্মই,	
ghetu,	ঘেটু,	ঘেটু,	
onupater,	অনুপাতের,	অনুপাতের,	
ancholsomuho,	অঞ্চলসমূহ,	অঞ্চলসমূহ,	
dhanak,	ধনক,	ধানক,	
monchosthol,	মঞ্চস্থল,	মঞ্চস্থল,	
krus,	ক্রুস,	ক্রুশ,	
oiteejye,	ঐতিহ্যে,	ঐতিহ্যে,	
cholochchitro,	চলচ্চিত্র,	চলচ্চিত্র,	
chomski,	চমস্কি,	চমস্কি,	
khiladirao,	খিলাদিরাও,	খিলাড়িরাও,	
firozaa,	ফিরোজাও,	ফিরোজা,	
priseflex,	প্রিসফ্লেক্স,	প্রাইজফ্লেক্স,	
pohnpeic,	পোন্সওয়েক,	ফোনপেইক,	
jolrong,	জলরং,	জলরঙ,	
nyeta,	নায়েটা,	ম্যাট,	
cholochchitratike,	চলচ্চিত্রাটিকে,	চলচ্চিত্রটিকে,	
gondogol,	গণ্ডগোল,	গন্ডগোল,	
jonesh,	জনেশ,	জোন্স,	
rilayensha,	ঋলিয়েনশা,	রিলায়েন্স,	
flirt,	ফ্লির্ট,	ফ্লার্ট,	
nothiboddho,	নথিবদ্ধ,	নথিবদ্ধ,	
kareer,	করির,	কারীর,	
hijritey,	হিজরিতে,	হিজরীতে,	
dormetori,	দর্মোটারি,	ডরমিটরি,	
sahittopritite,	সাহিত্যপ্রীতে,	সাহিত্যপ্রীতিতে,	
armeeniyana,	আর্মিণীয়,	আর্মেনিয়ান,	
bodhir,	বোধীর,	বধির,	
chakti,	চাকতি,	চাকতি,	
alaul,	আলাউল,	আলাওল,	
grambaashio,	গ্রামবাশীও,	গ্রামবাসীও,	
chire,	চিরে,	চিরে,	
erokomer,	এরকমের,	এরকমের,	
chiroharit,	চিরহারিত,	চিরহরিৎ,	
addabaj,	আড্ডাবাজ,	আড্ডাবাজ,	
ministara,	মিনিস্তার,	মিনিস্টার,	
bhuushito,	ভূষুতিত,	ভূষিত,	
duburir,	ডুবুরির,	ডুবুরির,	
azijer,	আজিজের,	আজিজের,	
asaktibandhan,	অস্কিতবন্ধন,	আসক্তিবন্ধন,	
bondhukey,	বন্ধুকে,	বন্ধুকে,	
durgotsab,	দুর্গোৎসব,	দুর্গোৎসব,	
iksaprishana,	ইক্ষপ্রিষণা,	এক্সপ্রেশন,	
drissoke,	দৃশ্যকে,	দৃশ্যকে,	
ganaparibahan,	গণপরিবহন,	গণপরিবহন,	
sikha,	সিখা,	শিখ,	
torkarir,	তররকারীর,	তরকারীর,	
blacq,	ব্ল্যাক,	ব্ল্যাক,	
balithubar,	বালিখুবার,	বালিথুবার,	
simons,	সিমন্স,	সিমন্স,	
sponsorshipe,	স্পন্সর্ষীপে,	স্পন্সরশীপে,	
laagche,	লাগছে,	লাগছে,	
kaalengaa,	কালেঙ্গা,	কালেঙ্গা,	
kaande,	কান্দে,	কাণ্ডে,	
aranyani,	অরণ্যানী,	অরণ্যানী,	
titarer,	তিতারের,	তিতারের,	
prachando,	প্রাচণ্ড,	প্রচণ্ড,	
chikitshar,	চিকিৎসার,	চিকিত্সার,	
nisader,	নিষাদের,	নিষাদের,	
akten,	আকতেন,	অকটেন,	
artore,	আর্তোর,	আর্টরে,	
manjushri,	মঞ্জুশ্রী,	মঞ্জুশ্রী,	
jatata,	জাতাতা,	যতোটা,	
yuro,	যুরো,	ইউরো,	
rakkhandurga,	রক্ষণদূর্গ,	রক্ষণদুর্গ,	
nepchooner,	নেপচুনের,	নেপচুনের,	
footballerra,	ফুটবলাররা,	ফুটবলাররা,	
enginiiring,	ইঞ্জিনির়ারিং,	ইঞ্জিনিয়ারিং,	
ghomta,	ঘোমটা,	ঘোমটা,	
elaakati,	এলাকাটি,	এলাকাটি,	
larson,	লারসন,	লারসন,	
bisheshshyo,	বিশেষ্য,	বিশেষ্য,	
marmader,	মারমাদের,	মারমাদের,	
protisthar,	প্রতিষ্ঠার,	প্রতিষ্ঠার,	
nek,	নেক,	নেক,	
protisthan,	প্রতিষ্ঠান,	প্রতিষ্টান,	
vagini,	ভাগিনী,	ভগিনী,	
saarbharti,	সরভর্তি,	সার্ভারটি,	
quota,	কোওটা,	কোটা,	
sikara,	সিকারা,	শিকার,	
mousumeo,	মৌসুমেও,	মৌসুমেও,	
cheess,	চিস,	চেস,	
chhootochhuti,	ছোটছৌটি,	ছুটোছুটি,	
themekey,	থেমেকে,	থিমকে,	
taunasipa,	তৌনসীপা,	টাউনশিপ,	
jacksonke,	জ্যাকসনকে,	জ্যাকসনকে,	
gatibege,	গাতিবেগে,	গতিবেগে,	
shite,	শিতে,	শীতে,	
potka,	পটকা,	পটকা,	
taffsherer,	তাফশেরের,	তাফসীরের,	
sokkhomotabriddhi,	সক্ষমতাবৃদ্ধি,	সক্ষমতাবৃদ্ধি,	
shikkhakram,	শিক্ষাক্রম,	শিক্ষাক্রম,	
planea,	প্লানে,	প্লেনে,	
duhsthanostho,	দুঃস্থানস্থ,	দুঃস্থানস্থ,	
nadike,	নাদিকে,	নদীকে,	
niknayman,	নিকনাযাম,	নিকনেইমান,	
ganohotyake,	গণহত্যাকে,	গণহত্যাকে,	
bhupal,	ভুপাল,	ভূপাল,	
arg,	আরগ,	আর্গ,	
primoo,	প্রীমিও,	প্রিমো,	
shikkharthirao,	শিক্ষার্থীরাও,	শিক্ষার্থীরাও,	
moshzidtike,	মসবিতটিকে,	মসজিদটিকে,	
dhila,	ধীলা,	ঢিলা,	
juboksoho,	যুবকসহ,	যুবকসহ,	
babare,	বাবারে,	বাবারে,	
elaakate,	এলাকাতে,	এলাকাতে,	
capsule,	ক্যাপসুল,	ক্যাপ্সুল,	
ekbakke,	একবাককে,	একবাক্যে,	
bedantodhormo,	বেদান্তধর্ম,	বেদান্তধর্ম,	
america,	আমেরিকা,	আমেরিকা,	
keuoi,	কেও,	কেউই,	
accountdharira,	অকাউন্টধারীরা,	একাউন্টধারীরা,	
marmaraa,	মর্মরা,	মারমারা,	
biprodas,	বিপ্রদাস,	বিপ্রদাস,	
showtey,	সাটে,	শোতে,	
anagarikra,	অনাগারিকরা,	অনাগরিকরা,	
kalnir,	কালনির,	কালনীর,	
bhikkharthe,	ভিক্ষার্থে,	ভিক্ষার্থে,	
nibirbhabe,	নিবীরভাবে,	নিবিরভাবে,	
delibhara,	দেলিভারা,	ডেলিভার,	
playtey,	প্লেইট,	প্লেটে,	
koota,	কোটা,	কোটা,	
jahara,	জাহারা,	যাহরা,	
mooney,	মুনে,	মুনে,	
shatan,	শতান,	শয়তান,	
kathmandute,	কাঠমান্ডতে,	কাঠমান্ডুতে,	
abhiyojan,	অভিযোজন,	অভিযোজন,	
osommotite,	অসম্মতিতে,	অসম্মতি,	
veemsen,	ভিমসেন,	ভীমসেন,	
nodiitei,	নদীইতেই,	নদীতেই,	
mosharroph,	মোশারফর,	মশাররফ,	
govindarajan,	গোবিন্দরাজন,	গোবিন্দরাজন,	
maaktoome,	মাক্তুমে,	মাকতুম,	
ramachandranke,	রামান্দ্রনকে,	রামাচন্দ্রনকে,	
ghoomachhe,	ঘুমাছে,	ঘুমাচ্ছে,	
chilona,	চিলোনা,	ছিলনা,	
kingsh,	কিংস,	কিংস,	
khoakshir,	খোয়াক্ষীর,	খোয়াক্ষীর,	
hoil,	হেল,	হইল,	
impaction,	ইম্প্যাকেশন,	ইমপ্যাকশন,	
kul,	কুল,	কুল,	
koordira,	কর্্দিরা,	কুর্দিরা,	
chaalaabi,	চালাবি,	চালাবে,	
akhando,	অখণ্ডও,	অখন্ড,	
krechi,	ক্রেচি,	করেছি,	
chhooti,	ছুটি,	ছুটি,	
agomonke,	আগোমনকে,	আগমনকে,	
forma,	ফরমা,	ফর্মা,	
batistambhatike,	বাতিস্তমভাাইকে,	বাতিস্তম্ভটিকে,	
chasee,	চাসী,	চেস,	
kaatbey,	কাটবে,	কাটবে,	
transhapharma,	ট্রান্সফরম্,	ট্রান্সফর্ম,	
michir,	মিচির,	মিচির,	
manob,	মানব,	মানব,	
uthe,	উঠে,	উঠে,	
sqirt,	স্কির্ট,	স্কার্ট,	
jamaanor,	জামানোর,	জমানোর,	
samajeek,	সমজিক,	সামাজিক,	
templet,	টেম্পলেট,	টেম্পলেট,	
purushika,	পুরুশিকা,	পুরুষিকা,	
angsogrohone,	অংশগ্রহণে,	অংশগ্রহনের,	
asamonjasyopurno,	অসামঞ্জস্যপূর্ণ,	অসামঞ্জস্যপূর্ণ,	
madhabike,	মাধবীকে,	মাধবীকে,	
utpatti,	উৎপাত্তি,	উতপত্তি,	
udbodhaney,	উদ্বধানে,	উদ্বোধনে,	
yatharthabhabe,	যথথরথাবাবে,	যথার্থভাবে,	
uqeliptas,	উকেলিপ্টাস,	ইউক্যালিপ্টাস,	
myari,	ম্যারি,	ম্যারি,	
uter,	ইউটার,	উটের,	
khali,	খালি,	খালি,	
sadeena,	সাদিন,	সাডেন,	
ancholsaha,	অঞ্চলসহ,	অঞ্চলসহ,	
natshi,	নাতশি,	নাত্সি,	
eigulor,	এইগুলোর,	এইগুলোর,	
siddhantei,	সিদ্ধন্তেই,	সিদ্ধান্তেই,	
bishshaasho,	বিষ্ষা,	বিশ্বাসও,	
ghaghat,	ঘাঘাট,	ঘাঘট,	
nirmankaaj,	নির্মাণকাজ,	নির্মাণকাজ,	
torabgonj,	তরাবঙ্গী,	তোরাবগঞ্জ,	
internship,	ইন্টারনিপ,	ইন্টার্নশিপ,	
brittakarey,	বৃত্তকারে,	বৃত্তাকারে,	
logotype,	লোগোটাপে,	লোগোটাইপ,	
sarder,	সার্ডার,	সরদার,	
jitpur,	জিতপুর,	জিতপুরের,	
konisttha,	কনিষ্টথা,	কনিষ্ঠ,	
ancholgoolote,	অঞ্চলগুলোতে,	অঞ্চলগুলোতে,	
bishwasho,	বিশ্বাসও,	বিশ্বাসও,	
shef,	শেফ,	শেফ,	
dadapur,	দাদাপুর,	দাদাপুর,	
agamane,	আগামানে,	আগমনে,	
shlok,	শ্লোক,	শ্লোক,	
rajtontro,	রাজতন্ত্র,	রাজতন্ত্র,	
bishwaashshke,	বিশ্বাশকে,	বিশ্বাসকে,	
kram,	ক্রাম,	ক্রম,	
banglota,	বাংলোটা,	বাংলোটা,	
fansi,	ফানসি,	ফাঁসী,	
aaeerese,	এইরেসে,	আইরেসে,	
siropa,	সিরোপা,	শিরোপা,	
saranor,	সারানোর,	সরানোর,	
senior,	সেনিওর,	সিনিয়র,	
bhittitei,	ভিত্তিতেই,	ভিত্তিতেই,	
uporzon,	উপরজন,	উপার্জন,	
plusey,	প্লুসে,	প্লাসে,	
shikkharrthirao,	শিক্ষার্থীরাও,	শিক্ষার্থীরাও,	
adwanced,	অ্যাডান্জড,	অ্যাডভান্সড,	
chakurijibirao,	চাকুরিজীবীরাও,	চাকুরীজীবীরাও,	
yaq,	যাক,	ইয়াক,	
ray,	রায়,	রায়,	
kumbhalnar,	কুম্ভলানার,	কুম্ভালনার,	
transform,	ট্রান্সফর্ম,	ট্রান্সফর্ম,	
mutar,	মুতার,	মুতার,	
qirq,	কির্ক,	কার্ক,	
saseza,	সাসেজা,	সসেজ,	
liaodong,	লিয়াওডং,	লিয়াওদং,	
byaboharkarir,	ব্যবহারকারীর,	ব্যবহারকারীর,	
planey,	প্ল্নে,	প্লেনে,	
dharavahiker,	ধারাবাহিকের,	ধারাবাহিকের,	
kanshat,	কাঁশত,	কানসাট,	
laicenshe,	লাইসেন্সে,	লাইসেন্স,	
jeshh,	যেশ,	জেস,	
anchalgoolir,	অঞ্চলগুলির,	অঞ্চলগুলির,	
parjotaker,	পার্যটাকের,	পর্যটকের,	
dhanyi,	ধনয়ি,	ধন্যি,	
dibug,	দিবুগ,	ডিবাগ,	
pingna,	পিংনা,	পিংনা,	
mukhoshdharir,	মুখোষধারীর,	মুখোশধারীর,	
sarollo,	সারোলো,	সারল্য,	
shomser,	শমসের,	সমশের,	
ragei,	রাগেই,	রাগেই,	
oxfordey,	অক্সফোর্ডে,	অক্সফোর্ডে,	
ekirokom,	একিরকম,	একইরকম,	
ranangone,	রনাঙ্গণে,	রণাঙ্গনে,	
bouddher,	বৌদ্ধের,	বৌদ্ধের,	
akram,	আকরাম,	আকরাম,	
siddhante,	সিদ্ধন্তে,	সিদ্ধান্তে,	
brittakare,	বৃত্তকারে,	বৃত্তাকারে,	
myat,	ম্যাট,	ম্যাট,	
ujobekeestan,	উজবহক্ষিতান,	উজবেকিস্তান,	
pyaleshtainer,	প্যালেশ্টাইনের,	প্যালেস্টাইনের,	
taroni,	তারোনি,	তরণী,	
maudelti,	মাউডলেটি,	মডেলটি,	
probhur,	প্রভুর,	প্রভুর,	
adorso,	আদর্স,	আর্দশ,	
bhenasha,	ভেনাশা,	ভেনাস,	
dharmantor,	ধর্মন্তর,	ধর্মান্তর,	
janghu,	জাংঘু,	জঙ্ঘু,	
munsi,	মুন্সি,	মুন্সী,	
neerbachoker,	নির্বাচকের,	নির্বাচকের,	
songasthatir,	সংস্থাটির,	সংস্থাটির,	
kagbeni,	কাগবেনি,	কাগবেনি,	
uponeesoder,	উপনিষদের,	উপনিষদের,	
indrani,	ইন্দ্রাণী,	ইন্দ্রাণী,	
alonkaran,	আলনকারণ,	অলঙ্করণ,	
adorsho,	আদর্শ,	আর্দশ,	
bhorkendra,	ভোকেন্ড্রা,	ভরকেন্দ্র,	
krisenter,	ক্রিসেন্টের,	ক্রিসেন্টের,	
niroja,	নিরোজা,	নিরোজা,	
konorup,	কোনৌরূপ,	কোনরূপ,	
rahi,	রহহি,	রাহী,	
srabosty,	স্র্বোসটি,	শ্রাবস্তী,	
moorali,	মুরালি,	মুরলী,	
shatokeo,	শতকেও,	শতকেও,	
amarika,	আমারিকা,	আমেরিকা,	
durgatsober,	দুর্গাৎসবের,	দুর্গোৎসবে,	
akai,	আকাই,	একাই,	
deelibhara,	দিলিভারা,	ডেলিভার,	
shamuker,	শামুকের,	শামুকের,	
elaakaate,	এলাকাতে,	এলাকাতে,	
konruup,	কোনরূপ,	কোনরূপ,	
loombinee,	লুমবিনি,	লুম্বিনী,	
aashanka,	আশঙ্কা,	আশংকা,	
dienes,	ডায়েনিস,	ডিএনএস,	
bii,	বিআই,	বি,	
nimnosakkharkari,	নিম্নসহক্রাকারী,	নিম্নস্বাক্ষরকারী,	
nirapattamulok,	নিরাপত্তামূলক,	নিরাপত্তামূলক,	
heavy,	হিভি,	হেভি,	
nagorikra,	নাগরিকরা,	নাগরিকরা,	
shikhbe,	শিখবে,	শিখবে,	
catholicbad,	ক্যাথকলিবাদ,	ক্যাথলিকবাদ,	
byabosthar,	ব্যবস্থার,	ব্যাবস্থার,	
naneer,	নানির,	নানীর,	
agomone,	অগমনে,	আগমনে,	
salphat,	সালফাত,	সালফেট,	
soheensotar,	সোহিনসতার,	সহিংসতার,	
teennis,	টেনিস,	টেনিস,	
choopi,	চুপি,	চুপি,	
ekhate,	এখাতে,	একহাতে,	
detik,	দেটিক,	দেতিক,	
sthapanagulo,	স্থাপানগুলো,	স্থাপনাগুলো,	
chalachchitroi,	চলচ্চিত্রই,	চলচ্চিত্রই,	
salchak,	সালচাক,	সালচাক,	
zerusaleme,	জেরুসামেলে,	জেরুসালেমে,	
vortuki,	ভর্তুকি,	ভর্তুকি,	
dhwajbhango,	ধ্বাগ্্যা,	ধ্বজভঙ্গ,	
tantubayer,	তন্তুবায়ের,	তন্তুবায়ের,	
bijepi,	বিজেপি,	বিজেপি,	
mankisundar,	মানকিসুন্দর,	মানকিসুন্দর,	
dikpal,	দিকপাল,	দিকপাল,	
upbrazillian,	আপব্রেলিয়ালিন,	আপব্রাজিলিয়ান,	
kommandar,	কম্মান্ডার,	কমাণ্ডার,	
biswashi,	বিশ্বাসী,	বিশ্বাসী,	
gonohotyakey,	গনহত্যাকে,	গণহত্যাকে,	
jyaqasana,	জ্যাকাসন,	জ্যাকসন,	
edaning,	এডানিং,	ইদানিং,	
houzgulite,	হাউজগুলিতে,	হাউজগুলিতে,	
societyke,	সোশিটটকে,	সোসাইটিকে,	
chapchap,	চাপচাপ,	চাপচাপ,	
achintopurer,	অচিন্তপুরের,	অচিন্তপুরের,	
meloonborroner,	মেলুবনরররের,	মেলবোর্নের,	
poroborti,	পরবর্তী,	পরর্বতী,	
nadnadeer,	নানদনীর,	নদনদীর,	
tophaat,	টফেট,	তফাৎ,	
nazad,	নাজাদ,	নাজাদ,	
boner,	বনের,	বনের,	
ooipoka,	আইপকা,	উইপোকা,	
ashamarthita,	অশমর্থিত,	অসমর্থিত,	
dipankar,	দীপাঙ্কার,	দিপঙ্কর,	
gosthike,	গোষ্ঠিকে,	গোষ্ঠীকে,	
kushakhali,	কুশাখালি,	কুশাখালি,	
bedanta,	বেদান্ত,	বেদান্ত,	
commissionvogider,	কমিশশাইবোগীদের,	কমিশনভোগীদের,	
prokolpogulor,	প্রকল্পগুলোর,	প্রকল্পগুলোর,	
byan,	ব্যান,	ব্যাং,	
camerapersoner,	ক্যামেরাপারসনের,	ক্যামেরাপার্সনের,	
planeti,	প্ল্যানিটি,	প্লেনটি,	
laaisensh,	লুইসেশ,	লাইসেন্স,	
kanasarabhesana,	কানারারেশনা,	কনসারভেশন,	
provur,	প্রভুর,	প্রভুর,	
mastarsa,	মাস্তারস,	মাস্টার্স,	
sthapanagulor,	স্থাপানগুলোর,	স্থাপনাগুলোর,	
scholars,	স্কলারস,	স্কলার্স,	
sonaktokaran,	সোনাক্তকরণ,	সনাক্তকরণ,	
aieesha,	আইইএসএ,	আইএএস,	
chakrapani,	চক্রপানি,	চক্রপানী,	
shasheja,	শােে,	সসেজ,	
jwar,	জ্বর,	জ্বর,	
jini,	জিনি,	যিনি,	
daltyagi,	দল্তজীগী,	দলত্যাগী,	
mimgulor,	মিমগুলোর,	মিমগুলোর,	
pacchi,	পাচচি,	পাচ্ছি,	
mangoleek,	মঙ্গলিক,	মাঙ্গলিক,	
mase,	মাসে,	মাসে,	
nimitte,	নিমিত্তে,	নিমিত্তে,	
vangley,	ভাঙ্গলি,	ভাঙলে,	
zerusalem,	জেরুসালেম,	জেরুসালেম,	
debate,	ডেবাতে,	ডিবেট,	
mukhyo,	মুখ্য,	মুখ্য,	
jibonnogor,	জীবন্যগর,	জীবননগর,	
arke,	আর্কে,	আরকে,	
shift,	শিফট,	শিফট,	
phuda,	ফুড়া,	ফুড,	
songbadmadhyame,	সংবাদমাধ্যমে,	সংবাদমাধ্যমে,	
chirkoot,	চিরকুট,	চিরকুট,	
sikkharthirao,	শিক্ষার্থীরাও,	শিক্ষার্থীরাও,	
avinetar,	আভিনেতার,	অভিনেতার,	
hunine,	হুনিনে,	হুনাইন,	
bufer,	বুফার,	বাফার,	
drissogoolote,	দৃশ্যগুলোতে,	দৃশ্যগুলোতে,	
philipiner,	ফিলিপিনের,	ফিলিপাইনের,	
prajanankal,	প্রজাননকাল,	প্রজননকাল,	
badhamuktovabe,	বাধমমুক্তভাবে,	বাধামুক্তভাবে,	
daaktikit,	দাক্তিকিত,	ডাকটিকিট,	
vabuk,	ভাবুক,	ভাবুক,	
marathi,	মারাথি,	মরাঠি,	
syfy,	সিএফইই,	সাইফাই,	
grooth,	গ্রুথ,	গ্রোথ,	
procharjontrogulo,	প্রচারগন্ত্রগুলো,	প্রচারযন্ত্রগুলো,	
spredshiit,	স্পার্ডশভিট,	স্প্রেডশীট,	
times,	টিইমস,	টাইমস্,	
carbus,	কার্বাস,	কারবাস,	
elakaai,	এলাকাই,	এলাকাই,	
hepatetisa,	হেপাটেটিস,	হেপাটাইটিস,	
falak,	ফালাক,	ফলক,	
bagdad,	বাগদাদ,	বাগদাদে,	
pratool,	প্রাতুল,	প্রতুল,	
batsmanei,	ব্যাটসম্যানেই,	ব্যাটসম্যানই,	
emarjensi,	এমারজেন্সি,	এমার্জেন্সি,	
ancholtike,	অঞ্চলটিকে,	অঞ্চলটিকে,	
bhagnekeo,	ভাগনেকেও,	ভাগ্নেকেও,	
chalochchitrei,	চলচ্চিত্রেই,	চলচ্চিত্রেই,	
spreedashita,	স্প্র্ইডিশিটা,	স্প্রেডশীট,	
mukhomandaley,	মুখমনান্ডলী,	মুখমণ্ডলে,	
selim,	সেলিম,	সেলিম,	
bhardwaj,	ভর্দ্বজ,	ভরদ্বাজ,	
dara,	দারা,	দারা,	
wilderske,	উইল্ডার্সকে,	উইল্ডার্সকে,	
khelaphate,	খেলাফাতে,	খেলাফতে,	
koruna,	কোরুনা,	করুণা,	
keui,	কেউই,	কেউই,	
matis,	মাতিস,	ম্যাটিস,	
sqalarashipa,	স্কলারোচিপা,	স্কলারশিপ,	
obdi,	অব্দি,	অব্দি,	
jinsa,	জিনসা,	জিন্স,	
gorrer,	গর্মের,	গোরের,	
byaktigotovabeo,	ব্যক্তিগতভাবেও,	ব্যাক্তিগতভাবেও,	
mekong,	মেকং,	মেকং,	
nagorikke,	নাগরিককে,	নাগরিককে,	
dishani,	দিশানি,	দিশানি,	
uddhritto,	উদ্ধৃত্ব,	উদ্ধৃত,	
naraphoka,	নারাফোকা,	নরফোক,	
onucheeder,	অনুচেদের,	অনুচ্ছেদের,	
kanasharabheshhana,	কনাশারেভশন,	কনসারভেশন,	
pare,	পারে,	পাড়ে,	
baipash,	বাইপাশ,	বাইপাস,	
plak,	প্লাক,	প্ল্যাক,	
skirt,	স্কির্ট,	স্কার্ট,	
karecho,	করেছো,	করেছো,	
bethikata,	বেথিকাটা,	বেঠিকতা,	
porishongkhanbid,	পরিশংখ্যানবিদ,	পরিসংখ্যানবিদ,	
susamo,	সুসামো,	সুসম,	
lokhindorer,	লখিন্দরের,	লখিন্দরের,	
hijrite,	হিজরিতে,	হিজরীতে,	
premo,	প্রেমো,	প্রিমো,	
daakteekite,	ডাক্তিকিতে,	ডাকটিকিটে,	
shahanara,	শাহানারা,	শাহানারা,	
atmira,	আত্মীরা,	আত্মীরা,	
bhotomulyoke,	ভোটমূল্যকে,	ভোটমূল্যকে,	
swajan,	স্বজন,	স্বজন,	
nogore,	নগরে,	নগরে,	
achintyabhedaved,	অচিন্ত্যভেদবেদ,	অচিন্ত্যভেদাভেদ,	
ghoomachhilo,	ঘুমাছিল,	ঘুমাচ্ছিল,	
foxcon,	ফক্সন,	ফক্সকন,	
kuttake,	কুট্টাকে,	কুত্তাকে,	
rinobodh,	ঋণবোধ,	ঋণবোধ,	
gaichhe,	গাইছে,	গাইছে,	
sift,	সিফট,	শিফট,	
torunra,	তরুনরা,	তরুণরা,	
chalochchitraeer,	চলচ্চিত্রের,	চলচ্চিত্রের,	
choudry,	ইাউ্ডির,	চৌধুরী,	
baharamporer,	বাহারম্পরের,	বহরমপুরের,	
aholyar,	অহল্যার,	অহল্যার,	
jonoshongjog,	জনশঙ্গগ,	জনসংযোগ,	
bajite,	বাজিতে,	বাজিতে,	
ekekrokom,	একেক্রকম,	একেকরকম,	
jothon,	যথন,	যথন,	
sobrakamer,	সব্রাকামের,	সবরকমের,	
shchalastic,	স্ক্যালাস্টিক,	স্কলাস্টিক,	
dhaanche,	ধানছে,	ধাঁচে,	
karaa,	কারা,	কারো,	
chowdhuryke,	চৌধুরিকে,	চৌধুরীকে,	
nodimatrik,	নদীমাত্রিক,	নদীমাতৃক,	
khudhartara,	ক্ষুধার্তরা,	ক্ষুধার্তরা,	
baju,	বাজু,	বাজু,	
chokhwala,	চোখবালা,	চোখওয়ালা,	
grambaasheeo,	গ্রামবাশীও,	গ্রামবাসীও,	
ekatto,	একাত্ত,	একাত্ব,	
nischitvabe,	নিশ্চিতভাবে,	নিশ্চিতভাবে,	
chorban,	চরবান,	চর্বন,	
oblivion,	অব্লিভিয়ন,	অবলিভিয়ন,	
asommoti,	অসম্মতি,	অসম্মতি,	
vimsen,	ভিমসেন,	ভীমসেন,	
indro,	ইন্দ্রো,	ইন্দ্র,	
sarbhare,	সরভরে,	সার্ভারে,	
samashtike,	সমশ্্তিকে,	সমষ্টিকে,	
landing,	ল্যান্ডিং,	ল্যান্ডিং,	
omeettrakkhor,	অমিত্ররক্ষর,	অমিত্রাক্ষর,	
asthishondhi,	অস্থিসন্ধি,	অস্থিসন্ধি,	
temanti,	তেমান্তি,	তেমনটি,	
whole,	হোলে,	হোল,	
prothakey,	প্রথাকে,	প্রথাকে,	
mangolic,	ম্যাঙ্গলিক,	মাঙ্গলিক,	
braqe,	ব্রেক,	ব্রেক,	
inziniyarsa,	ইঞ্জিনিয়ারসা,	ইঞ্জিনিয়ার্স,	
creshcent,	ক্রেসেন্ট,	ক্রিসেন্ট,	
dharabahikvabe,	ধারাবাহিকভাবে,	ধারাবাহিকভাবে,	
eevil,	ইভিল,	ইভিল,	
alpo,	আলপো,	অল্প,	
rohinibabu,	রোহিনীবাবু,	রোহিনীবাবু,	
dantahin,	দানতাহীন,	দন্তহীন,	
bastubad,	বস্তুবাদ,	বস্তুবাদ,	
karmake,	কারমাকে,	কর্মকে,	
graminphonor,	গ্রামিনবনোর,	গ্রামীণফোনর,	
arekdol,	আরেকডল,	আরেকদল,	
aborto,	আবর্ত,	আবর্ত,	
bhaandar,	ভান্ডার,	ভাণ্ডার,	
shit,	শীত,	শীত,	
shringa,	শ্রীংগা,	শৃঙ্গ,	
kinto,	কিন্ট,	কিনত,	
tigmanshu,	তিগমানশু,	তিগমংশু,	
upobasher,	উপবাশের,	উপবাসের,	
mitro,	মিত্রো,	মিত্র,	
siqhar,	সিখার,	শিকার,	
fuss,	ফুস,	ফাস,	
sima,	সিমা,	সীমা,	
gajano,	গজনও,	গজানো,	
poripake,	পরিপাকে,	পরিপাকে,	
alsaar,	আলসার,	আলসার,	
ayumi,	আয়ুমি,	আয়ুমি,	
chilahatee,	চিলাহাটি,	চিলাহাটি,	
shucharita,	শুচারিতা,	সুচরিতা,	
sanghatakder,	সংহঠকদের,	সংঘটকদের,	
qredita,	ক্রেডিটা,	ক্রেডিট,	
title,	টিটল,	টাইটেল,	
abdoone,	আবদুনে,	আবদুন,	
laaisens,	লাইসেন্স,	লাইসেন্স,	
heerani,	হেরানী,	হিরানি,	
zonsa,	জনসা,	জোন্স,	
dhyana,	ধ্যানা,	ধ্যান,	
antarctika,	অন্তার্ক্টিকা,	অ্যান্টার্কটিকা,	
charpanch,	চারপাঞ্চ,	চারপাঁচ,	
katiusha,	কতিউষা,	কাতিউশা,	
golimodhye,	গোলিমধ্যে,	গলিমধ্যে,	
amor,	আমর,	আমর,	
jhonkar,	ঝোঁকার,	ঝঙ্কার,	
holding,	হোল্ডিং,	হোল্ডিং,	
kk,	কেকে,	কেকে,	
peeri,	পীরই,	পেরি,	
crashlands,	ক্রান্্যাল্ডস,	ক্র্যাশল্যান্ডস,	
istoone,	ইস্তুনে,	স্টোন,	
bhenkates,	ভেঙ্কটেস,	ভেঙ্কটেশ,	
samratder,	সমরতদের,	সম্রাটদের,	
sadbi,	সাদবি,	সাধ্বী,	
jontropatigulite,	যন্ত্রপাতিগুলিতে,	যন্ত্রপাতিগুলিতে,	
adhikartai,	অধিকারততাই,	অধিকর্তাই,	
durbhagya,	দূর্ভাগ্য,	দূর্ভাগ্য,	
orrgho,	অর্ঘ,	অর্ঘ্য,	
byepass,	বিপাস,	বাইপাস,	
oncholtee,	অনচলটি,	অঞ্চলটি,	
shrabosty,	শ্রাবসটি,	শ্রাবস্তী,	
rejidens,	রেজিডেন্স,	রেসিডেন্স,	
epiela,	এপিল্জ,	আইপিএল,	
sahab,	সাহাব,	সাহাব,	
deil,	ডেল,	ডেইল,	
rohosyo,	রহস্য,	রহস্য,	
idyi,	ইডিই,	আইডিই,	
ultrasonography,	আল্ট্রানোস্রোগ,	আলট্রাসনোগ্রাফিও,	
gaaddafee,	গাদ্বাফি,	গাদ্দাফী,	
rudiger,	রুদীগের,	রুদিগের,	
skolarsip,	স্কলারসিপ,	স্কলারশিপ,	
dibi,	দিবি,	দিবি,	
uponishad,	উপনিশাদ,	উপনিষদ,	
cathalic,	ক্যাথালিক,	ক্যাথলিক,	
kuldip,	কুলদীপ,	কুলদীপ,	
bojata,	বোজাতা,	বোজাটা,	
haripur,	হরিপুর,	হরিপুর,	
daybhager,	দাবভাগের,	দায়ভাগের,	
kogake,	কোগাকে,	কোগাকে,	
mosjidsoho,	মসজিদসহ,	মসজিদসহ,	
pratijogira,	প্রতিযোগীরা,	প্রতিযোগীরা,	
daaoon,	দাওন,	ডাউন,	
anusvara,	অনুষ্বরা,	অনুস্বার,	
gandhiir,	গান্ধীর,	গান্ধীর,	
karmosansthan,	কর্মসানস্থান,	কর্মসংস্থান,	
bhagno,	ভাগনো,	ভগ্ন,	
eoki,	ইইকেই,	এওকি,	
badaghat,	বাদাঘাট,	বাদাঘাট,	
auttacharer,	অট্টাচারের,	অত্যাচারের,	
thanvi,	থানভি,	থানভী,	
shansthagulo,	শাংস্থাগুলো,	সংস্থাগুলো,	
khonjena,	খোঁজেনা,	খোঁজেনা,	
breqathru,	ব্রেকাররু,	ব্রেকথ্রু,	
ghotolen,	ঘটলনেন,	ঘটলেন,	
unitgulo,	ইউনিটগুলো,	ইউনিটগুলো,	
neerbahe,	নির্বাহে,	নির্বাহে,	
dharmiyabhabei,	ধর্্যিকভাবেই,	ধর্মীয়ভাবেই,	
suhayeler,	সুহায়েলের,	সুহায়েলের,	
konistho,	কনিষ্ঠ,	কনিষ্ঠ,	
mane,	মানে,	মানে,	
vedanta,	ভেদান্ত,	বেদান্ত,	
zubokder,	যুবকদের,	যুবকদের,	
juktorashtreo,	যুক্তরাষ্ট্রেও,	যুক্তরাষ্ট্রেও,	
sikkhokder,	শিক্ষকদের,	শিক্ষকদের,	
binakar,	বিনাকার,	বিনাকার,	
byboshthar,	ব্যবস্থার,	ব্যাবস্থার,	
dhrubaker,	ধ্রুবাকের,	ধ্রুবকের,	
chereche,	চেরেছে,	ছেড়েছে,	
vushito,	ভুষিত,	ভূষিত,	
marri,	ম্রি,	ম্যারি,	
gaphiloti,	গাফিলটি,	গাফিলতি,	
poripakey,	পরিপাকে,	পরিপাকে,	
zohns,	জনস,	জন্স,	
cs,	সিএস,	সিএস,	
zarniz,	জার্নিজ,	জারনিজ,	
durarohini,	দুরারাহিনী,	দুরারোহিণী,	
amiretus,	অ্যামিটারুস,	এমিরেটাস,	
anchalo,	অঞ্চালো,	অঞ্চলও,	
mukhomandaler,	মুখমন্ডালের,	মুখমণ্ডলের,	
shahidputra,	শহিদপুত্র,	শহীদপুত্র,	
aasar,	আসার,	আসর,	
kobutorer,	কবুতরের,	কবুতরের,	
matorom,	মাতররম,	মাতরম,	
miraclee,	মিরাকলি,	মিরাকেল,	
kanader,	কানাদের,	কণাদের,	
probhura,	প্রভূরা,	প্রভুরা,	
pujito,	পুজিত,	পুজিত,	
toroonraa,	তরুণরা,	তরুণরা,	
beshakbar,	বেশকবার,	বেশকবার,	
laps,	ল্যাপস,	ল্যাপস,	
cheerokoomari,	চিরকমারি,	চিরকুমারী,	
harris,	হ্যারিস,	হ্যারিস,	
hooldim,	হোল্ডিম,	হোল্ডিং,	
chikitsanirbhar,	চিকিতসনির্ভর,	চিকিৎসানির্ভর,	
seniar,	সেনিয়ার,	সিনিয়র,	
steena,	স্তিন,	স্টেন,	
jackey,	জ্যাকে,	জকি,	
armstronz,	আর্মস্ট্রোন,	আর্মস্ট্রং,	
vishnuu,	বিষ্ণু,	বিষ্ণু,	
karmojog,	কর্মযোগ,	কর্মযোগ,	
marketing,	মার্কেটিং,	মার্কেটিং,	
hajirhat,	হাজীরহাট,	হাজিরহাট,	
thandabhabe,	ঠান্ডাভাবে,	ঠাণ্ডাভাবে,	
prasadhani,	প্রসাধনী,	প্রসাধনী,	
prosadhani,	প্রসাধনী,	প্রসাধনী,	
daktickete,	ডাক্তিকেতে,	ডাকটিকিটে,	
latsaheb,	লাতসাবেব,	লাটসাহেব,	
nabyata,	নব্যতা,	নাব্যতা,	
ashiatic,	এশিয়াতিক,	এশিয়াটিক,	
ganochin,	গণছিন,	গণচীন,	
naabyota,	নব্যতা,	নাব্যতা,	
nischitobhave,	নিশ্চিতভাবে,	নিশ্চিতভাবে,	
teemothy,	টিমথি,	টিমোথি,	
tenishe,	তেনিশে,	টেনিসে,	
residence,	রেসিডেন্সে,	রেসিডেন্স,	
sweety,	স্বিটি,	সুইটি,	
aaps,	এএপিএস,	এএপিএস,	
mailkhanek,	মাইলখাডেক,	মাইলখানেক,	
khorsed,	খোরসেড,	খোরশেদ,	
osomorthito,	অসমর্থিত,	অসমর্থিত,	
balabhadra,	বলাবদরা,	বলভদ্র,	
marry,	ম্যারি,	ম্যারি,	
sikarer,	সিকারের,	শিকারের,	
rayyalati,	রৈয়লাটি,	রয়্যালটি,	
abheedhanik,	অভিধানিক,	অভিধানিক,	
nabatarange,	নবতরঙ্গে,	নবতরঙ্গে,	
parqim,	পারকিম,	পার্কিং,	
udbhaboney,	উদ্ভাবনে,	উদ্ভাবনে,	
anchalsaho,	অঞ্চলসহ,	অঞ্চলসহ,	
asif,	আসিফ,	আসিফ,	
ashok,	আশক,	আশোক,	
rajshri,	রাজশ্রী,	রাজশ্রী,	
nirarthak,	নিরার্থক,	নিরর্থক,	
inafarameshana,	ইনাফারেশন,	ইনফরমেশন,	
renoo,	রেনু,	রেনো,	
nirbaahe,	নির্বাহে,	নির্বাহে,	
bujhechhila,	বুঝেচ্ছিলা,	বুঝেছিল,	
toranganj,	তরঙঙ্গঞ্জ,	তোরাবগঞ্জ,	
kichutei,	কিছুতেই,	কিছুতেই,	
karu,	কারু,	কারু,	
popaike,	পপাইকে,	পপাইকে,	
boiragirhat,	বৈরাগিরহাট,	বৈরাগিরহাট,	
vogiroth,	ভোগীরথ,	ভগীরথ,	
jeten,	জেতেন,	জেতেন,	
teamothy,	টিমথি,	টিমোথি,	
crime,	ক্রাইম,	ক্রাইম,	
nischoy,	নিশ্চয়,	নিশ্চয়,	
sikkhakromer,	শিক্ষাক্রমের,	শিক্ষাক্রমের,	
kaamij,	কামিজ,	কামিজ,	
bipajjanak,	বিপজ্জানক,	বিপজ্জনক,	
grootha,	গ্রুথা,	গ্রোথ,	
aakik,	আকিক,	আকিক,	
pothon,	পথন,	পঠন,	
dharmee,	ধর্মী,	ধর্মী,	
chintamani,	চিন্তামনি,	চিন্তামনি,	
shotodha,	শতাধা,	শতধা,	
rajendracholer,	রাজেন্দ্রচলের,	রাজেন্দ্রচোলের,	
poscime,	পশ্চিমে,	পশ্চিমে,	
horash,	হোরাশ,	হোরাস,	
chhaikalo,	ছাকালো,	ছাইকালো,	
armshtrong,	আর্মশ্ট্রং,	আর্মস্ট্রং,	
oitijje,	ঐতিহ্যে,	ঐতিহ্যে,	
giitikobitar,	গীতিকববিতার,	গীতিকবিতার,	
atwabishvashi,	আত্বাবিশাবাসী,	আত্মবিশ্বাসী,	
ghuznavi,	ঘুজনাভি,	গজনভি,	
shikara,	শিকারা,	শিকার,	
rananganey,	রনাঙ্গনে,	রণাঙ্গনে,	
gotirodh,	গতিরোধ,	গতিরোধ,	
gej,	গেজ,	গেজ,	
doorger,	ডার্গের,	দুর্গের,	
torutoler,	তরুতলের,	তরুতলের,	
murali,	মুরালী,	মুরলী,	
manab,	মানাব,	মানব,	
samajikotar,	সমাজিকতার,	সামাজিকতার,	
kourabe,	কৌরাবে,	কৌরবে,	
dekaner,	দেকানের,	দেকানের,	
dacope,	ড্যাকোপ,	দাকোপ,	
kinenni,	কিনেননি,	কিনেননি,	
sheetke,	শীটকে,	শীতকে,	
probeshan,	প্রবেশান,	প্রবেশন,	
elbamtite,	এলবামটিতে,	এলবামটিতে,	
hooq,	হুক,	হুক,	
taunship,	টাউনশিপ,	টাউনশিপ,	
kottar,	কোত্তার,	কট্টর,	
as,	আশা,	অস,	
nazad,	নাজাদ,	নজদ,	
kkhur,	কুহর,	ক্ষুর,	
alraji,	আলরাজি,	আলরাজী,	
dianes,	ডায়েনিস,	ডিএনএস,	
suisharke,	সুইশারকে,	সুইশারকে,	
oncholshomuher,	অন্চচরসমূহের,	অঞ্চলসমূহের,	
bolechile,	বলেছিলে,	বলেছিলে,	
humner,	হুমনার,	হামনার,	
stana,	স্ত্যান,	স্টোন,	
hoteltee,	হোটেলটি,	হোটেলটি,	
townshhip,	টাষনপি,	টাউনশিপ,	
karadandey,	করাদন্দে,	কারাদণ্ডে,	
messengerer,	মেসেন্গার,	মেসেঞ্জারের,	
neelfamarir,	নীলফামারীর,	নীলফামারীর,	
dajhyo,	দাঝ্য,	দাহ্য,	
kale,	কাল্,	কালে,	
phokser,	ফকসের,	ফক্সের,	
si,	সিও,	এসআই,	
fasi,	ফাসি,	ফাঁসী,	
bihar,	বিহার,	বিহার,	
bondira,	বন্দীরা,	বন্দীরা,	
mast,	মাস্ট,	মাস্ত,	
wictor,	উইক্টর,	ভিক্টর,	
stander,	স্ট্যান্ডার,	স্ট্যাণ্ডের,	
jamjamat,	জাম্জামাত,	জমজমাট,	
masto,	মাস্তো,	মাস্ত,	
sarboshokteeman,	সর্বশক্তিমান,	সর্বশক্তিমান,	
survative,	সারভেটিভ,	সারভেটিভ,	
difinisian,	ডিফিনিসায়ান,	ডেফিনেশন,	
reliance,	রিলিয়েন্স,	রিলায়েন্স,	
tuleche,	তুলেছে,	তুলেছে,	
residensa,	রেসিডেন্সা,	রেসিডেন্স,	
ashirbadatri,	আশীর্বাদত্রী,	আশীর্বাদাত্রী,	
dubureer,	ডুবুরির,	ডুবুরির,	
chhuteer,	ছুটির,	ছুটির,	
cheentaikaree,	চিন্তাইকারী,	ছিনতাইকারী,	
bheenisa,	ভীনিসা,	ভেনিস,	
ashociatesh,	অ্যাসিয়েটস,	এসোসিয়েটস,	
peri,	পেরি,	পেরি,	
abhirupbabuke,	অভিরূপবাবুকে,	অভিরূপবাবুকে,	
evaner,	ইভানের,	ইভানের,	
mozdoor,	মজদুর,	মজদুর,	
nirgoon,	নিরগুণ,	নির্গুণ,	
unchuporjayer,	উঁচুপর্যায়ের,	উঁচুপর্যায়ের,	
manbe,	মানবে,	মানবে,	
motkey,	মটকে,	মতকে,	
segular,	সেগুলার,	সেগুলোর,	
tunaita,	টুনাইটা,	টুনাইট,	
ghurte,	ঘুরতে,	ঘুরতে,	
ayantarqatiqa,	অযন্ত্রকীকত,	অ্যান্টার্কটিকা,	
ghatla,	ঘাটলা,	ঘটল,	
firalem,	ফিরালেম,	ফিরালেম,	
jumlalancer,	জুমলালাঁসের,	জুমলাল্যান্সার,	
kraanti,	ক্রানটি,	ক্রান্তি,	
ponjikar,	পঞ্জিকার,	পঞ্জিকার,	
kidambi,	কিদাম্বি,	কিদম্বি,	
sutir,	সুটির,	সুতির,	
shubhag,	শুভাগ,	শুভাগ,	
attorkite,	অত্মরকিতে,	অতর্কিতে,	
ishtone,	ইশ্তোনে,	স্টোন,	
cholochchitra,	চলচ্চিত্রা,	চলচ্চিত্র,	
phood,	ফুড,	ফুড,	
rachonakal,	রচনাকাল,	রচনাকাল,	
siima,	সিম়া,	সীমা,	
paroner,	পারণের,	পারণের,	
osamanno,	অসামান্য,	অসামান্য,	
patigoniter,	পাটিগনিতের,	পাটিগণিতের,	
veenis,	ভিনিস,	ভেনিস,	
mukhomandoler,	মুখমনমনলের,	মুখমণ্ডলের,	
mette,	মেটে,	ম্যাট,	
orthonitir,	অর্থনীতির,	অর্থনীতির,	
rekhapat,	রেখাপাত,	রেখাপাত,	
asbab,	আসবাব,	আসবাব,	
bipti,	বিপ্তি,	বিপ্তি,	
ganokantha,	গণকোঁঠা,	গণকণ্ঠ,	
bamni,	বামনি,	বামনী,	
bornanukrome,	বর্ণানুক্রমে,	বর্নানুক্রমে,	
suraaropito,	সুরাপরিত,	সুরারোপিত,	
karpeter,	কারপেটের,	কার্পেটের,	
suchonakal,	সূচনাকাল,	সূচনাকাল,	
licencer,	লাইসেন্সার,	লাইসেন্সের,	
prime,	প্রাইম,	প্রাইম,	
chitlar,	চিতলার,	চিতলার,	
jhanjra,	ঝঞ্জরা,	ঝাঁজরা,	
plate,	প্লেট,	প্লেটে,	
aro,	আরো,	আরও,	
tukroti,	তুকরোতি,	টুকরোটি,	
perry,	পেরি,	পেরি,	
lyaataa,	ল্যাট,	ল্যাটা,	
neemeetto,	নিমিত্ত,	নিমিত্ত,	
bonnopran,	বন্যপ্রাণ,	বন্যপ্রাণ,	
humira,	হুমিরা,	হুমিরা,	
municipal,	মুনিসিপল,	মিউনিসিপ্যাল,	
adhunikkale,	আধুনিক্কালে,	আধুনিককালে,	
nederlande,	নেডারল্যাণ্ডে,	নেদারল্যান্ডে,	
yak,	যাক,	ইয়াক,	
arshie,	আর্ষিয়ে,	আরসিএ,	
rakim,	রকিম,	রাকিম,	
zubokra,	যুবক্রা,	যুবকরা,	
peeth,	পিথ,	পীঠ,	
snehban,	স্নেহবান,	স্নেহবান,	
mandarbani,	মন্দরবানী,	মন্দারবাণী,	
taronee,	তারণী,	তরণী,	
icelands,	আইসেল্যান্ডস,	আইসল্যান্ডসহ,	
arasie,	আরাসি,	আরসিএ,	
bosben,	বসবেন,	বসবেন,	
dai,	দাই,	ডে,	
nirmolota,	নির্মলতা,	নির্মলতা,	
audioguloke,	অডিওগুলোকে,	অডিওগুলোকে,	
sqolastiq,	স্কোলাস্টিক,	স্কলাস্টিক,	
jounatar,	যৌনাতার,	যৌনতার,	
prakalpagulor,	প্রকালগুলোর,	প্রকল্পগুলোর,	
manushgulor,	মানুষগুলোর,	মানুষগুলোর,	
bunot,	বুনোট,	বুনট,	
probolshoktio,	প্রবলসক্তিও,	প্রবলশক্তিও,	
pyore,	পিয়ের,	পিওর,	
cheenja,	চিঞজজা,	চেঞ্জ,	
teenisa,	তীনিস,	টেনিস,	
pustir,	পুস্তির,	পুষ্টির,	
kachhakaachhi,	কাছাকাচি,	কাছাকাছি,	
sonaicha,	সোনাইচা,	সোনাইচা,	
arthurer,	অর্থুরের,	আর্থারের,	
nabayug,	নবায়ুগ,	নবযুগ,	
ganosochetonota,	গণসচেতনতা,	গণসচেতনতা,	
iqbalke,	ইকবালকে,	ইকবালকে,	
sahozlabhbhatar,	সহজ্লভভতার,	সহজলভ্যতার,	
dokkhinangsho,	দক্ষিণাংশ,	দক্ষিণাংশ,	
toroonra,	তরুনরা,	তরুণরা,	
bagicha,	বাগিচা,	বাগিচা,	
somraat,	সোররাত,	সম্রাট,	
samajik,	সমজিক,	সামাজিক,	
supplenza,	সাপললেনজা,	সাপলেঞ্জা,	
manabmaner,	মানবমানের,	মানবমনের,	
rajan,	রাজান,	রাজন,	
salapheeta,	সালাফিটা,	সালফেট,	
batom,	বাতোম,	বাটম,	
uparjoner,	উপারজনের,	উপার্জনের,	
aairees,	এইরিস,	আইরিস,	
direqtareta,	ডিরেক্টরেট,	ডিরেক্টরেট,	
raagee,	রাগী,	রাগী,	
nopdnodir,	নপ্দদনির,	নদনদীর,	
plainey,	প্লাইন,	প্লেনে,	
hights,	হাইটস্,	হাইটস,	
moddhyoshtho,	মধ্যস্থ,	মধ্যস্থ,	
johny,	জোনি,	জনি,	
eenameela,	ইনামেলা,	এনামেল,	
patrol,	প্যাটরোল,	পেট্রোল,	
heena,	হীন,	হেনা,	
naazee,	নাজি,	নাত্সি,	
himchi,	হিমছি,	হিমচি,	
podotyagsongkranto,	পদত্যাগ্ন্র্রান্ত,	পদত্যাগসংক্রান্ত,	
turkamena,	তুরকামেনা,	তুর্কমেন,	
bhittow,	ভিত্তও,	ভিত্তিও,	
samany,	স্যানামি,	সামান্য,	
queri,	কায়েরি,	কোয়েরি,	
foolkopi,	ফুলকোপি,	ফুলকপি,	
siddharther,	সিদ্ধার্থের,	সিদ্ধার্থের,	
browser,	ব্রোসের,	ব্রাউজার,	
qraima,	ক্রাইমা,	ক্রাইম,	
beetloser,	বীটলোসের,	বিটলসের,	
chhadite,	ছাড়িতে,	ছড়িতে,	
nirbachokder,	নির্বাচকদের,	নির্বাচকদের,	
osthishondhi,	অস্থিসন্ধি,	অস্থিসন্ধি,	
chalchhe,	চলছে,	চলছে,	
bojhey,	বোঝে,	বোঝে,	
antarbhutto,	অন্তর্ভুত্ত,	অন্তর্ভুক্ত,	
dhadhiye,	ধাধিয়ে,	ধাধিয়ে,	
fanding,	ফ্যান্ডিং,	ফান্ডিং,	
abheedhaaneek,	অভিধানীক,	অভিধানিক,	
lampot,	ল্যাম্পোট,	লম্পট,	
ekbakye,	একবাক্যে,	একবাক্যে,	
irish,	আইরিশ,	আইরিস,	
dei,	দেয,	দিই,	
prosadhoner,	প্রসাধনের,	প্রসাধনের,	
lettar,	লেত্তার,	লেটার,	
neker,	নেকের,	নেকের,	
everage,	এভারেজ,	এভারেজ,	
sudrishya,	সুদৃশ্য,	সুদৃশ্য,	
jansha,	জানশ,	জন্স,	
caramiks,	ক্যারামিক্স,	সিরামিকস,	
nothivuktir,	নথিভুক্তির,	নথিভুক্তির,	
bharotchilo,	ভারতছিল,	ভারতছিল,	
nothivookta,	নথিভুক্ত,	নথিভুক্ত,	
rajpur,	রাজপুরের,	রাজপুর,	
prosadhaner,	প্রসাধনের,	প্রসাধনের,	
anubhutimalar,	অনুভূতিমালার,	অনুভূতিমালার,	
porinoti,	পরিণতি,	পরিণতি,	
ponchaashjon,	পঞ্চাশজন,	পঞ্চাশজন,	
klaud,	ক্লাউড,	ক্লাউড,	
romnar,	রোমনার,	রমনার,	
senabahinio,	সেনাবাহিনীও,	সেনাবাহিনীও,	
bikargrasta,	বিকারগ্রাস্ত,	বিকারগ্রস্ত,	
osthisondhi,	অস্থিসন্ধি,	অস্থিসন্ধি,	
telakucha,	তেলাকুচা,	তেলাকুচা,	
aprasangikbhabei,	অপ্রসঙ্গিবভাবেই,	অপ্রাসঙ্গিকভাবেই,	
salmaner,	সালমানের,	সালমানের,	
maktum,	মক্তুম,	মাকতুম,	
pooshti,	পুষ্টি,	পুষ্টি,	
redcrosser,	রেডক্রসের,	রেডক্রসের,	
liceensee,	লাইস্সি,	লাইসেন্স,	
manushsoho,	মানুষসহ,	মানুষসহ,	
tooku,	টুকু,	টুকু,	
patishapta,	পাতিশপ্ত,	পাটিসাপটা,	
nagorikderkey,	নাগরিকদেরকে,	নাগরিকদেরকে,	
baibosthaar,	বৈবস্থায়র,	ব্যবস্থার,	
turkii,	তুরকি,	তুর্কি,	
nirabota,	নিরাবতা,	নিরবতা,	
majlishpur,	মজলিশপুর,	মজলিশপুর,	
bikretara,	বিক্রেতারা,	বিক্রেতারা,	
tapdei,	তাপদেই,	তাপড়েই,	
puroheetder,	পুরোহিতদের,	পুরোহিতদের,	
abhijitda,	অভিজিতদা,	অভিজিতদা,	
ul,	উলা,	উল,	
jonmobhumitir,	জন্মভূমিতির,	জন্মভূমিটির,	
byaboharkarie,	ব্যবহারকারী,	ব্যবহারকারীই,	
prokolpotike,	প্রকল্পটিকে,	প্রকল্পটিকে,	
sthaponagulo,	স্থাপনাগুলো,	স্থাপনাগুলো,	
rezidence,	রেজিডেন্সে,	রেসিডেন্স,	
vins,	ভিন্স,	ভিন্স,	
dokan,	দোকান,	দোকান,	
nibobondhonkrito,	নিববন্ধনকৃত,	নিববন্ধনকৃত,	
shasonkarta,	শাসনকর্তা,	শাসনকর্তা,	
hoondayi,	হুন্দাই,	হুন্দাই,	
yucalyptus,	যুকাল্টপাস,	ইউক্যালিপ্টাস,	
anyorup,	অন্যরূপ,	অন্যরূপ,	
sookkho,	সুক্ষ,	সুক্ষ্ম,	
purple,	পারপল,	পার্পেল,	
umb,	উমববি,	ইউএমবি,	
batikromee,	বাটিক্রমি,	ব্যতিক্রমী,	
maail,	মাইল,	মাইল,	
pharanyeta,	ফরাণ্যেটা,	ফরম্যাট,	
nibondhocheler,	নিবন্ধচেলের,	নিবন্ধছেলের,	
jibanto,	জীবন্ত,	জীবন্ত,	
durotamo,	দুরোতামো,	দূরতম,	
seshardhe,	শেষার্ধে,	শেষার্ধে,	
dharabahiktite,	ধারাবাহিকটিতে,	ধারাবাহিকটিতে,	
militarir,	মিলিতারির,	মিলিটারির,	
manohputa,	মনোবুতা,	মনঃপুত,	
sthaponagulor,	স্থাপানাগুলোর,	স্থাপনাগুলোর,	
qor,	কর,	কর,	
yura,	ঝুরা,	ইউরো,	
oncholshomuh,	অন্চচরসমূহ,	অঞ্চলসমূহ,	
mukhbondho,	মুখবো্ধ,	মুখবন্ধ,	
landey,	ল্যান্ডে,	ল্যান্ডে,	
aarik,	আরিক,	আরিক,	
parqa,	পারকা,	পার্ক,	
canflikt,	কাযানফ্লিক্ট,	কনফ্লিক্ট,	
bboponer,	ব্যবপনের,	বপনের,	
jeelyaand,	জিলিয়ান্ড,	জিল্যান্ড,	
naazi,	নাজি,	নাত্সি,	
jewellery,	জিয়েলারি,	জুয়েলারির,	
bonnypran,	বন্নিপ্রাণ,	বন্যপ্রাণ,	
aswasteekor,	অস্বস্তিকর,	অস্বস্তিকর,	
shurugulo,	শুরুগুলো,	শুরুগুলো,	
poripaker,	পরিপাকের,	পরিপাকের,	
awatar,	আওতাার,	অবতার,	
brahmanera,	ব্রাহ্মণেরা,	ব্রাহ্মণেরা,	
srichoitonnodeb,	শ্রীচৈতন্যবেে,	শ্রীচৈতন্যদেব,	
arthonitir,	অর্থনীটির,	অর্থনীতির,	
mirina,	মিরিনা,	মিরিনা,	
jamkaalo,	জামকালো,	জমকালো,	
parisankhanbid,	পরিসংখ্যানদি,	পরিসংখ্যানবিদ,	
sexperter,	সেক্সপার্টের,	সেক্সপার্টের,	
rushad,	রুশা,	রুশদ,	
byaktikegreptar,	ব্যক্তিকেতপ্রেগর,	ব্যক্তিকেগ্রেপ্তার,	
melborrone,	মেলবোরনে,	মেলবোর্নে,	
qonfliqt,	কনফ্লিক্ট,	কনফ্লিক্ট,	
chilahaati,	চিলাহাটি,	চিলাহাটি,	
maadla,	মাদলা,	মাদলা,	
video,	ভিদেও,	ভিডিয়োও,	
aamoode,	আমোদে,	আমুদে,	
sobchey,	সবচে,	সবচে,	
doneta,	দনেতা,	ডোনাট,	
machgulo,	মাছগুলো,	মাছগুলো,	
dakten,	ডাকতেন,	ডাকতেন,	
samley,	সামলে,	সামলে,	
registaner,	রেজিস্টানের,	রেগিস্তানের,	
parkasa,	পারকাসা,	পার্কস,	
nyata,	ন্যাট,	ম্যাট,	
uindoos,	উইন্ডসা,	উইন্ডোস,	
kaash,	কাশ,	কাস,	
prakalpatike,	প্রকালপটিকে,	প্রকল্পটিকে,	
jaruri,	জারুরী,	জরূরী,	
chaaktir,	চাক্তির,	চাকতির,	
katateo,	কাটাতেও,	কাটাতেও,	
kalirkhal,	কালীরখাল,	কালিরখাল,	
sthapanar,	স্থাপনার,	স্থাপনার,	
pachchi,	পাচ্ছি,	পাচ্ছি,	
dheke,	ধেকে,	ঢেকে,	
songasthatike,	সংস্থাটিকে,	সংস্থাটিকে,	
chandrimaa,	চন্দ্রীমা,	চন্দ্রিমা,	
roy,	রয়ে,	রায়,	
hoonayin,	হুনাইন,	হুনাইন,	
safin,	সাফিন,	সাফিন,	
jani,	জানি,	জনি,	
faase,	ফেয়সে,	ফাঁসে,	
europia,	ইউরোপিয়া,	ইউরোপিয়া,	
vushi,	ভুষী,	ভুষি,	
gaddaphii,	গড়্মাফি,	গাদ্দাফী,	
podarthobidder,	পদার্থবিদদের,	পদার্থবিদদের,	
provritike,	প্রভৃতিকে,	প্রভৃতিকে,	
shikare,	শিকারে,	শিকারে,	
wishnu,	উইনশু,	বিষ্ণু,	
porirshoder,	পরিষ্রদের,	পরির্ষদের,	
rca,	আরএসএ,	আরসিএ,	
cholchhe,	চলছে,	চলছে,	
rakkhanvag,	রক্ষণভাগ,	রক্ষণভাগ,	
baieq,	বেইইক,	বাইক,	
ekoghore,	একঘরে,	একঘরে,	
prrajanankaal,	প্রযারণঙ্াল,	প্রজননকাল,	
bashoborty,	ব্যাশোবর্তি,	বশবর্তী,	
ashanka,	আশাঙ্কা,	আশংকা,	
palashir,	পলাশির,	পলাশীর,	
dristiheen,	দৃষ্টিহীন,	দৃষ্টিহীন,	
stona,	স্তনা,	স্টোন,	
nariderke,	নারীদেরকে,	নারীদেরকে,	
utpotti,	উৎপত্তি,	উতপত্তি,	
manir,	মণির,	মনির,	
modhumotii,	মধুমতিই,	মধুমতী,	
trutimatra,	ত্রুতিমত্রা,	ত্রুটিমাত্র,	
dipgulote,	দিপগুলোতে,	দ্বীপগুলোতে,	
gagee,	গাগি,	গেজ,	
hitaishi,	হিতাইশি,	হিতৈষী,	
khanabale,	খনবালে,	খানাবলে,	
baaiq,	বাইক,	বাইক,	
mausumer,	মৌসুমের,	মৌসুমের,	
michhilti,	মিছিলটি,	মিছিলটি,	
chhooteete,	ছুটিতে,	ছুটিতে,	
shringey,	শ্রিঙ্গে,	শৃঙ্গে,	
schilling,	সিলিং,	শিলিং,	
graambaasheeo,	গ্রামবাশীও,	গ্রামবাসীও,	
edseler,	এডসেলের,	এডসেলের,	
rakhtokkharoner,	রক্ষতককরহণের,	রক্তক্ষরণের,	
shikh,	শিখ,	শিখ,	
bosturoi,	বস্তুরই,	বস্তুরই,	
beila,	বেইলা,	বেইলা,	
satjaner,	সাতজনের,	সাতজনের,	
aziza,	আজিজা,	আজিজা,	
paab,	পাব,	পাব,	
sooya,	সুইয়া,	সোয়া,	
krom,	ক্রম,	ক্রম,	
nishad,	নিশাদ,	নিষাদ,	
laaishenshh,	লাইশেং,	লাইসেন্স,	
baibasthaar,	বৈবস্থার,	ব্যবস্থার,	
bhageri,	ভাগেরি,	ভাগেরই,	
subader,	সুবাদের,	সুবাদে,	
orbeet,	অরবিট,	অরবিট,	
ooporoshtho,	অপরোষ্ঠ,	উপরস্থ,	
jathartho,	যথথর্থ,	যথার্থ,	
besur,	বেসুর,	বেসুর,	
phutbolarder,	ফুটবলার্ডের,	ফুটবলারদের,	
atmabishvashi,	আত্মবিশবাী,	আত্মবিশ্বাসী,	
pratishthanik,	প্রতিষ্ঠানিক,	প্রাতিষ্ঠানিক,	
votarer,	ভোটারের,	ভোটারের,	
zeeland,	জিল্যান্ড,	জিল্যান্ড,	
bisnukey,	বিসনযুকে,	বিষ্ণুকে,	
grotha,	গ্রোথ,	গ্রোথ,	
nothivukto,	নথিভুক্ত,	নথিভুক্ত,	
sheets,	শীটস,	শীটস,	
booponer,	বূপনের,	বপনের,	
rupert,	রুপার্ট,	রুপার্ট,	
bishesyo,	বিশেষ্য,	বিশেষ্য,	
miitar,	মিতার,	মিত্র,	
breakthrough,	ব্রেকাররাউপ,	ব্রেকথ্রু,	
turkeyder,	তুর্কেডের,	তুর্কিদের,	
elakaasoho,	এলাকাসহ,	এলাকাসহ,	
avidur,	আভিদুর,	আভিদুর,	
saralya,	সরালজা,	সারল্য,	
kaley,	কালে,	কালে,	
antorvuktimulak,	আন্তর্ভূক্তিমূলক,	অন্তর্ভুক্তিমূলক,	
scuvi,	স্কুইভি,	স্কুভি,	
pratijogitamulak,	প্রতিযোগিমূলকল,	প্রতিযোগীতামূলক,	
gorjon,	গর্জন,	গর্জন,	
harbore,	হারবোর,	হারবারে,	
minilosar,	মিনিলোসার,	মিনিলোসার,	
prokolpow,	প্রকল্পব,	প্রকল্পও,	
vince,	ভিনকে,	ভিন্স,	
brindaboney,	বৃন্দাবনে,	বৃন্দাবনে,	
tecnokret,	টেক্সকরতে,	টেকনোক্র্যাট,	
ikboler,	ইকবলের,	ইকবলের,	
anyarup,	অন্যাূপ,	অন্যরূপ,	
greep,	গ্রীপ,	গ্রিপ,	
sazanor,	সাজানোর,	সাজানোর,	
deefinishion,	ডাফিনিশন,	ডেফিনেশন,	
transapharma,	ট্রান্সফরমা,	ট্রান্সফর্ম,	
jones,	জনেস,	জোন্স,	
hajeerhatt,	হজেহরহাট,	হাজিরহাট,	
pisach,	পিসাচ,	পিশাচ,	
bedey,	বেদে,	বেদে,	
bojhaao,	বোঝাও,	বোঝাও,	
porizoner,	পরিজনের,	পরিজনের,	
swasthohinotay,	স্বাস্থ্যহীনতায়,	স্বাস্থ্যহীনতায়,	
sinaake,	সিনাকে,	সিনাকে,	
nobotom,	নবতম,	নবতম,	
shamshernagar,	শমশেরনগর,	শমশেরনগর,	
oporishodhito,	অপরিষোধিত,	অপরিশোধিত,	
dip,	ডিপ,	দীপ,	
ujbekistaner,	উজ্বেকেষ্টানের,	উজবেকিস্তানের,	
societykey,	সোশিটেকে,	সোসাইটিকে,	
kindom,	কিন্দম,	কিংডম,	
subade,	সুবাদে,	সুবাদে,	
sanaktokaron,	সনাক্তকরণ,	সনাক্তকরণ,	
toxoid,	টক্সিয়,	টক্সয়েড,	
concerter,	কনজার্টার,	কানসাটের,	
basakey,	বাসাকে,	বাসাকে,	
basturoi,	বস্তুরই,	বস্তুরই,	
conflikt,	কনফ্লিক,	কনফ্লিক্ট,	
chikitsar,	চিকিতসার,	চিকিত্সার,	
badargaji,	বদরজগাজী,	বদরগাজী,	
bokahoke,	বোকাহোকে,	বকাহকে,	
parikhar,	পরিখরের,	পরিখার,	
anchalgulir,	অঞ্চলগুলির,	অঞ্চলগুলির,	
ponthaar,	পন্থার,	পন্থার,	
sangsakti,	সংসক্তি,	সংসক্তি,	
deliver,	ডেলিভার,	ডেলিভার,	
desiseyer,	ডিসিসেয়ের,	ডিজিজের,	
palbongser,	পালবংসের,	পালবংশের,	
coons,	কোন্স,	কুনস,	
supreetira,	সুপ্রিতিরা,	সুপ্রীতিরা,	
sangram,	সংগ্রাম,	সঙ্গ্রাম,	
tintikey,	তিনটিকে,	তিনটিকে,	
parishram,	পরিশ্রম,	পরিশ্রম,	
diznee,	ডিজনি,	ডিজনী,	
ponchaasjon,	পঞ্চাজসন,	পঞ্চাশজন,	
chet,	চেত,	চ্যাট,	
protishtan,	প্রতিষ্ঠান,	প্রতিষ্টান,	
horiddar,	হরিদদার,	হরিদ্বার,	
bhandar,	ভাণ্ডার,	ভাণ্ডার,	
magar,	মাগার,	মাগার,	
beem,	বিম,	বিম,	
soundorjotakei,	সৌন্দর্যতাকেই,	সৌন্দর্যটাকেই,	
argead,	আর্জড,	আর্জিদ,	
ipl,	ইউপিএল,	আইপিএল,	
cheef,	চিফ,	শেফ,	
becha,	বেচা,	বেচা,	
gudamjat,	গুদমজাত,	গুদামজাত,	
chat,	চাত,	চ্যাট,	
sbajan,	স্বজন,	স্বজন,	
oboshore,	অবশরে,	অবসরে,	
diiptii,	দিপ্টিই,	ডেপুটি,	
sahooseekotar,	সাহিসকুতার,	সাহসিকতার,	
munshiji,	মুন্সিজি,	মুনশীজি,	
byaptikaler,	ব্যাপ্তিকালের,	ব্যাপ্তিকালের,	
lesense,	লেসেন্সে,	লাইসেন্স,	
seramiks,	সেরামিকস,	সিরামিকস,	
nichols,	নিকোলস,	নিকলস,	
jesh,	জেশ,	জেস,	
shahoshikatar,	শহহসিকতার,	সাহসিকতার,	
akkelpure,	আক্কেলপুরে,	আক্কেলপুরে,	
somratra,	সম্রাত্র,	সম্রাটরা,	
poriskoron,	পরিস্করণ,	পরিষ্করণ,	
shomostigoto,	শমস্তিগত,	সমষ্টিগত,	
parshwer,	পারশ্বের,	পার্শ্বের,	
monzushree,	মনজুষ্ররী,	মঞ্জুশ্রী,	
bhenus,	ভেনাস,	ভেনাস,	
bhimsen,	ভীমসেন,	ভীমসেন,	
mandanda,	মন্দনদা,	মানদণ্ড,	
phising,	ফিসিং,	ফিসিং,	
abhidhaner,	অভিধানের,	অভিধানের,	
talgach,	তালগাছ,	তালগাছ,	
jaadrel,	জাদ্রেল,	জাঁদরেল,	
elakai,	এলাকাই,	এলাকাই,	
duuma,	দুমুমা,	দুমা,	
bulichev,	বুলিচেভ,	বুলিচেভ,	
ganoparibahaner,	গণপরিবহনেহন,	গণপরিবহনের,	
damakalkarmirao,	দমকলকর্মীরাও,	দমকলকর্মীরাও,	
gate,	গাতে,	গ্যেটে,	
punorabortonte,	পুনরাবর্তন্তে,	পুনরাবর্তন্তে,	
byomkesh,	ব্যম্কেশ,	ব্যোমকেশ,	
sahittekder,	সাহিত্যেকদের,	সাহিত্যেকদের,	
pachattar,	পাচতত্তর,	পাচাত্তার,	
shektore,	শেক্তরে,	সেক্টরে,	
korkotkraantee,	কর্কটকরণ্ড্য,	কর্কটক্রান্তি,	
sangbadmadhyame,	সংবাদমাধ্যমে,	সংবাদমাধ্যমে,	
mitrata,	মিত্রাটা,	মিত্রতা,	
choddo,	চোদ্দো,	চোদ্দো,	
shtonehenge,	স্তনহেঙ্গে,	স্টোনহেঞ্জ,	
meshintao,	মেশিনটাও,	মেশিনটাও,	
manjushree,	মঞ্জুর্রী,	মঞ্জুশ্রী,	
shommotir,	সম্মতির,	সম্মতির,	
chandanara,	চন্দনারা,	চন্দনারা,	
helloin,	হেলন,	হ্যালোইন,	
calabe,	চ্যাবে,	চালাবে,	
nagarikera,	নাগারিকেরা,	নাগরিকেরা,	
sadadyarao,	সদদ্যরাও,	সদদ্যরাও,	
satan,	সাতান,	শয়তান,	
darjiling,	দার্জিলিং,	দার্জিলিং,	
dhanijomite,	ধনিজনিতে,	ধানিজমিতে,	
jommu,	জম্মু,	জম্মু,	
wrighter,	হার্ঠার,	রাইটের,	
gazipur,	গাজীপুর,	গাজিপুর,	
dep,	ডিপ,	ডেপ,	
oncoltike,	অঙ্কোলটিকে,	অঞ্চলটিকে,	
gobeshana,	গবেষণা,	গবেষনা,	
umedpoor,	উমেডপুর,	উমেদপুর,	
vittio,	ভিত্তিও,	ভিত্তিও,	
shiqara,	শিকারা,	শিকার,	
chaudhuriyo,	চৌধুরিও,	চৌধুরীও,	
fiksing,	ফিক্সিং,	ফিক্সিং,	
gratha,	গ্রাথ,	গ্রোথ,	
bhittimul,	ভিত্তিমূল,	ভিত্তিমূল,	
rilayensa,	রিলায়েনসা,	রিলায়েন্স,	
motke,	মোটকে,	মতকে,	
musalmani,	মুসলমানি,	মুসলমানই,	
blacker,	ব্ল্যাকার,	ব্ল্যাকের,	
dajjha,	দাজঝা,	দাহ্য,	
chandrima,	চন্দ্রিমা,	চন্দ্রিমা,	
sambhabonao,	সম্ভাবনাও,	সম্ভবনাও,	
rastagulikeo,	রাস্তাগুলিকেও,	রাস্তাগুলিকেও,	
gaje,	গাজে,	গেজ,	
ajibon,	অজিবন,	আজীবন,	
murad,	মুরাদ,	মুরাদ,	
surakarder,	সুরাকরদের,	সুরকারদের,	
maley,	মালে,	মালে,	
aachhis,	আছিস,	আছিস,	
expreshshion,	এক্সপ্রেশন,	এক্সপ্রেশন,	
karir,	কারির,	কারীর,	
taap,	টাপ,	ট্যাপ,	
choudhurike,	চৌধুরীকে,	চৌধুরীকে,	
tookror,	টুকরর,	টুকরোর,	
vool,	ভুল,	উল,	
chanoo,	চানু,	চানু,	
borlen,	বররলেন,	বরলেন,	
raiji,	রাইজি,	রাইজি,	
chalochchitreei,	চলচ্চিত্রীই,	চলচ্চিত্রেই,	
abarte,	আবার্তে,	আবর্তে,	
gajiipur,	গাজিপুর,	গাজীপুর,	
mumtajer,	মুমতাজের,	মুমতাজের,	
aziboner,	আজিবনের,	আজীবনের,	
hastamathun,	হস্তমথুন,	হস্তমথুন,	
sakshatkarer,	সাক্ষাতকারের,	সাক্ষাৎকারের,	
eucalyptus,	ইউক্যালাপ্টাস,	ইউক্যালিপ্টাস,	
baet,	বিট,	বাইট,	
sachetanvabe,	সচেতনভাবে,	সচেতনভাবে,	
indra,	ইন্দ্রা,	ইন্দ্র,	
pradoshik,	প্রদোশিক,	প্রাদশিক,	
biplobi,	বিপ্লবী,	বিপ্লবী,	
teemothi,	তিমথি,	টিমোথি,	
foloshrutite,	ফলস্রুতিতে,	ফলশ্রুতিতে,	
ceramicer,	সিরারিমের,	সিরামিকের,	
hul,	হুল,	হুল,	
bikretaara,	বিক্রেতারা,	বিক্রেতারা,	
janoganonar,	জনগনানার,	জনগণনার,	
hames,	হামেস,	হোমস,	
dombhoke,	দম্ভকে,	দম্ভকে,	
lutherana,	লুথেরানা,	লুথেরান,	
pyatarne,	প্যাতার্নে,	প্যাটার্নে,	
naitikatavodh,	নৈতিকতাবোধ,	নৈতিকতাবোধ,	
chotogolper,	চটগল্পের,	ছোটগল্পের,	
towraat,	তোররাত,	তওরাত,	
dipke,	দিপকে,	দ্বীপকে,	
onurbar,	অনুরবার,	অনুর্বর,	
basermick,	বেসারমিক,	বেসারমিক,	
pack,	প্যাক,	প্ল্যাক,	
akreetokarjo,	আক্রিতকার্য,	অকৃতকার্য,	
bhiktara,	ভিক্তরা,	ভিক্টর,	
mishal,	মিশাল,	মিশাল,	
gejeted,	গেজেটেড,	গেজেটেড,	
padee,	পাদি,	পাড়ে,	
phakay,	ফাকায়,	ফাকে,	
mukherjee,	মুখর্ঝি,	মুখার্জী,	
lahano,	লাহানো,	লাহানো,	
ansareer,	আনসারীর,	আনসারীর,	
bondi,	বন্দী,	বন্দী,	
biswashi,	বিশ্বাসী,	বিশ্বাসই,	
mahakabi,	মহাকাবী,	মহাকবি,	
byatari,	ব্যাটারি,	ব্যাটারী,	
trenda,	ট্রেন্ড,	ট্রেন্ড,	
proteemake,	প্রতিমাকে,	প্রতিমাকে,	
jeebonnogor,	জীবনযোগর,	জীবননগর,	
atorkitey,	অতরকীতে,	অতর্কিতে,	
notikotar,	নতিকতার,	নৈতিকতার,	
brekthrough,	ব্রেক্্রাউগ,	ব্রেকথ্রু,	
kolkarkhana,	কোকারকরণ,	কলকারখানা,	
madhobeer,	মাধবীর,	মাধবীর,	
change,	চাঙ্গে,	চেঞ্জ,	
adarsho,	আদারশ,	আর্দশ,	
khelechen,	খেলেছেন,	খেলেছেন,	
bike,	বিকে,	বাইক,	
backflipe,	ব্যাকফ্লিপে,	ব্যাকফ্লিপে,	
ciima,	সিমা,	সীমা,	
jibnagore,	জীবনাগরে,	জীবননগর,	
antarctica,	অন্টার্ক্টিকা,	অ্যান্টার্কটিকা,	
cena,	সেনা,	সিনা,	
gaichey,	গাইছে,	গাইছে,	
groth,	গ্রোথ,	গ্রোথ,	
bhenise,	ভেনিসে,	ভেনিসে,	
bhumija,	ভূমিজা,	ভূমিজ,	
chikkingsasoho,	চিক্সিংসসহ,	চিকিংসাসহ,	
nirobota,	নিরবতা,	নিরবতা,	
bsnleu,	বিএনএনইএইএ,	বিএসএনএলইইউ,	
bibadey,	বিবাদে,	বিবাদে,	
tuni,	তুনী,	টুনি,	
nagorikra,	নাগরিকরা,	নাগরিকেরা,	
orthanitike,	অর্থানীতিকে,	অর্থনীতিকে,	
nathivookteer,	নথিভুক্তির,	নথিভুক্তির,	
laga,	লাগা,	লগ,	
olpo,	অল্প,	অল্প,	
asamorik,	আসমমরিক,	অসামরিক,	
pacbar,	পাকবার,	পাঁচবার,	
mandape,	মন্ডপে,	মন্ডপে,	
dharabahikbhabe,	ধারাবাহিকভাবে,	ধারাবাহিকভাবে,	
kayech,	কায়েছ,	কায়েছ,	
sachetonvabe,	সচেতনভাবে,	সচেতনভাবে,	
bidghootey,	বিডঘুটে,	বিদঘুটে,	
oyebjin,	ওয়েবজীন,	ওয়েবজিন,	
nutaner,	নুতানের,	নূতনের,	
sombhobonaao,	সম্ভবনাও,	সম্ভবনাও,	
falasrutite,	ফলাসরুতিতে,	ফলশ্রুতিতে,	
bbiswash,	বিবিশ্বাস,	বিশ্বাস,	
boshoborti,	বশবর্তী,	বশবর্তী,	
chalochchitreer,	চলচ্চিত্রীর,	চলচ্চিত্রের,	
phaltu,	ফাল্টু,	ফালতু,	
fatakesto,	ফাতাকেস্ট,	ফাটাকেষ্ট,	
dojo,	দজো,	ডোজো,	
nothibhukta,	নথিভুক্ত,	নথিভুক্ত,	
shorifer,	শরীফের,	শরিফের,	
saalsa,	সালসা,	সালসা,	
militaryr,	মিলিটারির,	মিলিটারির,	
shommoteer,	সম্মতির,	সম্মতির,	
thailandshoho,	থাইলান্ডসহ,	থাইল্যান্ডসহ,	
dorun,	দোরুন,	দরুণ,	
existing,	এক্সিস্টিং,	এক্সিসটিং,	
nirbahe,	নির্বাহে,	নির্বাহে,	
premoronge,	প্রেমরঙ্গে,	প্রেমরঙে,	
atibiplabi,	অতিবিপ্লাবী,	অতিবিপ্লবি,	
serology,	সিরোলজি,	সেরোলজি,	
abadamoner,	অবাদামনের,	অবদমনের,	
dibate,	দিবাতে,	ডিবেট,	
otyacharito,	অত্যাচারিত,	অত্যাচারিত,	
dokaangoolote,	ডোকাঙগুলোতে,	দোকানগুলোতে,	
tanshree,	তাঁশরী,	তানশ্রী,	
baarnish,	বর্ণীশ,	বার্নিশ,	
fising,	ফিসিং,	ফিসিং,	
kadakhonchar,	কাদাখোঁচার,	কাদাখোঁচার,	
mile,	মিলে,	মিলে,	
mekon,	মেকন,	মেকং,	
annanere,	অন্যানেরে,	অন্যানেরে,	
ruby,	রুবি,	রুবী,	
tata,	টোট,	তাতা,	
nischitobhabe,	নিশ্চিতভাবে,	নিশ্চিতভাবে,	
keyboarder,	কিভবোর্ডের,	কীবোর্ডের,	
ceramiker,	সেরামিকের,	সিরামিকের,	
hadisti,	হাদিস্তি,	হাদিসটি,	
bangalore,	বাঙ্গালোরে,	ব্যাঙ্গালুরে,	
aholya,	আহল্যা,	অহল্যা,	
firth,	ফিরথ,	ফার্থ,	
rushod,	রুশোদ,	রুশদ,	
pray,	প্রাই,	প্রায়,	
holdim,	হলল্ডিম,	হোল্ডিং,	
mohajot,	মহাযোত,	মহাজোট,	
lutharen,	লুথারেন,	লুথেরান,	
edic,	এডিক,	এডিক,	
aasirbaad,	আসীরবাদ,	আশির্বাদ,	
jolbe,	জলবে,	জ্বলবে,	
nibeditar,	নিবেদিতার,	নিবেদিতার,	
vaibon,	ভাইবন,	ভাইবোন,	
gobeshakgon,	গবেষকগণ,	গবেষকগণ,	
graambasider,	গ্রামবাসীদের,	গ্রামবাসীদের,	
sikkharrtheerao,	শিক্ষার্থীরাও,	শিক্ষার্থীরাও,	
nodiiteyi,	নদীইতে,	নদীতেই,	
waal,	ওয়াল,	উল,	
ramchander,	রামচন্দের,	রামচন্দরের,	
bishasey,	বিশেষে,	বিশ্বাসে,	
khaaneker,	খানেকের,	খানেকের,	
amiya,	আমিয়া,	অমিয়,	
digreeke,	ডিগ্রিকে,	ডিগ্রিকে,	
nodnodeer,	নদনদির,	নদনদীর,	
shiulijhra,	শিউলিঝরা,	শিউলিঝরা,	
santoshpore,	সন্তোষপরে,	সন্তোষপুর,	
difinishion,	ডিফিনিশন,	ডেফিনেশন,	
kkomandar,	ক্কমননদার,	কমাণ্ডার,	
lekhaksattwar,	লেখকসত্ত্বার,	লেখকসত্ত্বার,	
kushumba,	কুশুম্বা,	কুশুম্বা,	
sampadon,	সম্পাদন,	সম্পাদন,	
birmuktijoddhagan,	বিরমুক্তিযোদ্ধাগণ,	বীরমুক্তিযোদ্ধাগণ,	
muchi,	মুচি,	মুচি,	
turista,	তুরিস্তা,	টুরিস্ট,	
roopdan,	রূপদান,	রুপদান,	
collaborators,	কলাবরর্টরস,	কলাবরেটরস,	
jonoikaa,	জন়কাই,	জনৈকা,	
weenis,	ভাইনিস,	ভেনিস,	
kalenga,	কালেঙ্গা,	কালেঙ্গা,	
chalai,	চালাই,	চালাবে,	
batikromi,	বাটিক্রমি,	ব্যতিক্রমী,	
muchlima,	মুছলিমা,	মুছলিমা,	
muktijuddhojato,	মুক্তিযুদ্ধাত,	মুক্তিযুদ্ধজাত,	
meshmeshya,	মেশমেশ্যা,	মেশহমেশহিইয়া,	
fanse,	ফ্যান্সে,	ফাঁসে,	
hingsar,	হিংসার,	হিংসার,	
oswasteekor,	অস্বাস্তিকর,	অস্বস্তিকর,	
nikate,	নিকাতে,	নিকটে,	
domonmulok,	দমনমূলক,	দমনমূলক,	
ashamorthito,	অশামর্থিত,	অসমর্থিত,	
ronangane,	রনাঙ্গানে,	রণাঙ্গনে,	
pettern,	পেটার্ন,	প্যাটার্ন,	
makong,	মাকোং,	মেকং,	
crucer,	ক্রাসের,	ক্রুশের,	
paripakey,	পরিপাকে,	পরিপাকে,	
nottee,	নট্য,	নোটটি,	
tinhazar,	তিনহাজার,	তিনহাজার,	
konflict,	কনফ্লিক্ট,	কনফ্লিক্ট,	
aalaa,	আলা,	আলা,	
masjidsaha,	মসজিদসহ,	মসজিদসহ,	
aembed,	এম্বডড,	এম্বেড,	
shudhir,	শুধীর,	শুধীর,	
hazat,	হাজাত,	হজত,	
shudhui,	শুধুই,	শুধুই,	
sosoa,	সোসা,	শশা,	
gajetted,	গেজেটদে,	গেজেটেড,	
sahocorje,	সহকর্যে,	সাহচর্যে,	
tookrote,	টুকরোতে,	টুকরোতে,	
somabeshti,	সমাবেশটি,	সমাবেশটি,	
institutione,	ইনস্টিটিউনে,	ইনস্টিটিউশনে,	
maudelder,	মাউডেলদের,	মডেলদের,	
gloria,	গ্লোরিয়া,	গ্লোরিয়া,	
engrezder,	এংগ্রেজদের,	ইংরেজদের,	
purohitder,	পুরোহিতদের,	পুরোহিতদের,	
upobasee,	উপবাসী,	উপবাসী,	
firozapure,	ফিরোজাপুরে,	ফিরোজাপুরে,	
ongkush,	অংকুষ,	অংকুশ,	
turky,	টার্কি,	তুর্কি,	
patjata,	পাটজাতা,	পাটজাত,	
saramukhe,	সারামুখে,	সারামুখে,	
shakankti,	শককনকটি,	শকাঙ্কটি,	
yuroo,	যুরুও,	ইউরো,	
grahoksebai,	গ্রাহকসেবায়,	গ্রাহকসেবায়,	
safiin,	সাফিন,	সাফিন,	
sobche,	সভচে,	সবচে,	
arthonitite,	অর্থনীতিতে,	অর্থনীতিতে,	
chalochchitraeeo,	চলচ্চিত্রাওেও,	চলচ্চিত্রেও,	
kings,	কিংস,	কিংস,	
horidwar,	হরিদ্বার,	হরিদ্বার,	
shiter,	সিটের,	শীতের,	
jalbe,	জাবে,	জ্বলবে,	
bhalobasar,	ভালোবাসার,	ভালোবাসার,	
nathibhuktir,	নথিভুক্তির,	নথিভুক্তির,	
deputy,	ডিপুটি,	ডেপুটি,	
konnoder,	কন্যদের,	কন্যদের,	
scoore,	স্কোউর,	স্কোর,	
sainyader,	সৈন্যাদের,	সৈন্যদের,	
karaponner,	কারাপণ্যের,	কারাপণ্যের,	
rudroke,	রুদ্রকে,	রুদ্রকে,	
suri,	সুরী,	সুরি,	
graambaashio,	গ্রামবাশীও,	গ্রামবাসীও,	
deebug,	দেবুগ,	ডিবাগ,	
markeetim,	মার্কিটিং,	মার্কেটিং,	
rokkhonabekkhoner,	রক্ষণাবক্ষেষণের,	রক্ষণাবেক্ষণের,	
brixfield,	ব্রিক্সিল্ড,	ব্রিক্সফিল্ড,	
beekaargrasta,	বীকারগ্রাস্ত,	বিকারগ্রস্ত,	
anandamahale,	আনন্দমহলে,	আনন্দমহলে,	
uporitaley,	উপরিটালে,	উপরিতলে,	
madhnagar,	মধধনগর,	মাধনগরের,	
gara,	গারা,	গোর,	
erajyobasi,	এরাজ্যবাসী,	এরাজ্যবাসী,	
hariken,	হারিকেন,	হ্যারিকেন,	
batikromshalee,	বটিক্রমশালী,	ব্যতিক্রমধর্মী,	
promodwara,	প্রমদ্বারা,	প্রমদ্বারা,	
parisankhanvid,	পরিসংখ্যান্দি,	পরিসংখ্যানবিদ,	
gasthii,	গাস্থী,	গোষ্ঠীই,	
shuperheiro,	শুপারহেইরো,	সুপারহিরো,	
deputi,	ডেপুটি,	ডেপুটি,	
sangkulaan,	সংকুলন,	সংকুলান,	
nirgomon,	নির্গমন,	নির্গমন,	
keu,	কেউ,	কেউ,	
chalaabi,	চালাবী,	চালাবে,	
madhukori,	মধুকরি,	মাধুকরী,	
arifin,	আরিফিন,	আরিফিন,	
elakatay,	এলাকাটা,	এলাকাতে,	
eupheike,	ইউফেইকে,	ইউফেইকে,	
byatikrami,	ব্যতিক্রমি,	ব্যতিক্রমী,	
tricksguli,	ট্রিক্সগুলি,	ট্রিকসগুলি,	
biplabeer,	বিপ্লাবীর,	বিপ্লবীর,	
gardeen,	গার্ডিন,	গার্ডেন,	
spredsheet,	স্প্রেডশিট,	স্প্রেডশীট,	
musolmanera,	মুসলমানারা,	মুসলমানেরা,	
sausage,	সৌজেয়ে,	সসেজ,	
konoroop,	কোনরূপ,	কোনরূপ,	
futote,	ফুটোতে,	ফুটোতে,	
phox,	ফিিএক্স,	ফক্স,	
vorkendra,	ভরকেন্ড্রে,	ভরকেন্দ্র,	
jatinke,	জাতিনকে,	যতীনকে,	
siddhanter,	সিদ্ধান্তের,	সিদ্ধান্তের,	
bm,	বিএম,	বিএম,	
soketgulor,	সকেটগুলোর,	সকেটগুলোর,	
husni,	হুসনি,	হুসনি,	
koyeeri,	কয়ীর,	কোয়েরি,	
chargar,	চারগার,	চার্জার,	
debdebier,	দেবদেবীর,	দেবদেবীর,	
dito,	দিত,	দিতো,	
bifol,	বিফল,	বিফল,	
kuhelika,	কুহেলিকা,	কুহেলিকা,	
fimela,	ফিমেলা,	ফিমেল,	
tikta,	টিকটা,	তিক্ত,	
vaphara,	উফার,	বাফার,	
shikshakbrindo,	শিক্ষাকবৃন্দ,	শিক্ষকবৃন্দ,	
seqtara,	সেক্তারা,	সেক্টর,	
licensin,	লাইসেন্সিন,	লাইসেন্সিং,	
opohoron,	অপহরণ,	অপহরন,	
gabinius,	গাবিনিয়াস,	গাবিনিআস,	
suiza,	সুইজা,	সুইজা,	
ahong,	অহং,	অহং,	
esasiyetasa,	এসাসিয়েসা,	এসোসিয়েটস,	
prokalpagulo,	প্রকালপাগুলো,	প্রকল্পগুলো,	
anusthane,	অনুষ্ঠানে,	অনুষ্ঠানে,	
antarvuktimulak,	অন্তর্ভূকিতমূলক,	অন্তর্ভুক্তিমূলক,	
plator,	প্ল্যাটর,	প্লেটোর,	
protizogii,	প্রতিযোগী,	প্রতিযোগী,	
dubaate,	ডুবাতে,	ডুবাতে,	
haridware,	হরিদ্বারে,	হরিদ্বারে,	
ceramicsh,	সিরামিকস,	সিরামিকস,	
toching,	টকিং,	টোচিং,	
bishaashke,	বিশাশকে,	বিশ্বাসকে,	
tinage,	তিনাগে,	টিনেজ,	
muradpur,	মুরাদপুর,	মুরাদপুর,	
safiha,	সাফিহা,	সাফিহা,	
abeganuvutir,	আবেগানুভুতির,	আবেগানুভূতির,	
borkhastokritora,	বরখাস্তকররিতরা,	বরখাস্তকৃতরা,	
chhedon,	ছেদন,	ছেদন,	
jyesthaa,	জ্যেষ্ঠায়,	জ্যেষ্ঠা,	
okritokarjo,	অক্রিতকার্য,	অকৃতকার্য,	
grambaashi,	গ্রামবাশী,	গ্রামবাসী,	
qarqa,	কার্ক,	কার্ক,	
pratisthanikvabe,	প্রতিস্থানিকভাবে,	প্রাতিষ্ঠানিকভাবে,	
drissoteer,	দৃশসটির,	দৃশ্যটির,	
wagadada,	গয়গাদা,	বাগদাদ,	
teoner,	টেওনার,	টিওনার,	
jolaatonko,	জলাততনকো,	জলাতঙ্ক,	
harja,	হার্যা,	হার্জ,	
uporoshtho,	উপরশ্থ,	উপরস্থ,	
mathieu,	মাঠিয়ু,	ম্যাথিউ,	
dharavassokar,	ধারাভাষ্যকার,	ধারাভাষ্যকার,	
nirmolotaa,	নির্মলতা,	নির্মলতা,	
purohitra,	পুরোহিত্র,	পুরোহিতরা,	
gafeeloti,	গাফেলতি,	গাফিলতি,	
ukeliptas,	উকেলিপ্তাস,	ইউক্যালিপ্টাস,	
bbosonto,	ব্যবস্ত,	বসন্ত,	
chhadura,	ছদুরা,	ছাদুরা,	
rojapalaner,	রোজাপালানের,	রোজাপালনের,	
anektai,	অনেকটাই,	অনেকটাই,	
poschimey,	পশ্চিমে,	পশ্চিমে,	
ved,	ভেড,	বেদ,	
lirikti,	লিরিক্তি,	লিরিকটি,	
tiuning,	টিউনিং,	টিউনিং,	
deejeejer,	দিজেজীর,	ডিজিজের,	
laiseensee,	লাইসেন্স,	লাইসেন্স,	
daaradaa,	দারাদা,	দারদা,	
oncholke,	অনচলকে,	অঞ্চলকে,	
recondishon,	রেকন্ডিশন,	রিকন্ডিশন,	
pyor,	পিয়োর,	পিওর,	
station,	স্টেশন,	ষ্টেশন,	
madhuree,	মধুরী,	মাধুরী,	
rahee,	রহী,	রাহি,	
soorsa,	সুরসা,	সোর্স,	
carlosh,	কার্লো,	কার্লোস,	
jonee,	জনী,	জনি,	
akhhunno,	অখুন্ন,	অক্ষুণ্ণ,	
rajyotiro,	রাজ্যটিরও,	রাজ্যটিরও,	
hoteltite,	হোটেলটিতে,	হোটেলটিতে,	
dwijenbabuder,	দ্বিজেনবাবুদের,	দ্বিজেনবাবুদের,	
onshogrohoner,	অংশগ্রহণের,	অংশগ্রহনের,	
taler,	তালের,	তালের,	
spreadshiit,	স্প্রেডশিউট,	স্প্রেডশীট,	
ooipokar,	আইপকার,	উইপোকার,	
daakticketer,	ডাক্্িকেটের,	ডাকটিকিটের,	
scorey,	স্কোর,	স্কোরে,	
sommotitey,	সম্মতিতে,	সম্মতিতে,	
karmazog,	কারমোজো,	কর্মযোগ,	
carlos,	কার্লোস,	কার্লোস,	
ekghore,	একঘরে,	একঘরে,	
phartha,	ফার্থ,	ফার্থ,	
remission,	রেমিশন,	রিমিশন,	
bhyaatikaner,	ভ্যাটিকানের,	ভ্যাটিকানের,	
rodney,	রডেন,	রেডনি,	
ramantic,	রামান্টিক,	রোমান্টিক,	
deefinition,	ডাফিনিশন,	ডেফিনেশন,	
ogovir,	অগোভির,	অগভীর,	
freekeh,	ফ্রীকে,	ফ্রিকেহ,	
eeksapreeshana,	এক্সপ্রেশন,	এক্সপ্রেশন,	
chyeta,	চ্যেট,	চ্যাট,	
utsahi,	উত্সাহী,	উৎসাহী,	
dokanei,	দোকানেই,	দোকানেই,	
jaaygata,	জয়গত,	জায়গাটা,	
shumo,	শুমো,	সুমো,	
modyer,	মদ্যের,	মদ্যের,	
satarkakari,	সতর্ককারী,	সতর্ককারী,	
colgirl,	কললির,	কলগার্ল,	
tarkareer,	তারকারীর,	তরকারীর,	
phiksa,	ফিকসা,	ফিক্স,	
joones,	জুনেস,	জোন্স,	
boudhher,	বৌধের,	বৌদ্ধের,	
upobashii,	উপবাশীই,	উপবাসী,	
bodna,	বোদনা,	বদনা,	
elakatir,	এলাকাটির,	এলাকাটির,	
lishenshe,	লিশেশে,	লাইসেন্স,	
granthatyke,	গ্রান্থাটিকে,	গ্রন্থটিকে,	
remacry,	রিমাক্রি,	রেমাক্রী,	
somosto,	সমস্ত,	সমস্ত,	
jor,	জোর,	জ্বর,	
swatantrata,	স্বাতন্ত্র্যটা,	স্বতন্ত্রতা,	
chittronatyokar,	চিত্রনাট্যকার,	চিত্রনাট্যকার,	
plaiin,	প্লাইন,	প্লেন,	
pratijogider,	প্রতিযোগীদের,	প্রতিযোগীদের,	
hugeke,	হুগেকে,	হিউজকে,	
louhojato,	লৌহজাত,	লৌহজাত,	
hepatitis,	হেপাটাইটিস,	হেপাটাইটিস,	
hena,	হেইা,	হেনা,	
chaloke,	চালকে,	চালকে,	
kamla,	কামলা,	কামলা,	
soomitrar,	সুমিত্রার,	সুমিত্রার,	
jorury,	জোরুরি,	জরূরী,	
udyem,	উদ্যেম,	উদ্যেম,	
ramantika,	রমণটিকা,	রোমান্টিক,	
naabbota,	নব্বতা,	নাব্যতা,	
engrejer,	এংগেরাজের,	ইংরেজের,	
emargency,	ইমারজেন্সি,	এমার্জেন্সি,	
hisabagyan,	হিসাবগঞ্জ,	হিসাবজ্ঞান,	
akkhunno,	অক্ষুণ্য,	অক্ষুণ্ণ,	
chalake,	চালাকে,	চালকে,	
saver,	সভার,	সেভার,	
rotheen,	রথিন,	রথীন,	
lakshmir,	লক্ষ্মীর,	লক্ষ্মীর,	
shaddhi,	শাদ্ধি,	সাধ্বী,	
saazano,	সাজানো,	সাজানো,	
brittakar,	বৃত্তকার,	বৃত্তাকার,	
chupani,	চুপানি,	চুপানি,	
protinito,	প্রতিনিত,	প্রতিনিত,	
khalidke,	খালিদকে,	খালিদকে,	
eshtoniya,	এষ্টনীয়া,	এস্তোনিয়া,	
ronodeep,	রণদীপ,	রণদীপ,	
jhimochchilo,	ঝিমোচ্ছিল,	ঝিমোচ্ছিলো,	
durgotshob,	দুর্গোৎসব,	দুর্গোৎসব,	
agomoney,	অগমনে,	আগমনে,	
capshule,	ক্যাপশুলে,	ক্যাপসুল,	
deepan,	দীপান,	দীপন,	
tukroke,	টুকরোকে,	টুকরোকে,	
barrageke,	বারাগেকে,	ব্যারেজকে,	
bapokotor,	বাপকতর,	ব্যাপকতর,	
edmiral,	এডমিরাল,	এডমিরাল,	
bishnoo,	বিষ্ণু,	বিষ্ণু,	
spredasita,	স্প্রেডাসিটা,	স্প্রেডশীট,	
abikaul,	অবিকাল,	অবিকল,	
monchostho,	মঞ্চস্থ,	মঞ্চস্থ,	
distance,	ডিসট্যান্স,	ডিসট্যান্স,	
nabotom,	নাবতম,	নবতম,	
dumaa,	ডুমা,	দুমা,	
bairer,	বাইরের,	বাইরের,	
pratista,	প্রতিস্তা,	প্রতিষ্টা,	
gemske,	গেমসকে,	জেমসকে,	
taitela,	টাইটেলা,	টাইটেল,	
uposhthit,	উপশ্থিত,	উপস্থিত,	
shektor,	শেক্তর,	সেক্টর,	
andamana,	আন্দামানা,	আন্দামান,	
krisenta,	ক্রিসেন্ট,	ক্রিসেন্ট,	
fokskon,	ফক্সকন,	ফক্সকন,	
bhabatarini,	ভবতারিণী,	ভবতারিণী,	
chopal,	চোপল,	চপল,	
bajhyo,	বাঝ্য,	বাহ্য,	
karmasampadon,	কর্মসম্পদন,	কর্মসম্পাদন,	
eshiyetika,	এসিয়েটিকা,	এশিয়াটিক,	
licenshe,	লাইসেন্স,	লাইসেন্স,	
vitti,	ভিত্তি,	ভিত্তিই,	
futonta,	ফুটন্তা,	ফুটন্ত,	
muktilav,	মুক্তিলাভ,	মুক্তিলাভ,	
simantarkkhibahinir,	সীমান্তকরবিহহিনীর,	সীমান্তরক্ষীবাহিনীর,	
jaunotar,	যৌনতার,	যৌনতার,	
nothibhukteer,	নথিভুক্তির,	নথিভুক্তির,	
kantojir,	কান্তজীর,	কান্তজির,	
teman,	তেমান,	তেমন,	
udbhabaney,	উদ্ভবনে,	উদ্ভাবনে,	
langhoner,	লঙ্ঘনের,	লংঘনের,	
proteemar,	প্রতিমার,	প্রতিমার,	
soommo,	সুম্মো,	সুমো,	
cholochchitrake,	চলচ্চিত্রাকে,	চলচ্চিত্রকে,	
sumeeta,	সুমিত,	সুমিতা,	
kloud,	ক্লাউড,	ক্লাউড,	
akkheperi,	আক্ষেপেরই,	আক্ষেপেরই,	
orthanitir,	অর্থানীতির,	অর্থনীতির,	
porobortii,	পরবর্তীই,	পরর্বতী,	
shikhaboudi,	শিখাবৌদি,	শিখাবৌদি,	
plasse,	প্লাসে,	প্লাসে,	
daakten,	ডাকতেন,	ডাকতেন,	
hupile,	হুপিলে,	হুপিলে,	
kanshater,	কাঁশাতের,	কানসাটের,	
probhritike,	প্রভৃতিকে,	প্রভৃতিকে,	
fasir,	ফাসির,	ফাসীর,	
bhowanipur,	ভোওবানীপুর,	ভবানীপুর,	
pranidero,	প্রাণীদেরও,	প্রানীদেরও,	
mulyabriddhikale,	মূল্যবৃদ্ধিকলে,	মূল্যবৃদ্ধিকালে,	
gyandaas,	জ্ঞানদাস,	জ্ঞানদাস,	
drissogulo,	দৃশ্যগুলো,	দৃশ্যগুলো,	
pinglateo,	পিংলাতেও,	পিংলাতেও,	
sucre,	সুক্রে,	সাকার,	
summer,	সামমার,	সামার,	
eduardo,	এডুর়ার্ডো,	এডুয়ার্দো,	
tanu,	তানু,	তনু,	
balakarak,	বালাকারক,	বলকারক,	
mumtazer,	মুমতাজের,	মুমতাজের,	
palteche,	পালতেছে,	পাল্টেছে,	
goonoman,	গুণমান,	গুণমান,	
metropolitan,	মেট্রোপলিটান,	মেট্রোপলিটন,	
panchadadu,	পঞ্চদদু,	পঞ্চাদাদু,	
sinakey,	সিনাকে,	সিনাকে,	
karmakarke,	কারমাকারকে,	কর্মকারকে,	
sharansthal,	শরণস্থল,	শরণস্থল,	
babona,	ববনা,	বাবনা,	
niropekshtar,	নিরপেকষ্টার,	নিরপেক্ষতার,	
munim,	মুনিম,	মুনিম,	
chintakarma,	চিন্তাকর্ম,	চিন্তাকর্ম,	
feroza,	ফেরোজা,	ফিরোজা,	
ghoshito,	ঘোষিত,	ঘোষিত,	
shloker,	শ্লোকের,	শ্লোকের,	
sthapanatir,	স্থাপনাটির,	স্থাপনাটির,	
mach,	মাচ,	মাছ,	
mayily,	ম্যালি,	মাইলি,	
patengar,	পাতেঙ্গার,	পতেঙ্গার,	
dhormokorme,	ধর্মকর্মে,	ধর্মকর্মে,	
goodamjato,	গুদামজাত,	গুদামজাত,	
proshikkhane,	প্রশিক্ষানে,	প্রশিক্ষণে,	
geja,	গেজ,	গেজ,	
janamukhi,	জনমুখী,	জনমুখী,	
glanio,	গ্লানিও,	গ্লানিও,	
cheento,	চেন্টো,	চিনতো,	
milayatane,	মিলায়াতনে,	মিলায়তনে,	
dharavahik,	ধারাবাহিক,	ধারাবাহিক,	
sikkhakbrinda,	শিক্ষাকবৃন্দ,	শিক্ষকবৃন্দ,	
janagononar,	জননাগণার,	জনগণনার,	
siitei,	সিতেই,	শীতেই,	
comoros,	কমোরোস,	কোমোরোস,	
taranee,	তারানী,	তরণী,	
prijon,	প্রীজন,	প্রিজন,	
bhaisaho,	ভাইসহ,	ভাইসহ,	
matrirup,	মাতৃরূপ,	মাতৃরূপ,	
adhyatmikata,	অধ্যাত্মিকতা,	আধ্যাত্মিকতা,	
jolrang,	জলরাং,	জলরঙ,	
tep,	টেপ,	ট্যাপ,	
hypar,	হাইপার,	হাইপার,	
ingrezeeteo,	ইংরেজিতেও,	ইংরেজিতেও,	
sikkhagata,	শিক্ষাগত,	শিক্ষাগত,	
mookhomaundoler,	মুখমামৌল্যের,	মুখমণ্ডলের,	
shashtra,	সাস্ত্রা,	শাস্ত্র,	
dabliudabliui,	ডাবলিউদেববউলই,	ডাব্লিউডাব্লিউই,	
srk,	শ্রকক,	শাহরুখ,	
grauth,	গ্রাউথ,	গ্রোথ,	
dovaar,	দোভার,	ডোভার,	
sompadon,	সম্পাদন,	সম্পাদন,	
sarajibonbyapi,	সারাজীবন্যবাপী,	সারাজীবনব্যাপী,	
chiraharit,	চিরাহারিত,	চিরহরিৎ,	
omkar,	ওমকার,	ওঙ্কার,	
mesenjarer,	মেসেনজারের,	মেসেঞ্জারের,	
huqa,	হুকা,	হুক,	
gronther,	গ্রন্থের,	গ্রন্থের,	
mithener,	মিথেনের,	মিথেনের,	
kormopontha,	কর্মপন্থা,	কর্মপন্থা,	
sylvi,	সিলভি,	সিলভি,	
byathapather,	ব্যথাপঠের,	ব্যথাপথের,	
quary,	কোয়ারি,	কোয়েরি,	
bhugol,	ভূগল,	ভূগোল,	
kruser,	কুরুরের,	ক্রুশের,	
pitiler,	পিতিলের,	পিটিলের,	
daltagi,	দালতাগী,	দলত্যাগী,	
lopjonito,	লপ্যজিত,	লোপজনিত,	
charukala,	চারুকলা,	চারুকলা,	
shector,	শেক্টর,	সেক্টর,	
samoshtigato,	সমষ্টিতত,	সমষ্টিগত,	
install,	ইনস্টাল,	ইন্সটল,	
gabhaaskar,	গাভাসকার,	গাভাস্কার,	
charban,	চারবান,	চর্বন,	
phiksim,	ফিকমিম,	ফিক্সিং,	
nachiketa,	নচিকেতা,	নচিকেতা,	
agora,	অগরা,	আগোরা,	
dokaanei,	দোকানেই,	দোকানেই,	
ase,	আসে,	আসে,	
ekroop,	একরূপ,	একরূপ,	
yanqee,	যঞ্্,	ইয়াংকি,	
moonshi,	মুনশি,	মুন্সি,	
sangaskritipreme,	সংস্কৃতিপ্রেমে,	সংস্কৃতিপ্রেমে,	
thyachar,	থ্যাচার,	থ্যাচার,	
bosante,	বসন্তে,	বসন্তে,	
antorbhuktimulak,	আন্তর্ভূক্তিমূলক,	অন্তর্ভুক্তিমূলক,	
joubankal,	যৌবনকাল,	যৌবনকাল,	
soource,	সুর্স,	সোর্স,	
annorup,	অন্নরূপ,	অন্যরূপ,	
zoubankal,	যৌবনকাল,	যৌবনকাল,	
durgotsabe,	দুর্গোৎসবে,	দুর্গোৎসবে,	
shilver,	শিলভার,	সিলভার,	
protul,	প্রতুল,	প্রতুল,	
ekok,	একক,	একক,	
bodhirta,	বোধিরতা,	বধিরতা,	
uddhrito,	উদ্ধৃত,	উদ্ধৃত,	
nirbaho,	নির্বাহ,	নির্বাহ,	
ganoporibahon,	গণপরিবহন,	গণপরিবহন,	
asamanyo,	অসামন্য,	অসামান্য,	
eesa,	এইএসএ,	আইএএস,	
mukhabandha,	মুখববন্ধ,	মুখবন্ধ,	
venus,	ভেনাস,	ভেনাস,	
jyaqa,	জ্যাক,	জ্যাক,	
hindutirtha,	হিন্দুতীর্থ,	হিন্দুতীর্থ,	
aporishodhito,	অপরিষোধিত,	অপরিশোধিত,	
bonobhumi,	বনভূমি,	বনভূমি,	
asabhya,	অসভ্য,	অসভ্য,	
kalakushalir,	কলাকুশলীর,	কলাকুশলীর,	
steen,	স্টীন,	স্টেন,	
abheedhanic,	অভিধানিক,	অভিধানিক,	
protizogiita,	প্রতিযোগীতা,	প্রতিযোগীতা,	
norfolk,	নরফলক,	নরফোক,	
byapoktor,	ব্যাপক্তর,	ব্যাপকতর,	
toptoshele,	তপ্তশেলে,	তপ্তশেলে,	
protijogitamulok,	প্রতিযোগিতামূলক,	প্রতিযোগীতামূলক,	
seekkhokbrindo,	শিক্ষকবৃন্দ,	শিক্ষকবৃন্দ,	
jeebnagore,	জীবনগরে,	জীবননগর,	
harbare,	হরবারে,	হারবারে,	
chaiten,	চাইতেন,	চাইতেন,	
kailashrao,	কৈলাশরাও,	কৈলাশরাও,	
faltu,	ফাল্টু,	ফালতু,	
lendl,	লেন্ডল,	লেন্ডল,	
eporzonto,	এপরজন্ত,	এপর্যন্ত,	
hetimganje,	হেতিমগঞ্জে,	হেতিমগঞ্জে,	
lobbytey,	লবিইটে,	লবিতে,	
aaireshe,	আইরেশে,	আইরেসে,	
rabo,	রাবো,	রব,	
zerusalem,	জেরুসালেম,	জেরুজালেম,	
dhani,	ধনী,	ধানি,	
chai,	চাই,	ছাই,	
ajuhath,	অজুহাত,	অজুহাত,	
laat,	লাত,	লাট,	
laatimer,	লাটিমের,	লাটিমের,	
heze,	হেজে,	হেজ,	
ebhara,	এভারা,	এভার,	
flux,	ফ্লাক্স,	ফ্লাস্ক,	
parswer,	পারস্বের,	পার্শ্বের,	
shikkhadikkhay,	শিক্ষাদিক্ষায়,	শিক্ষাদিক্ষায়,	
srisri,	শ্রীশ্রি,	শ্রীশ্রী,	
chaudhurider,	চৌধুরীদের,	চৌধুরীদের,	
hundai,	হুন্ডাই,	হুন্দাই,	
cinematographar,	সিনেমাগোট্রাফার,	সিনেমাটোগ্রাফার,	
alimpiqa,	অলীম্পিকা,	অলিম্পিক,	
baipass,	বাইপাস,	বাইপাস,	
dalnata,	দলনতা,	ডালনাটা,	
catholicder,	ক্যাথলেকদের,	ক্যাথলিকদের,	
sures,	সুরেস,	সুরেশ,	
ghumachchila,	ঘুমাচ্ছিলা,	ঘুমাচ্ছিল,	
korley,	করলে,	করলে,	
chahidapotrer,	চাহিদাপত্রের,	চাহিদাপত্রের,	
teksuser,	টেকসুসের,	টেক্সাসের,	
shishupalgarh,	শিশুগর্্লার,	শিশুপালগড়ে,	
gasthi,	গাস্থি,	গোষ্ঠী,	
konroop,	কোরূপ,	কোনরূপ,	
vabook,	ভবক,	ভাবুক,	
drissotir,	দৃশ্যটির,	দৃশ্যটির,	
vetrillocuism,	ভেট্রিলক্যাইজিম,	ভেট্রিলোকুইজম,	
mmehonoti,	ম্মেহনটি,	মেহনতি,	
aireshe,	এইরেশে,	আইরেসে,	
soomita,	সুমিত,	সুমিতা,	
bosoben,	বসবেন,	বসবেন,	
taxikeo,	ট্যাক্সিকেও,	ট্যাক্সিকেও,	
chhintayikari,	ছিন্তাইকারী,	ছিনতাইকারী,	
laesens,	লাইসেন্স,	লাইসেন্স,	
hizriite,	হিজরিতে,	হিজরীতে,	
superheroo,	সুপারহিউরো,	সুপারহিরো,	
jyesttha,	জ্যেষ্ঠথা,	জ্যেষ্ঠা,	
bhabanir,	ভবনীর,	ভবানীর,	
korle,	করলে,	করলে,	
azimpur,	আজিমপুর,	আজিমপুর,	
vaabnake,	ভাবনাকে,	ভাবনাকে,	
graambasi,	গ্রামবাসী,	গ্রামবাসী,	
dimbacriti,	ডিম্বাক্রিটি,	ডিম্বাকৃতি,	
turbine,	তুরবিনে,	টারবাইন,	
chowdhurir,	চৌধুরির,	চৌধুরীর,	
land,	ল্যান্ড,	ল্যান্ড,	
gavaskar,	গাভাসকার,	গাভাস্কার,	
show,	শা,	শো,	
horas,	হোাস,	হোরাস,	
promothesh,	প্রমোতেশ,	প্রমথেশ,	
protijogi,	প্রতিযোগী,	প্রতিযোগী,	
utshahomulok,	উৎসাহমূলক,	উৎসাহমূলক,	
shten,	স্টেন,	স্টেন,	
kraim,	ক্রাইম,	ক্রাইম,	
eexpreession,	এক্সপ্রেশন,	এক্সপ্রেশন,	
sahozlabhbhotar,	সহজ্লভভতার,	সহজলভ্যতার,	
jounotar,	যৌনতার,	যৌনতার,	
myathiou,	ম্যাথিউপ,	ম্যাথিউ,	
daraider,	দারাইদের,	দরাইদের,	
booksar,	বুকসার,	বুক্সার,	
chalochchitrogulor,	চলচ্চিত্রগুলোর,	চলচ্চিত্রগুলোর,	
akkaas,	আক্কাস,	আককাস,	
sangitanusthane,	সংগীতানুষ্ঠানে,	সঙ্গীতানুষ্ঠানে,	
shaahaabiike,	শাহাবিকে,	সাহাবীকে,	
carzar,	কার্জার,	চার্জার,	
korimer,	করিমের,	করিমের,	
asociatis,	অসোসিয়েটিস,	এসোসিয়েটস,	
pretty,	প্রেটি,	প্রিটি,	
upobaasee,	উপবাসী,	উপবাসী,	
geejeeteeda,	গীজিটিদা,	গেজেটেড,	
kaalaam,	কালাম,	কালাম,	
besirbhaagi,	বেসিরভাগী,	বেশিরভাগই,	
andra,	আন্দ্রার,	আন্ড্রা,	
orthisoho,	অর্থিসহ,	অর্থিসহ,	
neemeette,	নিমিত্তে,	নিমিত্তে,	
nirikh,	নিরিখ,	নিরিখ,	
bbiseshyer,	ব্বিসেশেয়ের,	বিশেষ্যের,	
senabahineekey,	সেনাবাহিনীকে,	সেনাবাহিনীকে,	
dinifitian,	ডিনিফাইটিয়ান,	ডেফিনেশন,	
songkulan,	সংকুলন,	সংকুলান,	
nirvachaker,	নির্ভাচকের,	নির্বাচকের,	
fastag,	ফাস্তাগ,	ফ্যাসট্যাগ,	
qarpeta,	কার্পেটা,	কার্পেট,	
deqe,	দেকে,	ডেকে,	
durgatsob,	দুর্গাৎসব,	দুর্গোৎসব,	
sheekar,	শীকার,	শিকার,	
kash,	কাশ,	কাস,	
byabaharkarike,	ব্যবহারকারীকে,	ব্যবহারকারীকে,	
yukeliptash,	যুকেলিপ্তাশ,	ইউক্যালিপ্টাস,	
baarbadoj,	বারবাদজ,	বার্বাডোজ,	
duio,	দুইও,	দুইও,	
anichchi,	আনিচ্ছি,	আনিচ্ছি,	
gotihin,	গতিহীন,	গতিহীন,	
shrimoti,	শ্রীমতি,	শ্রীমতি,	
pyetarna,	প্যাতেরনা,	প্যাটার্ন,	
protijogii,	প্রতিযোগী,	প্রতিযোগী,	
asovarno,	অসভারণ,	অসবর্ণ,	
cholechi,	চলেছি,	চলেছি,	
tyap,	ত্যাপ,	ট্যাপ,	
vugorvey,	ভুগর্ভে,	ভূগর্ভে,	
maila,	মাইলা,	মাইল,	
rahee,	রহী,	রাহী,	
debeting,	ডেবেটিং,	ডিবেটিং,	
logic,	লজিক,	লজিক,	
nilfamarir,	নীলফামারীর,	নীলফামারীর,	
ghatleo,	ঘাটলেও,	ঘটলেও,	
uporitoler,	উপরিতলের,	উপরিতলের,	
peshto,	পেষ্টো,	পেষ্ট,	
bhujangta,	ভূজানটা,	ভুজঙ্গটা,	
sumi,	সুমি,	সুমি,	
dapadpi,	দপাপ্ডি,	দাপাদপি,	
pet,	পেট,	পেত,	
augustine,	অগাস্টিন,	অগাস্টিন,	
ganonanatto,	গণনানাত্ত,	গণনাট্য,	
dighol,	দিঘল,	দীঘল,	
tikto,	তিক্ত,	তিক্ত,	
laiseensim,	লাইসস্নিম,	লাইসেন্সিং,	
zaire,	জায়ারে,	জাইরে,	
niphelheim,	নিফেলহাইম,	নিফেলহেইম,	
ebham,	এহাম,	ইভিএম,	
amanisha,	আমানিশা,	অমানিশা,	
kekru,	কেকরু,	কেকরু,	
songbadmadhyomer,	সংবাদমাধ্যমের,	সংবাদমাধ্যমের,	
munjur,	মুঞ্জুর,	মুনজুর,	
shrabastee,	শ্রাবস্তি,	শ্রাবস্তী,	
dabarer,	দাবারের,	দাবারের,	
olympic,	অলিম্পিক,	অলিম্পিক,	
ritesh,	রিটিস,	রিতেশ,	
dolu,	দোলু,	ডলু,	
jatotaa,	জাতোটা,	যতোটা,	
gitikobita,	গীতিকবিতা,	গীতিকবিতা,	
bhalobaas,	ভালোবাস,	ভালোবাসা,	
borendroke,	বরেন্দ্রকে,	বরেন্দ্রকে,	
turisht,	টারিশ্ট,	টুরিস্ট,	
bulano,	বুলানো,	বুলান,	
casper,	ক্যাসপার,	ক্যাসপার,	
tokee,	তোকে,	তকি,	
mail,	মাইল,	মাইল,	
akkharkey,	অক্ষরকে,	অক্ষরকে,	
pakhtunistan,	পাখতুনিস্তান,	পাখতুনিস্তান,	
shasyadi,	শাস্যাদি,	শস্যাদি,	
akheli,	আখেলি,	আখেলী,	
bowie,	বুওয়ে,	বওই,	
ajeejer,	আজেজের,	আজিজের,	
ddheela,	ঢেলা,	ঢিলা,	
reejideencee,	রেজিডিন্সি,	রেসিডেন্স,	
turkyder,	টার্ক্ডিডের,	তুর্কিদের,	
bijito,	বিজিত,	বিজিত,	
baikalyo,	বাইকল্য,	বৈকল্য,	
kanthar,	কণ্ঠার,	কাঁথার,	
shringgo,	শ্রীংগো,	শৃঙ্গ,	
bostubad,	বস্তুবাদ,	বস্তুবাদ,	
taunsheep,	টউউনশিপ,	টাউনশিপ,	
sumita,	সুমিতা,	সুমিতা,	
antennal,	অ্যান্টেননাল,	অ্যান্টেনাল,	
jandrel,	জন্দ্রেল,	জাঁদরেল,	
teoyana,	তেওয়ান,	তাইওয়ান,	
addata,	আডদাতা,	আড্ডাটা,	
tachnach,	টাচনাচ,	তছনছ,	
naubom,	নাউবম,	নবম,	
shingping,	সিংপিং,	শিংপিং,	
maladabha,	মালাদাভা,	মলদোভা,	
treend,	ট্রান্ড,	ট্রেন্ড,	
ruptan,	রূপ্তান,	রূপটান,	
gaujano,	গৌজনও,	গজানো,	
bisheshshyer,	বিশেশ্যের,	বিশেষ্যের,	
madhoboir,	মাধবয়,	মাধবীর,	
nanilalke,	নানিলালকে,	ননীলালকে,	
spredashita,	স্প্রেডশািত,	স্প্রেডশীট,	
vagni,	ভাগ্নি,	ভগ্নী,	
muradke,	মুরাদকে,	মুরাদকে,	
aniyantrita,	অনিয়ন্ত্রীত,	অনিয়ন্ত্রিত,	
janar,	জানার,	জানার,	
tistar,	তিস্তার,	তিস্তার,	
uthhaane,	উঠানে,	উঠানে,	
purbancoler,	পূর্বাণকোলের,	পূর্বাঞ্চলের,	
ganaporibahaner,	গণপরিবহাসনের,	গণপরিবহনের,	
deefinision,	ডাফিনিশন,	ডেফিনেশন,	
rudrasagar,	রুদ্রসগর,	রুদ্রসাগরের,	
choukato,	চৌকাতো,	চৌকাত,	
seekkharthirao,	শিক্ষার্থীরাও,	শিক্ষার্থীরাও,	
protibedokrao,	প্রতিবেদকরাও,	প্রতিবেদকরাও,	
harbur,	হারবুর,	হারবার,	
champa,	চাম্পা,	চাঁপা,	
shhepha,	শেহা,	শেফ,	
chhanada,	ছানাদা,	ছানাদা,	
rajnoitik,	রাজনৈতিক,	রাজনৈতীক,	
neshadrabyer,	নেশাদ্রব্যের,	নেশাদ্রব্যের,	
totokson,	টোটোসন,	ততক্ষন,	
bulan,	বুলান,	বুলান,	
ostheesandhi,	অস্থিসন্ধি,	অস্থিসন্ধি,	
bbosben,	ব্যবসেন,	বসবেন,	
mumtaj,	মুমতজ,	মুমতাজ,	
qanasarabheshana,	কানারাভেষণা,	কনসারভেশন,	
vaider,	ভাইদের,	ভাইদের,	
debdebie,	দেবদেবী,	দেবদেবী,	
chhon,	ছনন,	ছোঁ,	
marodeho,	মারেহো,	মরদেহ,	
dreeshtiheen,	দৃষ্টিহীন,	দৃষ্টিহীন,	
shikkhartheerao,	শিক্ষার্থীরাও,	শিক্ষার্থীরাও,	
elakayi,	এলাকাই,	এলাকাই,	
kirke,	কীরকে,	কিরকে,	
dakkhinkare,	দক্ষিণকারে,	দক্ষিণকরে,	
neemitte,	নিমিত্তে,	নিমিত্তে,	
dera,	দেরা,	ডেরা,	
sectore,	সেক্টরে,	সেক্টরে,	
reetesh,	রীটেস,	রিতেশ,	
okkhorke,	অক্ষরকে,	অক্ষরকে,	
urey,	উরে,	ইউরি,	
habsi,	হাবসি,	হাবশী,	
scholarship,	স্কলারশিপ,	স্কলারশিপ,	
bondiira,	বন্দীরা,	বন্দীরা,	
karadando,	কারাদন্ড,	কারাদণ্ড,	
laaishheshh,	লৈষেশ,	লাইসেন্স,	
mukharji,	মুখর্জি,	মুখার্জী,	
duryogamoyee,	দুর্যোগায়ী,	দুর্যোগময়ী,	
stoonahenja,	স্তুহানেঞ্জা,	স্টোনহেঞ্জ,	
shangsthatikey,	সংশ্ঠতিকে,	সংস্থাটিকে,	
milea,	মিলি,	মাইলে,	
dijmarescu,	ডিজমারেস্কু,	দিজমার্সাকু,	
somoodrotote,	সমুদ্রততে,	সমুদ্রতটে,	
relance,	রিল্যাঙ্কে,	রিলায়েন্স,	
taalaal,	তালাল,	তালাল,	
durtomo,	দুর্তমো,	দূরতম,	
with,	উইথ,	ভিত,	
konagoolo,	কনাগুলো,	কণাগুলো,	
manush,	মানুশ,	মানুষ,	
bhabanipur,	ভবনীপুর,	ভবানীপুর,	
hert,	হার্ট,	হার্ট,	
sursur,	সুরসুর,	সুরসুর,	
dooburir,	ডুবুরির,	ডুবুরির,	
postay,	পোস্টে,	পোস্টে,	
neck,	নেক,	নেক,	
khalid,	খালিদ,	খালিদ,	
eshtonia,	এস্টোনিয়া,	এস্তোনিয়া,	
kaathhmaandute,	কাঠমান্ডতে,	কাঠমান্ডুতে,	
rajnikant,	রাজনীকান্ত,	রাজনীকান্ত,	
transformaarer,	ট্রান্সফারমাযার,	ট্রান্সফরমারের,	
kaalki,	কালকি,	কালকি,	
bodhukeo,	বোধুকেও,	বধুকেও,	
jeebanjapon,	জীবাজ্জাপন,	জীবনযাপন,	
bonshi,	বংশী,	বংশী,	
bisnuke,	বিসনয়কক,	বিষ্ণুকে,	
shaater,	সাতের,	শ্যুটার,	
boshoborty,	বশবোর্টি,	বশবর্তী,	
jemy,	জেমি,	জেমি,	
eokee,	ইইকে,	এওকি,	
ganesh,	গনেশ,	গণেশ,	
mulvitti,	মুলভিটটি,	মূলভিত্তি,	
sohokari,	সোকারি,	সহকারী,	
oxite,	অক্সিইট,	অক্সাইট,	
oindrila,	ঐন্দ্রিলা,	ঐন্দ্রিলা,	
vobani,	ভবানি,	ভবানী,	
rajbandir,	রাজবন্দির,	রাজবন্দীর,	
sharif,	শরীফ,	শরিফ,	
monjooshree,	মঞ্যূর্থী,	মঞ্জুশ্রী,	
bhenicer,	ভেনিসের,	ভেনিসের,	
ajeeboner,	অজিবনের,	আজীবনের,	
shikshakrom,	শিক্ষাক্রম,	শিক্ষাক্রম,	
jipiusamriddha,	জিপিউসসমৃদ্ধ,	জিপিউসমৃদ্ধ,	
directorate,	ডিরেক্টরেট,	ডিরেক্টরেট,	
bojhe,	বোঝে,	বোঝে,	
sithilota,	সিথিলতা,	শিথিলতা,	
mugdha,	মুগধা,	মুগ্ধ,	
dolphiny,	ডলফিনি,	ডলফিনি,	
odeb,	ওডেব,	ওদেব,	
dharabahikotitey,	ধারাবাহিককিতে,	ধারাবাহিকটিতে,	
manibhaijaner,	মণিভাজননের,	মণিভাইজানের,	
khudrokar,	ক্ষুদ্রকার,	ক্ষুদ্রকার,	
degree,	ডিগ্রি,	ডিগ্রি,	
paolasthi,	পাওলাস্থী,	পাওলাসথি,	
graambaashee,	গ্রামবাশী,	গ্রামবাসী,	
kurdider,	কুর্দিদের,	কুর্দিদের,	
mulbhitti,	মূলভিত্তি,	মূলভিত্তি,	
acrolect,	অ্যাক্কোলেক্ট,	অ্যাক্রোলেক্ট,	
mukhomondoler,	মুখমন্ডলের,	মুখমণ্ডলের,	
shekarmani,	শেকারমানি,	শেকরমানি,	
khude,	খুদে,	ক্ষুদে,	
vodqa,	ভোডকা,	ভদকা,	
mandope,	ম্যান্ডোপ,	মন্ডপে,	
bohorompurer,	বহরমপুরের,	বহরমপুরের,	
nachar,	নাচার,	নাচার,	
associatis,	অ্যাসোসিয়েটিস,	এসোসিয়েটস,	
nartana,	নর্তনা,	নর্টন,	
jaanar,	যানার,	জানার,	
byabaharkareederke,	ব্যবহারকারীদেরকে,	ব্যবহারকারীদেরকে,	
bachai,	বাচাই,	বাছাই,	
khuliechilam,	খুলিয়ছিলাম,	খুলিয়েছিলাম,	
shahjapur,	শাহতাপুর,	শাহজাপুর,	
bhushito,	ভূষিত,	ভূষিত,	
sohojlovyotar,	সহজলভোততার,	সহজলভ্যতার,	
alaoler,	আলালের,	আলাওলের,	
deilee,	ডেইলে,	ডেইলি,	
doloo,	দলু,	ডলু,	
sampadoner,	সম্পাদনের,	সম্পাদনের,	
everestey,	এভারেস্টে,	এভারেস্টে,	
meridiane,	মেরিডিয়ান,	মেরিডিয়ানে,	
suparahiro,	সুপারাহিরও,	সুপারহিরো,	
samratra,	সম্্তার,	সম্রাটরা,	
ghenshei,	ঘেনশেই,	ঘেঁষেই,	
dola,	দোলা,	দলা,	
ispredseet,	ইসপ্রেডস্ট,	স্প্রেডশীট,	
homeser,	হোমেসের,	হোমসের,	
shiropar,	শিরোপার,	শিরোপার,	
lungiti,	লুঙ্গিটি,	লুঙ্গিটি,	
phutanta,	ফুটান্ত,	ফুটন্ত,	
protiakromonei,	প্রতিযাক্রমেই,	প্রতিআক্রমণেই,	
stagecraft,	স্টেগেক্রফফ্ট,	স্টেজক্রাফট,	
ekshoti,	একশতি,	একশোটি,	
airish,	এইরিশ,	আইরিস,	
mashtarsha,	মাষ্টারশা,	মাস্টার্স,	
manoharpur,	মনোহরপুর,	মনোহরপুর,	
sudrissho,	সুদৃশ্,	সুদৃশ্য,	
huka,	হুকা,	হুক,	
hosbaleke,	হোসবালেকে,	হোসবালেকে,	
daaun,	দাউন,	ডাউন,	
ucchosito,	উক্চসিত,	উচ্ছসিত,	
sumoo,	সুমু,	সুমো,	
protistha,	প্রতিষ্ঠা,	প্রতিষ্টা,	
hitlere,	হিটলারে,	হিটলারে,	
zeland,	জেল্যান্ড,	জিল্যান্ড,	
madrasake,	মাদ্রাসাকে,	মাদ্রাসাকে,	
refleks,	রিফ্লেক্স,	রিফ্লেক্স,	
halding,	হেল্ডিং,	হোল্ডিং,	
pakistanira,	পাকিস্তানিরা,	পাকিস্তানীরা,	
bohudin,	বহুদীন,	বহুদিন,	
iub,	আইওবি,	আইইউবি,	
sobaiderke,	সবাইদেরকে,	সবাইদেরকে,	
grambaaseeder,	গ্রামবাসীদের,	গ্রামবাসীদের,	
kyatagorir,	ক্যাটাগরির,	ক্যাটাগরির,	
shithilata,	শিথিলতা,	শিথিলতা,	
ganjana,	গঞ্জনা,	গঞ্জনা,	
taims,	টাইমস,	টাইমস্,	
kompeeto,	কম্পিত,	কম্পিত,	
daaktikite,	দাক্তিকীতে,	ডাকটিকিটে,	
khitkar,	খিতকার,	ক্ষিতকর,	
jens,	জেনস,	জিন্স,	
inapharameshana,	ইনাফারমেনান,	ইনফরমেশন,	
amorendro,	অমরেন্দ্র,	অমরেন্দ্র,	
panchashjan,	পঞ্চাশজান,	পঞ্চাশজন,	
scholastic,	স্কোলাস্টিক,	স্কলাস্টিক,	
qaro,	কারো,	কারো,	
nutoner,	নিউটনের,	নূতনের,	
harysoner,	হার্সনের,	হ্যারিসনের,	
shnaipara,	শ্নাইপার,	স্নাইপার,	
pharmesigulote,	ফার্মেসিগুলোতে,	ফার্মেসীগুলোতে,	
moresbai,	মোরেসবাই,	মোরেসবাই,	
restuarant,	রেস্টুরান্ত,	রেষ্টুরেন্ট,	
juakhelar,	জুয়াখেলার,	জুয়াখেলার,	
langhaner,	লঙ্ঘনের,	লংঘনের,	
satyaky,	সত্যক্য,	সাত্যকি,	
maarmaader,	মরমাদের,	মারমাদের,	
hol,	হোল,	হোল,	
gunje,	গুঞ্জে,	গুঁজে,	
baaik,	বাইক,	বাইক,	
teunar,	টেউনার,	টিউনার,	
freelancerra,	ফ্রিল্যান্সরা,	ফ্রিল্যান্সাররা,	
shhow,	আইভ,	শো,	
nichupattir,	নিচুপত্তির,	নিচুপট্টির,	
bakhyateet,	ব্যাখ্যাট,	ব্যাখ্যাতীত,	
khoka,	খোকা,	খোকা,	
bamon,	বামন,	বামন,	
majdur,	মাজদুর,	মজদুর,	
vugoley,	ভুগোলে,	ভূগোলে,	
ghatiti,	ঘটটিটি,	ঘাঁটিটি,	
harishankar,	হরিশংকর,	হরিশংকর,	
adhyattikota,	আধ্যাত্মিকতা,	আধ্যাত্মিকতা,	
cheerontan,	চিরোন্তন,	চিরন্তন,	
bandi,	বন্দী,	বন্দী,	
akhandota,	অখণ্ডটা,	অখণ্ডতা,	
oojbekistan,	ওজবেকেস্তান,	উজবেকিস্তান,	
infarmatian,	ইনফর্মেশিয়ান,	ইনফরমেশন,	
pragreesa,	প্রগ্রিসা,	প্রগ্রেস,	
dhos,	ধস,	ধস,	
nathivukta,	নথিভুক্ত,	নথিভুক্ত,	
windo,	উইন্ডো,	উইন্ডো,	
jhijhi,	ঝিঝি,	ঝিঝি,	
taholo,	তাহলো,	তাহলো,	
pothnirdeshona,	পথনরিষ্ডেশন,	পথনির্দেশনা,	
hank,	হান্ক,	হাঙ্ক,	
phiqsa,	ফিকসা,	ফিক্স,	
bandhubhaabaapanna,	বন্ধুয়াবপন্নন্,	বন্ধুভাবাপন্ন,	
mentither,	মেন্টিথের,	মেনটিথের,	
johor,	জহর,	জহর,	
byaboharkariyi,	ব্যবহারকারী,	ব্যবহারকারীই,	
ishter,	ইসতের,	ইস্টের,	
middleton,	মিডলটেন,	মিডলটন,	
krimlin,	ক্রিলিন,	ক্রিমলিন,	
ghotleo,	ঘটলকেও,	ঘটলেও,	
qulim,	কুলিম,	কুলিং,	
ghumachche,	ঘুমাচ্ছে,	ঘুমাচ্ছে,	
bosontokke,	বসন্তকেে,	বসন্তকে,	
boikalyo,	বৈকাল্য,	বৈকল্য,	
abheedhaaneeck,	অভিধানিক,	অভিধানিক,	
baait,	বাইত,	বাইট,	
dinara,	দিনারা,	ডিনার,	
somonnitobhabe,	সমননিত্বভাবে,	সমন্বিতভাবে,	
plate,	প্লেট,	প্লেট,	
rashider,	রশিদের,	রশিদের,	
noiteekotar,	নৈতিকতার,	নৈতিকতার,	
muradkey,	মুরাডকে,	মুরাদকে,	
bitlaser,	বিটলাসের,	বিটলসের,	
balokarak,	বালোকারক,	বলকারক,	
chuti,	চুটি,	ছুটি,	
elaakaa,	এলাকা,	এলাকা,	
dankaan,	ডাঙ্কান,	ডানকান,	
alpa,	আলপা,	অল্প,	
horeepur,	হরিপুর,	হরিপুর,	
onchalgulir,	অঙ্চলগুলির,	অঞ্চলগুলির,	
bhangle,	ভাংলে,	ভাঙলে,	
dalee,	ডালি,	ডালে,	
kheylechen,	খেয়েলেছন,	খেলেছেন,	
byaboharkari,	ব্যবহারকারী,	ব্যবহারকারী,	
neshnos,	নেশনোস,	নেশনস,	
sarbhaarti,	সর্ভরটি,	সার্ভারটি,	
leaders,	লিডার্স,	লিডার্স,	
musallati,	মুসলতালি,	মুসল্লাটি,	
nabatamo,	নবতামো,	নবতম,	
fotanor,	ফোটানোর,	ফোটানোর,	
krush,	ক্রুশ,	ক্রুশ,	
shasankorta,	শাসনকর্তা,	শাসনকর্তা,	
daqten,	ডাকতেন,	ডাকতেন,	
bo,	বো,	বু,	
kanuner,	কানুনের,	কানুনের,	
dhaleshorii,	ধলেশরী,	ধলেশ্বরী,	
itostatah,	ইতোস্তাথা,	ইতস্ততঃ,	
rajtantrey,	রাজতন্ত্রে,	রাজতন্ত্রে,	
choson,	চোসন,	চোষণ,	
hugheke,	হুইকে,	হিউজকে,	
gonona,	গণনা,	গননা,	
poorohitder,	পুরোহিতদের,	পুরোহিতদের,	
codeti,	কোডেটি,	কোডটি,	
fake,	ফাকে,	ফাকে,	
dufresne,	ডুফ্রেসেন,	ডুফরেস্ন,	
poste,	পোস্টে,	পোস্টে,	
vejjanno,	ভেজ্যান্ন,	ভেজানো,	
shibraj,	শিবরাজ,	শিবরাজ,	
atmobonchito,	আত্মবঞ্চিত,	আত্মবঞ্চিত,	
prakalpoguli,	প্রকালপগুলি,	প্রকল্পগুলি,	
manobikotao,	মানবিকতাও,	মানবিকতাও,	
monohputo,	মনোভূত,	মনঃপুত,	
ardasha,	আর্দশ,	আর্দশ,	
edipass,	এডিপ্যাস,	ইডিপাস,	
pranibigyani,	প্রাণীবিজ্ঞানী,	প্রাণীবিজ্ঞানী,	
engreziteo,	এংরেজিতেও,	ইংরেজিতেও,	
mojdur,	মজদুর,	মজদুর,	
varma,	ভারমা,	ভার্মা,	
onker,	অঙ্কার,	ওঙ্কার,	
superheiroo,	সুপারহিরোর,	সুপারহিরো,	
liseensee,	লিসেইনসি,	লাইসেন্স,	
sanaktakaran,	সনক্তরকরণ,	সনাক্তকরণ,	
slatgulor,	স্ল্যাটগুলোর,	স্ল্যাটগুলোর,	
sithilotar,	সিথিলতার,	শিথিলতার,	
hojurer,	হজুরের,	হজুরের,	
bite,	বিতে,	বাইট,	
jomjamat,	জম্জামাত,	জমজমাট,	
orthoneeti,	অর্থনীতি,	অর্থনীতির,	
dhache,	ধাচে,	ধাঁচে,	
drabyatah,	দ্রব্যাতঃ,	দ্রব্যতঃ,	
bharpur,	ভারপুরের,	ভরপুর,	
mekapgulo,	মেকাপগুলো,	মেকআপগুলো,	
fakhrul,	ফখরুল,	ফাখরুল,	
assexe,	অ্যাসেক্সে,	অ্যাসেক্সে,	
deaubande,	দিউবান্ডে,	দেওবন্দে,	
doula,	দৌলা,	দৌলা,	
oncholgulir,	অন্চলগুলির,	অঞ্চলগুলির,	
masjidtir,	মাসজিতদির,	মসজিদটির,	
bokul,	বকুল,	বকুল,	
goteehin,	গোটিহীন,	গতিহীন,	
battery,	ব্যাটেরি,	ব্যাটারী,	
gazetted,	গেজেটেড,	গেজেটেড,	
pichte,	পিচতে,	পিছতে,	
hyaloyin,	হ্যালোয়ন,	হ্যালোইন,	
themeke,	থেমেকে,	থিমকে,	
firoze,	ফিরোজে,	ফিরোজ,	
bane,	বানে,	বনে,	
suhasini,	সুহাসিনী,	সুহাসিনী,	
armshtronj,	আর্মশ্ট্র্য,	আর্মস্ট্রং,	
moushumei,	মৌশুমেই,	মৌসুমেই,	
phareeksa,	ফরেকস,	ফরেক্স,	
prottokkhovabe,	প্রত্যক্ষবাবে,	প্রত্যক্ষভাবে,	
karecho,	করেছো,	করেছ,	
dologuloo,	দলগুলুও,	দলগুলোও,	
rubidium,	রুবিডিয়াম,	রুবিডিয়াম,	
aaziz,	আজিজ,	আজিজ,	
mahbunur,	মাহবুুুর,	মাহবুনুর,	
mujuru,	মুজুরু,	মুজুরু,	
patochitra,	পাটোচিত্র,	পটচিত্র,	
rajashri,	রাজশ্রী,	রাজশ্রী,	
bayshorkarikarone,	বায়শরকারীকরণে,	বেসরকারিকরণ,	
shansthaner,	সান্থানের,	সংস্থানের,	
bishhnu,	বিষ্ণু,	বিষ্ণু,	
chalachchitrer,	চলচ্চিত্রের,	চলচ্চিত্রের,	
cinemapremider,	সিনেমাপ্রেমীদের,	সিনেমাপ্রেমীদের,	
ratishilatai,	রতিশীলতাই,	রতিশীলতায়,	
barder,	বার্ডার,	বার্ডের,	
dembakreeti,	দেম্বাকৃতি,	ডিম্বাকৃতি,	
evereste,	এভারেস্টে,	এভারেস্টে,	
narbur,	নারবুর,	নরবুর,	
erythrian,	এরিথ্রিয়ান,	এরিথ্রিয়ান,	
deares,	ডিয়ারেস,	ডিআরএস,	
sumitrar,	সুমিত্রার,	সুমিত্রার,	
miraqela,	মিরাকেলা,	মিরাকেল,	
shrichaitanyadev,	শ্রীচৈত্যবন্ধে,	শ্রীচৈতন্যদেব,	
pleeta,	প্লিট,	প্লেট,	
puding,	পুদিং,	পুডিং,	
sethai,	সেথাই,	সেথাই,	
shrabostee,	শ্রাবসটি,	শ্রাবস্তী,	
biphal,	বিপাল,	বিফল,	
durgatsabe,	দুর্গাৎসবে,	দুর্গোৎসবে,	
maritimer,	মারিটিমের,	মেরিটাইমের,	
amudey,	অমুদে,	আমুদে,	
pratisthanik,	প্রতিস্থানিক,	প্রাতিষ্ঠানিক,	
moreecha,	মরিচা,	মরিচা,	
nirikho,	নিরিখো,	নিরিখ,	
seguloi,	সেগুলোই,	সেগুলোই,	
nirbahey,	নির্বাহে,	নির্বাহে,	
dobhaar,	দোভার,	ডোভার,	
ukeliptash,	উকেলিপত্স,	ইউক্যালিপ্টাস,	
swadesh,	স্বদেশ,	স্বদেশ,	
nirbachakder,	নির্বাচকদের,	নির্বাচকদের,	
kamti,	কামটি,	কমতি,	
vaticaner,	ভ্যাটিকানের,	ভ্যাটিকানের,	
gaziipur,	গাজিপুর,	গাজীপুর,	
anchalei,	অঞ্চলেই,	অঞ্চলেই,	
brindabane,	বৃন্দাবনে,	বৃন্দাবনে,	
binee,	বিনে,	বেনি,	
akatwa,	অকত্ব,	একাত্ব,	
kheshar,	খেশার,	খেশার,	
bopoon,	বপুন,	বপন,	
benojir,	বেনোজির,	বেনজীর,	
reflex,	রিফ্লেক্স,	রিফ্লেক্স,	
maner,	মানের,	মানে,	
uzobekeestaan,	উজবেকিৎসান,	উজবেকিস্তান,	
sanaktokaran,	সনকটকরণরা,	সনাক্তকরণ,	
scholastik,	স্কলাস্তিক,	স্কলাস্টিক,	
rockibul,	রকিবুল,	রকিবুল,	
blyaka,	ব্ল্যাক,	ব্ল্যাক,	
saraiki,	সরাইকি,	সরাইকি,	
rubidiyaam,	রুবিদীয়াম,	রুবিডিয়াম,	
deenes,	দেনেস,	দীনেশ,	
khargosher,	খরগোশের,	খরগোসের,	
narsinghomgulor,	নার্সিংহগুলোর,	নার্সিংহোমগুলোর,	
elakasoho,	এলাকাসহ,	এলাকাসহ,	
naagaalyand,	নাগাল্যান্দ,	নাগাল্যান্ড,	
rijoor,	রিজুর,	রিজুর,	
jomoker,	জমকের,	জমকের,	
nagorikota,	নাগরিকতা,	নাগরিকতা,	
average,	আভারেজ,	এভারেজ,	
shangkalonti,	সংকললনটি,	সংকলনটি,	
shilpojaat,	শিল্পজাত,	শিল্পজাত,	
protijogiider,	প্রতিযোগীদের,	প্রতিযোগীদের,	
emiratas,	এমিরাতাস,	এমিরেটাস,	
footbalarra,	ফুটবলাররা,	ফুটবলাররা,	
bossoben,	বসবেন,	বসবেন,	
bhogno,	ভগ্ন,	ভগ্ন,	
taateo,	তাতেও,	তাতেও,	
aakkas,	আক্কাস,	আককাস,	
uporitale,	উপরিতালে,	উপরিতলে,	
antarctica,	অন্টার্ক্টিকা,	অ্যান্টার্কটিকার,	
ateetkaale,	অতীতকালে,	অতীতকালে,	
hool,	হুল,	হুল,	
sotorkobhabey,	সতর্কভাবে,	সতর্কভাবে,	
gobeshokgon,	গবেষকগণ,	গবেষকগণ,	
osamarik,	ওসামারিক,	অসামরিক,	
juboke,	যুবকে,	যুবকে,	
khalidkay,	খালিদকায়,	খালিদকে,	
chitronattakar,	চিত্রনাট্ককার,	চিত্রনাট্যকার,	
maryir,	মারিয়ার,	ম্যারির,	
giitikobita,	গীতিকবিতা,	গীতিকবিতা,	
lubitz,	লুবিজট,	লুবিৎজ,	
dharmadasbabu,	ধর্মদাসবাবু,	ধর্মদাসবাবু,	
bage,	বাগে,	বাগে,	
nirvachokder,	নির্ভাক্ষদের,	নির্বাচকদের,	
ardasho,	আর্দাশো,	আর্দশ,	
kuronir,	কুরোনির,	কুরনীর,	
toler,	টলর,	তালের,	
cholochchitrer,	চলচ্চিত্রের,	চলচ্চিত্রের,	
hakone,	হাঁকে,	হাকোনে,	
uindos,	উইন্ডসো,	উইন্ডোস,	
kod,	কডড,	কোড,	
toki,	টোকি,	তকি,	
kosambir,	কোসাম্বির,	কোসাম্বীর,	
chalachchitrotike,	চালচ্চিত্রকেকে,	চলচ্চিত্রটিকে,	
shamshere,	শামশেরে,	শমসের,	
lyataa,	ল্যাট,	ল্যাটা,	
projanankal,	প্রজাননকাল,	প্রজননকাল,	
iling,	ইলিং,	ইলিং,	
samyuktha,	সম্যুক্ষ,	সামিউক্তা,	
heart,	হার্ট,	হার্ট,	
mukhobondho,	মুখবো্ধ,	মুখবন্ধ,	
baptics,	ব্যাপটিসস,	ব্যাপটিকস,	
atwobishvashi,	আত্ববিশ্বাসী,	আত্মবিশ্বাসী,	
bishwaashshoi,	বিশ্বাশভই,	বিশ্বাসই,	
orbit,	অরবিট,	অরবিট,	
dala,	ডালা,	দলা,	
kormokarer,	কর্মকারের,	কর্মকারের,	
jacksoner,	জ্যাকসনের,	জ্যাকসনের,	
bhromoner,	ভ্রমণের,	ভ্রমণের,	
antorvukta,	আন্তরভুক্ত,	অন্তর্ভুক্ত,	
porbotmala,	পর্বতমালায়,	পর্বতমালা,	
hamburgey,	হ্যামবার্জে,	হামবুর্গে,	
heawy,	হিভি,	হেভি,	
chhutir,	ছুটির,	ছুটির,	
shpredshiit,	স্প্রেডশিট,	স্প্রেডশীট,	
supparak,	সুপপরক,	সুপ্পারক,	
damodar,	দামোদার,	দামদর,	
totokhon,	ততোখন,	ততক্ষন,	
miley,	মিলে,	মিলে,	
pathanirdeshona,	পাথানির্বেশন,	পথনির্দেশনা,	
munot,	মুনোট,	মুনোট,	
heepatitis,	হিপাটাইটিস,	হেপাটাইটিস,	
bharotiyotar,	ভারতীয়তার,	ভারতীয়তার,	
smarok,	স্মারক,	স্মারক,	
homshke,	হোম্ককে,	হোমসকে,	
proshadhoner,	প্রশাধনের,	প্রসাধনের,	
udvabani,	উদ্ভবনি,	উদ্ভাবনী,	
alexandar,	আলেক্সান্ডার,	আলেকজান্ডার,	
khappar,	খপ্পার,	খপ্পর,	
mitroder,	মিত্রদের,	মিত্রদের,	
pleto,	প্লেটো,	প্লেটো,	
bupher,	বুফার,	বাফার,	
azaan,	আজান,	আজান,	
dhhaloor,	ঢালুর,	ঢালুর,	
vezano,	ভেজানো,	ভেজানো,	
ispredsheet,	ইসপ্রেডশিট,	স্প্রেডশীট,	
kichudinpar,	কিছুদিনপর,	কিছুদিনপর,	
lyandim,	ল্যান্ডিম,	ল্যান্ডিং,	
chhooteer,	ছুটির,	ছুটির,	
pluck,	প্লাক,	প্ল্যাক,	
sqalastiqa,	স্ক্যালাস্টিকা,	স্কলাস্টিক,	
deraa,	দেরা,	ডেরা,	
shabkam,	শাকমা,	শবকাম,	
progresh,	প্রোগ্রেশ,	প্রগ্রেস,	
bhromonkaale,	ভ্রমণকালে,	ভ্রমণকালে,	
paste,	পাস্তে,	পেষ্ট,	
komanera,	কমানেরা,	কমানেরা,	
dobhara,	দোভারা,	ডোভার,	
matthews,	ম্যাথিওস,	ম্যাথিউস,	
probeshkari,	প্রবেশকারী,	প্রবেশকারী,	
romarder,	রোমারদের,	রোমারদের,	
dalip,	দালিপ,	দালিপ,	
sharthe,	শার্থে,	স্বার্থে,	
prarthitao,	প্রার্থীতাও,	প্রার্থীতাও,	
iuro,	ইইরো,	ইউরো,	
licensedhari,	লাইসেন্ডাারী,	লাইসেন্সধারী,	
mitrota,	মিত্রতা,	মিত্রতা,	
madeling,	ম্যাডিলিং,	মডেলিং,	
kiuti,	কিউটি,	কিউটি,	
hastantar,	হস্তান্তর,	হস্তান্তর,	
angkita,	অংকিতা,	অঙ্কিতা,	
dormroome,	ডর্মররম,	ডর্মরুমে,	
jarmaniteo,	জারমানিতেও,	জার্মানিতেও,	
parijaner,	পারিজনের,	পরিজনের,	
obhijojan,	অভিযজন,	অভিযোজন,	
siqh,	সিখ,	শিখ,	
chalachchitra,	চলচ্চিত্র,	চলচ্চিত্র,	
byabaharkariderke,	ব্যবহারকারীদেরকে,	ব্যবহারকারীদেরকে,	
pabo,	পাবো,	পাব,	
enjineers,	এনজিনিয়ারস,	ইঞ্জিনিয়ার্স,	
croak,	ক্রোক,	ক্রোক,	
edmeeral,	এডমিরাল,	এডমিরাল,	
sollallhu,	সোল্লালহু,	সল্লাল্লাহু,	
balaruma,	বালারুমা,	বলরুম,	
sanghar,	সংহার,	সংহার,	
euqalyptus,	ইউক্যালাপ্টাস,	ইউক্যালিপ্টাস,	
ekatitto,	একাতিত্ব,	একাতিত্ব,	
oncholeo,	অনচালও,	অঞ্চলেও,	
remacri,	রিমাক্রি,	রেমাক্রী,	
mosjidtir,	মসজিদটির,	মসজিদটির,	
tahalo,	তাহালো,	তাহলো,	
shahurgulor,	শহুরগুলোর,	শহুরগুলোর,	
corymb,	করিম্ব,	করিম,	
horiddare,	হরিদ্দারে,	হরিদ্বারে,	
jaistho,	জয়শ্থ,	জ্যৈষ্ঠ,	
shilbar,	শিলবার,	সিলভার,	
fongli,	ফংংলি,	ফংলি,	
stonehenje,	স্তনেহেঙ্জে,	স্টোনহেঞ্জ,	
goolen,	গুলেন,	গুলেন,	
anutpadanshil,	অনুতপাদনশীল,	অনুৎপাদনশীল,	
anisa,	আনিসা,	আনিস,	
madhabi,	মাধবী,	মাধবী,	
gaj,	গজ,	গেজ,	
hood,	হাড,	হুড,	
chirantan,	চিরান্তন,	চিরন্তন,	
ahalyar,	অহল্যার,	অহল্যার,	
seo,	সেও,	সেও,	
parking,	পারকিং,	পার্কিং,	
torunosomriddho,	তরুণসমৃদ্ধ,	তরুণসমৃদ্ধ,	
dorneca,	ডো্নেকা,	ডরনেকা,	
noitikota,	নৈতিকতা,	নৈতিকতা,	
baarnis,	বার্নিস,	বার্নিশ,	
aagera,	আগেরা,	আগোরা,	
karima,	কারিমা,	করিম,	
rajdhani,	রাজধানী,	রাজধানি,	
meghacchonno,	মেঘাচ্যন্ন,	মেঘাচ্ছন্ন,	
sommoteer,	সম্মতির,	সম্মতির,	
gonjona,	গঞ্জনা,	গঞ্জনা,	
swartho,	স্বার্থ,	স্বার্থ,	
pratisthasaho,	প্রতিস্থাসহ,	প্রতিষ্ঠাসহ,	
hitokor,	হিটোকোর,	হিতকর,	
remakri,	রেমাক্রি,	রেমাক্রী,	
panchasjan,	পঞ্চজসজন,	পঞ্চাশজন,	
abti,	আবটি,	আবতি,	
notey,	নোটে,	নোটে,	
shekarone,	শেকারণে,	সেকারণে,	
tonoo,	তোনো,	তনু,	
armashtram,	আর্মস্থ্রম,	আর্মস্ট্রং,	
pathanatak,	পাঠানাকক,	পথনাটক,	
gobeshonar,	গবেষণার,	গবেষনার,	
drissogulote,	দৃশ্যগুলোতে,	দৃশ্যগুলোতে,	
korush,	করুশ,	ক্রুশ,	
tigre,	তিগ্রে,	টাইগার,	
chongar,	চঙ্গর,	চোঙ্গার,	
sahinsatar,	সহিনসতার,	সহিংসতার,	
chatrorai,	ছাত্ররাই,	ছাত্ররাই,	
faaj,	ফজজ,	ফাজ,	
jamseder,	জামসেদের,	জামসেদের,	
obdee,	বব্দি,	অব্দি,	
medilek,	মেদিলেক,	মেডিলেক,	
nehle,	নেহলে,	নেহলে,	
venisey,	ভেনিসে,	ভেনিসে,	
nisshongotake,	নিঃশঙ্গতাকে,	নিঃসঙ্গতাকে,	
monur,	মনুর,	মনুর,	
purbanchaler,	পূর্বাঞ্চলের,	পূর্বাঞ্চলের,	
shukrabab,	শুক্রবাব,	শুক্রবাব,	
inphormeshon,	ইনফ্রোশেন,	ইনফরমেশন,	
rahimed,	রহিমেদ,	রহিমেদ,	
matt,	ম্যাট,	ম্যাট,	
barbadoj,	বারবাদজ,	বার্বাডোজ,	
shilpikuler,	শিল্পিকুলের,	শিল্পীকুলের,	
panda,	পান্ডা,	পান্ডে,	
soleel,	সলিল,	সলিল,	
dhaleshwari,	ধলেশ্বরী,	ধলেশ্বরী,	
kinsa,	কিনসা,	কিংস,	
definition,	ডিফিশনশন,	ডেফিনেশন,	
lisense,	লিসেন্স,	লাইসেন্স,	
hansasya,	হাঁসস্য,	হংসস্য,	
longhan,	লঙ্ঘন,	লংঘন,	
shniper,	শ্নীপের,	স্নাইপার,	
bitertrate,	বিটার্ট্রেট,	বাইটারট্রেট,	
greenald,	গ্রিনাল্ড,	গ্রিনল্ড,	
bhogiroth,	ভোগীরথ,	ভগীরথ,	
bishashke,	বিশাশকে,	বিশ্বাসকে,	
rena,	রেনা,	রেনো,	
nathivukteer,	নথিভুক্তের,	নথিভুক্তির,	
shikshakbrinda,	শিক্ষাকবৃন্দ,	শিক্ষকবৃন্দ,	
pleena,	প্লিনা,	প্লেন,	
chokrantosoho,	চক্রান্তসহ,	চক্রান্তসহ,	
nick,	নিক,	নিক্,	
poorohitra,	পুরোহিত্র,	পুরোহিতরা,	
saoum,	সাওম,	সাওম,	
bairey,	বাইরে,	বাইরে,	
registrikrito,	রেজিস্ট্রিকৃত,	রেজিস্ট্রীকৃত,	
graambasheeo,	গ্রামবাশীও,	গ্রামবাসীও,	
kabutorer,	কবুতরের,	কবুতরের,	
karuna,	কাুনা,	করুণা,	
skolastik,	স্কলাস্তিক,	স্কলাস্টিক,	
abhidhanick,	অভিধানিক,	অভিধানিক,	
saptahokal,	সপ্তাহকাল,	সপ্তাহকাল,	
timoothi,	তিমুথি,	টিমোথি,	
milekhanek,	মিলেখানেক,	মাইলখানেক,	
vange,	ভ্ঙ্গে,	ভাঙ্গে,	
proo,	প্রো,	প্রো,	
qlauda,	ক্লাদ,	ক্লাউড,	
chhuti,	ছুটি,	ছুটি,	
baibosthar,	বৈবস্থার,	ব্যবস্থার,	
perri,	পেরি,	পেরি,	
deeares,	ডায়ারেস,	ডিআরএস,	
dakshinangsho,	দক্ষিণাংশ,	দক্ষিণাংশ,	
shikhra,	শিখরা,	শিখরা,	
paramartha,	পরমার্থ,	পরমার্থ,	
ahmed,	আহমেদ,	আহামদ,	
russad,	রুসাদ,	রুশদ,	
morathee,	মরাথি,	মরাঠি,	
pratiyogitar,	প্রতিযোগীতার,	প্রতিযোগীতার,	
bonsho,	বংশ,	বংশ,	
rohasyati,	রোহাস্যাটি,	রহস্যটি,	
corsin,	কর্সিন,	করসিন,	
cloring,	ক্লোরিং,	ক্লোরিং,	
roopdaan,	রূপদান,	রুপদান,	
fooloo,	ফুলো,	পোলো,	
laishenshim,	লাইশেনশিম,	লাইসেন্সিং,	
donat,	দোনাত,	ডোনাট,	
chheher,	ছেহের,	ছেহের,	
onkush,	অঙ্কুষ,	অংকুশ,	
chrystal,	ক্রিস্টলাল,	ক্রাইস্টাল,	
ajij,	আজিজ,	আজিজ,	
pouchute,	পৌছুতে,	পৌঁছুতে,	
graambasio,	গ্রামবাসিও,	গ্রামবাসীও,	
shringge,	শ্রিংগে,	শৃঙ্গে,	
aatmobishwasi,	আত্মবিশ্বাসী,	আত্মবিশ্বাসী,	
shardotsobei,	শার্তদসবেই,	শারদোৎসবেই,	
prodiiper,	প্রদীপেয়ের,	প্রদীপের,	
poketchorder,	পকেটচর্ডের,	পকেটচরদের,	
kinsha,	কিনশা,	কিংস,	
gyada,	জ্ঞাদা,	গ্যাদা,	
oitijhya,	ঐতিহ্যা,	ঐতিহ্য,	
vogno,	ভোগ্ন,	ভগ্ন,	
drishi,	দ্রিশি,	দৃশ্যই,	
mexicoteo,	মেক্সিকোটোও,	মেক্সিকোতেও,	
emarjenshi,	এমারজেন্সি,	এমার্জেন্সি,	
deputee,	দেপুটি,	ডেপুটি,	
palta,	পাল্টা,	পালটা,	
quartar,	কোয়ার্টার,	কোয়ার্টার,	
torunderke,	তরুণ্ডরকে,	তরুণদেরকে,	
ameettrakkhor,	আমিত্রাক্ষর,	অমিত্রাক্ষর,	
japanostho,	জাপানস্থ,	জাপানস্থ,	
amar,	আমার,	আমর,	
shho,	শাপ,	শো,	
marketin,	মার্কেটিন,	মার্কেটিং,	
raia,	রাইয়া,	রায়,	
rifleksa,	রিফলেকসা,	রিফ্লেক্স,	
jerushalema,	জেরুশালামা,	জেরুসালেম,	
awrbit,	আইরবিট,	অরবিট,	
rakkhanbhag,	রক্ষণভাগ,	রক্ষণভাগ,	
aansaareer,	আনসারীর,	আনসারীর,	
prachirer,	প্রাচীরের,	প্রাচিরের,	
palestine,	প্যালেস্টাইন,	প্যালেস্টাইনে,	
rajotwo,	রাজত্ব,	রাজত্ব,	
bhangchur,	ভংংচুর,	ভাংচুর,	
ranangane,	রনাঙ্গনে,	রণাঙ্গনে,	
kaaferder,	কাফেরদের,	কাফেরদের,	
neerbahi,	নির্বাহী,	নির্বাহি,	
elakaate,	এলাকাতে,	এলাকাতে,	
literacy,	লাইটারেসি,	লিটারেসি,	
bidhirnityang,	বিধির্নিত্যাং,	বিধির্নিত্যং,	
hughkey,	হাগকে,	হিউজকে,	
sookumari,	সুকুমারী,	সুকুমারী,	
bhejaano,	ভেজানও,	ভেজানো,	
ganoporibahoner,	গণপরিবহনের,	গণপরিবহনের,	
bidyadanke,	বিদ্যাদানকে,	বিদ্যাদানকে,	
sofie,	সোফি,	সোফি,	
chamski,	চাস্ককি,	চমস্কি,	
horippur,	হরিপুর,	হরিপুর,	
lajik,	লাজিক,	লজিক,	
gannaprakasham,	গণ্যপ্রকাশম,	গন্নাপ্রকাশম,	
peengna,	পিনগানা,	পিংনা,	
jahangirbad,	জাহাঙ্গীবর্দ,	জাহাঙ্গীরবাদ,	
samaptir,	সমাপ্তির,	সমাপ্তির,	
alexanderke,	আলেক্সান্ডারকে,	আলেকজান্ডারকে,	
danata,	দানাটা,	ডোনাট,	
songkolonti,	সংকলনটি,	সংকলনটি,	
nirgaman,	নির্গামান,	নির্গমন,	
maailkhanek,	মাইলখাডেক,	মাইলখানেক,	
protijogiitamulok,	প্রতিযোগিতামূলক,	প্রতিযোগীতামূলক,	
parq,	পারক,	পার্ক,	
spashtotai,	স্পষ্টতায়,	স্পষ্টতই,	
confliqt,	কনফ্লিক্ট,	কনফ্লিক্ট,	
metrikoleshana,	মেট্রিকোলেশন,	মেট্রিকোলেশন,	
niropekkho,	নিরপেক্ষ,	নিরপেক্ষ,	
oisamoyer,	ওসাময়ের,	ঐসময়ের,	
hydrological,	হাইড্রোলজিক্যাল,	হাইড্রোলজিক্যাল,	
directorete,	ডিরেক্টরতে,	ডিরেক্টরেট,	
alumni,	আলুমনি,	অ্যালমনি,	
chaka,	চাকা,	চাকা,	
akmato,	আকমাতো,	একমত,	
hertj,	হার্টজ,	হার্জ,	
asovyo,	অসভ্য,	অসভ্য,	
shoriph,	শরিফ,	শরিফ,	
poddhotiteyi,	পদ্ধতিতে,	পদ্ধতিতেই,	
bandhan,	বাঁধান,	বাঁধন,	
segulo,	সেগুলো,	সেগুলো,	
bouddho,	বৌদ্ধ,	বৌদ্ধ,	
volapuk,	ভলাপুক,	ভোলাপুক,	
koyekbare,	কয়েকবারে,	কয়েকবারে,	
cxt,	সিএসটিএ,	সিএক্সটি,	
omarader,	ওমারাদের,	ওমারাদের,	
valobasen,	ভালোবাসেন,	ভালোবাসেন,	
esprito,	এস্প্রিত,	এস্পিরিটো,	
swairacharibirodhi,	স্বৈরাচারবিরোধী,	স্বৈরাচারীবিরোধী,	
jaatti,	জাত্তি,	জাতটি,	
israelbahini,	ইসরালিইফাহিনি,	ইস্রায়েলবাহিনী,	
tukrote,	তুকরোতে,	টুকরোতে,	
moomtaj,	মুমতাজ,	মুমতাজ,	
buddhitii,	বুদ্ধিটি,	বুদ্ধিটিই,	
satarkabhabey,	সতর্কভাবে,	সতর্কভাবে,	
drishyogulotey,	দৃশ্যগুলিতে,	দৃশ্যগুলোতে,	
shanno,	শান্ন,	সান্নো,	
heteler,	হেটেলের,	হেটেলের,	
difinishian,	ডিফিনিভনিন,	ডেফিনেশন,	
domone,	ডমনে,	দমনে,	
chhutee,	ছুটি,	ছুটি,	
dipti,	দীপ্তি,	ডেপুটি,	
ovinetar,	অভিনেতার,	অভিনেতার,	
salafeta,	সালাফেটা,	সালফেট,	
madhoori,	মাধুরি,	মাধুরী,	
jotsna,	জোস্ন,	জ্যোৎস্না,	
shfingtar,	শ্বিংটার,	স্ফিংটার,	
farid,	ফারিদ,	ফরিদ,	
amburi,	অম্বুরী,	আম্বুরি,	
mahibur,	মহিবুর,	মহিবুর,	
duiekdiner,	দুইেকদীনের,	দুইএকদিনের,	
ohalyar,	ওহাল্যার,	অহল্যার,	
talgachh,	তালগাছ,	তালগাছ,	
dhangsachchi,	ধ্বংসচ্চি,	ধ্বংসাচ্ছি,	
karlei,	করলেই,	করলেই,	
sarsa,	সারসা,	সোর্স,	
kayartara,	কায়ার্তরা,	কোয়ার্টার,	
kusumeshu,	কুসুমেষু,	কুসুমেষু,	
kantajir,	কান্তাজীর,	কান্তজির,	
uttor,	উত্তর,	উওর,	
bangulzai,	বাঙ্গুলজাই,	বঙ্গুলিজাই,	
teenej,	তেনিজ,	টিনেজ,	
prakar,	প্রকার,	প্রকার,	
byaboharkarike,	ব্যবহারকারীকে,	ব্যবহারকারীকে,	
shresthoshcho,	শ্রেষ্ঠচ্চ,	শ্রেষ্ঠশ্চ,	
aashtikotaa,	অষ্টিকতা,	আস্তিকতা,	
shukraanoo,	শুকরানৌ,	শুক্রানু,	
thakeni,	থাকেনি,	থাকেনি,	
kobulennechha,	কবুলেনেনছা,	কবুলেন্নেছা,	
simaa,	সিমা,	সীমা,	
spredashiita,	স্প্রেডাশিয়াট,	স্প্রেডশীট,	
beauby,	বিউবি,	বিউবি,	
bosano,	বসানো,	বসানো,	
huk,	হুক,	হুক,	
beshyasdone,	বেশ্যাদসনে,	বেশ্যাসদনে,	
bhabaaponno,	ভবপান্য,	ভাবাপন্ন,	
hosne,	হোসনে,	হোসনে,	
motabolombira,	মতাবলম্বীরা,	মতাবলম্বীরা,	
deep,	দীপ,	দীপ,	
sportstar,	স্পোর্টস্টার,	স্পোর্টসস্টার,	
obosan,	অবসান,	অবসান,	
reshidensha,	রেশিদেনশা,	রেসিডেন্স,	
ovarview,	ওভারভিউ,	ওভারভিউ,	
dhandu,	ধন্দু,	ধন্দু,	
nutunotto,	নুতুনত্ব,	নতুনত্ব,	
highcommissionay,	হাইক্সোমিনিয়া,	হাইকমিশনে,	
abhidhaanic,	অভিধানিক,	অভিধানিক,	
niemond,	নিইমন্ড,	নিমন্ড,	
bandra,	বন্দ্রা,	বন্দীরা,	
ancholgoolir,	অঞ্চলগুলির,	অঞ্চলগুলির,	
koordider,	করর্ডাইডের,	কুর্দিদের,	
pronoti,	প্রণতি,	প্রণতি,	
chemjong,	চেমগং,	চেমজং,	
pader,	পাদের,	প্যাডের,	
maailey,	মাইলে,	মাইলে,	
moushum,	মৌশুম,	মৌসুম,	
touraat,	তররাত,	তওরাত,	
dormitory,	ডর্মিটরি,	ডরমিটরি,	
palkee,	পালকী,	পাল্কি,	
dorgah,	দরগাহ,	দরগাহ,	
grushko,	গ্রুশকো,	গ্রুশকো,	
zozyota,	যোজ্যতা,	যোজ্যতা,	
bapio,	বাপিও,	বাপিও,	
mohajote,	মহাযোতে,	মহাজোট,	
ujobekeestaner,	উজবৈক্ষেতানের,	উজবেকিস্তানের,	
asantosh,	অসন্তোষ,	অসন্তোষ,	
blasterke,	ব্লাস্টারকে,	ব্লাস্টারকে,	
robot,	রবট,	রোবোট,	
courtcaser,	কোর্টকাসের,	কোর্টকেসের,	
phutonta,	ফুটোনটা,	ফুটন্ত,	
talaa,	তালা,	তালা,	
plack,	প্ল্যাক,	প্ল্যাক,	
lakkhero,	লক্ষেরও,	লক্ষেরও,	
nomo,	নোমো,	নমো,	
soinyo,	সৈন্য,	সৈন্য,	
byabaharkaree,	ব্যবহারকারী,	ব্যবহারকারী,	
engrejra,	এংগেরজররা,	ইংরেজরা,	
contemporary,	কন্টেমবোরারি,	কন্টেম্পোরারি,	
dii,	দিয়,	দিই,	
dakticket,	ডক্্িকেট,	ডাকটিকিট,	
danakana,	দানাকানা,	ডানকান,	
suparharo,	সুপারহারও,	সুপারহিরো,	
semai,	সেমাই,	সেমাই,	
vabaponno,	ভবপান্য,	ভাবাপন্ন,	
chapal,	চাপল,	চপল,	
shajano,	শাজানো,	সাজানো,	
fitarsaho,	ফিতারসহ,	ফিতরসহ,	
mandondo,	মানদন্ড,	মানদণ্ড,	
bibecchyo,	বিবেচ্য,	বিবেচ্য,	
jati,	জাতি,	যাতি,	
somoibo,	সময়বো,	সমৈব,	
swarther,	স্বার্থের,	স্বার্থের,	
taposgoner,	তাপসগণের,	তাপসগণের,	
poschime,	পশ্চিমে,	পশ্চিমে,	
nikela,	নিকেলা,	নিকেল,	
modelkey,	মডেলকে,	মডেলকে,	
asovya,	অসভ্যা,	অসভ্য,	
digree,	ডিগ্রি,	ডিগ্রি,	
soori,	সুরী,	সুরি,	
blogarra,	ব্লাগররা,	ব্লগাররা,	
gopalrao,	গোপালরাও,	গোপালরাও,	
brojomohun,	ব্রোমহনুন,	ব্রোজোমোহন,	
shulfate,	শুলফাতে,	সালফেট,	
madhobi,	মাধবী,	মাধবী,	
bossonte,	বসন্তে,	বসন্তে,	
deobonde,	দেওবন্দে,	দেওবন্দে,	
bonvumitey,	বনভুতিজে,	বনভূমিতে,	
siddhanto,	সিদ্ধান্ত,	সিদ্ধান্তও,	
bardhitansh,	বর্ধিতানশ,	বর্ধিতাংশ,	
nuhas,	নুহাস,	নুহাশ,	
amarjito,	অমরজিত,	অমার্জিত,	
sepha,	সেফা,	শেফ,	
sheshdinti,	শেষদিন্তি,	শেষদিনটি,	
helly,	হেল্লি,	হিলি,	
swastir,	স্বস্তির,	স্বস্তির,	
samanyai,	সমন্যই,	সামান্যই,	
aakabar,	আকাবার,	আকাবার,	
lotharan,	লোথারন,	লুথেরান,	
elaakaati,	এলাকাটি,	এলাকাটি,	
chirkut,	চিরকুট,	চিরকুট,	
abhidhaaneeck,	অভিধানিক,	অভিধানিক,	
torkarite,	তর্কারিতে,	তরকারিতে,	
kaia,	কাইয়া,	কায়া,	
kei,	কেই,	কেই,	
nathivookto,	নথিভুক্ত,	নথিভুক্ত,	
chakundite,	চাকুন্ডিতে,	চাকুন্দিতে,	
pulivendla,	পুলিভেন্ডল,	পুলিভেন্ডলা,	
hozot,	হজোট,	হজত,	
ponero,	পনেরও,	পনের,	
kortona,	কর্তনা,	করতনা,	
jerusalemer,	জেরুসালেমের,	জেরুজালেমের,	
ovidhanik,	অভিধানিক,	অভিধানিক,	
mukhya,	মুখ্যা,	মুখ্য,	
joisttho,	জয়স্থ,	জ্যৈষ্ঠ,	
procharona,	প্রচারণা,	প্রচারণা,	
bouddha,	বৌদ্ধ,	বৌদ্ধ,	
bhramarotsab,	ভ্রমমর্তবা,	ভ্রমরোৎসব,	
muhuriganj,	মুহুরীগঞ্জ,	মুহুরীগঞ্জ,	
deh,	দেহ,	দেহ্,	
senabahinikey,	সেনাবাহিনীকে,	সেনাবাহিনীকে,	
saurce,	সোরস,	সোর্স,	
amittrakkhor,	আমিত্মার্কর,	অমিত্রাক্ষর,	
kurdira,	কুরদিরা,	কুর্দিরা,	
avisongson,	আভিসংসন,	অভিশংসন,	
poriharsoho,	পরিহারসহ,	পরিহারসহ,	
konar,	কোনার,	কণার,	
chenza,	চেনজা,	চেঞ্জ,	
neelkamal,	নীলকামাল,	নীলকমল,	
janosamaj,	জনসম্জ,	জনসমাজ,	
difinision,	ডিফিনিশন,	ডেফিনেশন,	
saabyastha,	সাব্যস্থ,	সাব্যস্থ,	
bisshonath,	বিশ্বনাথ,	বিশ্বনাথ,	
prity,	প্রিটি,	প্রিটি,	
windos,	উইন্ডোস,	উইন্ডোস,	
kotibondhe,	কোিদন্ধে,	কটিবন্ধে,	
manushti,	মনুষ্টি,	মানুষটি,	
disposes,	ডিসপোসেস,	ডিসপোজেস,	
sedikei,	সেদিকেই,	সেদিকেই,	
himsrot,	হিমস্রোট,	হিমস্রোত,	
firoza,	ফিরোজা,	ফিরোজা,	
shoreefpur,	শরীফপুর,	শরিফপুর,	
utotoro,	উততর,	উততর,	
ralf,	র্যালফ,	রালফ,	
qaferder,	কাফারদের,	কাফেরদের,	
madelim,	মাদেলিম,	মডেলিং,	
shandra,	শনন্দ্রার,	শান্দ্রার,	
dai,	দাই,	দিই,	
innahu,	ইন্নাহু,	ইন্নাহু,	
sossar,	সোসার,	সকার,	
saatzoner,	সাতজোনের,	সাতজনের,	
sukumaree,	সুকুমারী,	সুকুমারী,	
satarkatar,	সতর্কতার,	সতর্কতার,	
otyacharer,	অত্যাচারের,	অত্যাচারের,	
poriikkhateo,	পরিক্ষাতেও,	পরীক্ষাতেও,	
dhauto,	ধাত,	ধৌত,	
udbhaboni,	উদ্ভাবনী,	উদ্ভাবনী,	
sarboporee,	সর্বপরি,	সর্বোপরী,	
romancha,	রোমাঞ্চা,	রোমাঞ্চ,	
soundarja,	সৌন্দর্য্য,	সৌর্ন্দয্য,	
oikhan,	ওখহান,	ঐখান,	
ramolino,	রামলিনো,	রামোলিনো,	
mahafezkhanar,	মহাফেখখননার,	মহাফেজখানার,	
streegon,	স্ট্রীগন,	স্ত্রীগণ,	
volivoler,	ভলিভিলর,	ভলিভলের,	
bhimsenkei,	ভীমসেনকেই,	ভীমসেনকেই,	
cholocchitrer,	চলচ্চিত্রের,	চলচ্চিত্রের,	
toufik,	টৌফিক,	তৌফিক,	
parabortee,	পরবর্তী,	পরর্বতী,	
adhunikkaley,	আধুনিককালে,	আধুনিককালে,	
venuser,	ভেনাসের,	ভেনাসের,	
saras,	সারাস,	সরস,	
said,	সাইদ,	সাইদ,	
proshtotto,	প্রস্তত্ব,	প্রস্ত্তত,	
proboleme,	প্রবলেমে,	প্রবলেমে,	
carloos,	কার্লুস,	কার্লোস,	
shilpajata,	শিল্পজাতা,	শিল্পজাত,	
machsoho,	মাছসহ,	মাছসহ,	
madrasa,	মাদ্রাসা,	মাদ্রাসা,	
prasadhoner,	প্রাসাধনের,	প্রসাধনের,	
chinto,	চিন্তো,	চিনতো,	
ponera,	পনেরা,	পনের,	
lambaate,	ল্যামবাটে,	লম্বাটে,	
koreempoor,	করিমপুর,	করিমপুর,	
kade,	কাদে,	কোড,	
ghoomato,	ঘুমাতো,	ঘুমাতো,	
daqop,	ডাকোপ,	দাকোপ,	
baffer,	বাফার,	বাফার,	
beatleser,	বিটলেসের,	বিটলসের,	
foreks,	ফোরেকস,	ফরেক্স,	
bahati,	বাহাটি,	বাহাতি,	
sathik,	সাথিক,	সঠিক,	
sarjur,	সারুজুর,	সরযূর,	
proshtutkarok,	প্রস্তুতকারক,	প্রস্তুতকারক,	
disni,	ডিসনি,	ডিজনী,	
goora,	গুরা,	গোর,	
deciliter,	ডেসিলাইটের,	ডেসিলিটার,	
bojiye,	বোজিয়ে,	বজিয়ে,	
treebhuj,	ত্রিভূজ,	ত্রিভূজ,	
qarlosa,	কার্লোসা,	কার্লোস,	
varote,	ভারতে,	ভারতে,	
baire,	বাইরে,	বাইরে,	
sayanaida,	সায়নাই,	সায়ানাইড,	
probondhobhittik,	প্রবন্ধভিত্তিক,	প্রবন্ধভিত্তিক,	
obosorer,	অবসরের,	অবসরের,	
chalochchitraeei,	চলচ্চিত্রেই,	চলচ্চিত্রেই,	
godamjato,	গদামজাত,	গুদামজাত,	
ikbaaler,	ইকবালের,	ইকবালের,	
foks,	ফকস,	ফক্স,	
jubokti,	যুবকটি,	যুবকটি,	
forex,	ফোরেক্স,	ফরেক্স,	
vault,	ভাউলট,	ভল্ট,	
directarate,	ডিরেক্টরেট,	ডিরেক্টরেট,	
jund,	জুন্ড,	জুন্দ,	
asiatic,	এশিয়াতিক,	এশিয়াটিক,	
kajangale,	কাজাঙ্গালে,	কজঙ্গলে,	
fishing,	ফিশিং,	ফিসিং,	
apolokbhabe,	অপলোকভাবে,	অপলকভাবে,	
mozlis,	মজলিস,	মজলিশ,	
carlo,	কারলো,	কার্লো,	
sorting,	সর্টিং,	সর্টিং,	
atmiyasulabh,	আত্মীয়সুলভ,	আত্মীয়সুলভ,	
teter,	টেটের,	টেটের,	
tochhnochh,	তোচনচ,	তছনছ,	
hattey,	হ্যাটে,	হাঁটতে,	
chalochchitro,	চলচ্চিত্র,	চলচ্চিত্র,	
pnouchute,	পৌঁচুতে,	পৌঁছুতে,	
fand,	ফ্যান্ড,	ফান্ড,	
salsa,	সালসা,	সালসা,	
nobotomo,	নবতম,	নবতম,	
pratiyogita,	প্রতিযোগীতা,	প্রতিযোগীতা,	
echhti,	এছতিই,	এছটি,	
shoreefer,	শরীফের,	শরিফের,	
bujhtepari,	বুঝতেপারী,	বুঝতেপারি,	
langhangulir,	লঙ্ঘনগুলির,	লঙ্ঘনগুলির,	
brail,	ব্রেইল,	ব্রেইল,	
ansarir,	আনসারীর,	আনসারীর,	
besooro,	বেসুরো,	বেসুর,	
brake,	ব্রাকে,	ব্রেক,	
bishshasho,	বিষশাশ,	বিশ্বাসও,	
joumana,	জৌমানা,	জুমানা,	
landin,	লান্ডিন,	ল্যান্ডিং,	
seoul,	সেওউল,	সোল,	
elaaka,	এলাকা,	এলাকা,	
prosadhoni,	প্রসাধনী,	প্রসাধনী,	
basab,	বাসাব,	বাসাব,	
noditei,	নদীতেই,	নদীতেই,	
fud,	ফিউড,	ফুড,	
dhojovongo,	ধবযং্গ,	ধ্বজভঙ্গ,	
dagmukta,	দাগমুক্ত,	দাগমুক্ত,	
narsaari,	নরসারি,	নার্সারি,	
chaalkee,	চালকী,	চালকে,	
girilal,	গিরিলাল,	গিরিলাল,	
thyachara,	থ্যাচার,	থ্যাচার,	
bibhinno,	বিভিন্ন,	বিভন্ন,	
juktorastrer,	যুক্তরাস্ত্রের,	যুক্তরাষ্ট্রের,	
rasunkunchi,	রসসুঞ্চুচি,	রসুনকুঁচি,	
gujob,	গুজব,	গুজব,	
canservatian,	ক্যান্সারভেনান,	কনসারভেশন,	
cbi,	সিবিআই,	সিবিআই,	
antercticker,	অন্টারক্সিকের,	অ্যান্টার্কটিকের,	
hevy,	হেভি,	হেভি,	
dadar,	দাদার,	দাদার,	
gandogol,	গণ্ডগোল,	গন্ডগোল,	
tiger,	টিগের,	টাইগার,	
chal,	চাল,	চাল,	
keyu,	কেই,	কেউ,	
mardud,	মারদুদ,	মরদুদ,	
ashankai,	আশঙ্কাই,	আশঙ্কাই,	
jalarong,	জালারাং,	জলরঙ,	
nowel,	নুউেল,	নভেল,	
aarmstrong,	এর্মস্ট্রং,	আর্মস্ট্রং,	
mahasava,	মহাসভা,	মহাসভা,	
pachak,	পাচক,	পাচক,	
doorotomo,	দূরতম,	দূরতম,	
khoor,	খুর,	ক্ষুর,	
songrahak,	সংগ্রহক,	সংগ্রাহক,	
mele,	মেল,	মাইল,	
prabhritite,	প্রভৃতিতে,	প্রভৃতিতে,	
farhetin,	ফারহেটিন,	ফারহেতিন,	
krishibigyani,	কৃষিবিজ্ঞানী,	কৃষিবিজ্ঞানী,	
romjaner,	রোমজনের,	রমযানের,	
ruble,	রাবল,	রুবল,	
sbaajan,	স্বজন,	স্বজন,	
bisnoo,	বিস্নু,	বিষ্ণু,	
seconder,	সেকন্ডার,	সেকেন্ডের,	
uddhrita,	উদ্ধৃত,	উদ্ধৃত,	
ghomtaa,	ঘোমটা,	ঘোমটা,	
garora,	গারোরা,	গারোরা,	
aosafur,	আওসাফুর,	আওশাফুর,	
gingbhalobasen,	গিংবালবভানে,	গিংভালোবাসেন,	
juktarashtrasaha,	যুক্তরা্টরসসহ,	যুক্তরাষ্ট্রসহ,	
sangbadmadhyamgulote,	সংবাদমাধ্যমগুলোতে,	সংবাদমাধ্যমগুলোতে,	
bangobandhu,	বঙ্গবন্ধু,	বঙ্গবন্ধু,	
female,	ফেমালে,	ফিমেল,	
fol,	ফোল,	ফল,	
moshjidke,	মসবিতকে,	মসজিদকে,	
thaii,	থাইই,	থাই,	
sahajlabhbhotar,	সহজলভভততার,	সহজলভ্যতার,	
sipa,	সিপা,	শিপ,	
dinar,	দিনার,	ডিনার,	
bipradas,	বিপ্রদাস,	বিপ্রদাস,	
taderek,	তােরেক,	তাদেরেক,	
kakhnoba,	কক্্ভা,	কখনওবা,	
capsul,	ক্যাপসুল,	ক্যাপসুল,	
samanwitovabe,	সান্বতিতভাবে,	সমন্বিতভাবে,	
baganoto,	বাগানত,	বাগানত,	
madraser,	মাদ্রাসের,	মাদ্রাজের,	
khilaphat,	খিলাফত,	খিলাফত,	
bonorajite,	বনরাজিতে,	বনরাজিতে,	
fulkapi,	ফুলকাপি,	ফুলকপি,	
piulir,	পিউলির,	পিউলির,	
cantan,	ক্যান্টান,	ক্যান্টন,	
golghare,	গোঘরে,	গোলঘরে,	
nariider,	নারীদের,	নারীদের,	
norpholk,	নরফলক,	নরফোক,	
jeshtha,	যেশ্থ,	জ্যেষ্ঠা,	
phormat,	ফরম্যাট,	ফরম্যাট,	
phonekari,	ফোনকেরি,	ফোনকারী,	
sohinsotar,	সোহিনসতার,	সহিংসতার,	
neutrinoo,	নিউট্রিনো,	নিউট্রিনো,	
kiibord,	কিবডর্ড,	কীবোর্ড,	
katui,	কাটুই,	কাতুই,	
oshtader,	ওষ্টাদের,	ওস্তাদের,	
kyatgarite,	ক্যাটগারিতে,	ক্যাটগারিতে,	
manatmulak,	মনন্মুলক,	মানতমূলক,	
lutheerana,	লুথিরান,	লুথেরান,	
gamdan,	গামডান,	গামদান,	
dorgaaho,	দরগাহ,	দরগাহ,	
bahjya,	বাহ্যা,	বাহ্য,	
pancbaar,	পাঁকবার,	পাঁচবার,	
hilser,	হিলসার,	হিলসের,	
meshenjar,	মেশেনজার,	মেসেঞ্জার,	
jerusalema,	জেরুসালেমা,	জেরুসালেম,	
shcholastic,	শ্কোলাস্টিক,	স্কলাস্টিক,	
nirmol,	নির্মল,	নির্মল,	
adhyatmik,	আধ্যাত্মিক,	আধ্যাত্মিক,	
ghamta,	ঘামটা,	ঘোমটা,	
liedtke,	লিডটকে,	লইডটক,	
anhu,	আনহু,	আনহু,	
mercedes,	মার্সেডেস,	মার্সেডেস,	
olympicer,	অলিম্পিকের,	অলিম্পিকের,	
tolemy,	টলেমি,	টলেমির,	
nirbaaho,	নির্বাহ,	নির্বাহ,	
sahapathike,	সহপাঠীকে,	সহপাঠীকে,	
suraaropeeto,	সুরাপরিত,	সুরারোপিত,	
abosan,	অবসান,	অবসান,	
graambashee,	গ্রামবশী,	গ্রামবাসী,	
janmat,	জন্মাত,	জন্মাত,	
mookhomandoler,	মুকোমান্ডলের,	মুখমণ্ডলের,	
jhamala,	ঝামালা,	ঝামালা,	
manober,	মানবের,	মানবের,	
nanabornobishishto,	নানাবর্বিশনশিত,	নানাবর্ণবিশিষ্ট,	
ramzaner,	রামজনের,	রমযানের,	
udbodhani,	উদ্বোধনি,	উদ্বোধনী,	
shhashtra,	শাস্ত্রা,	শাস্ত্র,	
esoosiyetasa,	এসুসিয়েসা,	এসোসিয়েটস,	
jamjomat,	জাম্জাতাত,	জমজমাট,	
orthobochorke,	অর্থবছরকে,	অর্থবছরকে,	
jamarate,	জামারাতে,	জামারাতে,	
hari,	হারি,	হরি,	
attacharito,	অ্যাটাচারিত,	অত্যাচারিত,	
sondhisthaponer,	সন্ধিষ্যাপনের,	সন্ধিস্থাপনের,	
bhoolapuka,	ভুলাপুকা,	ভোলাপুক,	
fastara,	ফস্তারা,	ফস্টার,	
eukalyptus,	ইউক্যাল্ট্টাস,	ইউক্যালিপ্টাস,	
shuri,	শুরী,	সুরি,	
teliha,	তেলিহা,	তেলিহা,	
oitijjha,	ঐতিহ্তা,	ঐতিহ্য,	
sanstha,	সংস্থ,	সংস্থা,	
bbiswasho,	বিবিবশ্ব,	বিশ্বাসও,	
ajibooner,	অজিবুনের,	আজীবনের,	
kisti,	কিস্তি,	কিস্তি,	
footbalarer,	ফুটবলারের,	ফুটবলারের,	
milekhaanek,	মিলেখানেক,	মাইলখানেক,	
udor,	উদর,	উদর,	
scholarsip,	স্কলারসিপ,	স্কলারশিপ,	
rahshahi,	রাহশাহী,	রাহশাহী,	
mohammadi,	মোহাম্মাদি,	মুহাম্মদী,	
saainyo,	সাইন্যো,	সৈন্য,	
bachhaikrito,	বাছাইকৃত,	বাছাইকৃত,	
cholochchitrai,	চলচ্চিত্রাই,	চলচ্চিত্রই,	
bhyatikaner,	ভ্যাটিকানের,	ভ্যাটিকানের,	
kutubuddinke,	কুটুবুদ্দিনকে,	কুতুবুদ্দিনকে,	
ghoorchen,	ঘুরছেন,	ঘুরেছেন,	
probhuder,	প্রভুদের,	প্রভুদের,	
dokaangulotey,	দোকানগুলিতেও,	দোকানগুলোতে,	
ghurechen,	ঘুরেছেন,	ঘুরেছেন,	
niurolaji,	নিউরলাজি,	নিউরোলজি,	
nabbata,	নব্বতা,	নাব্যতা,	
olympik,	অলিম্পিক,	অলিম্পিক,	
baasaate,	বসসতে,	বাসাতে,	
hisaber,	হিসাবের,	হিসাবের,	
tiunara,	তিউনার,	টিউনার,	
charger,	চার্গের,	চার্জার,	
ishahak,	ইশাহক,	ইসাহাক,	
bosonte,	বসন্তে,	বসন্তে,	
bade,	বাদে,	বাদে,	
byaboharkareer,	ব্যবহারকারীর,	ব্যবহারকারীর,	
gonesher,	গণেশের,	গণেশের,	
uparzoner,	উপারজনের,	উপার্জনের,	
ekspression,	এক্সপ্রেশন,	এক্সপ্রেশন,	
kormobuddhite,	কর্মবুদ্ধিতে,	কর্মবুদ্ধিতে,	
noiteek,	নৈতিক,	নৈতিক,	
masjidti,	মাসজিতি,	মসজিদটি,	
veniser,	ভেনিসের,	ভেনিসের,	
tukrowti,	টুকরোটি,	টুকরোটি,	
aakaabar,	আকাবার,	আকাবার,	
muhurtati,	মুহুরততি,	মুহুর্তটি,	
shroddhabihin,	শ্রদ্ধাবিহীন,	শ্রদ্ধাবিহীন,	
machkabar,	মাচকাবার,	মাচকাবার,	
weelcomee,	ভিলকমী,	ওয়েলকাম,	
indrakanan,	ইন্দ্রাকনন,	ইন্দ্রকানন,	
shapad,	শাপাদ,	শ্বাপদ,	
orgho,	অর্ঘ,	অর্ঘ্য,	
gyandas,	জ্ঞানদাস,	জ্ঞানদাস,	
aalkatraa,	অলকাত্রা,	আলকাতরা,	
idipasha,	ইডিপাশা,	ইডিপাস,	
shamijir,	শামিজীর,	স্বামীজীর,	
shitei,	শিতেই,	শীতেই,	
swadhinotatukui,	স্বাধীনতাটুকুই,	স্বাধীনতাটুকুই,	
behrampurer,	বেহরামপুরের,	বহরমপুরের,	
vittiteo,	ভিত্তিতেও,	ভিত্তিতেও,	
khaschandpur,	খাশচানপুর,	খাসচাঁদপুর,	
kartona,	কারততানা,	করতনা,	
dewaben,	দেওয়াবেন,	দেওয়াবেন,	
favorite,	ফাভোরিতে,	ফেভারিট,	
ajeem,	আজিম,	আজিম,	
rinattak,	ঋণতত্তক,	ঋনাত্মক,	
horidbar,	হরিদবার,	হরিদ্বার,	
kuresher,	কুরেশের,	কুরেশের,	
ongshogrohoner,	অংশগ্রহণের,	অংশগ্রহনের,	
uddharkarmirai,	উদ্ধারকর্মীরাই,	উদ্ধারকর্মীরাই,	
debholopar,	ডেভলোপার,	ডেভলপার,	
groundta,	গ্রাউন্ডটা,	গ্রাউন্ডটা,	
sangkalanti,	সংকলান্তি,	সংকলনটি,	
iraner,	ইরানের,	ইরানের,	
vittimul,	ভিত্তিমূল,	ভিত্তিমূল,	
ingrejra,	ইংরেজরা,	ইংরেজরা,	
ekjoge,	একযোগে,	একযোগে,	
duple,	ডুপল,	ডুপ্লে,	
chalachchitro,	চলচ্চিত্র,	চলচ্চিত্র,	
karam,	করাম,	কেরাম,	
yathaarthabhaabe,	যথারথভাবে,	যথার্থভাবে,	
paadee,	পাদে,	পাড়ে,	
bhabotarini,	ভবততীরিন,	ভবতারিণী,	
pravura,	প্রভুরা,	প্রভুরা,	
surke,	সুরকে,	সুরকে,	
poste,	পোস্টে,	পোষ্টে,	
elakatite,	এলাকাটিতে,	এলাকাটিকে,	
siit,	সিত,	শীত,	
kathghera,	কাঠঘেরা,	কাঠঘেরা,	
daayitto,	দাইয়েত্ত,	দায়িত্ব,	
protyokkhovabey,	প্রত্যক্ষব্যবে,	প্রত্যক্ষভাবে,	
niketon,	নিকেতন,	নিকেতন,	
dada,	দাডা,	দাদা,	
bondhuvabaponyo,	বন্ধুভাব্যপ্য,	বন্ধুভাবাপন্ন,	
gondhe,	গন্ধে,	গন্ধে,	
satarka,	সাতারকা,	সতর্ক,	
nirvaha,	নির্বাহা,	নির্বাহ,	
uponeeshod,	উপনিষদ,	উপনিষদ,	
navaratri,	নবরতরী,	নবরাত্রি,	
biplabee,	বিপ্লবে,	বিপ্লবী,	
ghumachhe,	ঘুমাচে,	ঘুমাচ্ছে,	
madrasi,	মাদ্রাসী,	মাদ্রাজি,	
mirakela,	মিরাকেলা,	মিরাকেল,	
tecno,	টেকনো,	টেকনো,	
khagen,	খাগেন,	খগেন,	
naajii,	নাজি,	নাত্সি,	
shangsthaner,	সংস্থানের,	সংস্থানের,	
overholing,	ওভারহোলিং,	ওভারহোলিং,	
adbhanced,	অ্যানভান্ডড,	অ্যাডভান্সড,	
samaveshke,	সমাভেষকে,	সমাবেশকে,	
bollov,	বলভো,	বল্লভ,	
sheepha,	শীব,	শেফ,	
cn,	সিএন,	সিএন,	
kirti,	কীর্তি,	কীর্তি,	
mozdur,	মজদুর,	মজদুর,	
gandagol,	গন্ডাগল,	গন্ডগোল,	
vobanipur,	ভবানীপুর,	ভবানীপুর,	
sip,	সিপ,	শিপ,	
jaubankal,	যৌবনকাল,	যৌবনকাল,	
paikgachha,	পাইক্াাচা,	পাইকগাছা,	
torkareer,	তররকালীর,	তরকারীর,	
setike,	সেতিকে,	সেটিকে,	
dwibidho,	দ্বিবিধো,	দ্বিবিধ,	
guzober,	গুজবের,	গুজবের,	
tongaa,	টঙ্গা,	টোঙ্গা,	
kharar,	খরার,	খরার,	
atighataner,	অতিঘাটনের,	অতিঘটনের,	
addhattikotar,	আদ্ধাত্মিকতার,	আধ্যাত্মিকতার,	
phund,	ফান্ড,	ফান্ড,	
kokeyin,	কোকেইন,	কোকেইন,	
daap,	ডাপ,	ড্যাপ,	
taufik,	টাফিক,	তৌফিক,	
mawdeel,	মাডিল,	মডেল,	
soommita,	সুম্মিতা,	সুমিতা,	
akeeb,	আকীব,	আকিব,	
drishyer,	দৃশ্যের,	দৃশ্যের,	
rakshanbhag,	রক্ষণভাগ,	রক্ষণভাগ,	
jerusaleme,	জেরুসামেলে,	জেরুসালেমে,	
ekoirokom,	একরোকম,	একইরকম,	
dekhso,	দেখসো,	দেখসো,	
dholeshwari,	ধলেশ্বরী,	ধলেশ্বরী,	
byabaharkareer,	ব্যবহারকারীর,	ব্যবহারকারীর,	
jontrangshogulor,	যন্ত্রাংশগুলোর,	যন্ত্রাংশগুলোর,	
mathews,	ম্যাথিওস,	ম্যাথিউস,	
harza,	হার্জা,	হার্জ,	
aakkaash,	আক্কাশ,	আককাস,	
aarke,	আরকে,	আরকে,	
rohosyoti,	রহস্যোতি,	রহস্যটি,	
nikote,	নিকতে,	নিকটে,	
kanar,	কানার,	কণার,	
nirmalata,	নির্মলতা,	নির্মলতা,	
sadeep,	সাদীপ,	সদীপ,	
diibug,	দিবুগ,	ডিবাগ,	
prokar,	প্রকার,	প্রকার,	
bhogni,	ভগ্নী,	ভগ্নী,	
grambasheeo,	গ্রামবাশীও,	গ্রামবাসীও,	
mehsus,	মেহসুস,	মেহসুস,	
ap,	আপিপ,	আপ,	
kathmandu,	কাঠমান্ডু,	কাঠমান্ডু,	
zakharovar,	জখরাভোর,	জাখারোভার,	
alpakichudin,	অল্পকীউভুনি,	অল্পকিছুদিন,	
bongsho,	বংশ,	বংশ,	
rajbandi,	রাজবন্দী,	রাজবন্দী,	
bisshasyi,	বিশ্বস্যী,	বিশ্বাসই,	
codee,	কোদি,	কোডে,	
ispreedshiit,	ইসপ্রিশবিত,	স্প্রেডশীট,	
mokhmoley,	মোখমলে,	মখমলে,	
granada,	গ্র্যানাডা,	গ্র্যানাডা,	
chandil,	চন্দিল,	চান্ডিল,	
andon,	অ্যান্ডন,	আন্দোন,	
baugey,	বাউগে,	বাগে,	
peethey,	পিথে,	পীঠে,	
devolapar,	দেভলাপার,	ডেভলপার,	
bonvumi,	বনভুমি,	বনভূমি,	
choritrotakeo,	চরিত্রটাকেও,	চরিত্রটাকেও,	
query,	কোয়ারি,	কোয়েরি,	
sangbadmadhyomgulote,	সংবাদমাধ্যমগুলোতে,	সংবাদমাধ্যমগুলোতে,	
quata,	কোয়াতা,	কোটা,	
hafej,	হাফেজ,	হাফেয,	
prarthonakokkher,	প্রার্থনাকক্ষের,	প্রার্থনাকক্ষের,	
sompadonkaree,	সম্পাদনকারী,	সম্পাদনকারী,	
shtona,	স্তনা,	স্টোন,	
panchbar,	পাঁচবার,	পাঁচবার,	
kleentoner,	ক্লিনটনের,	ক্লিনটনের,	
abheedhaneek,	অভিধানীক,	অভিধানিক,	
valobase,	ভালোবাসে,	ভালোবাসে,	
tennys,	টেনিস,	টেনিস,	
laaisheesh,	লইশশ,	লাইসেন্স,	
bisheshya,	বিশেষ্য,	বিশেষ্য,	
elakatike,	এলাকাটিকে,	এলাকাটিকে,	
balatkar,	বালাতকর,	বলাৎকার,	
nagorikkey,	নাগরিককে,	নাগরিককে,	
torikher,	তরিখের,	তরিখের,	
sallallahu,	সাল্লাল্লাহু,	সল্লাল্লাহু,	
bibader,	বিবাদের,	বিবাদের,	
shatoke,	শতকে,	শতকে,	
kaferderke,	কাফেরদেরকে,	কাফেরদেরকে,	
krema,	ক্রেমা,	ক্রাইম,	
providere,	প্রভিদেরও,	প্রভাইডারে,	
photanor,	ফোটানোর,	ফোটানোর,	
audiotike,	অডিওটিকে,	অডিওটিকে,	
mojlish,	মজলীশ,	মজলিশ,	
mmadhukkori,	মম্ধুক্রী,	মাধুকরী,	
kholdhular,	খোলধালার,	খোলধূলার,	
pujit,	পুজিত,	পুজিত,	
polashir,	পলাশির,	পলাশীর,	
gandhariir,	গন্ধারীর,	গান্ধারীর,	
ghumacchilo,	ঘুমাচ্ছিল,	ঘুমাচ্ছিল,	
byabostho,	ব্যবস্থ,	ব্যাবস্থা,	
barnis,	বার্নিস,	বার্নিশ,	
joki,	জকি,	জকি,	
nationalser,	নেশনলাসের,	ন্যাশনালসের,	
maradeha,	মারেদহ,	মরদেহ,	
somsher,	সোশের,	সমশের,	
rajnaiteek,	রাজনৈতিক,	রাজনৈতীক,	
graambaaseer,	গ্রামবাসীর,	গ্রামবাসীর,	
chhutochhuti,	ছুটোছুটি,	ছুটোছুটি,	
steeit,	স্টিচ,	স্টেইট,	
mercial,	মার্সিয়াল,	মার্শিয়াল,	
shipley,	শিপলি,	শিপলে,	
dayitta,	দায়িত্ব,	দায়িত্ব,	
katbe,	কাটবে,	কাটবে,	
orbi,	ওরবি,	ওরবি,	
asaciates,	এসেসিয়েটস,	এসোসিয়েটস,	
gandhike,	গান্ধিকে,	গান্ধীকে,	
qyapasula,	ক্যাপসুলা,	ক্যাপসুল,	
youth,	যাউথ,	ইয়ুথ,	
judge,	জুদগে,	জাজ,	
dosha,	দোষা,	দোসা,	
habshi,	হাবশি,	হাবশী,	
agaldar,	আগলদার,	আগলদার,	
fibergulote,	ফাইবারগুলোতে,	ফাইবারগুলোতে,	
besirvagei,	বেসির্ঘাগেই,	বেশিরভাগেই,	
kadam,	কাদাম,	কদম,	
yaak,	যাক,	ইয়াক,	
birishiritey,	বিরিশিরতী,	বিরিশিরিতে,	
temonbhabe,	তেমনভাবে,	তেমনভাবে,	
stoic,	স্টোয়,	স্টোয়িক,	
itastata,	ইতাস্তা,	ইতস্তত,	
oichchheek,	ঐচ্ছিক,	ঐচ্ছিক,	
romantik,	রোমানটিক,	রোমান্টিক,	
autopromotioner,	অটোপ্রমেশনের,	অটোপ্রমোশনের,	
tintir,	তিনটির,	তিনটির,	
ajuhat,	অজুহাত,	অজুহাত,	
monjurul,	মন্জুরুল,	মনজুরুল,	
ivil,	আইভিল,	ইভিল,	
tokeo,	তোকেও,	টোকেও,	
bhramapraban,	ভ্রামপ্রবণ,	ভ্রমপ্রবণ,	
nirikhe,	নিরিখে,	নিরিখ,	
chalachchitrei,	চলচ্চিত্রেই,	চলচ্চিত্রেই,	
atarkitey,	অতারকাইতে,	অতর্কিতে,	
lagto,	লাগতো,	লাগতো,	
shoori,	সুরী,	সুরি,	
murader,	মুরাদের,	মুরাদের,	
thechar,	ঠেচার,	থ্যাচার,	
hondooras,	হন্ডুরাস,	হন্ডুরাস,	
akpashe,	আকপাশে,	একপাশে,	
laaz,	লাজ,	লাজ,	
laishensha,	লাইশেশ্া,	লাইসেন্স,	
labonaktatar,	লবণককতাার,	লবণাক্ততার,	
oncolsoho,	অঙ্কলসহ,	অঞ্চলসহ,	
kuthibarike,	কুঠিবারীকে,	কুঠিবাড়ীকে,	
shhikara,	শিকারা,	শিকার,	
musabbirul,	মুসাববিরুল,	মুসাব্বিরুল,	
nirbahi,	নির্বাহী,	নির্বাহি,	
chopol,	চপল,	চপল,	
paner,	পানের,	পানের,	
niketaner,	নিকেতানের,	নিকেতনের,	
hillse,	হিলসে,	হিলসে,	
gabeshonar,	গবেশনার,	গবেষনার,	
shkalarashhipa,	স্কলারশিপা,	স্কলারশিপ,	
fatakasto,	ফাতাকাস্ত,	ফাটাকেষ্ট,	
ship,	শিপ,	শিপ,	
jins,	জিন,	জিন্স,	
jotota,	যতটা,	যতোটা,	
victor,	ভিক্টর,	ভিক্টর,	
sthitiko,	স্থিতিকও,	স্থিতিকো,	
azin,	আজিন,	আজিন,	
kyathlik,	ক্যাথলিক,	ক্যাথলিক,	
naper,	নাপের,	ন্যাপের,	
panchashjon,	পঞ্চাশজন,	পঞ্চাশজন,	
srivatsalakshanang,	শ্রীবৎস্থালকভং,	শ্রীবৎসলক্ষণং,	
rakhtokkharone,	রক্ষতক্ষরেণ,	রক্তক্ষরণে,	
prothar,	প্রথার,	প্রথার,	
bikargrosto,	বিকারগ্রস্ত,	বিকারগ্রস্ত,	
daebug,	দাবুগ,	ডিবাগ,	
shalook,	শালুক,	শালুক,	
riazuddin,	রিয়াজুদ্দিন,	রিয়াজউদ্দীন,	
reshmirekha,	রেশমিরেখা,	রেশমীরেখা,	
tetela,	টেটেলা,	টাইটেল,	
parkin,	পারকিন,	পার্কিং,	
bhoutikeshu,	ভৌতিকেশু,	ভৌতিকেষু,	
monzooshree,	মনজুষ্রী,	মঞ্জুশ্রী,	
alkatra,	অলকাত্র,	আলকাতরা,	
grambaasi,	গ্রামবাসী,	গ্রামবাসী,	
timathi,	তিমাঠি,	টিমোথি,	
beam,	বিআইএম,	বিম,	
shakar,	শাকার,	সকার,	
horipur,	হরিপুর,	হরিপুর,	
ishton,	ইশততন,	স্টোন,	
dakope,	ডাকোপে,	দাকোপ,	
zoojyota,	যুজ্যতা,	যোজ্যতা,	
bhabarlaler,	ভাবারলারের,	ভবরলালের,	
kooshumba,	কুশুম্বা,	কুশুম্বা,	
sharifpur,	শরিফপুর,	শরিফপুর,	
bee,	বিআই,	বি,	
rajotta,	রাজত্ব,	রাজত্ব,	
saria,	সারিয়া,	সরিয়া,	
khabarsoho,	খাবারসহ,	খাবারসহ,	
graambaaseeder,	গ্রামবাসীদের,	গ্রামবাসীদের,	
korimpur,	করিমপুর,	করিমপুর,	
mah,	মহা,	মাহে,	
vobobibhuti,	ভব্বভূতি,	ভববিভূতি,	
baman,	বামান,	বামন,	
mononiitoder,	মনোনীয়দের,	মনোনীতদের,	
modhyekar,	মধ্যেকার,	মধ্যেকার,	
chorchita,	চর্চিত,	চর্চিত,	
thare,	থারে,	থরে,	
sahojatprobritti,	সহযাপত্রবৃত্তি,	সহজাতপ্রবৃত্তি,	
railliner,	রেললাইনের,	রেললাইনের,	
alaol,	আলাওল,	আলাওল,	
cloudbook,	ক্লাডবোক,	ক্লাউডবুক,	
headquartus,	হেডকার্াস,	হেডকোয়ার্টাস,	
ji,	জি,	জি,	
masjidke,	মাসজিদকে,	মসজিদকে,	
upbasher,	উপবাশের,	উপবাসের,	
bahubar,	বহুবার,	বহুবার,	
sangkoolan,	সংকুলান,	সংকুলান,	
ganosachetanata,	গণসচেতনাতা,	গণসচেতনতা,	
jamanataswarup,	জমনাত্স্বরূপ,	জামানতস্বরূপ,	
pracharanamulak,	প্রচারণামূলক,	প্রচারণামূলক,	
bhaangchur,	ভাংচুর,	ভাংচুর,	
bangladesh,	বাংলাদেশ,	বঙ্গালাদেস,	
lendol,	লেন্ডল,	লেন্ডল,	
sheshardhe,	শেষার্ধে,	শেষার্ধে,	
shishu,	শিশু,	শিশু,	
afzol,	আফজল,	আফজল,	
kampita,	কামপিটা,	কম্পিত,	
alankorana,	অলঙ্করণা,	অলঙ্করণ,	
mukhmondole,	মুখমন্ডলে,	মুখমণ্ডলে,	
lagche,	লাগছে,	লাগছে,	
aairish,	এইরিশ,	আইরিস,	
siddhantoo,	সিদ্ধান্ত,	সিদ্ধান্তও,	
vvimsenn,	ভিভিসমেন,	ভীমসেন,	
shahabike,	সাহাবিকে,	সাহাবীকে,	
plato,	প্ল্যাটো,	প্লেটো,	
chaanoo,	চানুও,	চানু,	
jonosomaj,	জনসমাজ,	জনসমাজ,	
lat,	লাত,	লাট,	
shourshe,	শৌর্শে,	সোর্স,	
oncholsomuho,	অন্চসামসহ,	অঞ্চলসমূহ,	
obharbhiu,	ওভারভিউ,	ওভারভিউ,	
modelgulo,	মডেলগুলো,	মডেলগুলো,	
bagdadii,	বাগদাদী,	বাগদাদী,	
kalki,	কালকি,	কালকি,	
ragee,	রাগী,	রাগী,	
dhyanastha,	ধ্যানস্থ,	ধ্যানস্থ,	
platform,	প্ল্যাটফর্ম,	প্লাটফর্ম,	
holuder,	হলুদের,	হলুদের,	
bisshasi,	বিশ্বাসী,	বিশ্বাসী,	
nutan,	নুতান,	নূতন,	
seeramiks,	সিরামিকস,	সিরামিকস,	
lambi,	ল্যাম্বি,	লম্বি,	
unchiyechilo,	উঁচিয়েছিল,	উঁচিয়েছিল,	
karore,	কারোর,	কারোর,	
pinogbagke,	পিনোগবাগকে,	পিনগবাগকে,	
mochlekha,	মোচলেখা,	মোছলেখা,	
annimated,	অ্যানিমেটেড,	এনিমেটেড,	
daktikit,	ডাক্তিকিত,	ডাকটিকিট,	
gurmukh,	গুরমুখ,	গুরমুখ,	
dhormoprobortokder,	ধর্মপ্রবর্তকদের,	ধর্মপ্রবর্তকদের,	
melbourner,	মেলবোর্নের,	মেলবোর্নের,	
elgoridom,	এলগোরিড,	এলগরিদম,	
generalissimo,	জেনারেলাসিমো,	জেনারেলিসিমো,	
hosney,	হোসেনে,	হোসনে,	
mulor,	মুলোর,	মুলোর,	
eekbalke,	এববাালকে,	ইকবালকে,	
siraju,	সিরাজু,	সিরাজু,	
muhaiminer,	মুহাইমিনের,	মুহাইমিনের,	
chikittsar,	চিকিত্সার,	চিকিত্সার,	
gejetade,	গেজেটাদে,	গেজেটেড,	
peterke,	পেতেরকে,	পিটারকে,	
moshahidur,	মোসাহিদুর,	মোশাহিদুর,	
jotinkey,	জতিনকে,	যতীনকে,	
pretti,	প্রেটি,	প্রিটি,	
kaansaat,	কানসাত,	কানসাট,	
chhayi,	ছায়ি,	ছাই,	
hossne,	হোসেন,	হোসনে,	
atak,	আটাক,	আটক,	
injiniyarim,	ইঞ্জিনিরিজম,	ইঞ্জিনিয়ারিং,	
obhaarbhiu,	ওভারভিউ,	ওভারভিউ,	
black,	ব্ল্যাক,	ব্ল্যাক,	
mohit,	মোহিত,	মুহিত,	
metropalitana,	মেট্রোপালাশনা,	মেট্রোপলিটন,	
ssahocorze,	শ্যাকসরে,	সাহচর্যে,	
dipon,	ডিপন,	দীপন,	
marpit,	মারপিট,	মারপিট,	
