siitei,	সিতেই,	শীতেই,	
uttor,	উটটর,	উওর,	
zubokder,	যুবকদের,	যুবকদের,	
ramachandranke,	রামাচন্দ্রনকে,	রামাচন্দ্রনকে,	
sangbadmadhyame,	সংবাদমাধ্যমে,	সংবাদমাধ্যমে,	
harasta,	হারাস্তা,	হারাস্তা,	
orgho,	অর্ঘ,	অর্ঘ্য,	
danaqana,	ডানাকানা,	ডানকান,	
sinaake,	সিনাকে,	সিনাকে,	
manatmulak,	মননতমূলক,	মানতমূলক,	
ateetkale,	আতিতকালে,	অতীতকালে,	
bharpur,	ভারপুর,	ভরপুর,	
trabuco,	ট্র্যাবিকো,	ট্র্যাবুকো,	
gostigulo,	গোস্তিগুলো,	গোষ্ঠীগুলো,	
elakayi,	এলাকাই,	এলাকাই,	
senabahinio,	সেনাবাহিনীও,	সেনাবাহিনীও,	
vaibon,	ভাইবন,	ভাইবোন,	
chowdhuryke,	চৌধ্রীকে,	চৌধুরীকে,	
saifai,	সাইফাই,	সাইফাই,	
panchashjon,	পঞ্চাশ্যন,	পঞ্চাশজন,	
naagaalyand,	নওগ্লাযান্ড,	নাগাল্যান্ড,	
arashie,	আরাশী,	আরসিএ,	
daebug,	দাইবুগ,	ডিবাগ,	
summer,	সামার,	সামার,	
abhidhanick,	অভিধানিক,	অভিধানিক,	
bharatey,	ভারতে,	ভারতে,	
landey,	ল্যান্ডে,	ল্যান্ডে,	
torkareer,	তর্কারীর,	তরকারীর,	
kaalaam,	কালাম,	কালাম,	
laishenshim,	লৈশিনশিম,	লাইসেন্সিং,	
gunje,	গুঞ্জে,	গুঁজে,	
kichutei,	কিছুটেই,	কিছুতেই,	
pooshteer,	পুষ্টির,	পুষ্টির,	
bangulzai,	বাঙ্গুজলাই,	বঙ্গুলিজাই,	
wishnu,	উইষ্ণু,	বিষ্ণু,	
chenza,	চেনজা,	চেঞ্জ,	
bahubar,	বাহুবার,	বহুবার,	
unitgulo,	ইউনিটগুলো,	ইউনিটগুলো,	
windos,	উইন্ডস,	উইন্ডোস,	
monzooshree,	মঞ্জশ্রী,	মঞ্জুশ্রী,	
bayshorkarikarone,	বাযশারকরণিকারণে,	বেসরকারিকরণ,	
aniyantrita,	অনিযনন্ত্রিত,	অনিয়ন্ত্রিত,	
promothesh,	প্রমথেষ,	প্রমথেশ,	
nodiiteyi,	নদীয়তেই,	নদীতেই,	
debete,	দেবেতে,	ডিবেট,	
horipur,	হরিপুর,	হরিপুর,	
manir,	মানির,	মনির,	
aachhis,	আছিস,	আছিস,	
nazranar,	নাজরানার,	নাজরানার,	
gaziipur,	গাজিপুর,	গাজীপুর,	
ekbai,	একবাই,	একবাই,	
soommo,	সুম্ম,	সুমো,	
hosney,	হোসনে,	হোসনে,	
kaale,	কালে,	কালে,	
shrabasti,	শ্রববস্তি,	শ্রাবস্তী,	
postar,	পোস্তার,	পোস্টের,	
balithubar,	বালিঠুবার,	বালিথুবার,	
stoonahenja,	স্তনিউজহজ্জা,	স্টোনহেঞ্জ,	
guha,	গুহা,	গোহ,	
shho,	শো,	শো,	
timathi,	তিমাথি,	টিমোথি,	
daaktikite,	দাক্তিকিতে,	ডাকটিকিটে,	
deares,	ডিয়ারস,	ডিআরএস,	
okritokarjo,	অক্রিতকার্য,	অকৃতকার্য,	
donat,	ডোনাট,	ডোনাট,	
definition,	ডিফিনিশন,	ডেফিনেশন,	
kourabe,	কৌরাবে,	কৌরবে,	
rajnikant,	রাজনীকান্ত,	রাজনীকান্ত,	
spancer,	স্প্যান্সের,	স্পেন্সার,	
ultrasonography,	আলট্রাস্নোগ্রাফি,	আলট্রাসনোগ্রাফিও,	
keyu,	কেয়ু,	কেউ,	
sarder,	সারদের,	সরদার,	
dipti,	দীপ্তি,	ডেপুটি,	
turky,	টার্কি,	তুর্কি,	
hyaloyin,	হ্যায়লিয়,	হ্যালোইন,	
sahinsatar,	সহিনসতার,	সহিংসতার,	
jesh,	জেশ,	জেস,	
oxite,	অক্সিট,	অক্সাইট,	
myari,	ম্যারি,	ম্যারি,	
rajotwo,	রাজত্ব,	রাজত্ব,	
saurce,	সার্স,	সোর্স,	
feemalee,	ফিমালি,	ফিমেল,	
judge,	জজগ,	জাজ,	
dajjha,	দজজ,	দাহ্য,	
graambasider,	গ্রামবাসীদের,	গ্রামবাসীদের,	
komanera,	কোমানেরা,	কমানেরা,	
kholdhular,	খোলধুলার,	খোলধূলার,	
osomorthito,	অসম্রথিত,	অসমর্থিত,	
graambasio,	গ্রামবাসিও,	গ্রামবাসীও,	
atwobishvashi,	আত্ববিশ্বাসী,	আত্মবিশ্বাসী,	
dakope,	ডাকোপে,	দাকোপ,	
kaande,	কানডে,	কাণ্ডে,	
krom,	ক্রম,	ক্রম,	
orbi,	ওরবি,	ওরবি,	
swastir,	স্বস্তির,	স্বস্তির,	
kormoi,	কর্মই,	কর্মই,	
sohinsotar,	সোহিনসতার,	সহিংসতার,	
kayartara,	কয়ারটার,	কোয়ার্টার,	
beam,	বিএইএম,	বিম,	
horidbar,	হরিদবার,	হরিদ্বার,	
thaanobhi,	থানভি,	থানভী,	
aholya,	অহল্যা,	অহল্যা,	
sqirt,	স্কার্ট,	স্কার্ট,	
nirvaha,	নির্ভাহ,	নির্বাহ,	
baptics,	ব্যাপটিকস,	ব্যাপটিকস,	
elaakaate,	এলাকাতে,	এলাকাতে,	
chhadura,	ছদুরা,	ছাদুরা,	
sadadyarao,	সদাদ্যারাও,	সদদ্যরাও,	
aaeerese,	আরইসে,	আইরেসে,	
taroni,	তারণী,	তরণী,	
godabari,	গোদাবারী,	গোদাবরী,	
kleentoner,	ক্লিননের,	ক্লিনটনের,	
hames,	হাম্স,	হোমস,	
pluck,	প্লাক,	প্ল্যাক,	
nodimatrik,	নদীমাত্রিক,	নদীমাতৃক,	
surke,	সুরকে,	সুরকে,	
nick,	নিক,	নিক্,	
narsinghomgulor,	নার্সিংহগ্গুলোর,	নার্সিংহোমগুলোর,	
encidablu,	এনসিডেববুল,	এনসিডাব্লু,	
jeebanjapon,	জীবাঞ্জপন,	জীবনযাপন,	
akkheperi,	আক্ষেপেরই,	আক্ষেপেরই,	
towraat,	টোরাট,	তওরাত,	
naneer,	নানীর,	নানীর,	
gronther,	গ্রন্থের,	গ্রন্থের,	
homsher,	হোমশের,	হোমসের,	
gorrer,	গোরার,	গোরের,	
kada,	কাদা,	কোডা,	
audiotike,	অডিওটিকে,	অডিওটিকে,	
michir,	মিচির,	মিচির,	
kade,	কাদ,	কোড,	
sangkalanti,	সংকললন্তি,	সংকলনটি,	
shuchonakal,	শুচনাকাল,	সূচনাকাল,	
eukalyptus,	ইউক্যালিপ্টাস,	ইউক্যালিপ্টাস,	
erythrian,	এরিথ্রিয়ান,	এরিথ্রিয়ান,	
shilpikuler,	শিল্পীকুলের,	শিল্পীকুলের,	
sthitiko,	স্থিতিকও,	স্থিতিকো,	
byabaharkareederke,	ব্যবহারকারীদেরকে,	ব্যবহারকারীদেরকে,	
inziniyarsa,	ইঞ্জিনিইরাস,	ইঞ্জিনিয়ার্স,	
bosontokke,	বসন্তককে,	বসন্তকে,	
flexta,	ফ্লেক্সটা,	ফ্লেক্সটা,	
grahoksebai,	গ্রাহকসেবাই,	গ্রাহকসেবায়,	
machgulo,	মাছগুলো,	মাছগুলো,	
valobase,	ভালোবাসে,	ভালোবাসে,	
sorting,	সর্টিং,	সর্টিং,	
ghotolen,	ঘটলেন,	ঘটলেন,	
angsogrohone,	অংসগ্রহণে,	অংশগ্রহনের,	
parijaner,	পরিজনের,	পরিজনের,	
zeeland,	জিল্যান্ড,	জিল্যান্ড,	
ashiatic,	অ্যাশিয়াটিক,	এশিয়াটিক,	
jamjamat,	জামজামত,	জমজমাট,	
ashankai,	আশাঙ্কাই,	আশঙ্কাই,	
abeganuvutir,	আবেগানগুবতির,	আবেগানুভূতির,	
dharmee,	ধর্মী,	ধর্মী,	
uporitaley,	উপরিতালে,	উপরিতলে,	
aairees,	আইরিস,	আইরিস,	
seekkhaou,	শিক্ষাও,	শিক্ষাও,	
romjaner,	রোমজানের,	রমযানের,	
lutheerana,	লুথিরানা,	লুথেরান,	
bisshonath,	বিশ্ননাথ,	বিশ্বনাথ,	
gajano,	গজনা,	গজানো,	
peeth,	পিথ,	পীঠ,	
dubaate,	দুবাতে,	ডুবাতে,	
maladabha,	মালাধা,	মলদোভা,	
naajii,	নাজি,	নাত্সি,	
abikaul,	অবিকাউল,	অবিকল,	
ssahocorze,	সাহোকর্জে,	সাহচর্যে,	
ispredsiit,	ইসপ্রেডসিট,	স্প্রেডশীট,	
kharar,	খারার,	খরার,	
aanaan,	আনান,	আনান,	
turista,	তুরিস্তা,	টুরিস্ট,	
subader,	সুবাদের,	সুবাদে,	
angibhutovabe,	অঙ্গীভূতভাবে,	অঙ্গীভূতভাবে,	
parikha,	পররিখা,	পরিখার,	
chhutee,	ছুটি,	ছুটি,	
asovarno,	অসভার্ণ,	অসবর্ণ,	
elakai,	এলাকাই,	এলাকাই,	
hamburgey,	হ্যামবার্গে,	হামবুর্গে,	
tep,	টিপ,	ট্যাপ,	
shasankorta,	শাসনকর্তা,	শাসনকর্তা,	
fastara,	ফাস্তারা,	ফস্টার,	
sten,	স্টেন,	স্টেন,	
registaner,	রেজিস্টেনের,	রেগিস্তানের,	
pakistanira,	পাকিস্তানিরা,	পাকিস্তানীরা,	
tintikey,	তিনটিকে,	তিনটিকে,	
headquartus,	হেডকাউর্টাস,	হেডকোয়ার্টাস,	
bibader,	বিবাদের,	বিবাদের,	
aamor,	আমর,	আমর,	
adhunikkale,	আধুনিক্কালে,	আধুনিককালে,	
gabhaaskar,	গাভাস্কার,	গাভাস্কার,	
dantahin,	দন্তাহীন,	দন্তহীন,	
rinobodh,	ঋণবোধ,	ঋণবোধ,	
fongli,	ফংলি,	ফংলি,	
shakankti,	শককন্টি,	শকাঙ্কটি,	
bhangle,	ভাঙ্গলে,	ভাঙলে,	
anyarup,	অন্যরূপ,	অন্যরূপ,	
udbhabaney,	উদ্ভাবনে,	উদ্ভাবনে,	
aditisaha,	আদিতিসহ,	অদিতিসহ,	
elakatir,	এলাকাটির,	এলাকাটির,	
zerusalem,	জেরুসালেম,	জেরুসালেম,	
shniper,	শ্নীপের,	স্নাইপার,	
remacri,	রিম্যাক্রি,	রেমাক্রী,	
saras,	সারাস,	সরস,	
gemske,	গেমসকে,	জেমসকে,	
dharabahikvabe,	ধারাবাহিকভাবে,	ধারাবাহিকভাবে,	
elaaka,	এলাকা,	এলাকা,	
rushad,	রুশাদ,	রুশদ,	
irana,	ইরানা,	ইরান,	
gloria,	গ্লোরিয়া,	গ্লোরিয়া,	
megh,	মেঘ,	মেঘ,	
blyaka,	ব্ল্যাক,	ব্ল্যাক,	
muhuriganj,	মুহুরীগঞ্জ,	মুহুরীগঞ্জ,	
shasonkarta,	শাসনকর্তা,	শাসনকর্তা,	
ispredseet,	ইস্প্রেডসিট,	স্প্রেডশীট,	
munjur,	মুঞ্জুর,	মুনজুর,	
chirantan,	চিরান্তন,	চিরন্তন,	
ooipoka,	উইপক,	উইপোকা,	
kinsha,	কিনশা,	কিংস,	
sikkhakbrinda,	শিক্ষাবৃন্দ,	শিক্ষকবৃন্দ,	
asovya,	অসভ্য,	অসভ্য,	
chire,	চিরে,	চিরে,	
chirkoot,	চিরকুট,	চিরকুট,	
shilpojaat,	শিল্পজাত,	শিল্পজাত,	
cheerontan,	চীরনতন,	চিরন্তন,	
madhabi,	মাধবী,	মাধবী,	
kosambir,	কোসাম্বীর,	কোসাম্বীর,	
bo,	বোএই,	বু,	
gopalrao,	গোপালরাও,	গোপালরাও,	
bongsho,	বংশ,	বংশ,	
janmat,	জননম,	জন্মাত,	
kathghera,	কাঠঘেরা,	কাঠঘেরা,	
manab,	মানব,	মানব,	
deil,	ডেইল,	ডেইল,	
aporishodhito,	অপরিষিধত,	অপরিশোধিত,	
bolatkar,	বলাৎকা,	বলাৎকার,	
chikitsanirbhar,	চিকিতসানির্ভর,	চিকিৎসানির্ভর,	
amiya,	আমিয়া,	অমিয়,	
amorendro,	অমরেন্দ্র,	অমরেন্দ্র,	
cooda,	কোডডা,	কোডা,	
umb,	ইউএমবি,	ইউএমবি,	
hariner,	হরিনের,	হরিণের,	
onker,	অঙ্কার,	ওঙ্কার,	
sangkulaan,	সংকুলান,	সংকুলান,	
licencedhari,	লাইসেন্ডাহারী,	লাইসেন্সধারী,	
maradeha,	মারাদেহা,	মরদেহ,	
distibutor,	ডিস্টিবুটর,	ডিস্টিবিউটারের,	
konoroop,	কোরূপ,	কোনরূপ,	
fud,	ফাদ,	ফুড,	
ikboler,	ইকবলের,	ইকবলের,	
soundorjotakei,	সৌন্দর্যটাকেই,	সৌন্দর্যটাকেই,	
oshtader,	অষ্টাদের,	ওস্তাদের,	
baet,	বিয়েট,	বাইট,	
joki,	জোকি,	জকি,	
torunderke,	তরুন্দেরকে,	তরুণদেরকে,	
vittio,	ভিত্তিও,	ভিত্তিও,	
hydrological,	হাইড্রোলজিক্যাল,	হাইড্রোলজিক্যাল,	
oncholeo,	অঞ্চলেও,	অঞ্চলেও,	
mase,	মাসে,	মাসে,	
qara,	কারা,	কর,	
sectore,	সেকটটরে,	সেক্টরে,	
chotogolper,	চটগল্পের,	ছোটগল্পের,	
jakatke,	জাকাতকে,	যাকাতকে,	
roopmatro,	রূপমাত্র,	রূপমাত্র,	
gasthii,	গাষ্ঠি,	গোষ্ঠীই,	
gonjona,	গঞ্জনা,	গঞ্জনা,	
jibonnogor,	জীবন্যগর,	জীবননগর,	
plainey,	প্লেই,	প্লেনে,	
plack,	প্ল্যাক,	প্ল্যাক,	
uparjon,	উপার্যন,	উপার্জন,	
bbiswashke,	বিব্ষিশ্বাকে,	বিশ্বাসকে,	
muradkey,	মুরাদকে,	মুরাদকে,	
sombhobonao,	সম্ভবনাও,	সম্ভবনাও,	
aalkatraa,	আলকাতরা,	আলকাতরা,	
soinyora,	সৈন্যরা,	সৈন্যরা,	
jones,	জনেস,	জোন্স,	
onshogrohoner,	অংশগ্রহণের,	অংশগ্রহনের,	
gajiipur,	গজিিপুর,	গাজীপুর,	
jolrong,	জলরং,	জলরঙ,	
upobaashee,	উপবাশী,	উপবাসী,	
nirbahey,	নির্বাহে,	নির্বাহে,	
brittakare,	বৃত্তকারে,	বৃত্তাকারে,	
karir,	করির,	কারীর,	
probondhobhittik,	প্রবন্ধভিত্তিক,	প্রবন্ধভিত্তিক,	
chiroharit,	চিরহাহিরিত,	চিরহরিৎ,	
gazipur,	গাজীপুর,	গাজিপুর,	
pratishthanik,	প্রতিষ্ঠানিক,	প্রাতিষ্ঠানিক,	
larson,	লারসন,	লারসন,	
siropa,	সিরোপা,	শিরোপা,	
path,	পাথ,	পাথ,	
horeepur,	হরিপুর,	হরিপুর,	
kaferderke,	কাফেরদেরকে,	কাফেরদেরকে,	
armashtram,	আর্মশ্ত্রম,	আর্মস্ট্রং,	
dakticket,	ডাকটিকেট,	ডাকটিকিট,	
hafej,	হাফেজ,	হাফেয,	
chhutochhooti,	ছুটোছুটি,	ছুটোছুটি,	
bhogno,	ভগ্ন,	ভগ্ন,	
baipash,	বাইপাশ,	বাইপাস,	
oitijhya,	ঐতিহ্য,	ঐতিহ্য,	
baarbadoj,	বারবাদজ,	বার্বাডোজ,	
foxcon,	ফক্সকন,	ফক্সকন,	
duple,	ডুপল,	ডুপ্লে,	
muhurtati,	মুহুর্তটি,	মুহুর্তটি,	
neerbahi,	নিরবাহী,	নির্বাহি,	
nisader,	নিসাদের,	নিষাদের,	
niroja,	নিরোজা,	নিরোজা,	
balaruma,	বালারুমা,	বলরুম,	
shikkhadikkhay,	শিক্ষাদিক্ষা,	শিক্ষাদিক্ষায়,	
kraim,	ক্রাইম,	ক্রাইম,	
heerani,	হিরানী,	হিরানি,	
niurolaji,	নিউরোলজি,	নিউরোলজি,	
site,	সাইট,	সিটে,	
spredashita,	স্প্রেডাশিত,	স্প্রেডশীট,	
bbosonto,	ব্বসন্ত,	বসন্ত,	
taatey,	তাইতে,	তাতে,	
nodimaatrik,	নদীমাত্রিক,	নদীমাতৃক,	
rohinibabu,	রোহিনীবাবু,	রোহিনীবাবু,	
chitronattakar,	চিত্রনাট্তকার,	চিত্রনাট্যকার,	
shoreefer,	শরফফের,	শরিফের,	
firoza,	ফিরোজা,	ফিরোজা,	
alpo,	অল্প,	অল্প,	
barder,	বার্ডার,	বার্ডের,	
bossoben,	বসববেন,	বসবেন,	
korush,	করুশ,	ক্রুশ,	
setike,	সেতিকে,	সেটিকে,	
deefinishion,	দীফিনিশন,	ডেফিনেশন,	
subade,	সুবাদে,	সুবাদে,	
dhwajbhango,	ধ্বাজঙ্গ,	ধ্বজভঙ্গ,	
boudher,	বৌধের,	বৌদ্ধের,	
olympicer,	অলিম্পিসের,	অলিম্পিকের,	
akkelpure,	আক্কেলপুরে,	আক্কেলপুরে,	
arg,	আর্,	আর্গ,	
sainyader,	সাইন্যাদের,	সৈন্যদের,	
oncolsoho,	অঙ্কোলসহ,	অঞ্চলসহ,	
parabortee,	পারাবর্তী,	পরর্বতী,	
aflatoxin,	আফ্লাটক্সিন,	আ্যফ্ল্যাটক্সিন,	
prapokkey,	প্রাপক্কে,	প্রাপককে,	
labonaaktotaar,	লবণকোত্তার,	লবণাক্ততার,	
spredshiit,	স্প্রেডশিট,	স্প্রেডশীট,	
venush,	ভেনুশ,	ভেনাস,	
ceramiker,	সেরামিকের,	সিরামিকের,	
shfingtar,	স্ফিংটা,	স্ফিংটার,	
seeramiks,	সিরামিক্স,	সিরামিকস,	
munsi,	মুন্সি,	মুন্সী,	
dapadpi,	দাপাদপি,	দাপাদপি,	
armstronz,	আর্মস্ট্রন,	আর্মস্ট্রং,	
ongkush,	অঙ্কুশ,	অংকুশ,	
footbalarer,	ফুটবলারের,	ফুটবলারের,	
shoori,	শুরী,	সুরি,	
aatmobishwasi,	আত্মবিশ্বাসী,	আত্মবিশ্বাসী,	
pader,	পাদের,	প্যাডের,	
kindom,	কিন্দম,	কিংডম,	
fanse,	ফেনসে,	ফাঁসে,	
poste,	পোস্টে,	পোষ্টে,	
apad,	অ্যাপড,	আপদ,	
chargar,	চারগর,	চার্জার,	
sahab,	সাহাব,	সাহাব,	
kaia,	কৈই,	কায়া,	
mercial,	মার্িয়াল,	মার্শিয়াল,	
bhagno,	ভগ্ন,	ভগ্ন,	
dwipke,	দ্বীপকে,	দ্বীপকে,	
breqathru,	ব্রেকাথরু,	ব্রেকথ্রু,	
smarak,	স্মরক,	স্মারক,	
fand,	ফ্যান্ড,	ফান্ড,	
boikolyo,	বৈকল্য,	বৈকল্য,	
notikotar,	নতিকতার,	নৈতিকতার,	
graminphonor,	গ্রামিনফোনোর,	গ্রামীণফোনর,	
rachanakal,	রচনাকাল,	রচনাকাল,	
prasadhani,	প্রসাধানি,	প্রসাধনী,	
koomarir,	কুমারীর,	কুমারীর,	
jothon,	যথন,	যথন,	
nilfamarir,	নীলফামারির,	নীলফামারীর,	
deputy,	ডিপাউটি,	ডেপুটি,	
protizogii,	প্রতিযোগী,	প্রতিযোগী,	
sinakey,	সিনাকে,	সিনাকে,	
shresthoshcho,	শ্রেষ্ঠস্চ,	শ্রেষ্ঠশ্চ,	
mukhya,	মুখ্যা,	মুখ্য,	
kaathhaamaandu,	কাথামান্দু,	কাঠমান্ডু,	
madhukori,	মধুকরী,	মাধুকরী,	
dekaner,	দেকানের,	দেকানের,	
machsoho,	মাচসহ,	মাছসহ,	
sontoshpur,	সন্তোপসুর,	সন্তোষপুর,	
bojhaao,	বোঝাও,	বোঝাও,	
pooshti,	পুষ্টি,	পুষ্টি,	
gaandaas,	গান্দাস,	জ্ঞানদাস,	
karmakarke,	কারমকারকে,	কর্মকারকে,	
gronthao,	গ্রন্থাও,	গ্রন্থও,	
kul,	কুল,	কুল,	
nothiboddho,	নথিবদ্ধ,	নথিবদ্ধ,	
rohosyoti,	রহস্যটি,	রহস্যটি,	
ghoomachhilo,	ঘুমাছিল,	ঘুমাচ্ছিল,	
cheerokoomari,	চিরকুমারি,	চিরকুমারী,	
everage,	এভারেজ,	এভারেজ,	
alankorana,	আলঙ্করণা,	অলঙ্করণ,	
dhaleshorii,	ধালেছরই,	ধলেশ্বরী,	
baman,	বামান,	বামন,	
nili,	নীলি,	নিলি,	
elbamtite,	এলবাম্টিতে,	এলবামটিতে,	
saralya,	সরলল্যা,	সারল্য,	
groundta,	গ্রুউন্ডটা,	গ্রাউন্ডটা,	
safiin,	সাফিন,	সাফিন,	
romantik,	রোমান্তিক,	রোমান্টিক,	
dhormoprobortokder,	ধর্মপ্রবর্তদের,	ধর্মপ্রবর্তকদের,	
uddhrita,	উদ্ধৃতা,	উদ্ধৃত,	
dholeshwari,	ধোলেশ্বরী,	ধলেশ্বরী,	
antercticker,	অ্যান্টার্ক্সকের,	অ্যান্টার্কটিকের,	
rakhete,	রাখেতে,	রাখেতে,	
taims,	টেইম্স,	টাইমস্,	
sangosrobomukto,	সংস্রবসমুক্ত,	সংস্রবমুক্ত,	
iksaprishana,	এক্সপ্রিষণ,	এক্সপ্রেশন,	
vins,	ভিন্স,	ভিন্স,	
bhandti,	ভান্ডটি,	ভাণ্ডটি,	
paadee,	পাডে,	পাড়ে,	
gaujano,	গৌজানো,	গজানো,	
hurricane,	হ্যারিকানে,	হ্যারিকেন,	
orbeet,	অরবিট,	অরবিট,	
nirikho,	নিরিখো,	নিরিখ,	
metropolitan,	মেট্রোপলিটান,	মেট্রোপলিটন,	
carlosh,	কারলোশ,	কার্লোস,	
shishupalgarh,	শিশুপলগড়,	শিশুপালগড়ে,	
valobasen,	ভালোবাসেন,	ভালোবাসেন,	
dakter,	ডাক্তের,	ডাকতের,	
ritesh,	রিথেশ,	রিতেশ,	
dhhaloor,	ঢালুর,	ঢালুর,	
gamdan,	গামদান,	গামদান,	
oyebjin,	ওয়েব্িন,	ওয়েবজিন,	
paab,	পাব,	পাব,	
innahu,	ইন্নাহু,	ইন্নাহু,	
seguloi,	সেগুলোই,	সেগুলোই,	
torunra,	তরুনরা,	তরুণরা,	
potka,	পটকা,	পটকা,	
bhabanipur,	ভবানীপুর,	ভবানীপুর,	
bhebechili,	ভেবেছিলি,	ভেবেছিলি,	
dharmadasbabu,	ধর্মদাসবাবু,	ধর্মদাসবাবু,	
alumni,	আলুমনি,	অ্যালমনি,	
babona,	বাবনা,	বাবনা,	
impaction,	ইম্পাক্শন,	ইমপ্যাকশন,	
suhasini,	সুহাসিনী,	সুহাসিনী,	
mastarsa,	মস্তর্স,	মাস্টার্স,	
tikta,	তিকটা,	তিক্ত,	
salapheeta,	সালফেত,	সালফেট,	
assaciates,	এ্যাসাযিয়েটস,	এসোসিয়েটস,	
baarnis,	ব্রনীস,	বার্নিশ,	
masjidsaho,	মাসজিদসহ,	মসজিদসহ,	
seebiai,	সিবিয়াই,	সিবিআই,	
gosthike,	গোষ্ঠিকে,	গোষ্ঠীকে,	
ongshogrohoner,	অংশগ্রহণের,	অংশগ্রহনের,	
ddebet,	ডিজেব,	ডিবেট,	
keuoi,	কেওই,	কেউই,	
nyata,	ন্যাট,	ম্যাট,	
bhujangta,	ভূজঙ্ত,	ভুজঙ্গটা,	
nutan,	নুটান,	নূতন,	
pancbaar,	পানক্বার,	পাঁচবার,	
biphal,	বিফাল,	বিফল,	
aaps,	এপিএস,	এএপিএস,	
fatakesto,	ফাটাকেস্তো,	ফাটাকেষ্ট,	
shahjapur,	শাহজাপুর,	শাহজাপুর,	
sanghatakder,	সংহটকাদের,	সংঘটকদের,	
dada,	ডাদা,	দাদা,	
chhooteete,	ছুটিতে,	ছুটিতে,	
nariderke,	নারীদেরকে,	নারীদেরকে,	
mukhamandoler,	মুখামন্ডলের,	মুখমণ্ডলের,	
gyandas,	জ্ঞানদাস,	জ্ঞানদাস,	
prokalpagulo,	প্রকালপাগুলো,	প্রকল্পগুলো,	
nathivookto,	নাথিভুক্ত,	নথিভুক্ত,	
nischitobhabe,	নিশ্চিতভাবে,	নিশ্চিতভাবে,	
upobasee,	উপবাসী,	উপবাসী,	
korimkey,	করিমকে,	করিমকে,	
goodamjato,	গুডমাজত,	গুদামজাত,	
khamotagulor,	ক্ষমতাগুলোর,	ক্ষমতাগুলোর,	
manabmaner,	মানবমানের,	মানবমনের,	
shekarmani,	শেখারমানি,	শেকরমানি,	
chikkingsasoho,	চিক্কিংসাসহ,	চিকিংসাসহ,	
anusthane,	অনুষ্ঠানে,	অনুষ্ঠানে,	
prachando,	প্রচাণ্ড,	প্রচণ্ড,	
karmazog,	কারমাোগ,	কর্মযোগ,	
jacksonke,	জ্যাকসনকে,	জ্যাকসনকে,	
diiptii,	দিপটিই,	ডেপুটি,	
shekarone,	শেখারনে,	সেকারণে,	
sumi,	সুমি,	সুমি,	
majlishpur,	মজলিশপুর,	মজলিশপুর,	
turbine,	টারবাইন,	টারবাইন,	
tookrokey,	তুকরকে,	টুকরোকে,	
volivoler,	ভলিভোলের,	ভলিভলের,	
dai,	হাই,	ডে,	
gratha,	গ্রাথা,	গ্রোথ,	
dufresne,	ডাফারস্ন,	ডুফরেস্ন,	
durbhagya,	দুর্ভাগ্য,	দূর্ভাগ্য,	
teennis,	টেনিস,	টেনিস,	
chal,	চাল,	চাল,	
ameettrakkhor,	অমিতর্ক্ষর,	অমিত্রাক্ষর,	
khoor,	খুর,	ক্ষুর,	
sarbhare,	সার্ভরে,	সার্ভারে,	
bhenkates,	ভেঁকাতেস,	ভেঙ্কটেশ,	
mukhomondoler,	মুখমন্ডলের,	মুখমণ্ডলের,	
mishal,	মিশাল,	মিশাল,	
abhidhaaneeck,	অভিধানিক,	অভিধানিক,	
tennis,	টেনিস,	টেনিস,	
nazad,	নাজাদ,	নজদ,	
matis,	মাতিস,	ম্যাটিস,	
somabeshti,	সমাবেশটি,	সমাবেশটি,	
ganesh,	গনেশ,	গণেশ,	
senior,	সেনিওর,	সিনিয়র,	
kantojir,	কান্তজির,	কান্তজির,	
pachak,	পাচাক,	পাচক,	
mimgulor,	মিমগুলোর,	মিমগুলোর,	
poriharsoho,	পরিহারসহ,	পরিহারসহ,	
enamela,	এনামেলা,	এনামেল,	
shringa,	শ্রিংগা,	শৃঙ্গ,	
nibirbhabe,	নিবির্ভাবে,	নিবিরভাবে,	
porirshoder,	পরির্শদের,	পরির্ষদের,	
choudhursoho,	চৌধুরসহ,	চৌধুরসহ,	
arthurer,	অর্থুরের,	আর্থারের,	
spenser,	স্পেন্সের,	স্পেন্সার,	
protishta,	প্রতিষ্টা,	প্রতিষ্টা,	
shangsthatikey,	সংস্থাটিকে,	সংস্থাটিকে,	
bhogiroth,	ভোগীরথ,	ভগীরথ,	
dembakreeti,	দেম্বকৃতি,	ডিম্বাকৃতি,	
chalake,	চালাকে,	চালকে,	
shikshakbrinda,	শিক্ষাবৃন্দ,	শিক্ষকবৃন্দ,	
birishiritey,	বিরিশিরিতে,	বিরিশিরিতে,	
bhyaatikaner,	ভ্যাটিকানের,	ভ্যাটিকানের,	
sahojatprobritti,	সহযাতপ্রতৃবৃত্তি,	সহজাতপ্রবৃত্তি,	
shikkharrthirao,	শিক্ষার্থীরাও,	শিক্ষার্থীরাও,	
sangkoolan,	সংকুলোন,	সংকুলান,	
juakhelar,	জুয়াখেলার,	জুয়াখেলার,	
hindutirtha,	হিন্দুতীর্থ,	হিন্দুতীর্থ,	
bibechyo,	বিবেচ্য,	বিবেচ্য,	
contemporary,	কন্টেমপারারি,	কন্টেম্পোরারি,	
rodney,	রডনে,	রেডনি,	
kisti,	কিস্তি,	কিস্তি,	
poddhotiteyi,	পদ্ধতিতেই,	পদ্ধতিতেই,	
wrighter,	হ্রিটার,	রাইটের,	
mozdur,	মজদুর,	মজদুর,	
brookoleen,	ব্রুকলিন,	ব্রুকলিন,	
krechi,	ক্রেচি,	করেছি,	
ogovir,	অগভির,	অগভীর,	
shikshakbrindo,	শিক্ষাবৃন্দ,	শিক্ষকবৃন্দ,	
shucharita,	শুচারিতা,	সুচরিতা,	
bojhey,	বোঝে,	বোঝে,	
protijogiitamulok,	প্রতিযোগিতামূলক,	প্রতিযোগীতামূলক,	
behrampurer,	বেহরামপুরের,	বহরমপুরের,	
deputi,	ডিপুটি,	ডেপুটি,	
laishensha,	লযেশন,	লাইসেন্স,	
sahooseekotar,	সহশুকতার,	সাহসিকতার,	
metropalitana,	মেট্রোপলিটোনন,	মেট্রোপলিটন,	
daakticketer,	ডাক্টিকেটের,	ডাকটিকিটের,	
byabaharkaree,	ব্যবহারকারী,	ব্যবহারকারী,	
koota,	কুতা,	কোটা,	
shaddhi,	শদ্ধি,	সাধ্বী,	
jani,	জানি,	জনি,	
asaciates,	এস্যাচিয়েটস,	এসোসিয়েটস,	
eokee,	ইওকে,	এওকি,	
lutherana,	লুথেরানা,	লুথেরান,	
jonmobhumitir,	জন্মভূমিতির,	জন্মভূমিটির,	
shingping,	শিংপিং,	শিংপিং,	
kurdira,	কুর্দিরা,	কুর্দিরা,	
chanoo,	চানু,	চানু,	
sahozlabhbhatar,	সহজলহবভার,	সহজলভ্যতার,	
rahi,	রাহি,	রাহী,	
uponishad,	উপনিষাদ,	উপনিষদ,	
bonshi,	বনশি,	বংশী,	
bhittiti,	ভিত্তিটি,	ভিত্তিটি,	
qaro,	কারো,	কারো,	
ciima,	সিইম,	সীমা,	
greep,	গ্রিপ,	গ্রিপ,	
mukhmondole,	মুখমন্ডলে,	মুখমণ্ডলে,	
santoshpore,	সান্তোষ্পরে,	সন্তোষপুর,	
probhura,	প্রভুরা,	প্রভুরা,	
prachirer,	প্রাচীরের,	প্রাচিরের,	
nariider,	নারীদের,	নারীদের,	
musalmanderke,	মুসলমাঁদকেরকে,	মুসলমানদেরকে,	
saamaanya,	সামান্য,	সামান্য,	
rastagulikeo,	রাস্তাগুলিকেও,	রাস্তাগুলিকেও,	
hisabagyan,	হিসাবজ্ঞান,	হিসাবজ্ঞান,	
shakara,	শাকারা,	সাকার,	
bhabaaponno,	ভাবাপন্ন,	ভাবাপন্ন,	
bandhan,	বাঁধন,	বাঁধন,	
maila,	মাইলা,	মাইল,	
vortuki,	ভোরটুকি,	ভর্তুকি,	
engrejra,	এংরেজরা,	ইংরেজরা,	
modele,	মডেলে,	মডেলে,	
niharkantibabu,	নিহারকান্তিবাবু,	নিহারকান্তিবাবু,	
spashtotai,	স্পষ্টতাই,	স্পষ্টতই,	
juboksoho,	যুবকসহ,	যুবকসহ,	
sushposhtolikhito,	সুষ্পশ্থিকিত,	সুষ্পষ্টলিখিত,	
itastata,	ইতাস্টতা,	ইতস্তত,	
dalee,	লালি,	ডালে,	
utkhaat,	উৎকাত,	উত্খাত,	
hafsa,	হাফা,	হাফসা,	
rudiger,	রুদিগের,	রুদিগের,	
grambasheeo,	গ্রামবাশীও,	গ্রামবাসীও,	
neelfamarir,	নেলফামারির,	নীলফামারীর,	
koruna,	করুনা,	করুণা,	
bikargrosto,	বিকারগ্রস্ত,	বিকারগ্রস্ত,	
meghacchonno,	মেঘাচ্ছন্ন,	মেঘাচ্ছন্ন,	
chalochchitrei,	চলচচ্ত্রেই,	চলচ্চিত্রেই,	
ashirbadatri,	অশীর্বদাত্রী,	আশীর্বাদাত্রী,	
shajano,	শাজানো,	সাজানো,	
treebhuj,	ত্রিভূজ,	ত্রিভূজ,	
vorkendra,	ভরকেন্দ্র,	ভরকেন্দ্র,	
pray,	প্রেয়,	প্রায়,	
hul,	হুল,	হুল,	
jund,	জান্ড,	জুন্দ,	
bishwaashshke,	বিশ্বশ্ষকে,	বিশ্বাসকে,	
tottorat,	তত্ত্বরাট,	তওরাত,	
spreedashita,	স্প্রিডিশিটা,	স্প্রেডশীট,	
siqhar,	শিখার,	শিকার,	
jerusaleme,	জেরুসালেমে,	জেরুসালেমে,	
bipradas,	বিপ্রদাস,	বিপ্রদাস,	
grauth,	গ্রাউথ,	গ্রোথ,	
francine,	ফ্রান্সিন,	ফ্রান্সিন,	
directorate,	ডাইরেক্টরেট,	ডিরেক্টরেট,	
drabyatah,	দ্রব্যাথা,	দ্রব্যতঃ,	
nimitte,	নিমিত্তে,	নিমিত্তে,	
gabhaskaar,	গভবস্কার,	গাভাস্কার,	
pratisthanik,	প্রতিস্থানিক,	প্রাতিষ্ঠানিক,	
hena,	হেন,	হেনা,	
siit,	সিত,	শীত,	
freelancerra,	ফ্রীল্যান্সার,	ফ্রিল্যান্সাররা,	
haripur,	হরিপুর,	হরিপুর,	
byke,	বিইকিকে,	বাইক,	
kogake,	কোগাকে,	কোগাকে,	
shikara,	শিকারা,	শিকার,	
rejidens,	রেজিডেন্স,	রেসিডেন্স,	
obosan,	অবসান,	অবসান,	
poschime,	পশ্চিমে,	পশ্চিমে,	
bosantake,	বসানটাকে,	বসন্তকে,	
ukeliptas,	উকেলিপ্টাস,	ইউক্যালিপ্টাস,	
ovidhaner,	অভিধানের,	অভিধানের,	
golimodhye,	গোলিমধ্যে,	গলিমধ্যে,	
nothivukto,	নথিভুক্ত,	নথিভুক্ত,	
soleel,	সলিল,	সলিল,	
ooporoshtho,	অপরস্থ,	উপরস্থ,	
bhoutikeshu,	ভৌতিকেশু,	ভৌতিকেষু,	
dadapur,	দাদাপুর,	দাদাপুর,	
khargosher,	খারগশের,	খরগোসের,	
desiseyer,	ডেসিসেয়ের,	ডিজিজের,	
deepan,	দীপন,	দীপন,	
bbosben,	ব্যবস্বেন,	বসবেন,	
mulor,	মুলোর,	মুলোর,	
nagorikra,	নাগোরিকরা,	নাগরিকেরা,	
quota,	কুওটা,	কোটা,	
laatimer,	লাতিমের,	লাটিমের,	
bongshokey,	বংশকে,	বংশকে,	
dakshinangsho,	দক্ষিণাংশ,	দক্ষিণাংশ,	
osommotite,	অসম্মতিতে,	অসম্মতি,	
aakaabaar,	আকাবার,	আকাবার,	
bohoodin,	বহউদিন,	বহুদিন,	
samanyai,	সামান্যই,	সামান্যই,	
militaryr,	মিলিটারির,	মিলিটারির,	
prashikkhane,	প্রশিক্ষণে,	প্রশিক্ষণে,	
foloshrutite,	ফলশ্রুটিতে,	ফলশ্রুতিতে,	
musalmani,	মুসলমানি,	মুসলমানই,	
shatodha,	শতোধা,	শতধা,	
graambasi,	গ্রামবাসী,	গ্রামবাসী,	
omanisa,	ওমানিসা,	অমানিশা,	
manoharpur,	মনোহরপুর,	মনোহরপুর,	
vangley,	ভ্যাংলে,	ভাঙলে,	
totokson,	টোটোকন,	ততক্ষন,	
adhyatmik,	আধ্যাত্মিক,	আধ্যাত্মিক,	
laaisensh,	লেইসেন্স,	লাইসেন্স,	
abheedhaaneeck,	অভিধানিক,	অভিধানিক,	
saseza,	সাসেজা,	সসেজ,	
supparak,	সুপপারক,	সুপ্পারক,	
tarkale,	তারকলে,	তারকালে,	
dreeshtiheen,	দৃষ্টিহীন,	দৃষ্টিহীন,	
hossne,	হোসনে,	হোসনে,	
ekshoti,	একশটি,	একশোটি,	
booksar,	বুকসার,	বুক্সার,	
hoondayi,	হুন্দায়ি,	হুন্দাই,	
konruup,	কনরুউপ,	কোনরূপ,	
yathaarthabhaabe,	যথার্থভাবে,	যথার্থভাবে,	
bulano,	বুলানো,	বুলান,	
mukharji,	মুখর্জি,	মুখার্জী,	
victor,	ভিক্টর,	ভিক্টর,	
shlok,	শ্লক,	শ্লোক,	
saainyo,	সাইন্য,	সৈন্য,	
langhangulir,	লঙ্ঘনগুলির,	লঙ্ঘনগুলির,	
agomoney,	অগোময়ে,	আগমনে,	
serology,	সেরোলজি,	সেরোলজি,	
bhittimul,	ভিত্তিমুল,	ভিত্তিমূল,	
vagini,	ভ্যাজিনি,	ভগিনী,	
tarkareer,	তারকারীর,	তরকারীর,	
aansareer,	আঁসারীর,	আনসারীর,	
byaktikegreptar,	ব্যক্তিক্গে্তত্তর,	ব্যক্তিকেগ্রেপ্তার,	
thaii,	থাই,	থাই,	
oncholsomuho,	অঞ্চসমূল,	অঞ্চলসমূহ,	
pharn,	ফার্ন,	ফার্ন,	
unchiyechilo,	উঁচিয়াছিল,	উঁচিয়েছিল,	
laaisheesh,	লাইশিস,	লাইসেন্স,	
dhamshrenite,	ধামশ্রেণীতে,	ধামশ্রেণীতে,	
poriikkhateo,	পরীক্ষাতেও,	পরীক্ষাতেও,	
hetimganje,	হেতিমগঞ্জে,	হেতিমগঞ্জে,	
stander,	স্ট্যান্ডার,	স্ট্যাণ্ডের,	
chikitshar,	চিকিৎসার,	চিকিত্সার,	
marodeho,	মারোদহ,	মরদেহ,	
laaishenshh,	লেইশেনশ,	লাইসেন্স,	
times,	টামেস,	টাইমস্,	
icelands,	আইসেল্যান্ড,	আইসল্যান্ডসহ,	
jonee,	জনে,	জনি,	
oikhan,	ঐখান,	ঐখান,	
graambaashee,	গ্রামবাশী,	গ্রামবাসী,	
aalkaatra,	আলকাত্র,	আলকাতরা,	
bojata,	বোজাটা,	বোজাটা,	
aborto,	আবর্ত,	আবর্ত,	
shoriph,	শরীি,	শরিফ,	
dobhaar,	দোভার,	ডোভার,	
simaa,	সিমা,	সীমা,	
foolkopi,	ফুলকোপি,	ফুলকপি,	
deliver,	ডেলিভার,	ডেলিভার,	
humira,	হুমিরা,	হুমিরা,	
jotinkey,	জটিনকে,	যতীনকে,	
modhyekar,	মধ্যেকার,	মধ্যেকার,	
nabayug,	নবায়ুগ,	নবযুগ,	
chinto,	চিন্ত,	চিনতো,	
choopi,	চুপি,	চুপি,	
soheensotar,	সোহীনসতার,	সহিংসতার,	
avisongson,	আভিসংসন,	অভিশংসন,	
jahangirbad,	জাহাঙ্গীরবাদ,	জাহাঙ্গীরবাদ,	
cs,	সিএস,	সিএস,	
banshite,	বাঁথিতে,	বাঁশিতে,	
kampita,	কম্পিতা,	কম্পিত,	
monchosthol,	মঞ্চস্থল,	মঞ্চস্থল,	
rokkhonabekkhoner,	রক্ষণাবেক্ষণের,	রক্ষণাবেক্ষণের,	
ajij,	আজিজ,	আজিজ,	
ujbekistaner,	উজবেক্সিতানের,	উজবেকিস্তানের,	
ajibooner,	আজিবনের,	আজীবনের,	
huka,	হুকা,	হুক,	
thyachara,	থ্যাচরা,	থ্যাচার,	
poderthobid,	পদের্থবিদ,	পদার্থবিদ,	
toxoid,	টক্সোড,	টক্সয়েড,	
sudrishya,	সুদৃশ্য,	সুদৃশ্য,	
ardasho,	আর্দাশো,	আর্দশ,	
hingsar,	হিংসার,	হিংসার,	
himchi,	হিমচি,	হিমচি,	
premo,	প্রেমো,	প্রিমো,	
obharbhiu,	অভারভু,	ওভারভিউ,	
vabaponno,	ভাবাপন্ন,	ভাবাপন্ন,	
kurdider,	কুর্দিদের,	কুর্দিদের,	
nadike,	নাদিকে,	নদীকে,	
dharavassokar,	ধারাভাষ্কর,	ধারাভাষ্যকার,	
engreziteo,	এংরেজিতেও,	ইংরেজিতেও,	
maaktoome,	মাক্তুমে,	মাকতুম,	
foreks,	ফরেক্স,	ফরেক্স,	
balabhadra,	বালাভদ্র,	বলভদ্র,	
bishasey,	বিশাসে,	বিশ্বাসে,	
neshnos,	নেশনোস,	নেশনস,	
kanuner,	কানুনের,	কানুনের,	
falak,	ফালাক,	ফলক,	
mukhomandaley,	মুখোমন্ডলে,	মুখমণ্ডলে,	
horiddare,	হরিদ্দারে,	হরিদ্বারে,	
baipass,	বাইপাস,	বাইপাস,	
onchalti,	অঁচালটি,	অঞ্চলটি,	
holding,	হোল্ডিং,	হোল্ডিং,	
caroline,	ক্যারোলিন,	ক্যরোলিন,	
middleton,	মিডলটেন,	মিডলটন,	
monzushree,	মন্ুর্রী,	মঞ্জুশ্রী,	
comoros,	কমোরোস,	কোমোরোস,	
sheshardhe,	শেষার্ধে,	শেষার্ধে,	
byathapather,	ব্যথাপথের,	ব্যথাপথের,	
neerbahe,	নিরবাহে,	নির্বাহে,	
generalissimo,	জেনারেলাসিমো,	জেনারেলিসিমো,	
teksuser,	টেকসুসের,	টেক্সাসের,	
chhanada,	ছানাদা,	ছানাদা,	
atibiplabi,	অতিবিপ্লাবী,	অতিবিপ্লবি,	
somraatra,	সম্রাত্র,	সম্রাটরা,	
songkoloney,	সংকলনে,	সংকলনে,	
pratijogitamulak,	প্রতিযোগিতামূলক,	প্রতিযোগীতামূলক,	
qredita,	ক্রেডিটা,	ক্রেডিট,	
prokolpotike,	প্রকল্পটিকে,	প্রকল্পটিকে,	
jatinkey,	জাতিনকে,	যতীনকে,	
cn,	সিএনএন,	সিএন,	
teman,	তেমান,	তেমন,	
chai,	চাই,	ছাই,	
byabosthar,	ব্যবস্থার,	ব্যাবস্থার,	
lambi,	লাম্বি,	লম্বি,	
sexperter,	সেক্সপার্টের,	সেক্সপার্টের,	
chongar,	চঙ্গার,	চোঙ্গার,	
bhyatikaner,	ভ্যাটিকানের,	ভ্যাটিকানের,	
bitlaser,	বিটলাসের,	বিটলসের,	
capshule,	কাপশালে,	ক্যাপসুল,	
salchak,	সালচক,	সালচাক,	
disposes,	ডিস্পোসেস,	ডিসপোজেস,	
mosharroph,	মশাররো,	মশাররফ,	
ghomtaa,	ঘোমটা,	ঘোমটা,	
ahalyar,	আহল্যার,	অহল্যার,	
latsaheb,	লততাহেব,	লাটসাহেব,	
kheshar,	খেশার,	খেশার,	
shangkalonti,	সংকললন্তি,	সংকলনটি,	
mohit,	মোহিত,	মুহিত,	
polashir,	পলাশির,	পলাশীর,	
fishing,	ফিশিং,	ফিসিং,	
shrabostee,	শ্রাবস্তি,	শ্রাবস্তী,	
atmobonchito,	আত্মবঞ্চিত,	আত্মবঞ্চিত,	
gaj,	গ়্,	গেজ,	
seramiks,	সেরামিকস,	সিরামিকস,	
remacry,	রিম্যাক্রি,	রেমাক্রী,	
choddo,	চদ্দ,	চোদ্দো,	
deenes,	দাইনেস,	দীনেশ,	
swajan,	স্বজন,	স্বজন,	
emargency,	এমার্জেন্সি,	এমার্জেন্সি,	
saver,	সাভার,	সেভার,	
upobaasee,	উপবাসী,	উপবাসী,	
champa,	চম্পা,	চাঁপা,	
uqeliptas,	ইকুলিপ্টাস,	ইউক্যালিপ্টাস,	
maudelti,	মাউডেলটি,	মডেলটি,	
shuri,	সুরী,	সুরি,	
saraiki,	সরাইকি,	সরাইকি,	
saranor,	সারানোর,	সরানোর,	
lagto,	লাগতো,	লাগতো,	
tennys,	টেনিস,	টেনিস,	
dalnata,	দলনতা,	ডালনাটা,	
laiseensee,	লেইসিনি,	লাইসেন্স,	
sanstha,	সাস্থথ,	সংস্থা,	
machkabar,	মাচকাবার,	মাচকাবার,	
eporjonto,	এপরজন্ত,	এপর্যন্ত,	
farid,	ফরিদ,	ফরিদ,	
gotihin,	গতিহীন,	গতিহীন,	
lyaandeeng,	ল্যান্ডিং,	ল্যান্ডিং,	
madhnagar,	মদনগর,	মাধনগরের,	
kalenga,	কালেঙ্গা,	কালেঙ্গা,	
carlos,	কার্লোস,	কার্লোস,	
anchalo,	আঁচালো,	অঞ্চলও,	
deep,	দীপ,	দীপ,	
russad,	রুসাড,	রুশদ,	
awatar,	আওয়াতার,	অবতার,	
bhaisaho,	ভাইসাহ,	ভাইসহ,	
damakalkarmirao,	দমকলকর্মীরাও,	দমকলকর্মীরাও,	
sharif,	শরিফ,	শরিফ,	
boudhher,	বৌধ্রের,	বৌদ্ধের,	
nazad,	নাজাদ,	নাজাদ,	
saoum,	সুয়াম,	সাওম,	
grambaashi,	গ্রামবাশী,	গ্রামবাসী,	
biswashi,	বিশ্বাশী,	বিশ্বাসই,	
elakatikay,	এলাকাটিকা,	এলাকাটিকে,	
manjushri,	মঞ্জুশ্রী,	মঞ্জুশ্রী,	
ikbaaler,	ইকবালের,	ইকবালের,	
dayitta,	দায়িত্ব,	দায়িত্ব,	
licenshe,	লাইসেন্স,	লাইসেন্স,	
munim,	মুনিং,	মুনিম,	
porishongkhanbid,	পরিশংখ্যানবিদ,	পরিসংখ্যানবিদ,	
shikhra,	শিখরা,	শিখরা,	
conservetion,	কনজারভেশন,	কনসারভেশন,	
chokrantosoho,	চক্রান্তসহ,	চক্রান্তসহ,	
kanshat,	কানশাট,	কানসাট,	
mele,	মেলে,	মাইল,	
jeshh,	জেশ,	জেস,	
shatoke,	শতককে,	শতকে,	
dhos,	ধস,	ধস,	
pratisthanikvabe,	প্রতিস্থানিকভাবে,	প্রাতিষ্ঠানিকভাবে,	
boikalyo,	বৈকাল্য,	বৈকল্য,	
aashtikotaa,	আষ্টিকতা,	আস্তিকতা,	
bonobhumi,	বনভূমি,	বনভূমি,	
rojapalaner,	রোজাপালানের,	রোজাপালনের,	
rakkhanvag,	রক্ষণভাগ,	রক্ষণভাগ,	
manushsoho,	মানুষসহ,	মানুষসহ,	
brekthrough,	ব্রেক্তরুগ,	ব্রেকথ্রু,	
dovaar,	দোভার,	ডোভার,	
chakurijibirao,	চাকুরেজিবিরাও,	চাকুরীজীবীরাও,	
iraner,	ইরানের,	ইরানের,	
neemitte,	নীমিত্তে,	নিমিত্তে,	
sahajlabhbhotar,	সহজলভ্বতার,	সহজলভ্যতার,	
chetanagato,	চেতনাগত,	চেতনাগত,	
bayii,	বায়ি,	বাঈ,	
uparzoner,	উপার্যজের,	উপার্জনের,	
panda,	পান্ডা,	পান্ডে,	
sambatsarkal,	সম্বতসরকাল,	সম্বৎসরকাল,	
suchonakal,	সূচনাকাল,	সূচনাকাল,	
akkhunno,	অক্ষুণ্ন,	অক্ষুণ্ণ,	
eevil,	এইভিল,	ইভিল,	
farhetin,	ফারহেতিন,	ফারহেতিন,	
bachai,	বাচাই,	বাছাই,	
dip,	ডিপ,	দীপ,	
quary,	কোয়ারি,	কোয়েরি,	
korle,	করলে,	করলে,	
nabyata,	নব্যতা,	নাব্যতা,	
bedanta,	বেদান্ত,	বেদান্ত,	
pisach,	পিসাচ,	পিশাচ,	
paikgachha,	পাইকগাছা,	পাইকগাছা,	
elakaasoho,	এলাকাসহ,	এলাকাসহ,	
ispredsheet,	ইস্প্রেডহিট,	স্প্রেডশীট,	
joumana,	জওমানা,	জুমানা,	
sakshatkarer,	সাক্ষতকারের,	সাক্ষাৎকারের,	
janar,	জানার,	জানার,	
dubureer,	ডুবুরির,	ডুবুরির,	
rilayensa,	রিলয়েনস,	রিলায়েন্স,	
bolbo,	বলবো,	বলবো,	
gandagol,	গণ্ডাগোল,	গন্ডগোল,	
rushod,	রুশোদ,	রুশদ,	
hood,	হোড,	হুড,	
muchi,	মুচি,	মুচি,	
bachhaikrito,	বছাশিরত,	বাছাইকৃত,	
forex,	ফোরেক্স,	ফরেক্স,	
sangsakti,	সংসক্তি,	সংসক্তি,	
lesense,	লেসেন্সে,	লাইসেন্স,	
godamjato,	গদাম্মতত,	গুদামজাত,	
fiksing,	ফিক্সিং,	ফিক্সিং,	
gananatyo,	গণনাত্য,	গণনাট্য,	
shulfate,	শুলফাতে,	সালফেট,	
qonfliqt,	কনফ্লিক্ট,	কনফ্লিক্ট,	
daakten,	দাকতেন,	ডাকতেন,	
jontropatigulite,	যন্ত্রপাতিগুলিতে,	যন্ত্রপাতিগুলিতে,	
arthanitike,	অর্থনীতিকে,	অর্থনীতিকে,	
pack,	পেক্স,	প্ল্যাক,	
rakkhanbhag,	রক্ষণভং,	রক্ষণভাগ,	
bishnoo,	বিষ্ণ,	বিষ্ণু,	
iuro,	ইউরো,	ইউরো,	
pyaleshtainer,	প্লালেশটেনের,	প্যালেস্টাইনের,	
khelaphate,	খেলাফাতে,	খেলাফতে,	
bisheshyo,	বিশেষ্য,	বিশেষ্য,	
kayed,	কায়েদ,	কায়েদ,	
loombinee,	লূম্বিনি,	লুম্বিনী,	
protul,	প্রতুল,	প্রতুল,	
phareeksa,	ফারককসা,	ফরেক্স,	
shikkharthirao,	শিক্ষার্থীরাও,	শিক্ষার্থীরাও,	
dushtogone,	দুষ্টগণে,	দুষ্টগণে,	
anchalsaho,	অঞ্চলসহ,	অঞ্চলসহ,	
bishhnu,	বিষ্ণু,	বিষ্ণু,	
khalid,	খালিদ,	খালিদ,	
jumlalancer,	জুমলালান্সের,	জুমলাল্যান্সার,	
protiakromonei,	প্রতিয়ামরণেই,	প্রতিআক্রমণেই,	
dormetori,	ডর্মেটরি,	ডরমিটরি,	
sahocorje,	সহহকর্যে,	সাহচর্যে,	
sadbi,	সাদবি,	সাধ্বী,	
protishtan,	প্রতিষ্টান,	প্রতিষ্টান,	
yuro,	য়ারও,	ইউরো,	
mawdeel,	মাইদিল,	মডেল,	
seconder,	সেকন্ডের,	সেকেন্ডের,	
kutubuddinke,	কুটুবুদ্দিনকে,	কুতুবুদ্দিনকে,	
porobortii,	পরবর্তী,	পরর্বতী,	
monjurul,	মঞ্জুরুল,	মনজুরুল,	
bbiswash,	বিব্ষিশ্বাশ,	বিশ্বাস,	
maner,	মনের,	মানে,	
yuroo,	যুরু,	ইউরো,	
gudamjat,	গুদমাজত,	গুদামজাত,	
chhon,	ছনন,	ছোঁ,	
mekong,	মেকং,	মেকং,	
breakthrough,	ব্র্কারগু,	ব্রেকথ্রু,	
sanghitar,	সংহীতার,	সংহিতার,	
jeelyaand,	জিল্যান্ড,	জিল্যান্ড,	
maley,	ম্যালি,	মালে,	
mirina,	মিরিনা,	মিরিনা,	
emerjency,	এমারজেন্সি,	এমার্জেন্সি,	
johny,	জযহনি,	জনি,	
capsule,	ক্যাপসুলে,	ক্যাপ্সুল,	
neck,	নেক,	নেক,	
grambaseer,	গ্রামবাসীর,	গ্রামবাসীর,	
sqolastiq,	স্কোলাস্তিক,	স্কলাস্টিক,	
nek,	নেক,	নেক,	
ganjana,	গঞ্জনা,	গঞ্জনা,	
bijepi,	বিজেপি,	বিজেপি,	
aprasangikbhabei,	অপ্রসংসিধভাবেই,	অপ্রাসঙ্গিকভাবেই,	
scholarship,	স্কলারশিপ,	স্কলারশিপ,	
swairacharibirodhi,	স্বৈরাচরিবিরোধী,	স্বৈরাচারীবিরোধী,	
dara,	দারা,	দারা,	
bollov,	বল্লভ,	বল্লভ,	
mugdal,	মুগদাল,	মুগডাল,	
probeshan,	প্রবেশন,	প্রবেশন,	
mononiitoder,	মনোনীতদের,	মনোনীতদের,	
sharoker,	শররকের,	স্মারকের,	
heepatitis,	হেপোটিটিস,	হেপাটাইটিস,	
edipass,	এডিপাস,	ইডিপাস,	
basaalt,	বাসাল্ল,	ব্যাসল্ট,	
swatantrata,	স্বাতন্ত্র্যটা,	স্বতন্ত্রতা,	
indrani,	ইন্দ্রাণী,	ইন্দ্রাণী,	
byaboharkarie,	ব্যবহারকারী,	ব্যবহারকারীই,	
suraropito,	সুরারোপিত,	সুরারোপিত,	
khudhartara,	ক্ষুধারটারা,	ক্ষুধার্তরা,	
bagdad,	বাগদাদ,	বাগদাদে,	
digreeke,	দিগ্রিকে,	ডিগ্রিকে,	
korley,	করলে,	করলে,	
purohitder,	পুরোহিতদের,	পুরোহিতদের,	
ghotol,	ঘটল,	ঘটল,	
notey,	নতে,	নোটে,	
dibi,	দিবি,	দিবি,	
prijon,	প্রিজন,	প্রিজন,	
mmadhuri,	মোমাধুরি,	মাধুরী,	
jhalkanite,	ঝাকালিতে,	ঝলকানীতে,	
nirabota,	নিরাবতা,	নিরবতা,	
ghoshanapatratio,	ঘোষণাপত্রটিও,	ঘোষণাপত্রটিও,	
zibonnogor,	জীবন্যগর,	জীবননগর,	
mugdha,	মুগ্ধ,	মুগ্ধ,	
souripurang,	সৌরিপুরং,	সৌরিপুরং,	
marpit,	মারপিট,	মারপিট,	
shasankarta,	শাসনকর্তা,	শাসনকর্তা,	
manjushree,	মঞ্জুর্ী,	মঞ্জুশ্রী,	
parking,	পারকিং,	পার্কিং,	
ghuznavi,	ঘুজনাভি,	গজনভি,	
byabaharkarike,	ব্যবহারকারীকে,	ব্যবহারকারীকে,	
ministara,	মিনিস্টারা,	মিনিস্টার,	
turkamena,	তুর্কমেন,	তুর্কমেন,	
chandrimaa,	চন্দ্রিমা,	চন্দ্রিমা,	
pleeta,	প্লিটা,	প্লেট,	
seqtara,	সেকতারা,	সেক্টর,	
dheke,	ধেকে,	ঢেকে,	
bopoon,	বপন,	বপন,	
kuldip,	কুলদিপ,	কুলদীপ,	
lokhindorer,	লোখিন্দরের,	লখিন্দরের,	
tanshree,	তন্শ্রী,	তানশ্রী,	
fansi,	ফানসি,	ফাঁসী,	
mosjidsoho,	মসজিদসহ,	মসজিদসহ,	
liseensee,	লিসেনি,	লাইসেন্স,	
madeling,	মাযাডেলিং,	মডেলিং,	
shommoteer,	সম্মতির,	সম্মতির,	
qaferderkey,	কাফেরদেরকে,	কাফেরদেরকে,	
venuser,	ভেনুসের,	ভেনাসের,	
umedpoor,	উমেদপুর,	উমেদপুর,	
bonsho,	বনশ,	বংশ,	
cinematographar,	সিনেমাটোগ্রফর,	সিনেমাটোগ্রাফার,	
deool,	দেওউল,	দেউল,	
naazee,	নাজ,	নাত্সি,	
nirgamon,	নির্গামন,	নির্গমন,	
bike,	বিকে,	বাইক,	
parq,	পার্ক,	পার্ক,	
lakkhero,	লাক্ষেরও,	লক্ষেরও,	
doobate,	দোবতে,	ডুবাতে,	
tahalo,	তাহালো,	তাহলো,	
nakkal,	নকককল,	নক্কল,	
halding,	হ্যাডলিং,	হোল্ডিং,	
inafarameshana,	ইনাফরামেশন,	ইনফরমেশন,	
bokul,	বকুল,	বকুল,	
dinara,	দিনারা,	ডিনার,	
graambasheeo,	গ্রামবিশেও,	গ্রামবাসীও,	
gejeted,	জেজেট,	গেজেটেড,	
naubom,	নাবম,	নবম,	
shchalastik,	স্কলাস্তিক,	স্কলাস্টিক,	
shektor,	শেক্তর,	সেক্টর,	
durgotsab,	দুর্গোৎসব,	দুর্গোৎসব,	
byaboharkari,	ব্যবহারকারী,	ব্যবহারকারী,	
install,	ইনস্টাল,	ইন্সটল,	
guzober,	গুজবের,	গুজবের,	
nirobota,	নিরবতা,	নিরবতা,	
dera,	ধীরা,	ডেরা,	
nabatarange,	নবতরঙ্গে,	নবতরঙ্গে,	
swarther,	স্বার্থের,	স্বার্থের,	
deelibhara,	দীলিভারা,	ডেলিভার,	
fising,	ফিসিং,	ফিসিং,	
khappar,	খপ্পর,	খপ্পর,	
poribahokotto,	পরিবাহকত্ব,	পরিবাহকত্ব,	
kompeeto,	কম্পিত,	কম্পিত,	
noitikota,	নৈতিকতা,	নৈতিকতা,	
durarohini,	দুরারাহিনী,	দুরারোহিণী,	
wodka,	ওয়োদকা,	ভদকা,	
bhogni,	ভগ্নী,	ভগ্নী,	
vaabnake,	ভাবনাকে,	ভাবনাকে,	
phiksim,	ফিক্সিম,	ফিক্সিং,	
nischitvabe,	নিশ্চিতভাবে,	নিশ্চিতভাবে,	
krisenta,	কৃষিস্টা,	ক্রিসেন্ট,	
nobotomo,	নবতম,	নবতম,	
mukhomandoler,	মুখমন্ডলের,	মুখমণ্ডলের,	
akkaas,	আক্কাস,	আককাস,	
canservatian,	ক্যান্সারিভেন,	কনসারভেশন,	
bhittitei,	ভিত্তিতেই,	ভিত্তিতেই,	
prajanankal,	প্রজননংকাল,	প্রজননকাল,	
vogiroth,	ভোগীরথ,	ভগীরথ,	
qulim,	কুলিম,	কুলিং,	
ganosochetonota,	গণসচেতনাটা,	গণসচেতনতা,	
mahafezkhanar,	মহাফেজখানার,	মহাফেজখানার,	
gitikobita,	গীতিকবিতা,	গীতিকবিতা,	
itostatah,	ইতস্তাথা,	ইতস্ততঃ,	
jatotaa,	জাতোতা,	যতোটা,	
vault,	ভাল্ট,	ভল্ট,	
sangitanusthane,	সঙ্গীতানুষ্ঠানে,	সঙ্গীতানুষ্ঠানে,	
byabaharkariderke,	ব্যবহারকারীদেরকে,	ব্যবহারকারীদেরকে,	
sheetke,	শীতকে,	শীতকে,	
ancholsomuho,	অঞ্চসমূলহ,	অঞ্চলসমূহ,	
institutione,	ইনস্টিটিউশন,	ইনস্টিটিউশনে,	
neermol,	নির্মল,	নির্মল,	
taigara,	টাইগর,	টাইগার,	
dighol,	দিঘল,	দীঘল,	
ghumachchila,	ঘুমাচ্ছিল,	ঘুমাচ্ছিল,	
deeares,	ডিয়ারস,	ডিআরএস,	
senabahinikey,	সেনাবাহিনীকে,	সেনাবাহিনীকে,	
enjineers,	এনজিনিজারস,	ইঞ্জিনিয়ার্স,	
kusumeshu,	কুসুমেষু,	কুসুমেষু,	
amudey,	আমুদে,	আমুদে,	
totokhon,	ততোখন,	ততক্ষন,	
nariderke,	নারীদেরকে,	নারিদেরকে,	
palbongsher,	পালবংশের,	পালবংশের,	
nothivukta,	নথিভুক্ত,	নথিভুক্ত,	
stona,	স্তনা,	স্টোন,	
crucer,	ক্রুচার,	ক্রুশের,	
uindos,	উইন্ডস,	উইন্ডোস,	
cholchhee,	চলছে,	চলছে,	
azaan,	আজান,	আজান,	
bajhyo,	বাঝ্য,	বাহ্য,	
ekok,	একক,	একক,	
basermick,	বাসেরমিক,	বেসারমিক,	
shtonehenge,	স্টোহেন্জে,	স্টোনহেঞ্জ,	
sorsa,	সোরসা,	সোর্স,	
shroddhabihin,	শ্রদ্ধাবিহীন,	শ্রদ্ধাবিহীন,	
asif,	আসিফ,	আসিফ,	
songasthaner,	সংস্থানের,	সংস্থানের,	
hondooras,	হন্ডুরাস,	হন্ডুরাস,	
bosontoke,	বসন্তকে,	বসন্তকে,	
fostar,	ফস্তার,	ফস্টার,	
porjotoker,	পর্যটকের,	পর্যটকের,	
soomitrar,	সুমিত্রার,	সুমিত্রার,	
edmiral,	এডমিরাল,	এডমিরাল,	
madraser,	মাদ্রাসের,	মাদ্রাজের,	
mukhoshdharir,	মুখোষধারীর,	মুখোশধারীর,	
barrageke,	বারোগেজকে,	ব্যারেজকে,	
armshtrong,	আর্মস্ট্রং,	আর্মস্ট্রং,	
antarctica,	অ্যান্ট্রাকটিকা,	অ্যান্টার্কটিকার,	
wagadada,	ওয়াগাডা,	বাগদাদ,	
nothivuktir,	নথিভুক্তির,	নথিভুক্তির,	
alraji,	আলরাজি,	আলরাজী,	
cholochchitraeeo,	চলচ্চিত্রী,	চলচ্চিত্রেও,	
nirgoon,	নির্গুণ,	নির্গুণ,	
bouddher,	বৌদ্ধের,	বৌদ্ধের,	
panchashjan,	পঞ্চশ্জন,	পঞ্চাশজন,	
dala,	দালা,	দলা,	
minister,	মিনিস্টার,	মিনিস্টার,	
helloin,	হেলোন,	হ্যালোইন,	
abheedhaaneek,	অভিধানিক,	অভিধানিক,	
bandi,	বাঁদি,	বন্দী,	
temanti,	তেমানটি,	তেমনটি,	
saarbhaarti,	সার্ভর্তী,	সার্ভারটি,	
cholchhe,	চলছে,	চলছে,	
noteti,	নোটেটি,	নোটটি,	
domonmulok,	ডমনমূলক,	দমনমূলক,	
antarctika,	অন্টার্টটিকা,	অ্যান্টার্কটিকা,	
hupile,	হুপিলে,	হুপিলে,	
gorjon,	গর্জন,	গর্জন,	
bhimsen,	ভীমসেন,	ভীমসেন,	
qyapasula,	ক্যাপাসুলা,	ক্যাপসুল,	
boshoborty,	বশবর্তী,	বশবর্তী,	
schilling,	স্কিলিং,	শিলিং,	
aamontrito,	আমন্ত্রিত,	আমন্ত্রিত,	
turkii,	তুরকি,	তুর্কি,	
uponeesoder,	উপনিসদের,	উপনিষদের,	
mesenjarer,	মেসেনজারের,	মেসেঞ্জারের,	
nisshongotake,	নিঃশংগতকাকে,	নিঃসঙ্গতাকে,	
nogore,	নগরে,	নগরে,	
pleta,	প্লেট,	প্লেটো,	
poripake,	পরিপাকে,	পরিপাকে,	
nosihote,	নসিহতে,	নসিহতে,	
creshcent,	ক্রেশসেন্ট,	ক্রিসেন্ট,	
mulbhitti,	মূলভিত্তি,	মূলভিত্তি,	
noiteek,	নৈতিক,	নৈতিক,	
phising,	ফিসিং,	ফিসিং,	
shukrabab,	শুক্রবাব,	শুক্রবাব,	
hozot,	হোজত,	হজত,	
ajuhath,	অজুহাত,	অজুহাত,	
grambaaseeder,	গ্রামবাসীদের,	গ্রামবাসীদের,	
argho,	আরঘঘ,	অর্ঘ্য,	
poste,	পোস্টে,	পোস্টে,	
masjidtir,	মসজিদটির,	মসজিদটির,	
rajtontro,	রাজতন্ত্র,	রাজতন্ত্র,	
ekatitto,	একাতিত্ব,	একাতিত্ব,	
qarpeta,	কারপেটা,	কার্পেট,	
sithilotar,	সিথিলতার,	শিথিলতার,	
logic,	লুজিক,	লজিক,	
ghamtaa,	ঘামটা,	ঘোমটা,	
freekeh,	ফ্রিকেহ,	ফ্রিকেহ,	
dhangsachchi,	ধ্বংসাচ্ছি,	ধ্বংসাচ্ছি,	
juktarashtrasaha,	যুক্তারশ্ট্রসহ,	যুক্তরাষ্ট্রসহ,	
badaghat,	বাদাঘাট,	বাদাঘাট,	
steen,	স্টিন,	স্টেন,	
philipiner,	ফিলিপিনের,	ফিলিপাইনের,	
chalchhe,	চাছছে,	চলছে,	
sharansthal,	সারন্থল,	শরণস্থল,	
injiniyarim,	ইঞ্জিনিয়ারীং,	ইঞ্জিনিয়ারিং,	
chhayi,	ছায়ি,	ছাই,	
cheenja,	চীনজা,	চেঞ্জ,	
postac,	পোস্টাক,	পোস্টকে,	
deaubande,	ডিউব্যান্ডে,	দেওবন্দে,	
udbodhani,	উদ্বোধানি,	উদ্বোধনী,	
tiunara,	তিউনারা,	টিউনার,	
samoshtigato,	সামস্তিগত,	সমষ্টিগত,	
matrirup,	মাতৃরূপ,	মাতৃরূপ,	
granthatyke,	গ্রান্থথাকে,	গ্রন্থটিকে,	
kanader,	কানাদের,	কণাদের,	
koordira,	কূর্ডিরা,	কুর্দিরা,	
lettar,	লেট্টার,	লেটার,	
gagee,	গেই,	গেজ,	
bhumija,	ভূমিজা,	ভূমিজ,	
khalidke,	খালিদকে,	খালিদকে,	
rubidium,	রুবিডিয়াম,	রুবিডিয়াম,	
khoka,	খোকা,	খোকা,	
conflict,	কনফ্লিক্ট,	কনফ্লিক্ট,	
salphat,	সালফাত,	সালফেট,	
pachchi,	পাচ্ছি,	পাচ্ছি,	
gobeshana,	গবেষণা,	গবেষনা,	
shoreefpur,	শরীফপুর,	শরিফপুর,	
jyaqasana,	জ্যাকসন,	জ্যাকসন,	
recondishon,	রেকোন্ডিশন,	রিকন্ডিশন,	
lidars,	লিডার্স,	লিডার্স,	
roopdan,	রূপদান,	রুপদান,	
hoteltite,	হোটেলটাইট,	হোটেলটিতে,	
faskari,	ফাসকারি,	ফাঁসকারী,	
bhotomulyoke,	ভোটমূল্যকে,	ভোটমূল্যকে,	
vaphara,	ভাপোরা,	বাফার,	
marketin,	মার্কেটিন,	মার্কেটিং,	
niutrino,	নিউট্রিনো,	নিউট্রিনো,	
motke,	মোটকে,	মতকে,	
kantajir,	কান্তাজির,	কান্তজির,	
collaborators,	কলাবরেটরস,	কলাবরেটরস,	
otyacharer,	অত্যাচারের,	অত্যাচারের,	
qarlosa,	কারলোসা,	কার্লোস,	
minishtarer,	মিনিশ্টারের,	মিনিস্টারের,	
baharamporer,	বাহারামপুরের,	বহরমপুরের,	
sofie,	সোফি,	সোফি,	
danakana,	দানাকানা,	ডানকান,	
asaktibandhan,	অসক্তিবন্ধন,	আসক্তিবন্ধন,	
marmaraa,	মারমারা,	মারমারা,	
uthe,	উঠে,	উঠে,	
jacksoner,	জ্যাকসনের,	জ্যাকসনের,	
ghurechen,	ঘুরেছেন,	ঘুরেছেন,	
procharona,	প্রচারণা,	প্রচারণা,	
myathiou,	ম্যাথওউ,	ম্যাথিউ,	
ved,	ভেদ,	বেদ,	
miraqela,	মিরাকেলা,	মিরাকেল,	
dinar,	দিনার,	ডিনার,	
ganokantha,	গণকন্ঠ,	গণকণ্ঠ,	
jwar,	জ্বার,	জ্বর,	
khalidkay,	খািিদকল,	খালিদকে,	
elakatike,	এলাকাটিকে,	এলাকাটিকে,	
dabliudabliui,	ডাব্লিউডুবিউলি,	ডাব্লিউডাব্লিউই,	
attorkite,	অ্যাটর্কিতে,	অতর্কিতে,	
phiqsa,	ফিক্সা,	ফিক্স,	
gara,	গারা,	গোর,	
mochlekha,	মোচলেখা,	মোছলেখা,	
foks,	ফক্স,	ফক্স,	
direectoratee,	দিরিক্তারতি,	ডিরেক্টরেট,	
plusey,	প্লুসে,	প্লাসে,	
seoul,	সেওল,	সোল,	
purbanchaler,	পূর্বঞ্চলের,	পূর্বাঞ্চলের,	
carlo,	কারলো,	কার্লো,	
raiialati,	রাইয়াইলাটি,	রয়্যালটি,	
nirmolota,	নির্মলতা,	নির্মলতা,	
ghoshito,	ঘোষিত,	ঘোষিত,	
tikto,	তিক্ত,	তিক্ত,	
palashir,	পলাশির,	পলাশীর,	
manobikotao,	মানবিকতাও,	মানবিকতাও,	
dankaan,	ডানকান,	ডানকান,	
asantosh,	আসন্তোষ,	অসন্তোষ,	
chalochchitraeeo,	চলচচ্ত্রীয়,	চলচ্চিত্রেও,	
modelkey,	মোডেলকে,	মডেলকে,	
kajangale,	কজজঙ্গলে,	কজঙ্গলে,	
thare,	থারে,	থরে,	
lagchhe,	লাগছে,	লাগছে,	
prosadhani,	প্রসাধানী,	প্রসাধনী,	
hastamathun,	হস্তমাথুন,	হস্তমথুন,	
phiksa,	ফিক্সা,	ফিক্স,	
gandhiir,	গান্ধির,	গান্ধীর,	
chilahaati,	চিলাহাটি,	চিলাহাটি,	
choritrotakeo,	চরিত্রতাকেও,	চরিত্রটাকেও,	
bhabotarini,	ভাবতারিনী,	ভবতারিণী,	
obosore,	অবসরে,	অবসরে,	
elgoridom,	এলজোরিডম,	এলগরিদম,	
cheekitsar,	চিকিৎসার,	চিকিত্সার,	
erajyobasi,	এরাজ্যবাসী,	এরাজ্যবাসী,	
tiuning,	তিউনিং,	টিউনিং,	
bisshaskey,	বিশ্ষাসকে,	বিশ্বাসকে,	
paroner,	পারণের,	পারণের,	
niphelheim,	নিফেলহাইম,	নিফেলহেইম,	
syfy,	সিএফইই,	সাইফাই,	
onupater,	অনুপাতের,	অনুপাতের,	
jommu,	জম্মু,	জম্মু,	
barack,	বারাক,	বারাক,	
chasee,	চাসী,	চেস,	
dienes,	ডায়েনস,	ডিএনএস,	
protijogii,	প্রতিযোগী,	প্রতিযোগী,	
bohudeen,	বহুদীন,	বহুদিন,	
kottar,	কতটার,	কট্টর,	
semai,	সেমাই,	সেমাই,	
jolrang,	জলরাং,	জলরঙ,	
samashtike,	সমাস্টিকে,	সমষ্টিকে,	
dormitory,	ডর্মিটরি,	ডরমিটরি,	
mexicoteo,	মেক্সিকোটেও,	মেক্সিকোতেও,	
shipley,	শিপলে,	শিপলে,	
nirmankarmisaha,	নির্মণ্করীমসহ,	নির্মাণকর্মীসহ,	
ispreedshiit,	ইসপ্রিডশিনিৎ,	স্প্রেডশীট,	
lirikti,	লিরিকটি,	লিরিকটি,	
cholochchitratike,	চলচ্চিত্রাটিকে,	চলচ্চিত্রটিকে,	
byepass,	ব্যাপেস,	বাইপাস,	
boshoborti,	বশবর্তী,	বশবর্তী,	
munshiji,	মুন্শিজি,	মুনশীজি,	
kheylechen,	খেয়েছেন,	খেলেছেন,	
toufiq,	তৌফিক,	তৌফিক,	
brindabane,	বৃন্দাবানে,	বৃন্দাবনে,	
mandape,	মান্ডাপে,	মন্ডপে,	
ghumachche,	ঘুমাচ্ছে,	ঘুমাচ্ছে,	
gobeshokgon,	গবেষকগণ,	গবেষকগণ,	
pachattar,	পাচতত্তর,	পাচাত্তার,	
mail,	মাইল,	মাইল,	
mangoleek,	মঙ্গলিক,	মাঙ্গলিক,	
ghatleo,	ঘাটলেও,	ঘটলেও,	
kingsh,	কিংশ,	কিংস,	
camerapersoner,	ক্যামেরাপারসনের,	ক্যামেরাপার্সনের,	
duryogamoyee,	দুর্যগোময়ী,	দুর্যোগময়ী,	
aakabar,	আকাবার,	আকাবার,	
sthapanatir,	স্থাপনাটির,	স্থাপনাটির,	
simons,	সিমন্স,	সিমন্স,	
jaunotar,	যৌনতার,	যৌনতার,	
monur,	মনুর,	মনুর,	
america,	আমেরিকা,	আমেরিকা,	
bojhao,	বোঝাও,	বোঝাও,	
timoothi,	তিমুথি,	টিমোথি,	
degreeo,	দেগ্রীও,	ডিগ্রিও,	
ajibon,	আজিবন,	আজীবন,	
nagorikderkey,	নাগরিকদেরকে,	নাগরিকদেরকে,	
brojomohun,	ব্রযোহমীন,	ব্রোজোমোহন,	
jatinke,	জাতিনকে,	যতীনকে,	
khelechen,	খেলেছেন,	খেলেছেন,	
residensa,	রেসিডেন্স,	রেসিডেন্স,	
sheekar,	শিকার,	শিকার,	
niemond,	নিইম্যান্ড,	নিমন্ড,	
cholechi,	চলেছি,	চলেছি,	
windows,	উইন্ডো,	উইন্ডোস,	
showtey,	শোতে,	শোতে,	
dhaanche,	ধানছে,	ধাঁচে,	
konar,	কোনার,	কণার,	
bosante,	বসান্তে,	বসন্তে,	
nathivookteer,	নাথিভুক্তির,	নথিভুক্তির,	
choson,	চোসন,	চোষণ,	
footballerra,	ফুটবলাররা,	ফুটবলাররা,	
taranee,	তরণে,	তরণী,	
jounotar,	যৌনতার,	যৌনতার,	
dewaben,	দেওবায়েন,	দেওয়াবেন,	
chaanoo,	চানো,	চানু,	
angshogrohon,	অংশগ্রহণ,	অংশগ্রহন,	
kalki,	কালকি,	কালকি,	
setikey,	সেতিকে,	সেটিকে,	
vushi,	ভুশি,	ভুষি,	
dai,	হাই,	দিই,	
anichchi,	আনিচ্ছি,	আনিচ্ছি,	
klaud,	ক্লাউড,	ক্লাউড,	
breq,	ব্রেক,	ব্রেক,	
uddhrito,	উদ্ধৃত,	উদ্ধৃত,	
bishwasho,	বিশ্বশো,	বিশ্বাসও,	
chadake,	চড়াকে,	চড়াকে,	
kortona,	কর্তনা,	করতনা,	
uporitoler,	উপরিতলের,	উপরিতলের,	
aajeej,	আজীজ,	আজিজ,	
orthoneeti,	অর্থনীতি,	অর্থনীতির,	
khuizza,	খুইজ্জা,	খুইজ্জা,	
beauby,	বিউবি,	বিউবি,	
mah,	মাহ,	মাহে,	
qrisenta,	ক্রিসেন্টা,	ক্রিসেন্ট,	
abadamoner,	আবাদামোনের,	অবদমনের,	
pretty,	প্রেটি,	প্রিটি,	
chemjong,	শেমজং,	চেমজং,	
tukrowti,	টুকরৌটি,	টুকরোটি,	
jaubankal,	যৌবনকাল,	যৌবনকাল,	
taposgoner,	তাপসগণের,	তাপসগণের,	
marmader,	মার্মাদের,	মারমাদের,	
addhattikotar,	আদ্ধাত্মিকতার,	আধ্যাত্মিকতার,	
macbeth,	ম্যাসবেথ,	ম্যাকবেথ,	
punosthaner,	পুনস্থানের,	পুনঃস্থানের,	
duiekdiner,	দুইকেকদিনের,	দুইএকদিনের,	
faltu,	ফাল্টু,	ফালতু,	
gavaskar,	গাভাসকার,	গাভাস্কার,	
mesenjjar,	মেসেঞ্জার,	মেসেঞ্জার,	
rajtontre,	রাজতন্ত্রে,	রাজতন্ত্রে,	
brake,	ব্রেক,	ব্রেক,	
oindrila,	ঐন্দ্রিলা,	ঐন্দ্রিলা,	
militarite,	মিলিটারিতে,	মিলিটারিতে,	
sallallahu,	সাল্লাল্লাহু,	সল্লাল্লাহু,	
bibadey,	বিবাদে,	বিবাদে,	
show,	শোব,	শো,	
accountdharira,	একাউন্টাধরীরা,	একাউন্টধারীরা,	
suparahiro,	সুপারহরি,	সুপারহিরো,	
lyaanding,	ল্যান্ডিং,	ল্যান্ডিং,	
becha,	বেচা,	বেচা,	
remakri,	রেমাক্রি,	রেমাক্রী,	
artilary,	আর্টিলারি,	আর্টিলারি,	
sures,	সুরেস,	সুরেশ,	
gazetted,	গ্যাজেট,	গেজেটেড,	
jaadrel,	জাদেল,	জাঁদরেল,	
haitasha,	হাইতাশা,	হাইটস,	
meridiane,	মেরিডিয়েন,	মেরিডিয়ানে,	
daybhager,	দয়ভাগের,	দায়ভাগের,	
firth,	ফার্থ,	ফার্থ,	
sheets,	শিট,	শীটস,	
atarkitey,	অ্যাটরকিতে,	অতর্কিতে,	
aziboner,	আজিবনের,	আজীবনের,	
rajyotiro,	রাজ্যটিরও,	রাজ্যটিরও,	
bisheshshyo,	বিশেষ্্য,	বিশেষ্য,	
ganaparibahan,	গণপরিবহণ,	গণপরিবহন,	
kanasarabhesana,	কনসরাভেষণ,	কনসারভেশন,	
residence,	রিসিডেন্স,	রেসিডেন্স,	
phutbolarder,	ফুটবোর্ডের,	ফুটবলারদের,	
redcrosser,	রেডক্রসের,	রেডক্রসের,	
bagicha,	বাগিচা,	বাগিচা,	
leaders,	লিডার্স,	লিডার্স,	
panchadadu,	পঞ্চদাদু,	পঞ্চাদাদু,	
billaho,	বিল্লাহ,	বিল্লাহ,	
rubidiyaam,	রুবিদিয়াম,	রুবিডিয়াম,	
talaa,	তালা,	তালা,	
bhramarotsab,	ভ্রমণরত্সব,	ভ্রমরোৎসব,	
arasie,	আরাসি,	আরসিএ,	
morathee,	মরাথী,	মরাঠি,	
stonehenje,	স্তনহেনজেজ,	স্টোনহেঞ্জ,	
sqalastiqa,	স্কালসাকিট,	স্কলাস্টিক,	
somonwitobhabey,	সমন্বিতভাবে,	সমন্বিতভাবে,	
granada,	গ্রানাড,	গ্র্যানাডা,	
siramikasa,	সিরামিকাসা,	সিরামিকস,	
jhamala,	ঝামালা,	ঝামালা,	
agamane,	আগামানে,	আগমনে,	
meghachchanno,	মেঘচ্ছন্ন,	মেঘাচ্ছন্ন,	
borlen,	বোরলেন,	বরলেন,	
ganoparibahaner,	গণপারীবহণের,	গণপরিবহনের,	
aaireshe,	আইরাশে,	আইরেসে,	
enginiiring,	ইঞ্জাইনিরি,	ইঞ্জিনিয়ারিং,	
hooq,	হুক,	হুক,	
karim,	করিম,	করিম,	
footbalarra,	ফুটবলাররা,	ফুটবলাররা,	
vezano,	ভেজানো,	ভেজানো,	
porbotmala,	পর্বতমালা,	পর্বতমালা,	
sawam,	সাভাম,	সাওম,	
hitlere,	হিটলারে,	হিটলারে,	
bisnoo,	বিস্নও,	বিষ্ণু,	
bhalobasar,	ভালবাসার,	ভালোবাসার,	
urey,	উরে,	ইউরি,	
maail,	মাইল,	মাইল,	
ruble,	রাবল,	রুবল,	
bharotiyotar,	ভারতীয়তার,	ভারতীয়তার,	
falasrutite,	ফলাসুরুটিতে,	ফলশ্রুতিতে,	
joones,	জুনেস,	জোন্স,	
soource,	সুর্স,	সোর্স,	
dhanyi,	ধনই,	ধন্যি,	
blogarra,	ব্লোগাররা,	ব্লগাররা,	
bapokotor,	বাপকতর,	ব্যাপকতর,	
lyataa,	ল্যাট,	ল্যাটা,	
akpaase,	আকপাসে,	একপাশে,	
narishwar,	নারীশ্বর,	নারীশ্বরের,	
osoborno,	অসবর্ণ,	অসবর্ণ,	
bonorajite,	বনরাজিতে,	বনরাজিতে,	
grontho,	গ্রন্থ,	গ্রন্থ,	
pet,	পিট,	পেত,	
shootar,	শুতার,	শ্যুটার,	
gyandaas,	জ্ঞানদাস,	জ্ঞানদাস,	
riphleksa,	রিফলেকসসা,	রিফ্লেক্স,	
eporzonto,	এপরজন্ত,	এপর্যন্ত,	
selim,	সেলিম,	সেলিম,	
muradke,	মুরাদকে,	মুরাদকে,	
dijmarescu,	ডিজমারেসপু,	দিজমার্সাকু,	
golghare,	গোলঘরে,	গোলঘরে,	
somoibo,	সময়ব,	সমৈব,	
shahurgulor,	শাহুরগুলোর,	শহুরগুলোর,	
diibug,	দীয়ুব,	ডিবাগ,	
monjooshree,	মঞ্জশ্রী,	মঞ্জুশ্রী,	
bishshasho,	বিষ্ষাস,	বিশ্বাসও,	
rajtantra,	রাজতন্ত্র,	রাজতন্ত্র,	
karuna,	কারুনা,	করুণা,	
boner,	বনের,	বনের,	
dokanei,	দোকানেই,	দোকানেই,	
jalbe,	জলবে,	জ্বলবে,	
phormat,	ফোরমাট,	ফরম্যাট,	
rupantarer,	রূপন্তরের,	রুপান্তরের,	
cocaine,	কোকেইন,	কোকেইন,	
baasaate,	বাসাতে,	বাসাতে,	
madhoori,	মধরী,	মাধুরী,	
cholochchitrake,	চলচ্চিত্রাকে,	চলচ্চিত্রকে,	
toufik,	তৌফিক,	তৌফিক,	
biswashi,	বিশ্বাশী,	বিশ্বাসী,	
monir,	মনির,	মনির,	
durgatsob,	দুর্গাৎসব,	দুর্গোৎসব,	
geja,	গেজা,	গেজ,	
guzon,	গুজন,	গুজব,	
debdebyr,	দেবডেবির,	দেবদেবীর,	
somratra,	সম্রাত্র,	সম্রাটরা,	
uporitale,	উপরিতালে,	উপরিতলে,	
hukar,	হুকার,	হুকার,	
moresbai,	মোরেসবাই,	মোরেসবাই,	
kinenni,	কিনেননি,	কিনেননি,	
brindaboney,	বৃন্দাবনে,	বৃন্দাবনে,	
jothartho,	যথার্থ,	যথার্থ,	
prothar,	প্রথার,	প্রথার,	
dijijer,	দিজিজের,	ডিজিজের,	
oisamoyer,	ঐসাময়ের,	ঐসময়ের,	
pathkrom,	পাঠক্রম,	পাঠক্রম,	
sohojlovyotar,	সহজল্যভতার,	সহজলভ্যতার,	
khuliechilam,	খুলিয়েছিলাম,	খুলিয়েছিলাম,	
bondiira,	বন্দিরা,	বন্দীরা,	
standards,	স্ট্যাণ্ডার্ডসহ,	স্টান্ডার্ডস,	
kram,	ক্রাম,	ক্রম,	
mumtaj,	মুমতাজ,	মুমতাজ,	
pathanirdeshona,	পাঠনদিরোশন,	পথনির্দেশনা,	
shudhir,	শুধীর,	শুধীর,	
anusvara,	অনুষ্বরা,	অনুস্বার,	
bamni,	বামনি,	বামনী,	
aarmstrong,	এর্মস্ট্রং,	আর্মস্ট্রং,	
dharabahikotitey,	ধারাবাহিকতিতে,	ধারাবাহিকটিতে,	
jubokti,	যুবকটি,	যুবকটি,	
asabhya,	অসভ্য,	অসভ্য,	
dhani,	ধানী,	ধানি,	
ajuhat,	অজুহাট,	অজুহাত,	
rananganey,	রাঙঙ্গনে,	রণাঙ্গনে,	
aarke,	আরকে,	আরকে,	
bisshasi,	বিশ্বাসি,	বিশ্বাসী,	
protisthar,	প্রতিষ্ঠার,	প্রতিষ্ঠার,	
ostad,	ওস্তাদ,	ওস্তাদ,	
juktorashtreo,	যুক্তরশ্ট্রেও,	যুক্তরাষ্ট্রেও,	
beila,	বিইলা,	বেইলা,	
stanahenja,	স্তনাহেঞ্জ,	স্টোনহেঞ্জ,	
elakatay,	এলাকাটা,	এলাকাতে,	
pronoti,	প্রণতি,	প্রণতি,	
dhache,	ধাকে,	ধাঁচে,	
ghotleyo,	ঘটেলও,	ঘটলেও,	
duburir,	ডুবুরির,	ডুবুরির,	
dhojovongo,	ধবলঙ্গ,	ধ্বজভঙ্গ,	
choudhurike,	চৌধুরীকে,	চৌধুরীকে,	
drissoke,	দ্রিশকে,	দৃশ্যকে,	
shringge,	শ্রিংজে,	শৃঙ্গে,	
sayatana,	সায়াতানা,	শয়তান,	
gasthi,	গাষ্ঠি,	গোষ্ঠী,	
koro,	কোরো,	করো,	
kekru,	কেকরু,	কেকরু,	
mangolic,	ম্যানগোলিক,	মাঙ্গলিক,	
konnoder,	কন্যদের,	কন্যদের,	
suiza,	সুইজা,	সুইজা,	
daktickete,	ডাকটিকেটে,	ডাকটিকিটে,	
mozdoor,	মজদুর,	মজদুর,	
maudelder,	মাউডলেদের,	মডেলদের,	
anandamahale,	আনন্দমহলে,	আনন্দমহলে,	
janghu,	জাহধু,	জঙ্ঘু,	
homeser,	হোমসের,	হোমসের,	
ujobekeestan,	উজয়বেকস্তান,	উজবেকিস্তান,	
choudry,	চাউডরি,	চৌধুরী,	
rajdhani,	রাজধানি,	রাজধানি,	
sambhabonao,	সম্ভাবনাও,	সম্ভবনাও,	
charukala,	চারুকলা,	চারুকলা,	
shcholastic,	স্কোলাস্টিক,	স্কলাস্টিক,	
ekbakke,	একবাককে,	একবাক্যে,	
antorvuktimulak,	আন্তর্ভুনিতমূলক,	অন্তর্ভুক্তিমূলক,	
annanere,	আন্নানেরে,	অন্যানেরে,	
dadar,	দাদার,	দাদার,	
longhan,	লংহান,	লংঘন,	
blasterke,	ব্লাস্টারকে,	ব্লাস্টারকে,	
aamoode,	আমোদ,	আমুদে,	
sampadon,	সম্পাদন,	সম্পাদন,	
tiger,	টিগের,	টাইগার,	
codee,	কোডি,	কোডে,	
udor,	উদর,	উদর,	
abosare,	অবসারে,	অবসরে,	
chilahatee,	চিলাহাটি,	চিলাহাটি,	
poripakey,	পরিপাকে,	পরিপাকে,	
proteemake,	প্রতিমাকে,	প্রতিমাকে,	
fevarite,	ফেভারিতে,	ফেভারিট,	
kuresher,	কুরেশের,	কুরেশের,	
aizulke,	আইজুলকে,	আইজুলকে,	
olpo,	ওলপো,	অল্প,	
karmoi,	কারমই,	কর্মই,	
glanio,	গ্লানিও,	গ্লানিও,	
bii,	বিআইউ,	বি,	
mardud,	মারদুড,	মরদুদ,	
vimsen,	ভিমসেন,	ভীমসেন,	
abti,	আবতি,	আবতি,	
shainyader,	শাইন্দের,	সৈন্যদের,	
magical,	ম্যাজিক্যাল,	ম্যাজিকাল,	
karaponner,	কারাপন্নের,	কারাপণ্যের,	
black,	ব্ল্যাক,	ব্ল্যাক,	
baarnish,	বার্নিশ,	বার্নিশ,	
oxfordey,	অক্সডোরি,	অক্সফোর্ডে,	
mayily,	মেযিলি,	মাইলি,	
youth,	যৌত,	ইয়ুথ,	
arsie,	আর্সি,	আরসিএ,	
chhooti,	ছুটি,	ছুটি,	
karmojog,	কর্মযোগ,	কর্মযোগ,	
kabutorer,	কবুতরের,	কবুতরের,	
chaka,	চাকা,	চাকা,	
chakundite,	চাকুন্দিতে,	চাকুন্দিতে,	
obhaarbhiu,	অভারভুউ,	ওভারভিউ,	
shiter,	শীতের,	শীতের,	
anchalgoolir,	অঞ্চলগুলির,	অঞ্চলগুলির,	
fooloo,	ফুলু,	পোলো,	
sommoteer,	সম্মতির,	সম্মতির,	
mahakabi,	মহাকাবী,	মহাকবি,	
saqara,	সাকারা,	সকার,	
hepatitis,	হেপাটিটিস,	হেপাটাইটিস,	
pragreesa,	প্রোগ্রিস,	প্রগ্রেস,	
chhuti,	ছুটি,	ছুটি,	
palestine,	প্যালেস্টাইন,	প্যালেস্টাইনে,	
miraclee,	মিরাকলি,	মিরাকেল,	
chupani,	চুপানী,	চুপানি,	
gandhikey,	গান্ধিকে,	গান্ধীকে,	
transform,	ট্রান্সফর্ম,	ট্রান্সফর্ম,	
palbongser,	পালবংসের,	পালবংশের,	
teemothi,	তোমোথি,	টিমোথি,	
peeri,	পীরি,	পেরি,	
siddhantoke,	সিদ্ধান্তকে,	সিদ্ধান্তকে,	
drissogoolote,	দৃশ্গগুলোতে,	দৃশ্যগুলোতে,	
bhupal,	ভুপাল,	ভূপাল,	
saarbharti,	সার্ভর্তী,	সার্ভারটি,	
murad,	মুরাদ,	মুরাদ,	
ansareer,	আনসারীর,	আনসারীর,	
queri,	কোয়েরি,	কোয়েরি,	
baibasthaar,	বৈবাস্থার,	ব্যবস্থার,	
zoubankal,	যৌবনকাল,	যৌবনকাল,	
bane,	বানে,	বনে,	
doorger,	ডেরার,	দুর্গের,	
evereste,	এভারেস্টে,	এভারেস্টে,	
bhageri,	ভাগেরই,	ভাগেরই,	
ashok,	আশক,	আশোক,	
prodiiper,	প্রদীপের,	প্রদীপের,	
tirmijii,	তিরমজিজই,	তিরমিজি,	
dinifitian,	দিনিফিয়েছন,	ডেফিনেশন,	
difinishion,	ডিফিনিশন,	ডেফিনেশন,	
ddheela,	ঢেল,	ঢিলা,	
tonoo,	টোনও,	তনু,	
bangladesh,	বাংলাদেশ,	বঙ্গালাদেস,	
jolbe,	জলবে,	জ্বলবে,	
parqa,	পার্ক,	পার্ক,	
sukumaree,	সুকুমরী,	সুকুমারী,	
magar,	মাগার,	মাগার,	
soundarja,	সৌন্দর্য্য,	সৌর্ন্দয্য,	
dagmukta,	দাগমুক্ত,	দাগমুক্ত,	
obhijojan,	অভিজোজন,	অভিযোজন,	
parisankhanbid,	পরিসংখন্িবি,	পরিসংখ্যানবিদ,	
biplabeer,	বিপ্লবীর,	বিপ্লবীর,	
popke,	পোপক,	পোপকে,	
ohalyar,	ওহাল্যার,	অহল্যার,	
daakteekite,	দাক্তিকীতে,	ডাকটিকিটে,	
kareer,	করির,	কারীর,	
varma,	ভারমা,	ভার্মা,	
kidambi,	কিদাম্বী,	কিদম্বি,	
paner,	পানের,	পানের,	
tecnokret,	টেকনোক্রট,	টেকনোক্র্যাট,	
cbi,	সিবিআই,	সিবিআই,	
mitro,	মিট্রো,	মিত্র,	
teemothy,	তামোথি,	টিমোথি,	
kalakushalir,	কলাকুশালীর,	কলাকুশলীর,	
otyacharito,	অত্যাচারিত,	অত্যাচারিত,	
hepatetisa,	হেপাতেটিসা,	হেপাটাইটিস,	
laaishheshh,	লাইশেষ,	লাইসেন্স,	
madhobeer,	মাধবীর,	মাধবীর,	
augustine,	অগাস্তিন,	অগাস্টিন,	
balatkar,	বালাতকার,	বলাৎকার,	
byomkesh,	ব্যমকেশ,	ব্যোমকেশ,	
avidur,	আভিদুর,	আভিদুর,	
shariba,	শারিবা,	শরিবা,	
daktikit,	দাকতিকিৎ,	ডাকটিকিট,	
kalkarkhana,	কলকরখানা,	কলকারখানা,	
nagorikke,	নাগরিককে,	নাগরিককে,	
motkey,	মটকে,	মতকে,	
kloud,	ক্লাউড,	ক্লাউড,	
badhamuktovabe,	বাধাম্ক্তভাবে,	বাধামুক্তভাবে,	
jeshtha,	জেষ্ঠ,	জ্যেষ্ঠা,	
achintyabhedaved,	অচিন্ত্যবিদেব,	অচিন্ত্যভেদাভেদ,	
batikromee,	বাতিক্রমী,	ব্যতিক্রমী,	
kinsa,	কিনসা,	কিংস,	
xpose,	এক্সপিএস,	এক্সপোজ,	
bhenom,	ভেনম,	ভেনম,	
palkee,	পালকি,	পাল্কি,	
samle,	সামলে,	সামলে,	
shangkulaan,	শংকুলান,	সংকুলান,	
fulkapi,	ফুলকাপি,	ফুলকপি,	
pohnpeic,	পোনপেক,	ফোনপেইক,	
oitijjo,	ঐতিহ্য,	ঐতিহ্য,	
barnis,	বার্নিস,	বার্নিশ,	
lisense,	লিসেন্সে,	লাইসেন্স,	
lendl,	লেন্ডল,	লেন্ডল,	
shibraj,	শিবরাজ,	শিবরাজ,	
eshtoniya,	এশনটিয়া,	এস্তোনিয়া,	
hillse,	হিলসে,	হিলসে,	
sharifpur,	শরিফপুর,	শরিফপুর,	
shardotsobei,	শার্দৎসবেই,	শারদোৎসবেই,	
chokhwala,	চোখবালা,	চোখওয়ালা,	
ghotleo,	ঘটলেও,	ঘটলেও,	
kormokarke,	কর্মকারকে,	কর্মকারকে,	
moreecha,	মরিচা,	মরিচা,	
torutoler,	তরুতলের,	তরুতলের,	
roopdaan,	রূপদান,	রুপদান,	
bidhirnityang,	বিধির্নিত্যাং,	বিধির্নিত্যং,	
prity,	প্রিটি,	প্রিটি,	
sumeeta,	সুমিতা,	সুমিতা,	
sethai,	সেথাই,	সেথাই,	
shilver,	শিলভের,	সিলভার,	
bokahoke,	বোকাহকে,	বকাহকে,	
sookkho,	সক্ষ,	সুক্ষ্ম,	
byatikrami,	ব্যতিক্রমী,	ব্যতিক্রমী,	
shasheja,	শশেজা,	সসেজ,	
matthews,	ম্যাথওয়েস,	ম্যাথিউস,	
thyachar,	থিয়াচা,	থ্যাচার,	
mohajot,	মহাজত,	মহাজোট,	
mojdur,	মজদুর,	মজদুর,	
khanabale,	খানাবালে,	খানাবলে,	
madelim,	মাদেলিম,	মডেলিং,	
artore,	আর্তোরে,	আর্টরে,	
alexandar,	আলেক্সান্ডার,	আলেকজান্ডার,	
gonesher,	গনেশের,	গণেশের,	
provur,	প্রভার,	প্রভুর,	
habathu,	হাবাথু,	হাবাথু,	
lotharan,	লোাধর,	লুথেরান,	
moddhyoshtho,	মধ্যশ্থ,	মধ্যস্থ,	
ghamta,	ঘামটা,	ঘোমটা,	
pabo,	পাবো,	পাব,	
arekdol,	আরেকদল,	আরেকদল,	
sookumari,	সুকেমারি,	সুকুমারী,	
samaveshke,	সমাভেশকে,	সমাবেশকে,	
nirgaman,	নির্গমান,	নির্গমন,	
graambaaseeo,	গ্রামবাসীও,	গ্রামবাসীও,	
gajetted,	গেজেট,	গেজেটেড,	
mmadhukkori,	ম্মাধুককরি,	মাধুকরী,	
alimpiqa,	আলিমপিকা,	অলিম্পিক,	
daacktickete,	ডাকক্টেকে,	ডাকটিকিটে,	
rajyabhogi,	রাজ্যভোগী,	রাজ্যভোগী,	
chikitsar,	চিকিৎসার,	চিকিত্সার,	
arifin,	আরিফিন,	আরিফিন,	
maryir,	মারির,	ম্যারির,	
salmanul,	সালমানুল,	সালমানুল,	
neerbachoker,	নির্বচাকের,	নির্বাচকের,	
taitela,	টাইটেল,	টাইটেল,	
ship,	শিপ,	শিপ,	
harysoner,	হারিসনের,	হ্যারিসনের,	
ayumi,	আয়ূমি,	আয়ুমি,	
difinisian,	ডিফিনিসিয়ান,	ডেফিনেশন,	
bipajjanak,	বিপজ্জনক,	বিপজ্জনক,	
madrasa,	মাদ্রাসা,	মাদ্রাসা,	
oswastikor,	অস্বস্তিকর,	অস্বস্তিকর,	
srisri,	শ্রীশ্রি,	শ্রীশ্রী,	
khiladirao,	খিলাড়িরাও,	খিলাড়িরাও,	
ashor,	আশোর,	আসর,	
afrazuler,	আফরাজুলের,	আফরাজুলের,	
qaferder,	কাফেরদের,	কাফেরদের,	
dep,	ডিপ,	ডেপ,	
gujob,	গুজব,	গুজব,	
vogno,	ভগনন,	ভগ্ন,	
bizito,	বিজিত,	বিজিত,	
emarjenshi,	এমরজেন্ি,	এমার্জেন্সি,	
hevy,	হেভি,	হেভি,	
parqim,	পার্কিম,	পার্কিং,	
satarka,	সতর্ক,	সতর্ক,	
mozlis,	মজলিস,	মজলিশ,	
jipiusamriddha,	জিপিআসামৃদ্ধ,	জিপিউসমৃদ্ধ,	
gronthoti,	গ্রন্থতি,	গ্রন্থটি,	
shten,	স্টেন,	স্টেন,	
andon,	আন্দন,	আন্দোন,	
tantubayer,	তন্তুবায়ের,	তন্তুবায়ের,	
popaike,	পোপাইকে,	পপাইকে,	
jolaatonko,	জলাতানকো,	জলাতঙ্ক,	
auttacharer,	অট্টাচারের,	অত্যাচারের,	
chorchita,	চর্চিতা,	চর্চিত,	
batom,	বাতম,	বাটম,	
shabkam,	শবকাম,	শবকাম,	
shandra,	শান্দ্রা,	শান্দ্রার,	
laagche,	লাগছে,	লাগছে,	
sachetanvabe,	সচেতনভাবে,	সচেতনভাবে,	
sthapanagulo,	স্থাপানগুলো,	স্থাপনাগুলো,	
jhijhi,	ঝিঝি,	ঝিঝি,	
buddhitii,	বুদ্ধিটিই,	বুদ্ধিটিই,	
azijer,	আজিজের,	আজিজের,	
jonomukhi,	জনমুখী,	জনমুখী,	
taronee,	তরণী,	তরণী,	
scoore,	স্কুরা,	স্কোর,	
grotha,	গ্রোথা,	গ্রোথ,	
norpholk,	নরফফল,	নরফোক,	
photanor,	ফোতানোর,	ফোটানোর,	
prokolpoti,	প্রকল্পটি,	প্রকল্পটি,	
beekaargrasta,	বিকারগ্রস্ত,	বিকারগ্রস্ত,	
laat,	ল্যাট,	লাট,	
zakharovar,	জাখরাভার,	জাখারোভার,	
protyokkhovabey,	প্রত্যক্ষভাবে,	প্রত্যক্ষভাবে,	
konflict,	কনফ্লিক্ট,	কনফ্লিক্ট,	
associatis,	এ্যাসোসিয়াটিস,	এসোসিয়েটস,	
ekhate,	এখাতে,	একহাতে,	
kk,	কেকে,	কেকে,	
baire,	বাইরে,	বাইরে,	
nowel,	নোয়েল,	নভেল,	
bondira,	বন্দিরা,	বন্দীরা,	
kalirkhal,	কালিরখাল,	কালিরখাল,	
blacq,	ব্ল্যাক,	ব্ল্যাক,	
vromonkaley,	ভ্রমনকালে,	ভ্রমণকালে,	
bikromei,	বিক্রমেই,	বিক্রমেই,	
songkulan,	সংকুলান,	সংকুলান,	
chalochchitraeei,	চলচচ্ত্রীতেই,	চলচ্চিত্রেই,	
talaal,	তালাল,	তালাল,	
medilek,	মেদিলেক,	মেডিলেক,	
sangasthagulo,	সংস্থাগুলো,	সংস্থাগুলো,	
shite,	শীতে,	শীতে,	
khilaphat,	খিলাফা,	খিলাফত,	
chalachchitrei,	চলচ্চিত্রেই,	চলচ্চিত্রেই,	
mailkhanek,	মাইলখানেক,	মাইলখানেক,	
gondhe,	গন্ধে,	গন্ধে,	
spredasita,	স্প্রেডাসিটা,	স্প্রেডশীট,	
ramantic,	রামান্তিক,	রোমান্টিক,	
trenda,	ট্রেন্ড,	ট্রেন্ড,	
satarkakari,	সতর্ককারী,	সতর্ককারী,	
atak,	আতাক,	আটক,	
ekla,	একলা,	একলা,	
harris,	হ্যারিস,	হ্যারিস,	
grootha,	গ্রুথ,	গ্রোথ,	
muradpur,	মুরাদপুর,	মুরাদপুর,	
uporzon,	উপরজন,	উপার্জন,	
shaahaabiike,	সাহাবিবীকে,	সাহাবীকে,	
patengar,	পাতেঙ্গার,	পতেঙ্গার,	
paripakey,	পরিপককে,	পরিপাকে,	
nadnadeer,	নদ্দীীর,	নদনদীর,	
procharjontrogulo,	প্রচারযন্ত্রগুলো,	প্রচারযন্ত্রগুলো,	
bonke,	বনকে,	বনকে,	
welaqama,	ওয়ালকামা,	ওয়েলকাম,	
pratista,	প্রতিস্তা,	প্রতিষ্টা,	
basturoi,	বাস্তুরই,	বস্তুরই,	
shikare,	শিকারে,	শিকারে,	
greenald,	গ্রিনাল্ড,	গ্রিনল্ড,	
annimated,	অ্যানিমেটেড,	এনিমেটেড,	
dito,	দিত,	দিতো,	
brahmanera,	ব্রাহ্মণেরা,	ব্রাহ্মণেরা,	
murali,	মুরালী,	মুরলী,	
nirmankaaj,	নির্মাণকাজ,	নির্মাণকাজ,	
vabnakey,	ভাবনাকে,	ভাবনাকে,	
sotorkobhabey,	সতর্কভাবে,	সতর্কভাবে,	
adarsho,	আদার্শ,	আর্দশ,	
songasthatike,	সংস্থাটিকে,	সংস্থাটিকে,	
udbodhaney,	উদ্বোধনে,	উদ্বোধনে,	
bosturoi,	বস্তুরই,	বস্তুরই,	
fasir,	ফাসির,	ফাসীর,	
cantan,	কান্টান,	ক্যান্টন,	
moorali,	মোরালি,	মুরলী,	
prrajanankaal,	প্রজাননকাল,	প্রজননকাল,	
poroborti,	পরবর্তী,	পরর্বতী,	
byomkes,	ব্যামকস,	ব্যোমকেশ,	
shourshe,	শৌর্ষে,	সোর্স,	
mercedes,	মার্সডেস,	মার্সেডেস,	
gejetade,	জেজেটাদে,	গেজেটেড,	
deejeejer,	দীজের,	ডিজিজের,	
shekender,	সেকেন্দের,	সেকেন্ডের,	
wilderske,	উইল্ডার্সকে,	উইল্ডার্সকে,	
bhalobaas,	ভালোবাস,	ভালোবাসা,	
soceitytey,	সোসাইটিতে,	সোসাইটিতে,	
pleto,	প্লেটো,	প্লেটো,	
temonbhabe,	তেমনভাবে,	তেমনভাবে,	
jerusalema,	জেরুসালেমা,	জেরুসালেম,	
sulfatee,	সালফাটি,	সালফেট,	
nuhas,	নুহাস,	নুহাশ,	
steena,	স্টিন,	স্টেন,	
somraatder,	সম্রাটদের,	সম্রাটদের,	
prasadhoni,	প্রাসধানী,	প্রসাধনী,	
omkar,	ওমকার,	ওঙ্কার,	
rabo,	রাবো,	রব,	
doula,	দৌলা,	দৌলা,	
proshtotto,	প্রশ্তত্ত্ব,	প্রস্ত্তত,	
plak,	প্লাক,	প্ল্যাক,	
ekatto,	একাত্ত,	একাত্ব,	
bipti,	বিপ্তি,	বিপ্তি,	
breel,	ব্রিল,	ব্রিল,	
onucheeder,	অনুচিদের,	অনুচ্ছেদের,	
kayech,	কায়েচ,	কায়েছ,	
drissoteer,	দ্রিষতির,	দৃশ্যটির,	
teta,	টেট,	টেটা,	
dakten,	ডাকতেন,	ডাকতেন,	
qanasarabheshana,	কনসর্ভেষণ,	কনসারভেশন,	
mast,	ম্যাস্ট,	মাস্ত,	
bodhirta,	বোধির্তা,	বধিরতা,	
supreetira,	সুপ্রিতারা,	সুপ্রীতিরা,	
bouddha,	বৌদ্ধ,	বৌদ্ধ,	
chetanagoto,	চেতানগত,	চেতনাগত,	
drissotir,	দৃষ্টির,	দৃশ্যটির,	
armeeniyana,	আর্মিনিয়ান,	আর্মেনিয়ান,	
shikhbe,	শিখবে,	শিখবে,	
protectionism,	প্রোটক্টিনিজম,	প্রোটেকশনিজম,	
konistho,	কনিষ্ঠ,	কনিষ্ঠ,	
hitokor,	হিতকর,	হিতকর,	
chintakarma,	চিন্তকর্ম,	চিন্তাকর্ম,	
deraa,	ধীরা,	ডেরা,	
ramonar,	রামনার,	রমনার,	
byatari,	ব্যাটারি,	ব্যাটারী,	
mach,	মাছ,	মাছ,	
osthishondhi,	অস্থিনন্ধি,	অস্থিসন্ধি,	
khudrokar,	ক্ষুদ্রকার,	ক্ষুদ্রকার,	
harja,	হার্জা,	হার্জ,	
birmuktijoddhagan,	বির্মুক্তিদ্যভোগন,	বীরমুক্তিযোদ্ধাগণ,	
sommotite,	সম্মতিতে,	সম্মতিতে,	
kaamij,	কামিজ,	কামিজ,	
sayanaida,	সায়ানাইডা,	সায়ানাইড,	
bhushito,	ভূষিত,	ভূষিত,	
susamo,	সুসামো,	সুসম,	
laga,	লাগা,	লগ,	
land,	ল্যান্ড,	ল্যান্ড,	
directorete,	ডাইরেক্টরতে,	ডিরেক্টরেট,	
diniphition,	ডিইনিফিটন,	ডেফিনেশন,	
priseflex,	প্রিসেল্ফক,	প্রাইজফ্লেক্স,	
janosamaj,	জনসমাজ,	জনসমাজ,	
senabahineekey,	সেনাবাহিনীকে,	সেনাবাহিনীকে,	
pretti,	প্রেত্তি,	প্রিটি,	
bhromoner,	ভ্রমণের,	ভ্রমণের,	
fakhrul,	ফখরুল,	ফাখরুল,	
laishensh,	লেশেনশ,	লাইসেন্স,	
uzobekeestaan,	উজযববেকস্তান,	উজবেকিস্তান,	
sangbadmadhyamgulote,	সংবাদমাধ্যমগুলোতে,	সংবাদমাধ্যমগুলোতে,	
dipke,	দিপকে,	দ্বীপকে,	
michhilti,	মিছিলটি,	মিছিলটি,	
saabyastha,	সাব্যস্থা,	সাব্যস্থ,	
chahidapotrer,	চাহিদাপত্রের,	চাহিদাপত্রের,	
gonona,	গনোনা,	গননা,	
rayyalati,	রেয়লায়িতী,	রয়্যালটি,	
bhabarlaler,	ভববরলালের,	ভবরলালের,	
pare,	পারে,	পাড়ে,	
mandope,	মাণ্ডোপে,	মন্ডপে,	
damodar,	দামোদার,	দামদর,	
capsul,	ক্যাপসুল,	ক্যাপসুল,	
daraider,	দারাইদের,	দরাইদের,	
kuronir,	কুরোনির,	কুরনীর,	
bhabaponno,	ভাবাপন্ন,	ভাবাপন্ন,	
thailandsaho,	থাইলান্ডাসহ,	থাইল্যান্ডসহ,	
ramnathbabur,	রামনাথবাবুর,	রামনাথবাবুর,	
ghoomato,	ঘুমাটো,	ঘুমাতো,	
pratool,	প্রাতুল,	প্রতুল,	
ponjikar,	পঞ্জিকার,	পঞ্জিকার,	
elakaai,	এলাকাই,	এলাকাই,	
elaakati,	এলাকাটি,	এলাকাটি,	
nottee,	নত্ট,	নোটটি,	
braqe,	ব্র্যাকে,	ব্রেক,	
horash,	হোরাশ,	হোরাস,	
gandharir,	গন্ধারীর,	গান্ধারীর,	
osamanno,	ওসামান্য,	অসামান্য,	
akai,	আকাই,	একাই,	
kakhnoba,	কখনোবা,	কখনওবা,	
somsher,	সমষের,	সমশের,	
aranyani,	অরণ্যনী,	অরণ্যানী,	
tyap,	ত্যাপ,	ট্যাপ,	
liceensee,	লাইসিন্স,	লাইসেন্স,	
dhanak,	ধনক,	ধানক,	
gaaddafee,	গাড়ফলে,	গাদ্দাফী,	
sikkhagata,	শিক্ষগত,	শিক্ষাগত,	
nagorikota,	নাগোরিকতা,	নাগরিকতা,	
kramp,	ক্রাযাম্প,	ক্র্যাম্প,	
jati,	জাতি,	যাতি,	
charban,	চারবান,	চর্বন,	
peshto,	পেশটো,	পেষ্ট,	
bonvumitey,	বনভূমিতে,	বনভূমিতে,	
hizriite,	হিজরিতে,	হিজরীতে,	
chalachchitrer,	চলচ্চিত্রের,	চলচ্চিত্রের,	
akhandota,	আখণ্ডটা,	অখণ্ডতা,	
kaloniir,	কালনির,	কালনীর,	
gore,	গোর,	গোর,	
maktum,	মাকতুম,	মাকতুম,	
rezidence,	রেজিডেন্সে,	রেসিডেন্স,	
khaschandpur,	খাশচন্দপুর,	খাসচাঁদপুর,	
vabook,	ভাবৌক,	ভাবুক,	
amarjito,	অমরজিত,	অমার্জিত,	
khanonkaj,	খননকাজ,	খননকাজ,	
chhintayikari,	ছিন্তায়িকারী,	ছিনতাইকারী,	
direqtareta,	ডিরেক্টরো,	ডিরেক্টরেট,	
jamaanor,	জমানোর,	জমানোর,	
chhadite,	ছাডিতে,	ছড়িতে,	
bairer,	বাইরের,	বাইরের,	
sardar,	সরদার,	সরদার,	
sbajan,	স্বজন,	স্বজন,	
habsi,	হাবসি,	হাবশী,	
ostheesandhi,	অস্থিসন্ধি,	অস্থিসন্ধি,	
katateo,	কাটাতেও,	কাটাতেও,	
mekon,	মেকন,	মেকং,	
abdoone,	আবদুনে,	আবদুন,	
mandondo,	মন্দন্ড,	মানদণ্ড,	
armori,	আরমোরি,	আরমোরি,	
chowdhurir,	চৌধীরির,	চৌধুরীর,	
shorifer,	শরীফের,	শরিফের,	
prosadhoni,	প্রসাধনী,	প্রসাধনী,	
phund,	ফুন্ড,	ফান্ড,	
addata,	আড্ডাটা,	আড্ডাটা,	
aatto,	আততো,	আত্ম,	
elaakaa,	এলাকা,	এলাকা,	
jonesh,	জোনেশ,	জোন্স,	
byabostho,	ব্যবস্থ,	ব্যাবস্থা,	
daqten,	ডাকতেন,	ডাকতেন,	
megacaldera,	মেগাকাডালার,	মেগাক্যাল্ডেরা,	
andra,	এন্দ্রা,	আন্ড্রা,	
oiteejye,	ঐতেহ্যে,	ঐতিহ্যে,	
senabahineeow,	সেনাবাহীনাউ,	সেনাবাহিনীও,	
sikkhakromer,	শিক্ষাক্রমের,	শিক্ষাক্রমের,	
mehsus,	মেহসুস,	মেহসুস,	
durotamo,	দূরতামো,	দূরতম,	
saatzoner,	সাতজোনের,	সাতজনের,	
kobulennechha,	কবুলেনোছা,	কবুলেন্নেছা,	
jewellery,	জিউলেরি,	জুয়েলারির,	
mausumeo,	মাসুমেও,	মৌসুমেও,	
zerusalem,	জেরুসালেম,	জেরুজালেম,	
laesens,	লেসেন্স,	লাইসেন্স,	
somonnitobhabe,	সমন্নিতভাবে,	সমন্বিতভাবে,	
modhumotii,	মধুমতিই,	মধুমতী,	
superheroo,	সুপারহিরো,	সুপারহিরো,	
sikkharthirao,	শিক্ষার্থীরাও,	শিক্ষার্থীরাও,	
seekkhokbrindo,	শিক্ষকবৃন্দ,	শিক্ষকবৃন্দ,	
vince,	ভিন্স,	ভিন্স,	
phaltu,	ফুলতু,	ফালতু,	
ghumacchilo,	ঘুমাচ্ছিল,	ঘুমাচ্ছিল,	
baaik,	বাইক,	বাইক,	
soomita,	সুমিতা,	সুমিতা,	
bifol,	বিফল,	বিফল,	
yanqee,	য়নকে,	ইয়াংকি,	
sanaktokaron,	সানক্তকারণ,	সনাক্তকরণ,	
huqa,	হুকা,	হুক,	
manushgulor,	মানুষগুলোর,	মানুষগুলোর,	
nirbachokder,	নির্বাচকদের,	নির্বাচকদের,	
skirt,	স্কার্ট,	স্কার্ট,	
tophaat,	তোফাত,	তফাৎ,	
jomjamat,	জম্জামত,	জমজমাট,	
samanwitovabe,	সমন্বিতভাবে,	সমন্বিতভাবে,	
ekbakye,	একবক্যে,	একবাক্যে,	
siddhantei,	সিদ্ধানটেই,	সিদ্ধান্তেই,	
kormopontha,	কর্মপন্ঠা,	কর্মপন্থা,	
jonoshongjog,	জনশাজ্জ,	জনসংযোগ,	
asamonjasyopurno,	অসামঞ্জস্যপূর্ণ,	অসামঞ্জস্যপূর্ণ,	
dipgulote,	ডিপগুলোতে,	দ্বীপগুলোতে,	
orhan,	অরহান,	ওরহান,	
proteemar,	প্রতিমার,	প্রতিমার,	
ronangane,	রোনাঙ্গনে,	রণাঙ্গনে,	
nutoner,	নুটনের,	নূতনের,	
tukroke,	টুকরোকে,	টুকরোকে,	
oswasteekor,	অস্বস্তিকর,	অস্বস্তিকর,	
rajtantro,	রাজতন্ত্র,	রাজতন্ত্র,	
zozyota,	যোগ্যতা,	যোজ্যতা,	
vetrillocuism,	ভেট্রিলিক্লাজম,	ভেট্রিলোকুইজম,	
ganoporibahoner,	গণপরিবহণের,	গণপরিবহনের,	
atmiyasulabh,	আত্মীয়সুলা,	আত্মীয়সুলভ,	
jeher,	জেহের,	জেহের,	
venkates,	ভেঙ্কটেস,	ভেঙ্কটেশ,	
shikshakrom,	শিক্ষাক্রম,	শিক্ষাক্রম,	
premoronge,	প্রেমরঙ্গে,	প্রেমরঙে,	
samajikatar,	সমাজিকতার,	সামাজিকতার,	
segulo,	সেগুলো,	সেগুলো,	
elaakate,	এলাকাতে,	এলাকাতে,	
alaoler,	আলাওলের,	আলাওলের,	
pouchute,	পৌছুতে,	পৌঁছুতে,	
melborrone,	মেলবোরেন,	মেলবোর্নে,	
keu,	কিউ,	কেউ,	
fotanor,	ফতানোর,	ফোটানোর,	
shpredshiit,	স্প্রেডশিট,	স্প্রেডশীট,	
manbe,	মানবে,	মানবে,	
oichchheek,	ঐচ্ছিক,	ঐচ্ছিক,	
raia,	রাইয়া,	রায়,	
sarboshokteeman,	সর্বশক্তিমান,	সর্বশক্তিমান,	
byaboharkareer,	ব্যবহারকারীর,	ব্যবহারকারীর,	
armshtronj,	আর্মস্ট্রন,	আর্মস্ট্রং,	
bbiseshyer,	ব্বিশেষ্যের,	বিশেষ্যের,	
grambaasi,	গ্রামবাসী,	গ্রামবাসী,	
bodhukeo,	বোধুকেও,	বধুকেও,	
zeland,	জেলাযান্ড,	জিল্যান্ড,	
bamon,	ব্যামন,	বামন,	
ghoomachhe,	ঘুমাছে,	ঘুমাচ্ছে,	
probolshoktio,	প্রবলশক্তিও,	প্রবলশক্তিও,	
chalochchitreer,	চলচচিত্রীর,	চলচ্চিত্রের,	
kyatagorir,	ক্যাটাগোরির,	ক্যাটাগরির,	
choshon,	চোষণ,	চোষণ,	
sudrissho,	সুদ্রিশো,	সুদৃশ্য,	
dei,	দেই,	দিই,	
teliha,	তেলিহা,	তেলিহা,	
heawy,	হিউভি,	হেভি,	
bhiktara,	ভিকতারা,	ভিক্টর,	
baait,	বোইট,	বাইট,	
puroheetder,	পুরোহিতদের,	পুরোহিতদের,	
jaanar,	জানার,	জানার,	
vool,	ভুল,	উল,	
venus,	ভেন্স,	ভেনাস,	
chakrapani,	চক্রপানি,	চক্রপানী,	
thabai,	থাবাই,	থাবাই,	
shudhui,	শুধুই,	শুধুই,	
chet,	চেত,	চ্যাট,	
sutir,	সুতির,	সুতির,	
sthapanar,	স্থাপনার,	স্থাপনার,	
robot,	রোবট,	রোবোট,	
ashamarthita,	আশামর্থিত,	অসমর্থিত,	
ovinetar,	অভিনেতার,	অভিনেতার,	
aakkaash,	আক্কাশ,	আককাস,	
futote,	ফুটোতে,	ফুটোতে,	
madhabike,	মাধাবীকে,	মাধবীকে,	
pothon,	পঠন,	পঠন,	
bashoborty,	ব্যাশোর্টি,	বশবর্তী,	
hol,	হোল,	হোল,	
antorbhuktimulak,	আন্তর্ভুণিকমূলক,	অন্তর্ভুক্তিমূলক,	
hunine,	হুনিন,	হুনাইন,	
mulyayonsapekkhe,	মূল্যবানপানেক্ষে,	মূল্যায়নসাপেক্ষে,	
shudden,	শুদেন,	সাডেন,	
buth,	বুথ,	বুথ,	
vvimsenn,	ভ্ভিভসেন,	ভীমসেন,	
kaathhmaandute,	কাঠমন্ডুতে,	কাঠমান্ডুতে,	
bosonte,	বসন্তে,	বসন্তে,	
parkin,	পারকিন,	পার্কিং,	
relance,	রিল্যান্স,	রিলায়েন্স,	
osthisondhi,	অস্থিনন্ধি,	অস্থিসন্ধি,	
jomoker,	জমকের,	জমকের,	
basaake,	বাসাকে,	বাসাকে,	
chopal,	চোপাল,	চপল,	
nationalser,	নেশনেলসের,	ন্যাশনালসের,	
mandanda,	মনদদন,	মানদণ্ড,	
rotheen,	রথিন,	রথীন,	
pharmesigulote,	ফার্মিসেগুলোতে,	ফার্মেসীগুলোতে,	
dhormokorme,	ধর্মকর্মে,	ধর্মকর্মে,	
nirarthak,	নিরার্থক,	নিরর্থক,	
gobeshonar,	গবেষণার,	গবেষনার,	
starker,	স্টার্কের,	স্টার্কের,	
railliner,	রেললিনের,	রেললাইনের,	
ancholgoolir,	অঞ্চলগুলির,	অঞ্চলগুলির,	
licensedhari,	লাইসেন্সধারী,	লাইসেন্সধারী,	
graambashee,	গ্রামবাশী,	গ্রামবাসী,	
beshirbhaagei,	বেশীরভাগেই,	বেশিরভাগেই,	
rakkhandurga,	রক্ষণদূর্গ,	রক্ষণদুর্গ,	
indro,	ইন্ড্রো,	ইন্দ্র,	
samajikotar,	সামাজিকতার,	সামাজিকতার,	
obosorer,	অবসরের,	অবসরের,	
zubokra,	যুবকরা,	যুবকরা,	
kaalengaa,	কালেঙ্গা,	কালেঙ্গা,	
dhanijomite,	ধনিজমিতে,	ধানিজমিতে,	
grooth,	গ্রুথ,	গ্রোথ,	
akten,	আকতেন,	অকটেন,	
juddhahato,	যুদ্ধাহাতো,	যুদ্ধাহত,	
beetloser,	বিটলসের,	বিটলসের,	
taunasipa,	তৌনোপিপা,	টাউনশিপ,	
zerusalemer,	জেরুসালেমের,	জেরুজালেমের,	
yucalyptus,	আয়াল্লাপিটাস,	ইউক্যালিপ্টাস,	
konagoolo,	কনাগুলো,	কণাগুলো,	
karpeter,	কারপেটের,	কার্পেটের,	
video,	ভিদেও,	ভিডিয়োও,	
sorano,	সোরানো,	সরানো,	
chalochchitreei,	চলচচ্ত্রীতেই,	চলচ্চিত্রেই,	
hari,	হারি,	হরি,	
jarmaniteo,	জর্মণীতেও,	জার্মানিতেও,	
chirontan,	চিরোত্নান,	চিরন্তন,	
torkarir,	তর্কারির,	তরকারীর,	
dhanche,	ধনচে,	ধাঁচে,	
ishter,	ইস্টার,	ইস্টের,	
byabaharkareer,	ব্যবহারকারীর,	ব্যবহারকারীর,	
bossonte,	বসন্তে,	বসন্তে,	
kanthar,	কান্ঠার,	কাঁথার,	
rajan,	রাজন,	রাজন,	
tahorir,	তাহরীর,	তাহরীর,	
fokskon,	ফক্সকোন,	ফক্সকন,	
rajnoitik,	রাজনৈতিক,	রাজনৈতীক,	
planey,	প্ল্যানে,	প্লেনে,	
kushakhali,	কুশাখালী,	কুশাখালি,	
baju,	বাজু,	বাজু,	
orthobochorke,	অর্থবছরকে,	অর্থবছরকে,	
nothibhukteer,	নথিভুক্তির,	নথিভুক্তির,	
dolu,	দলু,	ডলু,	
baaiq,	বাইক,	বাইক,	
siddhantoo,	সিদ্ধান্ত,	সিদ্ধান্তও,	
ghetu,	ঘেটু,	ঘেটু,	
dibate,	দিবাতে,	ডিবেট,	
alonkaran,	আলোঙ্করণ,	অলঙ্করণ,	
cuti,	কুটি,	কিউটি,	
teamothy,	টিমোথি,	টিমোথি,	
idipasha,	ইদিপাশা,	ইডিপাস,	
mooney,	মুনে,	মুনে,	
kalnir,	কালনির,	কালনীর,	
si,	সি,	এসআই,	
hadisti,	হাদিস্টি,	হাদিসটি,	
bhimsenkei,	ভীমসেনকেই,	ভীমসেনকেই,	
canflikt,	ক্যানফ্লিক,	কনফ্লিক্ট,	
emiratas,	এমিরাতাস,	এমিরেটাস,	
engrezder,	ইংরেজদের,	ইংরেজদের,	
orthonitir,	অর্থনীতির,	অর্থনীতির,	
markeetim,	মার্কটিং,	মার্কেটিং,	
sazanor,	সাজানোর,	সাজানোর,	
fitarsaho,	ফিতারসহ,	ফিতরসহ,	
nutunotto,	নুতুনত্ত,	নতুনত্ব,	
madaspushto,	মাদসমুষ্ট,	মদদপুষ্ট,	
prakare,	প্রকারে,	প্রকারে,	
kkomandar,	কোমান্ডার,	কমাণ্ডার,	
heteler,	হেটেলের,	হেটেলের,	
refleks,	রিফ্লেক্স,	রিফ্লেক্স,	
eduardo,	এডুর্য়া,	এডুয়ার্দো,	
crashlands,	ক্র্যাশল্যান্ডস,	ক্র্যাশল্যান্ডস,	
sanaktokaran,	সনাক্তকরণ,	সনাক্তকরণ,	
rinattak,	ঋণতত্ক,	ঋনাত্মক,	
protijogiider,	প্রতিযোগীদের,	প্রতিযোগীদের,	
forma,	ফর্মা,	ফর্মা,	
phox,	ফক্স,	ফক্স,	
inphormeshon,	ইনফরমেশন,	ইনফরমেশন,	
protizogiita,	প্রতিযোগীতা,	প্রতিযোগীতা,	
hoil,	হইয়েল,	হইল,	
kandy,	ক্যান্ডি,	ক্যান্ডি,	
adorsho,	আদর্শ,	আর্দশ,	
oncoltike,	অঙ্কলটিকে,	অঞ্চলটিকে,	
shef,	শেফ,	শেফ,	
beatleser,	বিটলেসের,	বিটলসের,	
taalaal,	তালাল,	তালাল,	
tigmanshu,	তিগমানশু,	তিগমংশু,	
bethikata,	বেঠিকতা,	বেঠিকতা,	
udvaboney,	উদ্ভাবনে,	উদ্ভাবনে,	
jamjomat,	জমজোমাত,	জমজমাট,	
maunchostho,	মানচন্স্থ,	মঞ্চস্থ,	
liaodong,	লিয়াডডং,	লিয়াওদং,	
katbe,	কাটবে,	কাটবে,	
ajeem,	আজিম,	আজিম,	
fastag,	ফাস্টাগ,	ফ্যাসট্যাগ,	
sompadonkaree,	সম্পাদনকারী,	সম্পাদনকারী,	
alexanderke,	আলেক্সাক্্ডারে,	আলেকজান্ডারকে,	
suri,	সুরী,	সুরি,	
review,	রিভিয়ে,	রিভিউও,	
pranibigyani,	প্রাণীবিজ্ঞানী,	প্রাণীবিজ্ঞানী,	
gaddaphii,	গদ্দাফি,	গাদ্দাফী,	
ghoorchen,	ঘুরছেন,	ঘুরেছেন,	
meshmeshya,	মেশমেশ্য,	মেশহমেশহিইয়া,	
byapoktor,	ব্যাপকটর,	ব্যাপকতর,	
nirbahe,	নির্বাহে,	নির্বাহে,	
bhorkendra,	ভরকেন্দ্র,	ভরকেন্দ্র,	
rakshanbhag,	রক্ষণভং,	রক্ষণভাগ,	
nachiketa,	নচিকেত,	নচিকেতা,	
moshzidtike,	মশজিদ্তিকে,	মসজিদটিকে,	
euqalyptus,	ইউক্যালিপ্টাস,	ইউক্যালিপ্টাস,	
pranidero,	প্রাণীদেরও,	প্রানীদেরও,	
ishton,	ইসততন,	স্টোন,	
dhrubaker,	ধ্রুবাকের,	ধ্রুবকের,	
bojhe,	বোঝে,	বোঝে,	
soommita,	সুমিতা,	সুমিতা,	
krusher,	ক্রুষের,	ক্রুশের,	
darjiling,	ডার্জিলিং,	দার্জিলিং,	
matt,	মাট,	ম্যাট,	
shansthaner,	শানস্থানের,	সংস্থানের,	
raghubar,	রঘুবার,	রঘুবীর,	
ayantarqatiqa,	আয়ান্টরকথিক,	অ্যান্টার্কটিকা,	
asiatic,	অ্যাসিয়াটিক,	এশিয়াটিক,	
fake,	ফেক,	ফাকে,	
karu,	কুরু,	কারু,	
mohammadi,	মোহাম্মাদি,	মুহাম্মদী,	
shektore,	শেকতরে,	সেক্টরে,	
bondhuvabaponyo,	বন্ধুবাবণপ্য,	বন্ধুভাবাপন্ন,	
vabuk,	ভাবুক,	ভাবুক,	
chalachchitro,	চলচ্চিত্র,	চলচ্চিত্র,	
tarunra,	তরুণরা,	তরুণরা,	
janamukhi,	জানামুখি,	জনমুখী,	
kormobuddhite,	কর্মবুদ্ধিতে,	কর্মবুদ্ধিতে,	
madrasi,	মাদ্রাসি,	মাদ্রাজি,	
sahozlabhbhotar,	সহজলহবভার,	সহজলভ্যতার,	
feroza,	ফেরোজা,	ফিরোজা,	
edaning,	এডানিং,	ইদানিং,	
manushe,	মানুশে,	মানুষে,	
bhagnekeo,	ভাগনেকেও,	ভাগ্নেকেও,	
eekbalke,	এইকবালকে,	ইকবালকে,	
proshadhoner,	প্রশাধনের,	প্রসাধনের,	
ponchasjon,	পঞ্চাসজন,	পঞ্চাশজন,	
joubankal,	যৌবনকাল,	যৌবনকাল,	
dorgah,	ডরগাহ,	দরগাহ,	
echhti,	এছটি,	এছটি,	
korimer,	করিমের,	করিমের,	
farna,	ফারনা,	ফার্ন,	
pracharanamulak,	প্রচারনমূলক,	প্রচারণামূলক,	
taateo,	তাতেও,	তাতেও,	
suparichiti,	সুপারিচিতি,	সুপরিচিতি,	
korimpur,	করিমপুর,	করিমপুর,	
suraaropeeto,	সুরারপিত,	সুরারোপিত,	
tenishe,	তেনিশে,	টেনিসে,	
sarboporee,	সর্বপরী,	সর্বোপরী,	
srabosty,	স্রাবোস্তি,	শ্রাবস্তী,	
chorban,	চোরবান,	চর্বন,	
suporichita,	সুপরিচিতা,	সুপরিচিত,	
habol,	হাবল,	হাবোল,	
heavy,	হিভি,	হেভি,	
sobche,	সবছে,	সবচে,	
ratishilatai,	রাতিশীলতাই,	রতিশীলতায়,	
zommu,	জম্মু,	জম্মু,	
shakar,	শাকার,	সকার,	
omarader,	ওমারাদের,	ওমারাদের,	
shatan,	শাতান,	শয়তান,	
ul,	উল,	উল,	
gandhiio,	গান্ধিও,	গান্ধীও,	
konorup,	কোনরূপ,	কোনরূপ,	
vagni,	ভাগনি,	ভগ্নী,	
poriskoron,	পরিস্করণ,	পরিষ্করণ,	
pratiyogitar,	প্রতিযোগীতার,	প্রতিযোগীতার,	
dianes,	দায়নেস,	ডিএনএস,	
inapharameshana,	ইনাপরাশেনা,	ইনফরমেশন,	
roktokhoron,	রক্তখোণ,	রক্তক্ষরণের,	
plator,	প্ল্যাটর,	প্লেটোর,	
neshadrabyer,	নেশাদ্রব্যের,	নেশাদ্রব্যের,	
graambaashio,	গ্রামবাশিও,	গ্রামবাসীও,	
dola,	দোলা,	দলা,	
veemsen,	ভিমসেন,	ভীমসেন,	
agomone,	অগমনে,	আগমনে,	
zesa,	জেসা,	জেস,	
avetar,	আভেতার,	অবতার,	
patigoniter,	পাটিজনিতের,	পাটিগণিতের,	
byabosthar,	ব্যবস্থার,	ব্যবস্থার,	
amor,	আমর,	আমর,	
gazeetteed,	গজেতিদ,	গেজেটেড,	
sikarder,	সিকারদের,	শিকারদের,	
agora,	অগোরা,	আগোরা,	
ramchander,	রামচন্দের,	রামচন্দরের,	
hughes,	হুঘেস,	হিউজেস,	
ekspression,	এক্সপ্রেশন,	এক্সপ্রেশন,	
karadandey,	করাদন্ডে,	কারাদণ্ডে,	
oojbekistan,	ঔজ্বেকসিত্তান,	উজবেকিস্তান,	
autopromotioner,	অটপপ্রোমোশনের,	অটোপ্রমোশনের,	
logotype,	লোগোটাইপ,	লোগোটাইপ,	
fatakasto,	ফাতাসা্ত,	ফাটাকেষ্ট,	
bijito,	বিজিত,	বিজিত,	
tinhazar,	তিনহাজার,	তিনহাজার,	
reetesh,	রেতেশ,	রিতেশ,	
dooburir,	ডুবিরি,	ডুবুরির,	
shattoki,	শত্তকি,	সাত্যকি,	
bornanukrome,	বর্ণানিকরূমে,	বর্নানুক্রমে,	
oboshore,	অবশরে,	অবসরে,	
toler,	টোলার,	তালের,	
samratder,	সাম্রতদের,	সম্রাটদের,	
aashanka,	আশাঙ্কা,	আশংকা,	
langhaner,	লঙ্ঘনের,	লংঘনের,	
neemeetto,	নীমত,	নিমিত্ত,	
mashtarsha,	মস্তর্শ,	মাস্টার্স,	
anhu,	আনহু,	আনহু,	
hosto,	হস্ত,	হস্ত,	
makame,	মাকামে,	মাকামে,	
felto,	ফেলটো,	ফেলত,	
mujuru,	মুজুরু,	মুজুরু,	
aakkas,	আক্কাস,	আককাস,	
joisttho,	যৈষ্ঠ,	জ্যৈষ্ঠ,	
tunaita,	টুনাইটা,	টুনাইট,	
protinito,	প্রতিনিত,	প্রতিনিত,	
protijogitamulok,	প্রতিযোগিতামূলক,	প্রতিযোগীতামূলক,	
tanu,	টানু,	তনু,	
lobbytey,	লবিটি,	লবিতে,	
cathalic,	ক্যাথালিক,	ক্যাথলিক,	
vedanta,	ভেদান্ত,	বেদান্ত,	
jeebnagore,	জীবনগরে,	জীবননগর,	
overholing,	ওভারহললিং,	ওভারহোলিং,	
jamarate,	জামারাতে,	জামারাতে,	
esprito,	এসপ্রিত,	এস্পিরিটো,	
byaptikaler,	ব্যাপ্তিকালের,	ব্যাপ্তিকালের,	
samany,	সামানি,	সামান্য,	
kazianis,	কাজিয়ানিস,	কাজানিস,	
shahidputra,	শহিদপুত্র,	শহীদপুত্র,	
karam,	করাম,	কেরাম,	
evaner,	এভানের,	ইভানের,	
songrahak,	সংগ্রহক,	সংগ্রাহক,	
saalsa,	সালসা,	সালসা,	
karima,	কারিমা,	করিম,	
hilser,	হিলসের,	হিলসের,	
supplenza,	সাপ্লিজা,	সাপলেঞ্জা,	
chalochchitro,	চলচচিত্র,	চলচ্চিত্র,	
esoosiyetasa,	এসোসিয়েতস,	এসোসিয়েটস,	
mmehonoti,	ম্মাহীনটি,	মেহনতি,	
chamski,	চামস্কি,	চমস্কি,	
abarte,	আবার্তে,	আবর্তে,	
bondishalatei,	বন্দিশালাতেই,	বন্দিশালাতেই,	
batistambhatike,	বাতিস্তম্ভটিকে,	বাতিস্তম্ভটিকে,	
amarika,	আমারিকা,	আমেরিকা,	
paste,	পাস্তে,	পেষ্ট,	
vugorvey,	ভুগরভে,	ভূগর্ভে,	
toroonraa,	তরণরা,	তরুণরা,	
meshintao,	মেশিনটাও,	মেশিনটাও,	
manushera,	মানুষেরা,	মানুষেরা,	
chaaktir,	চাকটির,	চাকতির,	
shhashtra,	শশত্রা,	শাস্ত্র,	
taunship,	টাউনশিপ,	টাউনশিপ,	
khagen,	খাগেন,	খগেন,	
sangbadmadhyomgulote,	সংবাদমাধ্যমগুলোতে,	সংবাদমাধ্যমগুলোতে,	
brekethru,	ব্রেকেথ্রু,	ব্রেকথ্রু,	
plaiin,	প্লাইন,	প্লেন,	
shangsthaner,	সংস্থানের,	সংস্থানের,	
peterke,	পেটারকে,	পিটারকে,	
atwabishvashi,	আত্ববিশ্বাসী,	আত্মবিশ্বাসী,	
chhaikalo,	ছাইকালো,	ছাইকালো,	
mahibur,	মহিবুর,	মহিবুর,	
narbur,	নারবুর,	নরবুর,	
chaudhurider,	চৌধিরীদের,	চৌধুরীদের,	
taffsherer,	তাফশেরের,	তাফসীরের,	
masto,	মাস্তো,	মাস্ত,	
harishankar,	হরিষঙ্কর,	হরিশংকর,	
protijogi,	প্রতিযোগী,	প্রতিযোগী,	
transformaarer,	ট্রান্সফরমারের,	ট্রান্সফরমারের,	
scholastik,	স্কলাস্তিক,	স্কলাস্টিক,	
qlauda,	ক্লাড,	ক্লাউড,	
sommotitey,	সম্মতিতে,	সম্মতিতে,	
atighataner,	অতিঘানারের,	অতিঘটনের,	
jeten,	জেতেন,	জেতেন,	
biplabee,	বিপ্লবী,	বিপ্লবী,	
rudroke,	রুদ্রকে,	রুদ্রকে,	
shrabosty,	শ্রাবস্তি,	শ্রাবস্তী,	
bone,	বনন,	বনে,	
akar,	আকার,	একার,	
kushumba,	কুশুম্বা,	কুশুম্বা,	
nirdesika,	নির্দেসিকা,	নির্দেশিকা,	
pichte,	পিছতে,	পিছতে,	
protistha,	প্রতিষ্ঠা,	প্রতিষ্টা,	
rubala,	রুবালা,	রুবল,	
mumtajer,	মুমতাজের,	মুমতাজের,	
karmasampadon,	কর্মসম্পদন,	কর্মসম্পাদন,	
caramiks,	ক্যামারিক্স,	সিরামিকস,	
bidghootey,	বিদগুতে,	বিদঘুটে,	
goteehin,	গতিহীন,	গতিহীন,	
musabbirul,	মুসাববিরুল,	মুসাব্বিরুল,	
olympik,	অলিম্পিক,	অলিম্পিক,	
shalook,	শালুক,	শালুক,	
bosben,	বসবেন,	বসবেন,	
nikela,	নিকেলা,	নিকেল,	
satjaner,	সাতজানের,	সাতজনের,	
amontronkarider,	আমন্ত্রণকারীদের,	আমন্ত্রণকারীদের,	
aholyar,	অহল্যার,	অহল্যার,	
pinogbagke,	পিনোগবাগকে,	পিনগবাগকে,	
shiqara,	শিকারা,	শিকার,	
kod,	কোড,	কোড,	
assexe,	অ্যাসেক্সে,	অ্যাসেক্সে,	
kiandi,	কিয়ান্ডি,	ক্যান্ডি,	
rakhtokkharoner,	রাখটক্ষাণণের,	রক্তক্ষরণের,	
talgachh,	তালগাছ,	তালগাছ,	
hugeke,	হুগেকে,	হিউজকে,	
pratijogira,	প্রতিযোগীরা,	প্রতিযোগীরা,	
societykey,	সোশিটিকে,	সোসাইটিকে,	
jegulur,	জেগুলুর,	যেগুলুর,	
utpotti,	উৎপত্তি,	উতপত্তি,	
jalarong,	জ্যালারং,	জলরঙ,	
bonnopran,	বন্যপ্রাণ,	বন্যপ্রাণ,	
distance,	ডিসট্যান্স,	ডিসট্যান্স,	
vishnuu,	বিশ্নু,	বিষ্ণু,	
ishtone,	ইসতোন,	স্টোন,	
jokkher,	যক্ষের,	যক্ষের,	
edic,	এডিক,	এডিক,	
hosbaleke,	হোসবালেকে,	হোসবালেকে,	
dwibidho,	দ্বিবিধ,	দ্বিবিধ,	
doltyagi,	দলত্যাগী,	দলত্যাগী,	
jaanachhe,	জানাছে,	জানাচ্ছে,	
goora,	গুরা,	গোর,	
bodhir,	বধির,	বধির,	
tuni,	তুনি,	টুনি,	
mausumer,	মাসুমের,	মৌসুমের,	
bisnukey,	বিস্নুকে,	বিষ্ণুকে,	
carbus,	কার্বাস,	কারবাস,	
average,	এভারেজ,	এভারেজ,	
adorso,	আদর্সো,	আর্দশ,	
aarik,	আরিক,	আরিক,	
bornolikhon,	বর্ণলিখন,	বর্ণলিখন,	
townshhip,	টু্শনিশ,	টাউনশিপ,	
manob,	মনোব,	মানব,	
seniar,	সেনিয়ার,	সিনিয়র,	
acrolect,	অ্যাক্রোলেক্ট,	অ্যাক্রোলেক্ট,	
heart,	হের্ট,	হার্ট,	
deefinision,	ডিফিনিশন,	ডেফিনেশন,	
ghatla,	ঘাটলা,	ঘটল,	
maritimer,	মারিটিমের,	মেরিটাইমের,	
kotibondhe,	কটিবন্ধে,	কটিবন্ধে,	
eucalyptus,	ইউজ্যালিপটাস,	ইউক্যালিপ্টাস,	
maailkhanek,	মাইলখানেক,	মাইলখানেক,	
gabeshonar,	গবেষণার,	গবেষনার,	
huk,	হুক,	হুক,	
jibnagore,	জীবনাগরে,	জীবননগর,	
chiraharit,	চিরাহারিত,	চিরহরিৎ,	
bastubad,	বস্তুবাদ,	বস্তুবাদ,	
rajshri,	রাজশিরী,	রাজশ্রী,	
babare,	বাবারে,	বাবারে,	
sthapona,	স্থাপনা,	স্থাপনা,	
chuti,	চুতি,	ছুটি,	
sikha,	সিখা,	শিখ,	
sohokari,	সহকারী,	সহকারী,	
jandrel,	জান্দ্রেল,	জাঁদরেল,	
samratra,	সাম্রাত্র,	সম্রাটরা,	
kyatgarite,	ক্যাটগারিতে,	ক্যাটগারিতে,	
lebina,	লেবিনা,	লেবিনা,	
shiulijhra,	শিউলিঝরা,	শিউলিঝরা,	
yaak,	উয়ক,	ইয়াক,	
ekekrokom,	একেক্রকম,	একেকরকম,	
sooya,	সোয়া,	সোয়া,	
cholochchitra,	চলচ্চিত্র,	চলচ্চিত্র,	
naazi,	নাজি,	নাত্সি,	
chaloke,	চালকে,	চালকে,	
harees,	হারিস,	হ্যারিস,	
durgatsober,	দুর্গাৎসবের,	দুর্গোৎসবে,	
mekapgulo,	মেকাপগুলো,	মেকআপগুলো,	
votarer,	ভোটারের,	ভোটারের,	
dikpal,	দিকপাল,	দিকপাল,	
kings,	কিংস,	কিংস,	
cena,	সিনা,	সিনা,	
beshakbar,	বেশকবার,	বেশকবার,	
raiji,	রাইজী,	রাইজি,	
manohputa,	মনঃপুতা,	মনঃপুত,	
pacbar,	পাস্ার,	পাঁচবার,	
kamla,	কামলায়,	কামলা,	
iling,	ইলিং,	ইলিং,	
niketon,	নিকেতন,	নিকেতন,	
jyaqa,	জ্যাক,	জ্যাক,	
dormroome,	ডর্মূূমে,	ডর্মরুমে,	
atmabishvashi,	আত্মবিশ্বাসী,	আত্মবিশ্বাসী,	
scholastic,	স্কোলাস্টিক,	স্কলাস্টিক,	
armeenian,	আর্মেনিয়ান,	আর্মেনিয়ান,	
mookhomandoler,	মুখমান্ডলের,	মুখমণ্ডলের,	
hank,	হ্যাঙ্ক,	হাঙ্ক,	
samyuktha,	সাম্যুক্ঠ,	সামিউক্তা,	
modelgulo,	মোডেলগুলো,	মডেলগুলো,	
houzgulite,	হাউজগুলিতে,	হাউজগুলিতে,	
kanar,	কানার,	কণার,	
vesselli,	ভেসেলি,	ভেসেলি,	
philo,	ফিল,	ফিলো,	
kale,	কালে,	কালে,	
munot,	মুনোট,	মুনোট,	
raagee,	রাগে,	রাগী,	
dii,	ডিআই,	দিই,	
bhabanir,	ভবানীর,	ভবানীর,	
vodqa,	ভোডকা,	ভদকা,	
haris,	হারিস,	হ্যারিস,	
mousumeo,	মৌসুমেও,	মৌসুমেও,	
phakay,	ফাকে,	ফাকে,	
ase,	আসে,	আসে,	
pothnirdeshona,	পথনির্দেশনা,	পথনির্দেশনা,	
shrabastee,	শ্রাবস্তি,	শ্রাবস্তী,	
jyesthaa,	জ্যেষ্ঠা,	জ্যেষ্ঠা,	
holdim,	হোল্ডিং,	হোল্ডিং,	
dajhyo,	দাঝ্য,	দাহ্য,	
udbhaboney,	উদ্ভাবনে,	উদ্ভাবনে,	
doloo,	দল,	ডলু,	
nimnosakkharkari,	নিম্নস্কাষকারী,	নিম্নস্বাক্ষরকারী,	
sponsorshipe,	স্পন্সর্শিপে,	স্পন্সরশীপে,	
byan,	ব্যান,	ব্যাং,	
shiropar,	শিরোপার,	শিরোপার,	
cholochchitrer,	চলচ্চিত্রের,	চলচ্চিত্রের,	
milayatane,	মিলায়টনে,	মিলায়তনে,	
taufik,	তৌফিক,	তৌফিক,	
ghurte,	ঘুরতে,	ঘুরতে,	
ray,	রায়,	রায়,	
ghenshei,	ঘেনশেই,	ঘেঁষেই,	
adhunikkaley,	আধুনিক্ালে,	আধুনিককালে,	
lubitz,	লুবিৎজ,	লুবিৎজ,	
graambaaseeder,	গ্রামবাসীদের,	গ্রামবাসীদের,	
songbadmadhyame,	সংবাদমাধ্যমে,	সংবাদমাধ্যমে,	
sangharshik,	সংঘ্রষিক,	সাংঘর্ষিক,	
oxforde,	অক্সফোর্ডে,	অক্সফোর্ডে,	
madhobi,	মাধবি,	মাধবী,	
karlei,	কারলেই,	করলেই,	
gondogol,	গণ্ডগোল,	গন্ডগোল,	
bisnuke,	বিস্নুকে,	বিষ্ণুকে,	
abheedhanik,	অভিধানিক,	অভিধানিক,	
ramzaner,	রামজনের,	রমযানের,	
bonbhumi,	বনভূমি,	বনভূমি,	
bhenicer,	ভেনিসের,	ভেনিসের,	
masjidti,	মসজিদটি,	মসজিদটি,	
nibobondhonkrito,	নিববন্ধনকৃত,	নিববন্ধনকৃত,	
oncholke,	অঞ্চলকে,	অঞ্চলকে,	
lungiti,	লুংগিটি,	লুঙ্গিটি,	
catholicbad,	ক্যাথলিকব্যাড,	ক্যাথলিকবাদ,	
kaley,	কালে,	কালে,	
suiti,	সুইটি,	সুইটি,	
akeeb,	আকিব,	আকিব,	
banglota,	বাংলোটা,	বাংলোটা,	
girilal,	গিরিলাল,	গিরিলাল,	
agaldar,	আগালদার,	আগলদার,	
swasthohinotay,	স্বাস্থ্যহীনতা,	স্বাস্থ্যহীনতায়,	
amiretus,	আমিরেটিস,	এমিরেটাস,	
shitei,	শিতেই,	শীতেই,	
holuder,	হলুদের,	হলুদের,	
olympic,	অলিম্পিক,	অলিম্পিক,	
patininda,	পাতিনিন্দা,	পতিনিন্দ,	
informetion,	ইনফরমেশন,	ইনফরমেশন,	
dhalur,	ধালুর,	ঢালুর,	
swadhinotatukui,	স্বাধীনতাটুকু,	স্বাধীনতাটুকুই,	
bedantodhormo,	বেদান্তধর্ম,	বেদান্তধর্ম,	
kiibord,	কিববোর্ড,	কীবোর্ড,	
torabgonj,	তরাবগঞ্জ,	তোরাবগঞ্জ,	
bahjya,	বাহ্যা,	বাহ্য,	
eshiyetika,	এশিয়েটিকা,	এশিয়াটিক,	
giitikobita,	গীতিকিবিত,	গীতিকবিতা,	
firozapure,	ফিরোজাপুরে,	ফিরোজাপুরে,	
ghotaibe,	ঘটাইবে,	ঘটাইবে,	
aosafur,	আওফাফুর,	আওশাফুর,	
rayyaleti,	রেয়ায়েতী,	রয়্যালটি,	
metrikoleshana,	মেত্রিকোলেশন,	মেট্রিকোলেশন,	
bishshaasho,	বিষ্বশো,	বিশ্বাসও,	
horas,	হোরাস,	হোরাস,	
fatkabazare,	ফতকাবাজারে,	ফাটকাবাজারে,	
ganonanatto,	গণনানত্ত,	গণনাট্য,	
niropekkho,	নিরপেক্ষ,	নিরপেক্ষ,	
roy,	রোয়,	রায়,	
shamshernagar,	শম্শেরগর,	শমশেরনগর,	
binakar,	বিনাকার,	বিনাকার,	
puding,	পুডিং,	পুডিং,	
ramolino,	রামালিনো,	রামোলিনো,	
oncholtee,	অঞ্চলটি,	অঞ্চলটি,	
nathibhuktir,	নাথিভুক্তির,	নথিভুক্তির,	
dharavahikbhabe,	ধারাভাষিকভাবে,	ধারাবাহিকভাবে,	
hitaishi,	হিতাশি,	হিতৈষী,	
palta,	পাল্টা,	পালটা,	
shamshere,	শমশেরে,	শমসের,	
kadapaker,	কাড়াপাকের,	কড়াপাকের,	
sadeena,	সাদিনা,	সাডেন,	
remission,	রেমিশন,	রিমিশন,	
tigmanshu,	তিগমানশু,	তিগ্মাংশু,	
ganosachetanata,	গণসচেতনাটা,	গণসচেতনতা,	
mitroder,	মিত্রদের,	মিত্রদের,	
furio,	ফুরিও,	ফুরিও,	
swartho,	স্বার্থ,	স্বার্থ,	
serup,	সেরুপ,	সেরূপ,	
dharmiyabhabei,	ধর্মীয়ভাবেই,	ধর্মীয়ভাবেই,	
saazano,	সাজানো,	সাজানো,	
charger,	চার্গের,	চার্জার,	
turkyder,	টার্কেডের,	তুর্কিদের,	
suchanakal,	সুচনাকাল,	সূচনাকাল,	
jonoikaa,	জনৈকা,	জনৈকা,	
lopjonito,	লোপজনিত,	লোপজনিত,	
unchuporjayer,	উঁচচপর্যায়ের,	উঁচুপর্যায়ের,	
shchalastic,	স্কালাল্টিক,	স্কলাস্টিক,	
helly,	হেলি,	হিলি,	
horippur,	হরিপ্পুর,	হরিপুর,	
akhandata,	আখণ্ডটা,	অখণ্ডতা,	
taunsheep,	টাউন্িপ,	টাউনশিপ,	
grushko,	গ্রুষ্কো,	গ্রুশকো,	
byaktigotovabeo,	ব্যক্তিগতভাবেও,	ব্যাক্তিগতভাবেও,	
pinglateo,	পিংলাতেও,	পিংলাতেও,	
corsin,	কর্সিন,	করসিন,	
talgach,	তালগাছ,	তালগাছ,	
poripaker,	পরিপাকের,	পরিপাকের,	
courtcaser,	কর্টকাসের,	কোর্টকেসের,	
nagorikkey,	নাগরিককে,	নাগরিককে,	
asociatis,	এসোশিয়েটিস,	এসোসিয়েটস,	
sarajibonbyapi,	সারাজিবন্যাবী,	সারাজীবনব্যাপী,	
chheher,	ছেহের,	ছেহের,	
akkharkey,	অক্ষরকে,	অক্ষরকে,	
doneta,	ডোনেটা,	ডোনাট,	
streegon,	স্ট্রিগন,	স্ত্রীগণ,	
pillai,	পিল্লাই,	পিল্লাই,	
bapio,	বাপিও,	বাপিও,	
treend,	ট্রিন্ড,	ট্রেন্ড,	
veenish,	ভীনিশ,	ভেনিস,	
batsmanei,	ব্যাটসম্যানেই,	ব্যাটসম্যানই,	
eigulor,	এইগুলোর,	এইগুলোর,	
bishnu,	বিষ্ণু,	বিষ্ণু,	
dhonni,	ধন্নী,	ধন্যি,	
boiragirhat,	বৈরাগীরহাট,	বৈরাগিরহাট,	
sportstar,	স্পোর্টস্টার,	স্পোর্টসস্টার,	
dishani,	দিশানি,	দিশানি,	
poorohitra,	পৌরোহিত্র,	পুরোহিতরা,	
satarkokari,	সতর্ককারী,	সতর্ককারী,	
parswer,	পারস্বের,	পার্শ্বের,	
siddhanter,	সিদ্ধান্তের,	সিদ্ধান্তের,	
station,	স্টেশন,	ষ্টেশন,	
nyeta,	ন্যাট,	ম্যাট,	
chhedon,	ছেদন,	ছেদন,	
shilbar,	শিলবার,	সিলভার,	
vittiteo,	ভিত্তিতেও,	ভিত্তিতেও,	
avinetar,	অভিনেতার,	অভিনেতার,	
heze,	হেজে,	হেজ,	
keyboarder,	কেয়বার্ডের,	কীবোর্ডের,	
noitik,	নৈটিক,	নৈতিক,	
hughkey,	হুঘকে,	হিউজকে,	
alpakichudin,	আল্পকিচুদিন,	অল্পকিছুদিন,	
suparharo,	সুপারহোর,	সুপারহিরো,	
horidwar,	হরিদ্বার,	হরিদ্বার,	
mithener,	মিথেনের,	মিথেনের,	
faaj,	ফজ,	ফাজ,	
dhyana,	ধ্যানা,	ধ্যান,	
byaboharkarike,	ব্যবহারকারীকে,	ব্যবহারকারীকে,	
eexpreession,	এক্সপ্রিপন,	এক্সপ্রেশন,	
torikher,	তরিখের,	তরিখের,	
sedikei,	সেদিকেই,	সেদিকেই,	
daaradaa,	দারাদা,	দারদা,	
sahittekder,	সাহিত্যেকদের,	সাহিত্যেকদের,	
bhoolapuka,	ভুলাপুকা,	ভোলাপুক,	
rajotta,	রাজত্ব,	রাজত্ব,	
shikkhakram,	শিক্ষাক্রম,	শিক্ষাক্রম,	
geographics,	জিওগ্রাফিক্স,	জিওগ্রাফিকস,	
venice,	ভেনিস,	ভেনিস,	
bunot,	বানোট,	বুনট,	
shatokeo,	শতকেও,	শতকেও,	
murader,	মুরাদের,	মুরাদের,	
bhromonkaale,	ভ্রমণকালে,	ভ্রমণকালে,	
graambaasheeo,	গ্রামবাশীও,	গ্রামবাসীও,	
turisht,	তুরিৎস,	টুরিস্ট,	
kodorer,	কদরের,	কদরের,	
eura,	ইউরা,	ইউরো,	
expreshshion,	এক্সপ্রেশন,	এক্সপ্রেশন,	
foxer,	ফক্সার,	ফক্সের,	
prasadhoner,	প্রসাধনের,	প্রসাধনের,	
restuarant,	রেস্টুরান্ট,	রেষ্টুরেন্ট,	
segular,	সেগুলার,	সেগুলোর,	
landin,	ল্যান্ডিন,	ল্যান্ডিং,	
hijritey,	হিজরিতে,	হিজরীতে,	
karecho,	করেছো,	করেছ,	
chilona,	চিলনা,	ছিলনা,	
sampadoner,	সম্পাদনের,	সম্পাদনের,	
hajirhat,	হাজিরহাট,	হাজিরহাট,	
orthisoho,	অর্থিসহ,	অর্থিসহ,	
myat,	মাযাট,	ম্যাট,	
abhidhaner,	অভিধানের,	অভিধানের,	
lendol,	লেন্ডল,	লেন্ডল,	
elahabade,	এলাহাবাদে,	এলাহাবাদে,	
ganoporibahon,	গণপরিবহণ,	গণপরিবহন,	
kormyi,	কর্মি,	কর্মই,	
teenisa,	তিনিসা,	টেনিস,	
tricksguli,	ট্রিকসগুলি,	ট্রিকসগুলি,	
afzol,	আফজল,	আফজল,	
kolkarkhana,	কলকারখানা,	কলকারখানা,	
gonohotyakey,	গণহট্যাকে,	গণহত্যাকে,	
taxikeo,	ট্যাক্সিকেও,	ট্যাক্সিকেও,	
binee,	বিনি,	বেনি,	
dhangsantup,	ধ্বংসন্তুপ,	ধ্বংসন্তুপ,	
dokaangulotey,	দোকাগুলোতেই,	দোকানগুলোতে,	
dibet,	ডিবেট,	ডিবেট,	
meloonborrone,	মেলবুনরোণনে,	মেলবোর্নে,	
nischoy,	নিশ্চয়,	নিশ্চয়,	
rakhtokkharone,	রাখকট্ষণরণে,	রক্তক্ষরণে,	
with,	উইথ,	ভিত,	
tomader,	তোমাদের,	তোমাদের,	
haridware,	হরিদ্বারে,	হরিদ্বারে,	
horiddar,	হরিদ্দার,	হরিদ্বার,	
ankanshilpe,	আনকনশিল্পে,	অঙ্কনশিল্পে,	
dipankar,	দীপন্কর,	দিপঙ্কর,	
bbiswashi,	বিব্ষিশ্বাসী,	বিশ্বাসই,	
labonaktatar,	লবনন্টতার,	লবণাক্ততার,	
nanabornobishishto,	নানাবর্ণবিশিষ্ট,	নানাবর্ণবিশিষ্ট,	
karmake,	কারমেক,	কর্মকে,	
sumitrar,	সুমিত্রার,	সুমিত্রার,	
muhaiminer,	মুহাইমিনের,	মুহাইমিনের,	
patjata,	পাতজাতা,	পাটজাত,	
sabrakamer,	সব্রকামের,	সবরকমের,	
noiteekotar,	নৈতিকতার,	নৈতিকতার,	
poorohitder,	পূরহিতদের,	পুরোহিতদের,	
drishi,	দৃরি,	দৃশ্যই,	
themeke,	থেমেকে,	থিমকে,	
commissionvogider,	কমিশনিভগদের,	কমিশনভোগীদের,	
telakucha,	তেলাকুচা,	তেলাকুচা,	
vushito,	ভুশিত,	ভূষিত,	
songkolonti,	সংকলনটি,	সংকলনটি,	
ghumachhe,	ঘুমাছে,	ঘুমাচ্ছে,	
saifullahil,	সাইফুল্লাহিল,	সাইফুল্লাহিল,	
shikkhartheerao,	শিক্ষার্থীরাও,	শিক্ষার্থীরাও,	
plasse,	প্লাস,	প্লাসে,	
pitiler,	পিতিলের,	পিটিলের,	
soorsa,	সুর্স,	সোর্স,	
mitrata,	মিত্রটা,	মিত্রতা,	
ganaporibahaner,	গণপরিবহণের,	গণপরিবহনের,	
pleena,	প্লেন,	প্লেন,	
ranangone,	রণাঙ্গনে,	রণাঙ্গনে,	
taholo,	তাহলো,	তাহলো,	
manushti,	মনুষ্টি,	মানুষটি,	
juktorastrer,	যুক্তারস্ত্রের,	যুক্তরাষ্ট্রের,	
pakhtunistan,	পাখতুন্সিত্ন,	পাখতুনিস্তান,	
graambaaseer,	গ্রামবাসীর,	গ্রামবাসীর,	
bodhirota,	বধিরতা,	বধিরতা,	
baganoto,	বাগানত,	বাগানত,	
veniser,	ভেনিসের,	ভেনিসের,	
kinto,	কিন্তো,	কিনত,	
anubhutimalar,	অনুভূতিমালার,	অনুভূতিমালার,	
poscater,	পোস্কেটের,	পশ্চাতের,	
anagarikra,	আনাগারিকরা,	অনাগরিকরা,	
tigre,	তিগরে,	টাইগার,	
tetela,	টেটেলা,	টাইটেল,	
teentir,	তীনটির,	তিনটির,	
shishu,	শিশু,	শিশু,	
utpatti,	উৎপত্তি,	উতপত্তি,	
peerry,	পাইরি,	পেরি,	
bhandar,	ভান্দার,	ভাণ্ডার,	
mitrer,	মিত্রের,	মিত্রের,	
sonaicha,	সোনাইছা,	সোনাইচা,	
nikote,	নিকতে,	নিকটে,	
bhabatarini,	ভবততরিনী,	ভবতারিণী,	
seo,	সিও,	সেও,	
oedipus,	এডিপাস,	ইডিপাস,	
pujit,	পুজিত,	পুজিত,	
stana,	স্তননা,	স্টোন,	
bodna,	বদনা,	বদনা,	
antorvukta,	আন্তরভুক্ত,	অন্তর্ভুক্ত,	
aswasteekor,	অস্বস্তিকর,	অস্বস্তিকর,	
bondi,	বো্দি,	বন্দী,	
drishyogulotey,	দৃশ্যগুলোতে,	দৃশ্যগুলোতে,	
teoyana,	তেওয়ান,	তাইওয়ান,	
shhepha,	শেফ,	শেফ,	
backflipe,	ব্যাচফ্লিপে,	ব্যাকফ্লিপে,	
ponchashjon,	পঞ্চাশজন,	পঞ্চাশজন,	
jamanataswarup,	জমনাতস্বরূপ,	জামানতস্বরূপ,	
udvabani,	উদ্ভাবাণী,	উদ্ভাবনী,	
grambaashio,	গ্রামবাশিও,	গ্রামবাসীও,	
naraphoka,	নারোফোকা,	নরফোক,	
hojurer,	হজুরের,	হজুরের,	
daayitto,	দায়িত্ব,	দায়িত্ব,	
jatata,	জাতাতা,	যতোটা,	
calabe,	ক্যালাব,	চালাবে,	
lambaate,	ল্যাম্বাট,	লম্বাটে,	
shasyadi,	শাস্যাদি,	শস্যাদি,	
siraju,	সিরাজু,	সিরাজু,	
sip,	সিপ,	শিপ,	
abosan,	অবসান,	অবসান,	
shnaipara,	শ্নাইপারা,	স্নাইপার,	
taler,	তালের,	তালের,	
survative,	সারভাটিভ,	সারভেটিভ,	
municipal,	মুনিসিপাল,	মিউনিসিপ্যাল,	
hoteltee,	হোটেলটি,	হোটেলটি,	
eoki,	ইইকি,	এওকি,	
tukroti,	টুকরতি,	টুকরোটি,	
probeshkari,	প্রবেশকারী,	প্রবেশকারী,	
ekjoge,	একযোগে,	একযোগে,	
daaun,	ডাউন,	ডাউন,	
monchostho,	মঞ্চস্থ,	মঞ্চস্থ,	
fol,	ফলস,	ফল,	
mukherjee,	মুখেরিজ,	মুখার্জী,	
sealvi,	সিলভি,	সিলভি,	
jyesttha,	জ্যেষ্ঠস,	জ্যেষ্ঠা,	
arke,	আরকে,	আরকে,	
bahati,	বাহাতী,	বাহাতি,	
janoganonar,	জনগোননার,	জনগণনার,	
kei,	কিই,	কেই,	
suraaropito,	সুরারোপিত,	সুরারোপিত,	
saqara,	সাকারা,	সাকার,	
torunosomriddho,	তরূণসরৃদ্ধ,	তরুণসমৃদ্ধ,	
hisaber,	হিসাবের,	হিসাবের,	
bishesyo,	বিশেষ্য,	বিশেষ্য,	
bsnleu,	বিএসএনএল,	বিএসএনএলইইউ,	
deciliter,	ডেসাইলিটার,	ডেসিলিটার,	
uporoshtho,	উপরস্থ,	উপরস্থ,	
scuvi,	স্কুভি,	স্কুভি,	
nabotom,	নাবোতম,	নবতম,	
faase,	ফাসে,	ফাঁসে,	
majdur,	মজদুর,	মজদুর,	
maailey,	মাইলে,	মাইলে,	
neelkamal,	নীলকমলল,	নীলকমল,	
pravritir,	প্রভৃতির,	প্রভৃতির,	
abdan,	আবদান,	আব্দান,	
tawnship,	তাবনশিপ,	টাউনশিপ,	
romarder,	রোমার্ডের,	রোমারদের,	
maarmaader,	মার্মাদের,	মারমাদের,	
lendal,	লেন্ডাল,	লেন্ডল,	
eeksapreeshana,	একস্প্রপিণ,	এক্সপ্রেশন,	
pyetarna,	প্যাটেরঁা,	প্যাটার্ন,	
liedtke,	লিয়েডকে,	লইডটক,	
lat,	ল্ট,	লাট,	
ardasha,	আরদাশা,	আর্দশ,	
sollallhu,	সোল্লালহু,	সল্লাল্লাহু,	
ajeejer,	আজেজীর,	আজিজের,	
swostir,	স্বস্তির,	স্বস্তির,	
nirikhe,	নিরিখে,	নিরিখ,	
gej,	গেজ,	গেজ,	
shikh,	শিখ,	শিখ,	
chandanara,	চন্দনারা,	চন্দনারা,	
ganohotyake,	গণহত্যাকে,	গণহত্যাকে,	
gaichhe,	গাইছে,	গাইছে,	
abheedhaneek,	অভিধানিক,	অভিধানিক,	
shithilata,	শিথিলতা,	শিথিলতা,	
chhutochhuti,	ছুটোছুটি,	ছুটোছুটি,	
hizrite,	হিজরিতে,	হিজরীতে,	
abhijitda,	অভিজিতদা,	অভিজিতদা,	
shapad,	শাপাদ,	শ্বাপদ,	
mathieu,	ম্যাথিউ,	ম্যাথিউ,	
nothivookta,	নথিভুক্তা,	নথিভুক্ত,	
navaratri,	নবরত্রী,	নবরাত্রি,	
kyathlik,	ক্যাথলিক,	ক্যাথলিক,	
hansasya,	হাঁসস্য,	হংসস্য,	
ceramicer,	সেরামিসের,	সিরামিকের,	
bikretara,	বিক্রেতারা,	বিক্রেতারা,	
harbore,	হরবরে,	হারবারে,	
thailandshoho,	থাইলন্ডোস,	থাইল্যান্ডসহ,	
bhaandar,	ভান্ডার,	ভাণ্ডার,	
abanishankar,	অবনীষঙ্কর,	অবনিশংকর,	
esasiyetasa,	এসাশিয়েতস,	এসোসিয়েটস,	
rajbandir,	রাজবন্দির,	রাজবন্দীর,	
change,	চাঙ্গে,	চেঞ্জ,	
mag,	ম্যাগ,	এমএজি,	
amar,	আমার,	আমর,	
ujobekeestaner,	উজয়বেকস্টানের,	উজবেকিস্তানের,	
yatharthabhabe,	যথথরাভাবে,	যথার্থভাবে,	
nichupattir,	নিচুপাতটির,	নিচুপট্টির,	
ishahak,	ইশাহাক,	ইসাহাক,	
uchchotara,	উচ্চতারা,	উচ্চতর,	
artherer,	আর্থেরের,	আর্থারের,	
hights,	হাইটস্,	হাইটস,	
bairey,	বাইরে,	বাইরে,	
temonvabe,	তেমনভাবে,	তেমনভাবে,	
nirapattamulok,	নিরাপত্তামূলক,	নিরাপত্তামূলক,	
sahojlovyotar,	সহলোঘ্যতার,	সহজলভ্যতার,	
rockibul,	রকিবুল,	রকিবুল,	
ahmed,	আহমেদ,	আহামদ,	
suparichito,	সুপারিচিত,	সুপরিচিত,	
ralf,	রেলফ,	রালফ,	
mutar,	মুতার,	মুতার,	
oporishodhito,	অপরিষিধি,	অপরিশোধিত,	
purbancoler,	পূর্বনক্ললের,	পূর্বাঞ্চলের,	
directarate,	ডারেক্টেটাতে,	ডিরেক্টরেট,	
matorom,	মাতরম,	মাতরম,	
uter,	ইউটের,	উটের,	
chhatrodiger,	ছাত্রদিগের,	ছাত্রদিগের,	
amanisa,	আমানিসা,	অমানিশা,	
nomo,	নোমো,	নমো,	
sikkharrtheerao,	শিক্ষার্থীরাও,	শিক্ষার্থীরাও,	
eupheike,	ইউফেইকে,	ইউফেইকে,	
satarkabhabey,	সতর্কভাবে,	সতর্কভাবে,	
ponchaasjon,	পঞ্চাশজন,	পঞ্চাশজন,	
saptahokal,	সপ্তাহকাল,	সপ্তাহকাল,	
kani,	কানি,	কানি,	
makhno,	মাখনো,	মাখনো,	
sikara,	সিকারা,	শিকার,	
benojir,	বেনোজীর,	বেনজীর,	
durgotshob,	দুর্গত্ব,	দুর্গোৎসব,	
karaa,	করা,	কারো,	
ponero,	পনেরো,	পনের,	
garora,	গারোরা,	গারোরা,	
safiha,	সাফিহা,	সাফিহা,	
somraat,	সম্রত,	সম্রাট,	
ashanka,	আশাঙ্কা,	আশংকা,	
prothakey,	প্রথাকে,	প্রথাকে,	
hertj,	হেরত্জ,	হার্জ,	
spredashiita,	স্প্রেডাশিয়া,	স্প্রেডশীট,	
delibhara,	ডেলিভারা,	ডেলিভার,	
nirvachokder,	নির্ভচকদের,	নির্বাচকদের,	
firti,	ফিরটি,	ফিরতি,	
dokaanei,	দোকানেই,	দোকানেই,	
primoo,	প্রিমও,	প্রিমো,	
prokolpow,	প্রকল্প,	প্রকল্পও,	
pyatarne,	প্যাটার্ন,	প্যাটার্নে,	
tolemyr,	টলেমির,	টলেমির,	
srivatsalakshanang,	শ্রীবৎসলাংহাং,	শ্রীবৎসলক্ষণং,	
bisheshshyer,	বিশেষ্্যের,	বিশেষ্যের,	
chopol,	চোপল,	চপল,	
shubhag,	শুভাগ,	শুভাগ,	
kumbhalnar,	কুম্ভলনার,	কুম্ভালনার,	
shamijir,	শামিজীর,	স্বামীজীর,	
phokser,	ফকসের,	ফক্সের,	
duuma,	দুইমা,	দুমা,	
khabarsoho,	খাবারসহ,	খাবারসহ,	
krush,	কুরুশ,	ক্রুশ,	
iqbalke,	ইকবলকে,	ইকবালকে,	
shahanara,	শাহানারা,	শাহানারা,	
landing,	ল্যান্ডিং,	ল্যান্ডিং,	
baffer,	বাফার,	বাফার,	
andamana,	আন্দামানা,	আন্দামান,	
jeebonnogor,	জীবন্যগর,	জীবননগর,	
harza,	হারজা,	হার্জ,	
mankisundar,	মাককীসুন্দর,	মানকিসুন্দর,	
flux,	ফ্লাক্স,	ফ্লাস্ক,	
lavta,	লাভটা,	লাভটা,	
bhittow,	ভিত্ত,	ভিত্তিও,	
welcome,	ওয়ালকম,	ওয়েলকাম,	
mukhyo,	মুখ্য,	মুখ্য,	
maadla,	মাদলা,	মাদলা,	
osamarik,	ওসামারিক,	অসামরিক,	
teestar,	তিস্তার,	তিস্তার,	
ranangane,	রণাঙ্গনে,	রণাঙ্গনে,	
omeettrakkhor,	অমিত্রাক্ষর,	অমিত্রাক্ষর,	
nehle,	নেলহে,	নেহলে,	
bibhinno,	বিভিন্ন,	বিভন্ন,	
jerusalemer,	জেরুসালেমের,	জেরুজালেমের,	
jhanjra,	ঝাঁজরা,	ঝাঁজরা,	
dooburira,	ডুবিরিরা,	ডুবুরিরা,	
moshahidur,	মোশাহিদুর,	মোশাহিদুর,	
mumtazer,	মুমতাজের,	মুমতাজের,	
ghatiti,	ঘটিটি,	ঘাঁটিটি,	
rahshahi,	রাহশাহী,	রাহশাহী,	
reshidensha,	রেশিদেনশা,	রেসিডেন্স,	
konisttha,	কোনিস্ঠথ,	কনিষ্ঠ,	
karmokarke,	কার্মকারকে,	কর্মকারকে,	
sheepha,	শীফা,	শেফ,	
bedey,	বেদে,	বেদে,	
nanir,	নানির,	নানীর,	
battery,	ব্যাটারি,	ব্যাটারী,	
veenis,	ভীনিস,	ভেনিস,	
musallati,	মুসল্লাটি,	মুসল্লাটি,	
phartha,	ফারথা,	ফার্থ,	
bouddho,	বৌদ্ধ,	বৌদ্ধ,	
daltagi,	দলতাগী,	দলত্যাগী,	
shem,	সেম,	সেম,	
seekkharthirao,	শিক্ষার্থীরাও,	শিক্ষার্থীরাও,	
vitti,	ভিত্তি,	ভিত্তিই,	
minilosar,	মিনিলোসার,	মিনিলোসার,	
pingna,	পিনগনা,	পিংনা,	
borendroke,	বরেন্দ্রকে,	বরেন্দ্রকে,	
lampot,	ল্যাম্পট,	লম্পট,	
ghomta,	ঘোমটা,	ঘোমটা,	
miley,	মিলে,	মিলে,	
chittronatyokar,	চিত্রোন্ত্যকার,	চিত্রনাট্যকার,	
shumo,	সুমো,	সুমো,	
brittakar,	বৃত্তকার,	বৃত্তাকার,	
gannaprakasham,	গণ্নাপ্রকাশম,	গন্নাপ্রকাশম,	
pulivendla,	পুলিভেন্ডলা,	পুলিভেন্ডলা,	
prakalpagulor,	প্রকালপাগুলোর,	প্রকল্পগুলোর,	
shit,	সিত,	শীত,	
ganakantha,	গণকন্ঠ,	গণকণ্ঠ,	
barbadoj,	বারবাদজ,	বার্বাডোজ,	
jini,	জিনি,	যিনি,	
samajik,	সামাজিক,	সামাজিক,	
bitertrate,	বিতেরত্রাতে,	বাইটারট্রেট,	
akhhunno,	আখুন্ন,	অক্ষুণ্ণ,	
phood,	পুড,	ফুড,	
heena,	হীনা,	হেনা,	
aakaabar,	আকাবার,	আকাবার,	
noditei,	নদীতেই,	নদীতেই,	
mumtaz,	মুমতাজ,	মুমতাজ,	
khorsed,	খর্সড,	খোরশেদ,	
chalaabi,	চালাবি,	চালাবে,	
cheentaikaree,	চিনতাইকরী,	ছিনতাইকারী,	
epiela,	এপিলা,	আইপিএল,	
milekhaanek,	মিলেখানেক,	মাইলখানেক,	
giitikobitar,	গীতিকিবিতার,	গীতিকবিতার,	
iub,	আইইবি,	আইইউবি,	
bidyadanke,	বিদ্যাদানকে,	বিদ্যাদানকে,	
shomser,	শম্সের,	সমশের,	
lishenshe,	লিশেন্ে,	লাইসেন্স,	
jhonkar,	ঝোঁকার,	ঝঙ্কার,	
sadeep,	সাদীপ,	সদীপ,	
geejeeteeda,	গীজিত,	গেজেটেড,	
shikshagato,	শিক্ষগত,	শিক্ষাগত,	
shommotir,	সম্মতির,	সম্মতির,	
magrey,	ম্যাগ্রে,	ম্যাগ্রে,	
himsrot,	হিমস্রট,	হিমস্রোত,	
masjidsaha,	মসজিদসহ,	মসজিদসহ,	
ooipokar,	উইপকর,	উইপোকার,	
madhoboir,	মাধবইর,	মাধবীর,	
uthhaane,	উঠানে,	উঠানে,	
cinemapremider,	সিনেমাপ্রেমীদের,	সিনেমাপ্রেমীদের,	
juboke,	যুবকে,	যুবকে,	
wictor,	উইক্টর,	ভিক্টর,	
plate,	প্লেইট,	প্লেট,	
rupert,	রিপার্ট,	রুপার্ট,	
suisharke,	সুইশারকে,	সুইশারকে,	
eshtonia,	এশতনিয়া,	এস্তোনিয়া,	
debdebie,	দেবদেবী,	দেবদেবী,	
eenameela,	ইনমাইলা,	এনামেল,	
apolokbhabe,	অপলকভাবে,	অপলকভাবে,	
paramartha,	পরমার্থ,	পরমার্থ,	
difinishian,	ডিফিনিশিয়ান,	ডেফিনেশন,	
akpashe,	আকপাশে,	একপাশে,	
ji,	জিআই,	জি,	
proo,	প্রু,	প্রো,	
nartana,	নরটানা,	নর্টন,	
krishibigyani,	কৃষিবিজ্ঞানী,	কৃষিবিজ্ঞানী,	
votar,	ভোটার,	ভোটার,	
probhuder,	প্রভুদের,	প্রভুদের,	
vobanipur,	ভবানীপুর,	ভবানীপুর,	
parinati,	পারিনাটি,	পরিণতি,	
mataram,	মাতারাম,	মাতরম,	
mahasava,	মহাসভ,	মহাসভা,	
serveray,	সার্ভারে,	সার্ভারে,	
jontrototto,	যন্ত্রতত্ত্ব,	যন্ত্রতত্ত্ব,	
yura,	য়ুরা,	ইউরো,	
bhuushito,	ভূূতিত,	ভূষিত,	
transhapharma,	ত্রাণপাশ্রম,	ট্রান্সফর্ম,	
chintamani,	চিন্তমনি,	চিন্তামনি,	
bhaangchur,	ভাংচুর,	ভাংচুর,	
gobeshakgon,	গবেষকগণ,	গবেষকগণ,	
utshahomulok,	উৎসমহমূলক,	উৎসাহমূলক,	
suhayeler,	সুহায়েলের,	সুহায়েলের,	
aasirbaad,	আসীরবাদ,	আশির্বাদ,	
oitijje,	ঐতিহ্যে,	ঐতিহ্যে,	
qor,	কোর,	কর,	
doorotomo,	দরততম,	দূরতম,	
biplobi,	বিপ্লবী,	বিপ্লবী,	
vandar,	ভনন্দার,	ভাণ্ডার,	
ghumunoi,	ঘুমুনোই,	ঘুমুনোই,	
dibya,	দিব্য,	দিব্যা,	
ebham,	এভাম,	ইভিএম,	
vobani,	ভোবানি,	ভবানী,	
vittimul,	ভিত্তিমুল,	ভিত্তিমূল,	
scorey,	স্কোরি,	স্কোরে,	
ashonkai,	আশঙ্কাই,	আশঙ্কাই,	
dombhoke,	দম্ভকে,	দম্ভকে,	
jhumjhumita,	ঝুমঝুমিতা,	ঝুমঝুমিটা,	
tokeo,	তোকেও,	টোকেও,	
qyantana,	ক্যান্তনা,	ক্যান্টন,	
rahimed,	রহিমেদ,	রহিমেদ,	
edseler,	এডসেলের,	এডসেলের,	
mahbunur,	মাহবুনুর,	মাহবুনুর,	
khoakshir,	খোয়াক্ষির,	খোয়াক্ষীর,	
tochhnochh,	তথবক,	তছনছ,	
arshie,	আর্ষি,	আরসিএ,	
meshenjar,	মেশেঞ্জার,	মেসেঞ্জার,	
kommandar,	কম্্যান্ডার,	কমাণ্ডার,	
oitijjha,	ঐতিহ্যা,	ঐতিহ্য,	
ekoirokom,	একোরকম,	একইরকম,	
nutaner,	নুটানের,	নূতনের,	
dologuloo,	দলগুলো,	দলগুলোও,	
arthonitir,	অর্থনীতির,	অর্থনীতির,	
tongaa,	টোঙ্গা,	টোঙ্গা,	
deebug,	দীবুগ,	ডিবাগ,	
chakti,	চাকতি,	চাকতি,	
akmato,	আকমত,	একমত,	
elakaatite,	এলাকাটিতে,	এলাকাটিকে,	
vobobibhuti,	বববিভূতি,	ভববিভূতি,	
abhidhaanic,	অভিধানিক,	অভিধানিক,	
lutharan,	লুথারন,	লুথেরান,	
katui,	কাটুই,	কাতুই,	
chouhate,	চৌহাটে,	চৌহাটে,	
bage,	বোগে,	বাগে,	
japanostho,	জাপানোস্থ,	জাপানস্থ,	
jaruri,	জরুরি,	জরূরী,	
marry,	ম্যারি,	ম্যারি,	
shashtra,	শাস্ত্র,	শাস্ত্র,	
uposhthit,	উপস্থিত,	উপস্থিত,	
satan,	সাতান,	শয়তান,	
sikarer,	সিকারের,	শিকারের,	
everestey,	এভারেস্টে,	এভারেস্টে,	
samley,	স্যামলে,	সামলে,	
nodnodeer,	নদনদির,	নদনদীর,	
bim,	বিম,	বিম,	
padee,	পাদে,	পাড়ে,	
bihar,	বিহার,	বিহার,	
gafeeloti,	গাফেলতি,	গাফিলতি,	
dhyanastha,	ধ্যানস্থ,	ধ্যানস্থ,	
dalip,	দালীপ,	দালিপ,	
ramantika,	রামান্তিকা,	রোমান্টিক,	
sumoo,	সুমো,	সুমো,	
mukhbondho,	মুখবন্ধ,	মুখবন্ধ,	
marketing,	মার্কেটিং,	মার্কেটিং,	
madrasake,	মাদ্রাসাকে,	মাদ্রাসাকে,	
probhur,	প্রভুর,	প্রভুর,	
adhyattikota,	আধ্যাত্মিকতা,	আধ্যাত্মিকতা,	
taufiq,	তৌফিক,	তৌফিক,	
aziza,	আজিজা,	আজিজা,	
nibeditar,	নিবেদিতার,	নিবেদিতার,	
argead,	আর্জড,	আর্জিদ,	
danab,	দানাব,	দানব,	
rajpur,	রাজপুর,	রাজপুর,	
bhejaano,	ভেজানো,	ভেজানো,	
bishashke,	বিষাশকে,	বিশ্বাসকে,	
charpanch,	চারপাঞ্চ,	চারপাঁচ,	
prottokkhovabe,	প্রত্যক্ষভাবে,	প্রত্যক্ষভাবে,	
prosadhaner,	প্রসাধনের,	প্রসাধনের,	
asbab,	আসবাব,	আসবাব,	
sobrakamer,	সব্রাকামের,	সবরকমের,	
bandra,	বান্দ্রা,	বন্দীরা,	
nabatamo,	নবতম,	নবতম,	
bhenasha,	ভেনাশা,	ভেনাস,	
tateo,	তাতেও,	তাতেও,	
ched,	চেদ,	ছেদ,	
ebhara,	এভারা,	এভার,	
abhirupbabuke,	অভিরুপবাবুকে,	অভিরূপবাবুকে,	
rijoor,	রিজুর,	রিজুর,	
nothibhukta,	নথিভুক্ত,	নথিভুক্ত,	
jotsna,	জোতসনা,	জ্যোৎস্না,	
tooku,	তুকু,	টুকু,	
gaphiloti,	গাফিলটি,	গাফিলতি,	
kadam,	কাদম,	কদম,	
shamuker,	শামুকের,	শামুকের,	
kkhur,	কুকুর,	ক্ষুর,	
bhangchur,	ভাংচুর,	ভাংচুর,	
gaddaafee,	গদ্দফফী,	গাদ্দাফী,	
aakik,	আকিক,	আকিক,	
spredsheet,	স্প্রেডশিট,	স্প্রেডশীট,	
gaichey,	গাইছে,	গাইছে,	
kaatbey,	কাটবে,	কাটবে,	
asommoti,	অসম্মতি,	অসম্মতি,	
parkasa,	পারকাসা,	পার্কস,	
gabinius,	গাবিনিয়াস,	গাবিনিআস,	
kortam,	কোরতাম,	করতাম,	
oncoleo,	অঙ্কোলো,	অঞ্চলেও,	
tinage,	তিনাজে,	টিনেজ,	
ragei,	রাগেই,	রাগেই,	
prangulo,	প্রাণগুলো,	প্রানগুলো,	
beem,	বিআইউ,	বিম,	
upacharjo,	উপাচার্য,	উপাচার্য,	
thandabhabe,	তান্ডভাবে,	ঠাণ্ডাভাবে,	
bejiye,	বেজিয়ে,	বেজিয়ে,	
diznee,	দিজনি,	ডিজনী,	
shahabike,	সাহাবীকে,	সাহাবীকে,	
jibanto,	জীবন্ত,	জীবন্ত,	
moonshi,	মুনশি,	মুন্সি,	
shurugulo,	শুরুগুলো,	শুরুগুলো,	
nirmolotaa,	নির্মলতা,	নির্মলতা,	
ateetkaale,	অতীতকালে,	অতীতকালে,	
jackey,	জ্যাকে,	জকি,	
johor,	জহর,	জহর,	
chaudhuriyo,	চৌধিরীও,	চৌধুরীও,	
utotoro,	উততর,	উততর,	
rahee,	রহে,	রাহি,	
drishyer,	দৃশ্যের,	দৃশ্যের,	
firalem,	ফিরালেম,	ফিরালেম,	
bowie,	বইও,	বওই,	
obdi,	অব্দি,	অব্দি,	
dumaa,	দুমা,	দুমা,	
shikshagata,	শিক্ষগত,	শিক্ষাগত,	
opohoron,	অপহরণ,	অপহরন,	
mathews,	ম্যাথেবস,	ম্যাথিউস,	
hosne,	হোসনে,	হোসনে,	
biprodas,	বিপ্রদাস,	বিপ্রদাস,	
dwijenbabuder,	দ্বিজেনবাবুদের,	দ্বিজেনবাবুদের,	
rilayensha,	রিলয়েনশা,	রিলায়েন্স,	
onkush,	অঙ্কুশ,	অংকুশ,	
elakatite,	এলাকাটিতে,	এলাকাটিকে,	
purushika,	পুরুষিকা,	পুরুষিকা,	
conflikt,	কনফ্লিক্ট,	কনফ্লিক্ট,	
kaaferder,	কাফেরদের,	কাফেরদের,	
gurmukh,	গুরমুখ,	গুরমুখ,	
detik,	দেটিক,	দেতিক,	
kokeyin,	কোকেইন,	কোকেইন,	
mythological,	মিথোজজিক্যাল,	মাইথলজিকাল,	
pyor,	পিওর,	পিওর,	
chapal,	চাপাল,	চপল,	
chinito,	চিনিত,	চিনতো,	
elakaate,	এলাকাতে,	এলাকাতে,	
mirakela,	মিরাকেল,	মিরাকেল,	
laaz,	লাজ,	লাজ,	
niknayman,	নিক্নামান,	নিকনেইমান,	
dhaleshwari,	ধলেশ্বরী,	ধলেশ্বরী,	
kuttake,	কুটটাকে,	কুত্তাকে,	
ahong,	আহং,	অহং,	
bade,	বাদ,	বাদে,	
tata,	তাতা,	তাতা,	
bosano,	বসপানো,	বসানো,	
bupher,	বুফার,	বাফার,	
jemy,	জেমি,	জেমি,	
niropekshtar,	নিরপেক্ষটার,	নিরপেক্ষতার,	
milekhanek,	মিলেখানেক,	মাইলখানেক,	
karecho,	করেছো,	করেছো,	
purborekorde,	পূর্বরেকর্ডে,	পূর্বরেকর্ডে,	
thakeni,	ঠাকেনী,	থাকেনি,	
prakar,	প্রকার,	প্রকার,	
sonaktokaran,	সোনাক্তকরণ,	সনাক্তকরণ,	
providere,	প্রভিদেরে,	প্রভাইডারে,	
ovarview,	ওভারভিভ,	ওভারভিউ,	
podarthobidder,	পদার্থবিদদের,	পদার্থবিদদের,	
israelbahini,	ইসরায়েববিহীন,	ইস্রায়েলবাহিনী,	
cxt,	সিসিএটি,	সিএক্সটি,	
transapharma,	ট্রান্সফর্ম,	ট্রান্সফর্ম,	
prokar,	প্রকার,	প্রকার,	
aairish,	আইরিশ,	আইরিস,	
prarthitao,	প্রার্থীতাও,	প্রার্থীতাও,	
gandhike,	গান্ধিকে,	গান্ধীকে,	
bagdadii,	বাগদাদী,	বাগদাদী,	
disni,	ডিসনি,	ডিজনী,	
gardeen,	গার্ডিন,	গার্ডেন,	
azin,	অজিন,	আজিন,	
dolphiny,	ডললিনি,	ডলফিনি,	
chrystal,	ক্রিস্টাল,	ক্রাইস্টাল,	
eesa,	ইইস,	আইএএস,	
daqop,	ডাকপ,	দাকোপ,	
patishapta,	পািশপ্ত,	পাটিসাপটা,	
concerter,	কনসারটার,	কানসাটের,	
orbit,	অরবিট,	অরবিট,	
ghoor,	ঘুর,	ঘুর,	
prosadhoner,	প্রসাধনের,	প্রসাধনের,	
pratiyogita,	প্রতিযোগিত,	প্রতিযোগীতা,	
baibosthaar,	বৈবস্থার,	ব্যবস্থার,	
bhugol,	ভূগোল,	ভূগোল,	
rifleksa,	রিফলেকসস,	রিফ্লেক্স,	
koreempoor,	করমমপুর,	করিমপুর,	
fuss,	ফুজ,	ফাস,	
kode,	কোড়ে,	কোড,	
chikittsar,	চিকিত্সার,	চিকিত্সার,	
whole,	ওহলে,	হোল,	
riazuddin,	রিয়াউদ্দিন,	রিয়াজউদ্দীন,	
spreadshiit,	স্প্রেডশিট,	স্প্রেডশীট,	
thanvi,	থানভি,	থানভী,	
bolvodro,	বলভোদ্র,	বলভদ্র,	
byboshthar,	বিবস্থার,	ব্যাবস্থার,	
muktijuddhojato,	মুক্তিযুদ্ধানও,	মুক্তিযুদ্ধজাত,	
sondhisthaponer,	সন্ধিষ্ঠাপনের,	সন্ধিস্থাপনের,	
jathartho,	যথার্থ,	যথার্থ,	
basab,	বাসব,	বাসাব,	
bboponer,	ব্বপনের,	বপনের,	
rasunkunchi,	রসুনকুঁচি,	রসুনকুঁচি,	
ekirokom,	একিরোকম,	একইরকম,	
prabhritite,	প্রভৃতিতে,	প্রভৃতিতে,	
messengerer,	মেসেনগ্রের,	মেসেঞ্জারের,	
bufer,	বুফার,	বাফার,	
prothati,	প্রথাটি,	প্রথাটি,	
mile,	মিলে,	মিলে,	
sthaponagulo,	স্থাপনাগুলো,	স্থাপনাগুলো,	
badargaji,	বদরগাজি,	বদরগাজী,	
ancholgoolote,	অ্যাঙ্চগোলোতে,	অঞ্চলগুলোতে,	
oncholshomuher,	অঞ্চশমূলের,	অঞ্চলসমূহের,	
deputee,	ডিপুটি,	ডেপুটি,	
govindarajan,	গোবিন্দরাজন,	গোবিন্দরাজন,	
fasi,	ফ্যাসি,	ফাঁসী,	
croak,	ক্রোক,	ক্রোক,	
salafeta,	সালাফেতা,	সালফেট,	
dharavahik,	ধারাভাহিক,	ধারাবাহিক,	
jins,	জিন্স,	জিন্স,	
upobashii,	উপবাশী,	উপবাসী,	
jotharthovabey,	যথার্থভাবে,	যথার্থভাবে,	
dharabahikbhabe,	ধারাবাহিকভাবে,	ধারাবাহিকভাবে,	
slatgulor,	স্ল্যাটগুলোর,	স্ল্যাটগুলোর,	
nathivukta,	নাথিভুক্ত,	নথিভুক্ত,	
sausagee,	সৌসগে,	সসেজ,	
kichudinpar,	কিছুদিনপর,	কিছুদিনপর,	
provritike,	প্রভৃতিকে,	প্রভৃতিকে,	
aro,	আরো,	আরও,	
ekoghore,	একঘরে,	একঘরে,	
langhoner,	লঙ্ঘনের,	লংঘনের,	
antennal,	অ্যান্টেনাল,	অ্যান্টেনাল,	
rajbandi,	রাজবন্দী,	রাজবন্দী,	
nederlande,	নেদারল্যান্ডে,	নেদারল্যান্ডে,	
shahoshikatar,	শাহ্সিকাটার,	সাহসিকতার,	
anyorup,	অন্যরূপ,	অন্যরূপ,	
turbiner,	টারবিনের,	টারবাইনের,	
ipl,	আইপিএল,	আইপিএল,	
tasminer,	তাসমিনের,	তাসমিনের,	
upobasher,	উপবাশের,	উপবাসের,	
satarkatar,	সতর্কটার,	সতর্কতার,	
songbadmadhyomer,	সংবাদমাধ্যমের,	সংবাদমাধ্যমের,	
jerushalema,	জেরুশালেমা,	জেরুসালেম,	
sausage,	সৌগে,	সসেজ,	
erokomer,	এরকমের,	এরকমের,	
kaansaat,	কানসাট,	কানসাট,	
promodwara,	প্রমদ্বারা,	প্রমদ্বারা,	
protisthan,	প্রতিষ্ঠান,	প্রতিষ্টান,	
bonvumi,	বনভূমি,	বনভূমি,	
jontrangshogulor,	যন্ত্রাংশগুলোর,	যন্ত্রাংশগুলোর,	
koordider,	কূর্ডিদের,	কুর্দিদের,	
prokolpogulikei,	প্রকল্পগুলিকেই,	প্রকল্পগুলিকেই,	
cloring,	ক্লোরিং,	ক্লোরিং,	
shhikara,	শিকারা,	শিকার,	
shift,	শিফ্ট,	শিফট,	
rena,	রেন,	রেনো,	
ahalya,	অহল্যা,	অহল্যা,	
besooro,	বেসৌরো,	বেসুর,	
chhooteer,	ছোটির,	ছুটির,	
debholopar,	ডেভোলপার,	ডেভলপার,	
dhandu,	ধনন্দু,	ধন্দু,	
sarjur,	সারুজ,	সরযূর,	
ancholtike,	অঞ্চলটিকে,	অঞ্চলটিকে,	
devolapar,	দেবলোপার,	ডেভলপার,	
bulan,	বুলান,	বুলান,	
neutrinoo,	নিউট্রিনো,	নিউট্রিনো,	
shikhaboudi,	শিখাবৌদি,	শিখাবৌদি,	
perry,	পেরি,	পেরি,	
romnar,	রোমনার,	রমনার,	
teunar,	তেউনার,	টিউনার,	
kanasharabheshhana,	কনশরাভেষণা,	কনসারভেশন,	
tecno,	টেকনো,	টেকনো,	
lettere,	লেটারে,	লেটারে,	
chalachchitroi,	চলচ্চিত্রই,	চলচ্চিত্রই,	
goshthiti,	গোষ্ঠিটি,	গোষ্ঠীটি,	
kash,	কাশ,	কাস,	
vugoley,	ভুগলে,	ভূগোলে,	
gandogol,	গণ্ডগোল,	গন্ডগোল,	
ashociatesh,	আশোসিয়েটস,	এসোসিয়েটস,	
jhimochchilo,	ঝিমচ্ছিল,	ঝিমোচ্ছিলো,	
sachetonvabe,	সচেতনভাবে,	সচেতনভাবে,	
dakteekiter,	ডাক্তিকীতের,	ডাকটিকিটের,	
panchbar,	পাঁচবার,	পাঁচবার,	
daaktikit,	দাক্তিকিৎ,	ডাকটিকিট,	
srk,	স্রিভিক,	শাহরুখ,	
shtona,	স্তোনা,	স্টোন,	
mukhabandha,	মুখাবন্ধ,	মুখবন্ধ,	
marri,	মারি,	ম্যারি,	
saramukhe,	সামাুখে,	সারামুখে,	
shansthagulo,	শাঁষ্ঠগুলো,	সংস্থাগুলো,	
kaalki,	কালকি,	কালকি,	
folleni,	ফলেনি,	ফলেনি,	
nirikh,	নিরিখ,	নিরিখ,	
orunima,	ওরুনিমা,	অরুণিমা,	
durgotsabe,	দুর্গতসাবে,	দুর্গোৎসবে,	
romancha,	রোমাঞ্চ,	রোমাঞ্চ,	
khude,	খোদে,	ক্ষুদে,	
nanilalke,	নানীলালকে,	ননীলালকে,	
manush,	মনুষ,	মানুষ,	
sahachke,	সহচাকে,	সাহাচকে,	
chomski,	চমস্কি,	চমস্কি,	
alaul,	আলাউল,	আলাওল,	
odeb,	ওদেব,	ওদেব,	
mukhomandaler,	মুখমন্ডলের,	মুখমণ্ডলের,	
shrimoti,	শ্রীমটি,	শ্রীমতি,	
idyi,	ইডি,	আইডিই,	
sector,	সেক্টর,	সেক্টর,	
dimbacriti,	ডিম্বাক্রিটি,	ডিম্বাকৃতি,	
toching,	তোচিং,	টোচিং,	
poscime,	পশ্চিম,	পশ্চিমে,	
shhow,	শোব,	শো,	
porizoner,	পরিজনের,	পরিজনের,	
bharotchilo,	ভারতছিল,	ভারতছিল,	
madhuri,	মধুরী,	মাধুরী,	
satarkabhabe,	সতর্কভাবে,	সতর্কভাবে,	
patrol,	পেটরোল,	পেট্রোল,	
nibondhocheler,	নিবন্ধচেলের,	নিবন্ধছেলের,	
hijrite,	হিজরিতে,	হিজরীতে,	
cheess,	চিজ,	চেস,	
korkotkraantee,	কর্কটরক্যান্তি,	কর্কটক্রান্তি,	
bonnypran,	বন্যপ্রাণ,	বন্যপ্রাণ,	
chalachchitra,	চলচ্চিত্র,	চলচ্চিত্র,	
neemeette,	নীমতিত,	নিমিত্তে,	
ekghore,	একঘরে,	একঘরে,	
chhotogolper,	ছোটগল্পের,	ছোটগল্পের,	
uindoos,	উইন্ডুস,	উইন্ডোস,	
bujhechhila,	বুঝেছিল,	বুঝেছিল,	
nepchooner,	নেপচুনের,	নেপচুনের,	
snehban,	স্নেহবান,	স্নেহবান,	
jounatar,	যৌনতার,	যৌনতার,	
oitijhyotike,	ঐতিহ্যটিকে,	ঐতিহ্যটিকে,	
istoone,	ইস্তুনে,	স্টোন,	
sobaiderke,	সবাইদেরকে,	সবাইদেরকে,	
bikargrasta,	বিকারগ্রস্ত,	বিকারগ্রস্ত,	
nabbata,	নব্বতা,	নাব্যতা,	
joubanbatee,	যৌবনবতী,	যৌবনবতী,	
dokaangoolote,	দোকাগগুলোতে,	দোকানগুলোতে,	
jamkaalo,	জামকালো,	জমকালো,	
mukhobondho,	মুখবন্ধ,	মুখবন্ধ,	
brixfield,	ব্রিক্সিল্ড,	ব্রিক্সফিল্ড,	
jansha,	জান্শা,	জন্স,	
qraima,	ক্রাইমা,	ক্রাইম,	
plate,	প্লেইট,	প্লেটে,	
templet,	টেম্পলেট,	টেম্পলেট,	
ap,	এপি,	আপ,	
sompadon,	সম্পাদন,	সম্পাদন,	
abhiyojan,	অভিযোজন,	অভিযোজন,	
sanghar,	সঙ্ঘর,	সংহার,	
daaoon,	দাউন,	ডাউন,	
sarollo,	সরল্লো,	সারল্য,	
dupleks,	ডুপ্লেক্স,	ডুপ্লে,	
gandhariir,	গন্ধারীর,	গান্ধারীর,	
jamseder,	জামসেদের,	জামসেদের,	
aieesha,	আইশা,	আইএএস,	
adhikartai,	অধিকারতাই,	অধিকর্তাই,	
naobihar,	নাবিহার,	নৌবিহার,	
ruby,	রুবি,	রুবী,	
rca,	আরসিএ,	আরসিএ,	
bojiye,	বজিয়ে,	বজিয়ে,	
kruser,	ক্রুসের,	ক্রুশের,	
dhauto,	ধাউত,	ধৌত,	
punorabortonte,	পুনরাবর্তনটে,	পুনরাবর্তন্তে,	
europia,	ইউরোপিয়া,	ইউরোপিয়া,	
ganochin,	গণোচিন,	গণচীন,	
saria,	সারিয়া,	সরিয়া,	
cholochchitrai,	চলচ্চিত্রায়,	চলচ্চিত্রই,	
laaisens,	লেইসেন্স,	লাইসেন্স,	
firozaa,	ফিরোজা,	ফিরোজা,	
nischitobhave,	নিশ্চিতভাবে,	নিশ্চিতভাবে,	
nagarikera,	নাগরিকেরা,	নাগরিকেরা,	
ajijer,	অজিজের,	আজিজের,	
jitpur,	জিতপুরের,	জিতপুরের,	
sangram,	সংগ্রাম,	সঙ্গ্রাম,	
elaakaati,	এলাকাটি,	এলাকাটি,	
peengna,	পিনগনা,	পিংনা,	
colgirl,	কলগ্রিল,	কলগার্ল,	
orthanitike,	অর্থানীতিকে,	অর্থনীতিকে,	
moomtaj,	মোমতাজ,	মুমতাজ,	
nojder,	নজদের,	নজদের,	
bhowanipur,	ভোয়ানিপুর,	ভবানীপুর,	
nilkuthir,	নীলকুঠির,	নীলকুঠির,	
phutanta,	ফুউত্নটা,	ফুটন্ত,	
bhenise,	ভেনিসে,	ভেনিসে,	
notti,	নট্টি,	নোটটি,	
toranganj,	তোরাঙ্গঞ্জ,	তোরাবগঞ্জ,	
deefinition,	ডিফিনশশন,	ডেফিনেশন,	
favorite,	ফ্যাভোরিতে,	ফেভারিট,	
tookror,	তুকরর,	টুকরোর,	
bhardwaj,	ভর্দ্বজ,	ভরদ্বাজ,	
arthonitite,	অর্থনীতিতে,	অর্থনীতিতে,	
lajik,	লাজিক,	লজিক,	
krus,	ক্রুস,	ক্রুশ,	
projanankal,	প্রজাননকাল,	প্রজননকাল,	
sithilota,	সিথিলতা,	শিথিলতা,	
abheedhanic,	অভিভেনিক,	অভিধানিক,	
fanding,	ফ্যান্ডিং,	ফান্ডিং,	
quartar,	কোয়ার্টার,	কোয়ার্টার,	
churger,	চুর্গের,	চার্জের,	
kaleo,	কালেও,	কালেও,	
eesosiyeetasa,	ইসসিসাইত,	এসোসিয়েটস,	
chhuteer,	ছুতির,	ছুটির,	
parshwer,	পার্শ্বের,	পার্শ্বের,	
mohajote,	মহাজতে,	মহাজোট,	
dosha,	দোষা,	দোসা,	
salmaner,	সালমানের,	সালমানের,	
orthanitir,	অর্থানীটির,	অর্থনীতির,	
machhti,	মাছটি,	মাছটি,	
natshi,	নাৎশি,	নাত্সি,	
silabhara,	সিলাভারা,	সিলভার,	
literacy,	লিটারেসি,	লিটারেসি,	
nirvachaker,	নির্ভচাকের,	নির্বাচকের,	
uddhritto,	উদ্ধৃত্ত,	উদ্ধৃত,	
kaash,	কাশ,	কাস,	
bohudin,	বহুদিন,	বহুদিন,	
uddhritir,	উদ্ধৃতির,	উদ্ধৃতির,	
indra,	ইন্দ্রা,	ইন্দ্র,	
sosoa,	সোসোয়া,	শশা,	
poketchorder,	পকেটচর্ের,	পকেটচরদের,	
norfolk,	নরফলক,	নরফোক,	
aviyojan,	অভিযোজন,	অভিযোজন,	
edmeeral,	এডলিরাল,	এডমিরাল,	
stoic,	স্টইক,	স্টোয়িক,	
zaire,	জাইরে,	জাইরে,	
shuperheiro,	শুপেরহেরেও,	সুপারহিরো,	
jaaygata,	জায়গাতা,	জায়গাটা,	
hattey,	হ্যাটে,	হাঁটতে,	
dhhaabi,	ঢাবি,	ঢাবি,	
shrichaitanyadev,	শ্রীচৈতন্যাদেভ,	শ্রীচৈতন্যদেব,	
korijachilen,	করিযাছিলেন,	করিযাছিলেন,	
orrgho,	অর্ঘ,	অর্ঘ্য,	
sift,	সিফ্ট,	শিফট,	
aireshe,	আইরেশে,	আইরেসে,	
duhsthanostho,	দুঃস্থানস্থ,	দুঃস্থানস্থ,	
husni,	হুসনি,	হুসনি,	
krema,	ক্রেম,	ক্রাইম,	
varote,	ভারোতে,	ভারতে,	
torkarite,	তর্কারিতে,	তরকারিতে,	
weelcomee,	বইলকমি,	ওয়েলকাম,	
byaboharkariyi,	ব্যবহারকারী,	ব্যবহারকারীই,	
nirmalata,	নির্মলতা,	নির্মলতা,	
corymb,	করিএম,	করিম,	
lahano,	লাহানো,	লাহানো,	
teoner,	তিওনার,	টিওনার,	
musolmanera,	মুসলমানেরা,	মুসলমানেরা,	
moushumei,	মৌশুমেই,	মৌসুমেই,	
bishaashke,	বিষাশকে,	বিশ্বাসকে,	
yak,	যক,	ইয়াক,	
mette,	মেটে,	ম্যাট,	
ganochien,	গণোচিয়েন,	গণচীন,	
kobutorer,	কবুতরের,	কবুতরের,	
chalochchitrogulor,	চলচচিত্রাগুলোর,	চলচ্চিত্রগুলোর,	
qirq,	কির্ক,	কার্ক,	
akram,	আকরাম,	আকরাম,	
zeebonto,	জীবন্ত,	জীবন্ত,	
bibecchyo,	বিবেচ্ছ,	বিবেচ্য,	
teter,	তেটের,	টেটের,	
oncholgulir,	অপ্চগুলির,	অঞ্চলগুলির,	
parisankhanvid,	পরিসংখ্নাভি,	পরিসংখ্যানবিদ,	
boiporiityen,	বৈপরিত্যেন,	বৈপরীত্যেন,	
laiseensim,	লাইসিনসিং,	লাইসেন্সিং,	
deh,	দেহ,	দেহ্,	
harbare,	হরবারে,	হারবারে,	
ivil,	ইভিল,	ইভিল,	
kormoke,	কর্মকে,	কর্মকে,	
malinga,	মালিঙ্গা,	মালিংগা,	
pratijogider,	প্রততযোগীদের,	প্রতিযোগীদের,	
rajbondir,	রাজবন্দির,	রাজবন্দীর,	
carzar,	কার্জার,	চার্জার,	
sahapathike,	সহপাঠিকে,	সহপাঠীকে,	
jotota,	যতটা,	যতোটা,	
balokarak,	বালকারাক,	বলকারক,	
sangbadmadhyome,	সংবাদমাধ্যমে,	সংবাদমাধ্যমে,	
zarniz,	জার্নিজ,	জারনিজ,	
bee,	বিআই,	বি,	
turkeyder,	তার্কেয়েদের,	তুর্কিদের,	
doorotaumo,	ডরোতাও,	দূরতম,	
purohitra,	পুরোহিত্র,	পুরোহিতরা,	
naper,	নেপার,	ন্যাপের,	
laicenshe,	লেইসেন্স,	লাইসেন্স,	
simantarkkhibahinir,	সীমান্তরক্ষিমারিনীর,	সীমান্তরক্ষীবাহিনীর,	
zoojyota,	যোজ্যতা,	যোজ্যতা,	
indrakanan,	ইন্দ্রকোনন,	ইন্দ্রকানন,	
adbhanced,	অ্যাডভান্ড,	অ্যাডভান্সড,	
vejjanno,	ভেজ্ঞানন,	ভেজানো,	
zerusaleme,	জেরুসালেমে,	জেরুসালেমে,	
elakasoho,	এলাকাসহ,	এলাকাসহ,	
bangalore,	বাঙ্গালোর,	ব্যাঙ্গালুরে,	
rudrasagar,	রুদ্রাসাগর,	রুদ্রসাগরের,	
monroe,	মনরো,	মনেরোর,	
amburi,	অম্বুরি,	আম্বুরি,	
goonoman,	গুনমান,	গুণমান,	
dharmantor,	ধর্মান্তর,	ধর্মান্তর,	
confliqt,	কনফ্লিক,	কনফ্লিক্ট,	
toptoshele,	তপ্তশেলে,	তপ্তশেলে,	
tolemy,	তলেমি,	টলেমির,	
sarsa,	সারসা,	সোর্স,	
dorgaaho,	দর্গাহ,	দরগাহ,	
hool,	হুল,	হুল,	
dibug,	দিবুগ,	ডিবাগ,	
sqalarashipa,	স্কলারশিপ,	স্কলারশিপ,	
alpa,	আলপা,	অল্প,	
as,	এ্য,	অস,	
dephinishion,	ডেফিশীনন,	ডেফিনেশন,	
fibergulote,	ফাইবারগুলোতে,	ফাইবারগুলোতে,	
angkita,	অঙ্কিত,	অঙ্কিতা,	
pariyech,	পারিয়েছ,	পরিয়েছ,	
saom,	সাওম,	সাওম,	
panthar,	পান্থার,	পন্থার,	
gronthowo,	গ্রন্থবও,	গ্রন্থও,	
bulichev,	বুলিছেভ,	বুলিচেভ,	
pujito,	পুজিত,	পুজিত,	
touraat,	তাউরাত,	তওরাত,	
modyer,	মদ্যের,	মদ্যের,	
smarok,	স্মারক,	স্মারক,	
khaaneker,	খানেকের,	খানেকের,	
prakalpoguli,	প্রকা্পলগুলি,	প্রকল্পগুলি,	
licencer,	লাইসেন্সের,	লাইসেন্সের,	
okkhorke,	অক্ষরকে,	অক্ষরকে,	
sangaskritipreme,	সংস্কৃতিপ্রেমে,	সংস্কৃতিপ্রেমে,	
asamorik,	আসামরিক,	অসামরিক,	
deqe,	দেকে,	ডেকে,	
kathmandute,	কাঠমন্ডুতে,	কাঠমান্ডুতে,	
pratisthasaho,	প্রতিষ্ঠাসহ,	প্রতিষ্ঠাসহ,	
nirbahi,	নির্বাহী,	নির্বাহি,	
debeting,	ডেভিটিং,	ডিবেটিং,	
kuthibarike,	কুঠিবারীকে,	কুঠিবাড়ীকে,	
sipa,	সিপ,	শিপ,	
abdi,	আবদদি,	অব্দি,	
jansa,	জানসা,	জন্স,	
hajeerhatt,	হাজেরহাউট,	হাজিরহাট,	
siddhante,	সিদ্ধান্তে,	সিদ্ধান্তে,	
raagei,	রাগেই,	রাগেই,	
kraanti,	ক্রান্টি,	ক্রান্তি,	
jinsa,	জিনসা,	জিন্স,	
bhikkharthe,	ভিক্ষার্থে,	ভিক্ষার্থে,	
probhritike,	প্রভৃতিকে,	প্রভৃতিকে,	
cheento,	চিনততো,	চিনতো,	
alsaar,	আলসার,	আলসার,	
dong,	ডন,	ডং,	
kanshater,	কানশাটের,	কানসাটের,	
koyekbare,	কয়েকবারে,	কয়েকবারে,	
soinyo,	সৈন্য,	সৈন্য,	
baikalyo,	বাইকাল্য,	বৈকল্য,	
kailashrao,	কৈলাশরাও,	কৈলাশরাও,	
mosjidtir,	মসজিদটির,	মসজিদটির,	
moushum,	মৌশুম,	মৌসুম,	
skolastik,	স্কলাস্তিক,	স্কলাস্টিক,	
pacchi,	পাচচি,	পাচ্ছি,	
ancholsaha,	আঞ্চলসহ,	অঞ্চলসহ,	
soteciety,	সোটেসিটি,	সোসাইটিতে,	
balakarak,	বালাকারক,	বলকারক,	
sumita,	সুমিতা,	সুমিতা,	
meloonborroner,	মেলবুনরণেের,	মেলবোর্নের,	
dokan,	দোকান,	দোকান,	
hastantar,	হস্তান্তর,	হস্তান্তর,	
shasonamoleri,	শাসনমমলেরই,	শাসনামলেরই,	
kachhakaachhi,	কাচাকাছি,	কাছাকাছি,	
ala,	আলা,	আলা,	
dojo,	ডোজ,	ডোজো,	
tintir,	তিনটির,	তিনটির,	
peethey,	পিথে,	পীঠে,	
attacharito,	অট্যাচারিত,	অত্যাচারিত,	
jens,	জেন্স,	জিন্স,	
neshnosh,	নেশনোষ,	নেশনস,	
wedanta,	উয়েদান্ট,	বেদান্ত,	
stagecraft,	স্টেজাক্রাফটট্,	স্টেজক্রাফট,	
mitrota,	মিত্রটা,	মিত্রতা,	
parishram,	পরিশ্রম,	পরিশ্রম,	
hariken,	হরিকেন,	হ্যারিকেন,	
muktilav,	মুকতিলাভ,	মুক্তিলাভ,	
durgatsabe,	দুর্গাৎসবে,	দুর্গোৎসবে,	
tapdei,	তাপদেই,	তাপড়েই,	
aalaa,	আলালা,	আলা,	
prithibir,	পৃথিবীর,	পৃথবীর,	
aasar,	আসার,	আসর,	
udyem,	উদ্যেম,	উদ্যেম,	
gatibege,	গতিবেগে,	গতিবেগে,	
ponchaashjon,	পঞ্চাশজন,	পঞ্চাশজন,	
trutimatra,	ত্রুতিমাত্র,	ত্রুটিমাত্র,	
alaol,	আলাউল,	আলাওল,	
bosoben,	বোববেন,	বসবেন,	
sanaktakaran,	সনক্তকরণ,	সনাক্তকরণ,	
chatrorai,	ছাত্ররাই,	ছাত্ররাই,	
baugey,	বাউগে,	বাগে,	
aagera,	আগেরা,	আগোরা,	
jetam,	জেতাম,	যেতাম,	
kagbeni,	কাগবেনি,	কাগবেনি,	
chhuteete,	ছুটিতে,	ছুটিতে,	
dokkhinangsho,	দক্ষিণাংশ,	দক্ষিণাংশ,	
pettern,	পেটার্ন,	প্যাটার্ন,	
bhaibon,	ভাইবন,	ভাইবোন,	
lagche,	লাগছে,	লাগছে,	
jahara,	জাহারা,	যাহরা,	
oblivion,	অব্লিভিন,	অবলিভিয়ন,	
batikromi,	বাতিক্রমি,	ব্যতিক্রমী,	
rohosyo,	রহস্য,	রহস্য,	
baieq,	বিইয়েক,	বাইক,	
heelser,	হিলসের,	হিলসের,	
lekhaksattwar,	লেখকসত্ত্বার,	লেখকসত্ত্বার,	
shanno,	শান্নো,	সান্নো,	
nagorikra,	নাগোরিকরা,	নাগরিকরা,	
byaboharkarir,	ব্যবহারকারীর,	ব্যবহারকারীর,	
shilpajata,	শিল্পজাতা,	শিল্পজাত,	
rajendracholer,	রাজেন্দ্রচালের,	রাজেন্দ্রচোলের,	
uparjoner,	উপার্যনের,	উপার্জনের,	
batikromshalee,	বাতিক্রমশললী,	ব্যতিক্রমধর্মী,	
parka,	পররক,	পার্ক,	
sweety,	স্বিতি,	সুইটি,	
lyandim,	ল্যান্ডিম,	ল্যান্ডিং,	
swadesh,	স্বদেশ,	স্বদেশ,	
zonsa,	জনসস,	জোন্স,	
naitikatavodh,	নৈতিকতাবোধ,	নৈতিকতাবোধ,	
antarctica,	অ্যান্ট্রাকটিকা,	অ্যান্টার্কটিকা,	
amittrakkhor,	অমিত্রাক্ষর,	অমিত্রাক্ষর,	
rajtantrey,	রাজতন্ত্রে,	রাজতন্ত্রে,	
tistar,	তিস্তার,	তিস্তার,	
ovidhanik,	অভিধানিক,	অভিধানিক,	
qarqa,	কার্ক,	কার্ক,	
thailand,	থাইল্যান্ড,	থাইল্যান্ড,	
irish,	ইরিশ,	আইরিস,	
taderek,	তাদেরেক,	তাদেরেক,	
durtomo,	দূর্তম,	দূরতম,	
steeit,	স্টিট,	স্টেইট,	
miitar,	মিতার,	মিত্র,	
nirmol,	নির্মল,	নির্মল,	
antarbhutto,	অন্তর্ভূত্ত,	অন্তর্ভুক্ত,	
bakhyateet,	ব্যাখ্যিত,	ব্যাখ্যাতীত,	
moshjidke,	মশজিদকে,	মসজিদকে,	
anchalgulir,	অঞ্চলগুলির,	অঞ্চলগুলির,	
jocqey,	জককে,	জকি,	
samaptir,	সমাপ্তির,	সমাপ্তির,	
uddharkarmirai,	উদ্ধারকর্মীরাই,	উদ্ধারকর্মীরাই,	
tookrote,	তুকরোতে,	টুকরোতে,	
srichoitonnodeb,	শ্রীচৈতন্যদেব,	শ্রীচৈতন্যদেব,	
sobchey,	সবে,	সবচে,	
salsa,	সালসা,	সালসা,	
audioguloke,	অডিওগুলোকে,	অডিওগুলোকে,	
ponthaar,	পন্থার,	পন্থার,	
kormokarer,	কর্মকারের,	কর্মকারের,	
phutonta,	ফুটনটা,	ফুটন্ত,	
shaater,	সাতের,	শ্যুটার,	
hazat,	হাজাত,	হজত,	
rata,	রাতা,	রত,	
dorneca,	ডর্নকক,	ডরনেকা,	
atmira,	আতমিরা,	আত্মীরা,	
chirkut,	চিরকুট,	চিরকুট,	
harbur,	হাবুর,	হারবার,	
naabyota,	নব্যতা,	নাব্যতা,	
bikretaara,	বিক্রেতারা,	বিক্রেতারা,	
digree,	দিগ্রি,	ডিগ্রি,	
chhootochhuti,	ছোটথচুটি,	ছুটোছুটি,	
rajashri,	রাজশ্রী,	রাজশ্রী,	
mokhmoley,	মখমলে,	মখমলে,	
codeti,	কোডেটি,	কোডটি,	
brail,	ব্রেইল,	ব্রেইল,	
registrikrito,	রেজিস্ট্রিকৃত,	রেজিস্ট্রীকৃত,	
besirbhaagi,	বেসিরভাগী,	বেশিরভাগই,	
poschimey,	পশ্চিমে,	পশ্চিমে,	
utsahamulak,	উৎসমূহলৎ,	উৎসাহমূলক,	
chitlar,	চিতলার,	চিতলার,	
societytey,	সোশাটিটি,	সোসাইটিতে,	
upbasher,	উপবাশের,	উপবাসের,	
utsahi,	উৎসাহী,	উৎসাহী,	
futonta,	ফুটনটা,	ফুটন্ত,	
oncholshomuh,	অঞ্চসমূহ,	অঞ্চলসমূহ,	
vaider,	ভাইদের,	ভাইদের,	
thechar,	থেচার,	থ্যাচার,	
taap,	টাপপ,	ট্যাপ,	
akhando,	আখান্ড,	অখন্ড,	
temone,	তেমোনে,	তেমনই,	
daltyagi,	দল্ত্যগী,	দলত্যাগী,	
louhojato,	লৌহজাত,	লৌহজাত,	
santaa,	সান্তা,	সান্তা,	
rohasyati,	রহস্যাটি,	রহস্যটি,	
skolarsip,	স্কোলারসিপ,	স্কলারশিপ,	
weenis,	উইনিস,	ভেনিস,	
samajeek,	সমাজিক,	সামাজিক,	
gingbhalobasen,	গিংভালাবসেন,	গিংভালোবাসেন,	
chaiten,	চাইতেন,	চাইতেন,	
adhyatmikata,	আধ্যাত্মিকতা,	আধ্যাত্মিকতা,	
emarjensi,	এমারজেন্সি,	এমার্জেন্সি,	
sombhobonaao,	সম্ভবনাও,	সম্ভবনাও,	
dipon,	দিপন,	দীপন,	
bolechile,	বলেছিলে,	বলেছিলে,	
meropenemer,	মেরোপেনেমের,	মেরোপেনেমের,	
masjidke,	মাসজিদকে,	মসজিদকে,	
rajnaiteek,	রাজনৈতিক,	রাজনৈতীক,	
hooldim,	হুল্ডিং,	হোল্ডিং,	
hypar,	হাইপার,	হাইপার,	
lakshmir,	লক্ষ্মীর,	লক্ষ্মীর,	
deilee,	দেইলী,	ডেইলি,	
panchasjan,	পঞ্চসাজন,	পঞ্চাশজন,	
onurbar,	অনুর্বার,	অনুর্বর,	
daap,	ডাইপ,	ড্যাপ,	
tatey,	তাতে,	তাতে,	
khali,	খালি,	খালি,	
bostubad,	বস্তুবাদ,	বস্তুবাদ,	
vaticaner,	ভ্যাটিকেনের,	ভ্যাটিকানের,	
ruptan,	রাপটান,	রূপটান,	
baibosthar,	বৈবস্থার,	ব্যবস্থার,	
choukato,	চৌকাত,	চৌকাত,	
rohasyer,	রহাস্যের,	রহস্যের,	
janagononar,	জানোগনার,	জনগণনার,	
anisa,	আনিসা,	আনিস,	
platform,	প্ল্যাটফর্ম,	প্লাটফর্ম,	
nikate,	নিকাতে,	নিকটে,	
ukeliptash,	উকেলিপ্টাশ,	ইউক্যালিপ্টাস,	
shoodhooi,	সৌধই,	শুধুই,	
gaje,	গাজে,	গেজ,	
asovyo,	অসভ্য,	অসভ্য,	
chandrima,	চান্দ্রিমা,	চন্দ্রিমা,	
laps,	ল্যাপ,	ল্যাপস,	
ingreziteo,	ইংরেজিতেও,	ইংরেজিতেও,	
nopdnodir,	নপ্নদদির,	নদনদীর,	
annorup,	আন্নরূপ,	অন্যরূপ,	
ashamorthito,	আশামর্থিত,	অসমর্থিত,	
surakarder,	সুরকারদের,	সুরকারদের,	
lutharen,	লুথারেন,	লুথেরান,	
waal,	ওয়াল,	উল,	
cloudbook,	ক্লাউডবক,	ক্লাউডবুক,	
shector,	শেক্টর,	সেক্টর,	
siima,	সিইমা,	সীমা,	
bite,	বিতে,	বাইট,	
sylvi,	সিলভি,	সিলভি,	
kuhelika,	কুহেলিকা,	কুহেলিকা,	
nichols,	নিকোলস,	নিকলস,	
aembed,	আমম্বেদ,	এম্বেড,	
keui,	কিউ,	কেউই,	
duio,	দুইও,	দুইও,	
volapuk,	ভোলাপুক,	ভোলাপুক,	
query,	কোর,	কোয়েরি,	
hert,	হের্ট,	হার্ট,	
achintopurer,	অচিন্তপুরের,	অচিন্তপুরের,	
tukrote,	টুকরোতে,	টুকরোতে,	
soolke,	সুলকে,	শুল্কে,	
bisshas,	বিশ্বাস,	বিশ্বাস,	
shunani,	শুনানি,	শুনানী,	
female,	ফেমালে,	ফিমেল,	
dekhso,	দেখসো,	দেখসো,	
beshyasdone,	বেশ্যাসদনে,	বেশ্যাসদনে,	
dristiheen,	দৃষ্টিহীন,	দৃষ্টিহীন,	
rakim,	রাকিম,	রাকিম,	
carloos,	কারলোস,	কার্লোস,	
chaudhurio,	চাধুরিও,	চৌধুরীও,	
katiusha,	কাটিয়াহা,	কাতিউশা,	
bheenisa,	ভীনিসা,	ভেনিস,	
uponeeshod,	উপনিশদ,	উপনিষদ,	
progresh,	প্রজগরেশ,	প্রগ্রেস,	
scholars,	স্কোলারস,	স্কলার্স,	
pathanatak,	পাঠানাটক,	পথনাটক,	
poddhotitei,	পদ্ধতিতেই,	পদ্ধতিতেই,	
aqram,	আকরাম,	আকরাম,	
proshikkhane,	প্রশিক্ষণে,	প্রশিক্ষণে,	
chakradhare,	চাকরাধারে,	চক্রধরে,	
phonekari,	ফোনেকারি,	ফোনকারী,	
firoze,	ফিরোজে,	ফিরোজ,	
kanasarabheeshana,	কনসরাভেষণ,	কনসারভেশন,	
rashedul,	রাশেদুল,	রাশিদুল,	
pradoshik,	প্রদোশিক,	প্রাদশিক,	
domone,	ডোমোন,	দমনে,	
chhutir,	ছুটির,	ছুটির,	
kirke,	কিরকে,	কিরকে,	
manibhaijaner,	মণিভাইজানের,	মণিভাইজানের,	
chaalkee,	চালকে,	চালকে,	
gyada,	জ্দাদা,	গ্যাদা,	
mulvitti,	মূলভিত্তি,	মূলভিত্তি,	
hock,	হক,	হুক,	
kartona,	কারতোনা,	করতনা,	
khonjena,	খোঁজেনা,	খোঁজেনা,	
crime,	ক্রাইম,	ক্রাইম,	
naabbota,	নাব্বোটা,	নাব্যতা,	
ummool,	উম্মুল,	উম্মুল,	
siddhanto,	সিদ্ধান্ত,	সিদ্ধান্তও,	
booroon,	বূরুন,	বোরন,	
habshi,	হাবশি,	হাবশী,	
sokkhomotabriddhi,	সক্ষমতবারিদ্ধি,	সক্ষমতাবৃদ্ধি,	
mane,	মানে,	মানে,	
chalai,	চালাই,	চালাবে,	
anchalei,	অঞ্চলেই,	অঞ্চলেই,	
nirbaahe,	নির্বাহে,	নির্বাহে,	
nirbachakder,	নির্বাচকদের,	নির্বাচকদের,	
neker,	নেকের,	নেকের,	
tachnach,	টাচনাচ,	তছনছ,	
prokolpogulor,	প্রকল্পগুলোর,	প্রকল্পগুলোর,	
aaziz,	আজিজ,	আজিজ,	
infarmatian,	ইনফারম্যায়ান,	ইনফরমেশন,	
prarthonakokkher,	প্রার্থনাক্ষরের,	প্রার্থনাকক্ষের,	
milea,	মিলেয়া,	মাইলে,	
bhutbhut,	ভূতভুট,	ভুটভুট,	
dabarer,	দাবারের,	দাবারের,	
ucchosito,	উচ্চসিত,	উচ্ছসিত,	
raunanganey,	রৌনঙ্গনে,	রণাঙ্গনে,	
jiland,	জিল্যান্ড,	জিল্যান্ড,	
grambaasheeo,	গ্রামবাশীও,	গ্রামবাসীও,	
danata,	দানাটা,	ডোনাট,	
marathi,	মারাথি,	মরাঠি,	
licensin,	লাইসেন্সিন,	লাইসেন্সিং,	
addabaj,	আদ্দাবাজ,	আড্ডাবাজ,	
sheshdinti,	শেষদিনটি,	শেষদিনটি,	
gate,	গাতে,	গ্যেটে,	
karadando,	কারাদান্ড,	কারাদণ্ড,	
atorkitey,	অটোরিকতে,	অতর্কিতে,	
ponera,	পনেরা,	পনের,	
bishwaashshoi,	বিশ্বশ্ষই,	বিশ্বাসই,	
nirgomon,	নির্গমন,	নির্গমন,	
perri,	পেরি,	পেরি,	
uthaney,	উঠানে,	উঠানে,	
jaistho,	যৈত্ঠ,	জ্যৈষ্ঠ,	
bhadaka,	ভাদাকা,	ভদকা,	
lyaataa,	ল্যাটা,	ল্যাটা,	
bandhubhaabaapanna,	বন্ধুভাবাপন্ন,	বন্ধুভাবাপন্ন,	
jaandrel,	যান্দ্রেল,	জাঁদরেল,	
reliance,	রিলিয়েন্স,	রিলায়েন্স,	
highcommissionay,	হাইকোম্সিনিয়া,	হাইকমিশনে,	
ingrezeeteo,	ইংরেজিতেও,	ইংরেজিতেও,	
chalachchitroke,	চলচ্চিত্রকে,	চলচ্চিত্রকে,	
ernad,	এরনাড,	এরনাড,	
hakone,	হাকনে,	হাকোনে,	
title,	টিটল,	টাইটেল,	
chalachchitrotike,	চলচ্চিত্রটিকে,	চলচ্চিত্রটিকে,	
monzeele,	মঞ্জিলে,	মঞ্জিলে,	
obdee,	অবদী,	অব্দি,	
narsaari,	নরসরি,	নার্সারি,	
pnouchute,	পৌচুতে,	পৌঁছুতে,	
drishyogulote,	দৃশ্যগুলোতে,	দৃশ্যগুলোতে,	
qonflict,	কনফ্লিক্ট,	কনফ্লিক্ট,	
debdebier,	দেবদেবীর,	দেবদেবীর,	
aabarte,	আবার্তে,	আবর্তে,	
ronodeep,	রণদীপ,	রণদীপ,	
noditir,	নদীটির,	নদীটির,	
karmosansthan,	কর্মসংস্থান,	কর্মসংস্থান,	
ajeeboner,	আজীবনের,	আজীবনের,	
tokee,	তকক,	তকি,	
kooshumba,	কোশুম্বা,	কুশুম্বা,	
sima,	সিম,	সীমা,	
kiuti,	কিউটি,	কিউটি,	
ansarir,	আনসারীর,	আনসারীর,	
existing,	এক্সিস্টিং,	এক্সিসটিং,	
bisshasyi,	বিশস্য্য,	বিশ্বাসই,	
said,	সাইদ,	সাইদ,	
darji,	দার্জি,	দরজি,	
ceramicsh,	সেরামিক্স,	সিরামিকস,	
bhramapraban,	ভ্রমপ্রবণ,	ভ্রমপ্রবণ,	
internship,	ইন্টারমশিপ,	ইন্টার্নশিপ,	
adwanced,	অ্যাডব্যান্স,	অ্যাডভান্সড,	
torabganj,	তোরাবগঞ্জ,	তোরাবগঞ্জ,	
vange,	ভাঙ্গে,	ভাঙ্গে,	
bm,	বিএম,	বিএম,	
themekey,	থেমেকে,	থিমকে,	
basakey,	বাসাকে,	বাসাকে,	
sepha,	সেফা,	শেফ,	
zohns,	জনস,	জন্স,	
krisenter,	কৃষিন্টের,	ক্রিসেন্টের,	
sahittopritite,	সাহিত্যপ্রীতে,	সাহিত্যপ্রীতিতে,	
prakalpatike,	প্রকল্পটিকে,	প্রকল্পটিকে,	
nobotom,	নবতম,	নবতম,	
prime,	প্রাইম,	প্রাইম,	
akatwa,	আকাত্ব,	একাত্ব,	
dharavahiker,	ধারাভাহিকের,	ধারাবাহিকের,	
fimela,	ফাইমেলা,	ফিমেল,	
madhuree,	মধুরী,	মাধুরী,	
browser,	ব্রুজের,	ব্রাউজার,	
gujab,	গুজাব,	গুজব,	
shringgo,	শ্রিংগ,	শৃঙ্গ,	
shomostigoto,	সমস্তিগত,	সমষ্টিগত,	
bujhtepari,	বুঝতেপারি,	বুঝতেপারি,	
madhumati,	মধুমতি,	মধুমতী,	
mukhomandal,	মুখমন্ডল,	মুখমণ্ডল,	
nodiitei,	নদীতেই,	নদীতেই,	
abodamaner,	অবদামানের,	অবদমনের,	
nirbaaho,	নির্বাহ,	নির্বাহ,	
coons,	কুন্স,	কুনস,	
somoodrotote,	সমন্দ্রতে,	সমুদ্রতটে,	
laesensh,	লেসেন্,	লাইসেন্স,	
ragee,	রেজ,	রাগী,	
akreetokarjo,	আকৃতকার্য্য,	অকৃতকার্য,	
satyaky,	সত্যক্,	সাত্যকি,	
bondhukey,	বন্ধুকে,	বন্ধুকে,	
sbaajan,	স্বজন,	স্বজন,	
yukeliptash,	যুকেলিপ্ঠাস,	ইউক্যালিপ্টাস,	
mookhomaundoler,	মুখমাউন্ডালের,	মুখমণ্ডলের,	
difinision,	ডিফিনিশন,	ডেফিনেশন,	
deenesh,	দীনেশ,	দীনেশ,	
nathivukteer,	নাঠিভুক্তির,	নথিভুক্তির,	
maudelgulo,	মাউডলেগলো,	মডেলগুলো,	
anutpadanshil,	অনুত্পদাশীল,	অনুৎপাদনশীল,	
awrbit,	অরবিট,	অরবিট,	
deobonde,	দেওবন্দে,	দেওবন্দে,	
pravura,	প্রভুরা,	প্রভুরা,	
nishad,	নিষাদ,	নিষাদ,	
abhidhaaner,	অভিধানের,	অভিধানের,	
degree,	দেগরী,	ডিগ্রি,	
sursur,	সুরসুর,	সুরসুর,	
tyapa,	ট্যাপ,	ট্যাপ,	
asthishondhi,	অস্থিষন্ধি,	অস্থিসন্ধি,	
reejideencee,	রেজিনিন্সী,	রেসিডেন্স,	
flirt,	ফ্লার্ট,	ফ্লার্ট,	
bajite,	বাজিতে,	বাজিতে,	
asamanyo,	অসামান্য,	অসামান্য,	
bbiswasho,	বিব্ষিবাসো,	বিশ্বাসও,	
proshtutkarok,	প্রষ্তুতকারক,	প্রস্তুতকারক,	
bhenus,	ভেনুস,	ভেনাস,	
patochitra,	পটোচিত্র,	পটচিত্র,	
planea,	প্লানা,	প্লেনে,	
sobrakomer,	সব্রাকমের,	সবরকমের,	
protibedokrao,	প্রতিবেদকরাও,	প্রতিবেদকরাও,	
dakkhinkare,	দক্ষিণকারে,	দক্ষিণকরে,	
dacope,	ডাকোপে,	দাকোপ,	
siqh,	সিক,	শিখ,	
chaalaabi,	চালাবি,	চালাবে,	
rahee,	রহে,	রাহী,	
paira,	পাইরা,	পাইরা,	
chapchap,	চাঁচাপ,	চাপচাপ,	
goolen,	গুলেন,	গুলেন,	
paolasthi,	পাওলাস্থী,	পাওলাসথি,	
militarir,	মিলিতারির,	মিলিটারির,	
titarer,	তিতারের,	তিতারের,	
ekghare,	একঘারে,	একঘরে,	
amanisha,	আমানিশা,	অমানিশা,	
tuleche,	তুলেছে,	তুলেছে,	
dobhara,	দোভারা,	ডোভার,	
booponer,	বূপনের,	বপনের,	
shukraanoo,	শুক্রাণও,	শুক্রানু,	
soori,	সুরী,	সুরি,	
monohputo,	মনঃপুত,	মনঃপুত,	
sikkhokder,	শিক্ষকদের,	শিক্ষকদের,	
jakso,	জাকসো,	যক্ষ,	
abhidhaanick,	অভিধানিক,	অভিধানিক,	
planeti,	প্লানেটি,	প্লেনটি,	
bisheshya,	বিশেষ্য,	বিশেষ্য,	
muchlima,	মুছলিমা,	মুছলিমা,	
palteche,	পালতেছে,	পাল্টেছে,	
dharabahiktite,	ধারাবাহিকটিতে,	ধারাবাহিকটিতে,	
rashider,	রশিদের,	রশিদের,	
onchalgulir,	অঁচালগুলির,	অঞ্চলগুলির,	
parjotaker,	পার্যটাকের,	পর্যটকের,	
nothibhukto,	নথিভুক্ত,	নথিভুক্ত,	
ceramiksh,	পেরামিক্স,	সিরামিকস,	
kathmandu,	কাঠমণ্ডু,	কাঠমান্ডু,	
teenej,	তেনেজ,	টিনেজ,	
bohorompurer,	বহরমপুরের,	বহরমপুরের,	
shkalarashhipa,	স্কলারশিপ,	স্কলারশিপ,	
cholochchitro,	চলচ্চিত্র,	চলচ্চিত্র,	
jaatti,	যাত্তি,	জাতটি,	
dhadhiye,	ধাধিয়ে,	ধাধিয়ে,	
jonosomaj,	জনসমাজ,	জনসমাজ,	
quata,	কুয়াতা,	কোটা,	
azimpur,	আজিমপুর,	আজিমপুর,	
jorury,	জোরুরি,	জরূরী,	
aansaareer,	আঁসারীর,	আনসারীর,	
cheekitshar,	চিকিৎসার,	চিকিত্সার,	
antarvuktimulak,	অন্তর্ভূকিতমূলক,	অন্তর্ভুক্তিমূলক,	
seshardhe,	শেষার্ধে,	শেষার্ধে,	
dweepgoolotey,	ড্বিপগুলোতে,	দ্বীপগুলোতে,	
digrir,	ডিগ্রির,	ডিগ্রির,	
digri,	ডিগ্রি,	ডিগ্রি,	
karore,	কাররে,	কারোর,	
superheiroo,	সুপারহিরো,	সুপারহিরো,	
sthapanagulor,	স্থাপানুগলোর,	স্থাপনাগুলোর,	
mulyabriddhikale,	মূল্যবৃদ্ধিখালে,	মূল্যবৃদ্ধিকালে,	
jor,	জর,	জ্বর,	
siddharther,	সিদ্ধার্থের,	সিদ্ধার্থের,	
peri,	পেরি,	পেরি,	
humner,	হামারান,	হামনার,	
blacker,	ব্ল্যাকার,	ব্ল্যাকের,	
rachonakal,	রচনাকাল,	রচনাকাল,	
chandil,	চণ্ডীল,	চান্ডিল,	
podotyagsongkranto,	পদত্যাসংযাক্রান্ত,	পদত্যাগসংক্রান্ত,	
pharanyeta,	ফরণ্নেট,	ফরম্যাট,	
nirbaho,	নির্বাহো,	নির্বাহ,	
rekhapat,	রেখাপাত,	রেখাপাত,	
konroop,	কনরুপ,	কোনরূপ,	
mandarbani,	মন্দরবাণী,	মন্দারবাণী,	
sathik,	সাতিক,	সঠিক,	
motabolombira,	মতাবলম্বীরা,	মতাবলম্বীরা,	
casper,	ক্যাসপার,	ক্যাসপার,	
societyke,	সোশাটিকে,	সোসাইটিকে,	
purple,	পারপপল,	পার্পেল,	
mojlish,	মজলিশ,	মজলিশ,	
bardhitansh,	বার্ধিতন্শ,	বর্ধিতাংশ,	
chyeta,	চেটা,	চ্যাট,	
bandhano,	বাঁধানো,	বাঁধানো,	
piulir,	পিউলির,	পিউলির,	
brittakarey,	বৃত্তকরে,	বৃত্তাকারে,	
reflex,	রিফ্লেক্স,	রিফ্লেক্স,	
yaq,	য্যাক,	ইয়াক,	
upbrazillian,	উপব্রেজিল্যালিন,	আপব্রাজিলিয়ান,	
ixprission,	এক্সপ্রিপসন,	এক্সপ্রেশন,	
proboleme,	প্রবলেমে,	প্রবলেমে,	
mentither,	মেন্তিথের,	মেনটিথের,	
pushtee,	পুষ্টি,	পুষ্টি,	
playtey,	প্লেই,	প্লেটে,	
somosto,	সমস্ত,	সমস্ত,	
balatarin,	ব্যালাতারিন,	বালাতারিয়ান,	
kharavel,	খারাভেল,	খারবেল,	
debate,	দেবাতে,	ডিবেট,	
airish,	আইরিশ,	আইরিস,	
besur,	বেসুর,	বেসুর,	
gotirodh,	গতিরোধ,	গতিরোধ,	
koyeeri,	কয়েরী,	কোয়েরি,	
chat,	চটট,	চ্যাট,	
terlarang,	তেরলারাং,	তেরলারং,	
highcomissione,	হাইকোমিশনে,	হাইকমিশনে,	
borkhastokritora,	বরখাস্তকৃতরা,	বরখাস্তকৃতরা,	
hoonayin,	হুনাইন,	হুনাইন,	
sthaponagulor,	স্থাপনাগুলোর,	স্থাপনাগুলোর,	
hugheke,	হুঘেকে,	হিউজকে,	
soketgulor,	সোকেটগুলোর,	সকেটগুলোর,	
phuda,	ফুডা,	ফুড,	
cheef,	চিফ,	শেফ,	
udbhaboni,	উদ্ভাবনী,	উদ্ভাবনী,	
ghaghat,	ঘাঘাট,	ঘাঘট,	
parther,	পার্থের,	পার্থের,	
kathla,	কাঠলা,	কাঠলা,	
besirvagei,	বেসিরভাগেই,	বেশিরভাগেই,	
plato,	প্ল্যাটো,	প্লেটো,	
kaferder,	কাফেরদের,	কাফেরদের,	
khitkar,	খিতকার,	ক্ষিতকর,	
bajpa,	বাজপা,	বাজপা,	
cholocchitrer,	চলচিচ্ত্রের,	চলচ্চিত্রের,	
toki,	তোকি,	তকি,	
manober,	মনোবের,	মানবের,	
milton,	মিলটন,	মিলটন,	
postay,	পোস্টে,	পোস্টে,	
chalochchitraeer,	চলচচ্ত্রীর,	চলচ্চিত্রের,	
dorun,	ডোরুন,	দরুণ,	
parikhar,	পররিখার,	পরিখার,	
kamti,	কামটি,	কমতি,	
durlabhatwang,	দুর্লভ্তমাং,	দুর্লভত্বং,	
kadakhonchar,	কাদাখোঁচার,	কাদাখোঁচার,	
akheli,	আখেলি,	আখেলী,	
catholicder,	ক্যাথলিকদের,	ক্যাথলিকদের,	
krimlin,	ক্রিমিল,	ক্রিমলিন,	
bangobandhu,	বঙ্গবন্ধু,	বঙ্গবন্ধু,	
renoo,	রেনো,	রেনো,	
anektai,	অনেকটাই,	অনেকটাই,	
venisey,	ভেনিসে,	ভেনিসে,	
pyore,	প্যার,	পিওর,	
windo,	উইন্ডো,	উইন্ডো,	
drissogulote,	দৃশসগুলোতে,	দৃশ্যগুলোতে,	
melbourner,	মেলবোর্নের,	মেলবোর্নের,	
shommotite,	সম্মতিতে,	সম্মতিতে,	
hijri,	হিজরি,	হিজরী,	
pustir,	পুস্তির,	পুষ্টির,	
ekroop,	একরূপ,	একরূপ,	
sucre,	সাক্র,	সাকার,	
toroonra,	তরণরা,	তরুণরা,	
sarbhaarti,	সারভর্তি,	সার্ভারটি,	
hundai,	হুন্দাই,	হুন্দাই,	
scholarsip,	স্কলারসিপ,	স্কলারশিপ,	
dhila,	ধীলা,	ঢিলা,	
safin,	সাফিন,	সাফিন,	
porinoti,	পরিণটি,	পরিণতি,	
shringey,	শ্রিংজে,	শৃঙ্গে,	
drissogulo,	দৃষোগুলো,	দৃশ্যগুলো,	
groth,	গ্রোথ,	গ্রোথ,	
makong,	মাজক,	মেকং,	
alkatra,	আলকাত্র,	আলকাতরা,	
edaningkale,	এডানিংকালে,	ইদানীংকালে,	
morodeho,	মরদেহ,	মরদেহ,	
kirti,	কীরটি,	কীর্তি,	
sharthe,	শার্থে,	স্বার্থে,	
agomonke,	আগমনকে,	আগমনকে,	
niketaner,	নিকেতানের,	নিকেতনের,	
sossar,	সোসার,	সকার,	
nachar,	নাচার,	নাচার,	
chereche,	চেরেছে,	ছেড়েছে,	
homshke,	হোমশকে,	হোমসকে,	
shotodha,	শতধা,	শতধা,	
rokibul,	রোিিউল,	রকিবুল,	
engrejer,	এংরেজের,	ইংরেজের,	
reshmirekha,	রেশমেরিখা,	রেশমীরেখা,	
ingrejra,	ইংরেজরা,	ইংরেজরা,	
vaisoho,	ভাইসহ,	ভাইসহ,	
songasthatir,	সংস্থাটির,	সংস্থাটির,	
shloker,	শ্লোকের,	শ্লোকের,	
