shahanara,	শাহানারা,	শাহানারা,	
banglota,	বাংলোটা,	বাংলোটা,	
shasonamoleri,	শাসনমললেরই,	শাসনামলেরই,	
registaner,	রেজিস্টানের,	রেগিস্তানের,	
gabhaaskar,	গভভাস্কার,	গাভাস্কার,	
fanse,	ফ্যান্সে,	ফাঁসে,	
lendl,	লেন্ডল,	লেন্ডল,	
abhidhanick,	অভিভানিত,	অভিধানিক,	
sanghatakder,	সংঘটকদের,	সংঘটকদের,	
soource,	সুউর্সে,	সোর্স,	
blogarra,	ব্লগারা,	ব্লগাররা,	
jackey,	জ্যাক,	জকি,	
charukala,	চারুকালা,	চারুকলা,	
anusthane,	অনুষ্ঠানে,	অনুষ্ঠানে,	
daakteekite,	ডাকটিকিতে,	ডাকটিকিটে,	
shikh,	শিখ,	শিখ,	
dagmukta,	দগবুক্ত,	দাগমুক্ত,	
bhenkates,	ভেঁকাতেস,	ভেঙ্কটেশ,	
saarbhaarti,	সার্ভারটি,	সার্ভারটি,	
asovarno,	অসবররণ্য,	অসবর্ণ,	
alkatra,	আলকাত্রা,	আলকাতরা,	
khonjena,	খোঞজেনা,	খোঁজেনা,	
notti,	নটটি,	নোটটি,	
bhabanipur,	ভবানিপুর,	ভবানীপুর,	
salafeta,	সালাফেটা,	সালফেট,	
gaichey,	গাইছে,	গাইছে,	
daebug,	দাবুদ,	ডিবাগ,	
palkee,	পালকি,	পাল্কি,	
jotsna,	জোস্ন,	জ্যোৎস্না,	
jemy,	জেমি,	জেমি,	
rajyotiro,	রাজ্যতিরও,	রাজ্যটিরও,	
bodhir,	বোধির,	বধির,	
hyaloyin,	হ্যালোয়ন,	হ্যালোইন,	
naitikatavodh,	নৈতিকাতাবোধ,	নৈতিকতাবোধ,	
kampita,	কম্পিতা,	কম্পিত,	
impaction,	ইমপ্যাক্টিন,	ইমপ্যাকশন,	
behrampurer,	বেহরামপুরের,	বহরমপুরের,	
teman,	তেমান,	তেমন,	
karmoi,	কার্মই,	কর্মই,	
kurdider,	কুর্দিদের,	কুর্দিদের,	
sethai,	সেথাই,	সেথাই,	
vaphara,	ভাফারা,	বাফার,	
elakatay,	এলাকাটায়,	এলাকাতে,	
amudey,	আমুদে,	আমুদে,	
aashtikotaa,	আশ্টিকতাও,	আস্তিকতা,	
evaner,	ইভানের,	ইভানের,	
deelibhara,	দিলিভারা,	ডেলিভার,	
charger,	চার্গের,	চার্জার,	
orthanitike,	অর্থানিটিকে,	অর্থনীতিকে,	
ganjana,	গঞ্জনা,	গঞ্জনা,	
dikpal,	ডিক্াল,	দিকপাল,	
baju,	বাজু,	বাজু,	
mugdha,	মুগধা,	মুগ্ধ,	
manushera,	মননুশেরা,	মানুষেরা,	
harris,	হারিস,	হ্যারিস,	
skirt,	স্কিট,	স্কার্ট,	
mandarbani,	মন্দরবাণী,	মন্দারবাণী,	
tuleche,	টুলেছে,	তুলেছে,	
bidyadanke,	বিদ্যাদানকে,	বিদ্যাদানকে,	
shaahaabiike,	শাহাবাইবিকে,	সাহাবীকে,	
gajiipur,	গজিজীরুর,	গাজীপুর,	
foreks,	ফরেক,	ফরেক্স,	
providere,	প্রভিদেরে,	প্রভাইডারে,	
saazano,	সাজানো,	সাজানো,	
haris,	হারিস,	হ্যারিস,	
elahabade,	এলাহাবাদে,	এলাহাবাদে,	
sookkho,	সৌক্ষ,	সুক্ষ্ম,	
suraaropito,	সুরার্পিত,	সুরারোপিত,	
bisshaskey,	বিশ্বাসকে,	বিশ্বাসকে,	
gandharir,	গন্ধারীর,	গান্ধারীর,	
oojbekistan,	উজভেক্সিকান,	উজবেকিস্তান,	
raghubar,	রঘুবার,	রঘুবীর,	
toroonraa,	টরনরার,	তরুণরা,	
mohajot,	মহাজত,	মহাজোট,	
aarik,	আরিক,	আরিক,	
chhooteete,	ছোটটতে,	ছুটিতে,	
dharabahikotitey,	ধারাবাহিকতিতে,	ধারাবাহিকটিতে,	
kings,	কিংস,	কিংস,	
seconder,	সেকন্ডের,	সেকেন্ডের,	
cholochchitratike,	চলচ্চিত্রটিকে,	চলচ্চিত্রটিকে,	
talgachh,	তালগাছ,	তালগাছ,	
shringge,	শ্রিগ্নে,	শৃঙ্গে,	
ashor,	আশোর,	আসর,	
leaders,	লিডার্স,	লিডার্স,	
mozdoor,	মজ্্যুর,	মজদুর,	
hugheke,	হুচেকে,	হিউজকে,	
jamaanor,	জামানোর,	জমানোর,	
bishnu,	বিষ্ণু,	বিষ্ণু,	
ancholsaha,	অঞ্চলসহ,	অঞ্চলসহ,	
shiulijhra,	শিউলিহরা,	শিউলিঝরা,	
nodimaatrik,	নদিমাত্রিক,	নদীমাতৃক,	
qaferderkey,	কাফেরদেরকে,	কাফেরদেরকে,	
bonorajite,	বনরাজিতে,	বনরাজিতে,	
slatgulor,	স্ল্যাটগুলোর,	স্ল্যাটগুলোর,	
akram,	আকরাম,	আকরাম,	
footballerra,	ফুটবললেরাা,	ফুটবলাররা,	
amiya,	আমিয়া,	অমিয়,	
laaisens,	লেইসস্স,	লাইসেন্স,	
maaktoome,	মাক্তমে,	মাকতুম,	
nirikh,	নিরিখ,	নিরিখ,	
mercedes,	মার্সেডস,	মার্সেডেস,	
taffsherer,	টাফারশের,	তাফসীরের,	
kogake,	কোগাকে,	কোগাকে,	
nothivookta,	নথিভ্্ততা,	নথিভুক্ত,	
hooldim,	হুলডিম,	হোল্ডিং,	
madaspushto,	মাদসমুষ্ট,	মদদপুষ্ট,	
everage,	ইভারেজ,	এভারেজ,	
rananganey,	রানাঙ্গানে,	রণাঙ্গনে,	
peri,	পেরি,	পেরি,	
sonaicha,	সোনাইচা,	সোনাইচা,	
natshi,	নাটশি,	নাত্সি,	
daacktickete,	ড্যাক্টেকটিকে,	ডাকটিকিটে,	
parkasa,	পারকাসা,	পার্কস,	
cocaine,	কোকেইন,	কোকেইন,	
somabeshti,	সমাবেশটি,	সমাবেশটি,	
thakeni,	থাকেনি,	থাকেনি,	
baibosthaar,	বৈবস্থার,	ব্যবস্থার,	
oboshore,	অবশরে,	অবসরে,	
bhebechili,	ভেবেছিলি,	ভেবেছিলি,	
refleks,	রেফলেক্স,	রিফ্লেক্স,	
jeshtha,	যেশ্থা,	জ্যেষ্ঠা,	
bikretara,	বিক্রেতরা,	বিক্রেতারা,	
soommo,	সমম্ম,	সুমো,	
panchashjon,	পঞ্চচন্জ,	পঞ্চাশজন,	
tigmanshu,	টিগমানশু,	তিগ্মাংশু,	
carzar,	কার্জার,	চার্জার,	
ameettrakkhor,	আমিত্তরক্ষকর,	অমিত্রাক্ষর,	
ashamorthito,	আসমার্থিত,	অসমর্থিত,	
ispredsiit,	ইসপ্রেডিসটি,	স্প্রেডশীট,	
vaabnake,	ভাবনাকে,	ভাবনাকে,	
orthanitir,	অর্থানিটির,	অর্থনীতির,	
mehsus,	মেহসুস,	মেহসুস,	
bufer,	বুফার,	বাফার,	
jati,	জাতি,	যাতি,	
korley,	করলে,	করলে,	
naraphoka,	নারাফোকা,	নরফোক,	
nothivukto,	নথিভুক্ত,	নথিভুক্ত,	
amontronkarider,	অমন্ত্রনকারীদের,	আমন্ত্রণকারীদের,	
superheroo,	সুপারহহেরো,	সুপারহিরো,	
choudry,	চৌড্রি,	চৌধুরী,	
biprodas,	বিপ্রদাস,	বিপ্রদাস,	
suraropito,	সুরাপরিত,	সুরারোপিত,	
falasrutite,	ফলস্রুটিতে,	ফলশ্রুতিতে,	
falak,	ফালাক,	ফলক,	
dharabahikvabe,	ধারাবাহিকভাবে,	ধারাবাহিকভাবে,	
horas,	হোরাস,	হোরাস,	
laagche,	লাগছে,	লাগছে,	
bapokotor,	বাপকতর,	ব্যাপকতর,	
chopol,	চপল,	চপল,	
somosto,	সমস্ত,	সমস্ত,	
keu,	কেউ,	কেউ,	
dipon,	ডিপন,	দীপন,	
mast,	ম্যাস্ট,	মাস্ত,	
ohalyar,	ওহালগর,	অহল্যার,	
talaa,	তালা,	তালা,	
fud,	ফুড,	ফুড,	
ghotleyo,	ঘটলেও,	ঘটলেও,	
bishshasho,	বিশ্বাশ,	বিশ্বাসও,	
plate,	প্লেট,	প্লেটে,	
karmake,	কারমাকে,	কর্মকে,	
jeebonnogor,	জীবননগর,	জীবননগর,	
akhhunno,	অখুন্ন,	অক্ষুণ্ণ,	
lubitz,	লুবিটজ,	লুবিৎজ,	
patininda,	পতিনিন্দা,	পতিনিন্দ,	
matrirup,	মাতৃরূপ,	মাতৃরূপ,	
vishnuu,	বিশ্ণু,	বিষ্ণু,	
shrichaitanyadev,	শ্রীচারনন্তিবাদ,	শ্রীচৈতন্যদেব,	
arshie,	আরশিই,	আরসিএ,	
doltyagi,	দলত্যাগী,	দলত্যাগী,	
rilayensa,	রিলায়েন্সা,	রিলায়েন্স,	
punorabortonte,	পুনরোবর্তন্তে,	পুনরাবর্তন্তে,	
geejeeteeda,	গিজিতা,	গেজেটেড,	
tiger,	টিগের,	টাইগার,	
bulano,	বুলানো,	বুলান,	
ashirbadatri,	অশির্বাদততরী,	আশীর্বাদাত্রী,	
bonsho,	বনশো,	বংশ,	
shrabasti,	শ্রাবস্তি,	শ্রাবস্তী,	
hughes,	হুগেশ,	হিউজেস,	
erokomer,	এরকোমের,	এরকমের,	
jyaqa,	জ্যাকা,	জ্যাক,	
pader,	পাদের,	প্যাডের,	
bishesyo,	বিশেষ্য,	বিশেষ্য,	
baet,	বেইট,	বাইট,	
batikromee,	বাতিক্যময়,	ব্যতিক্রমী,	
gate,	গ্যাট,	গ্যেটে,	
agomone,	আগমমোন,	আগমনে,	
tenishe,	তেনিশে,	টেনিসে,	
alraji,	আল্াজি,	আলরাজী,	
palta,	পালটা,	পালটা,	
sobrakamer,	সব্রকামের,	সবরকমের,	
horiddar,	হরিদ্দার,	হরিদ্বার,	
planea,	প্লানেয়,	প্লেনে,	
hansasya,	হাঁসাসয়,	হংসস্য,	
bondhukey,	বন্ধুকে,	বন্ধুকে,	
stoonahenja,	স্টোউনাঞ্জে,	স্টোনহেঞ্জ,	
balakarak,	বালাকারক,	বলকারক,	
mekapgulo,	মেকাপগুলো,	মেকআপগুলো,	
remacri,	রিমাক্রি,	রেমাক্রী,	
dera,	ডিরাআ,	ডেরা,	
protibedokrao,	প্রতিবেদকারও,	প্রতিবেদকরাও,	
moorali,	মোরালি,	মুরলী,	
chalachchitrei,	চলচ্চিত্রেই,	চলচ্চিত্রেই,	
shringa,	শ্রিঙ্গা,	শৃঙ্গ,	
bibhinno,	বিভিন্ন,	বিভন্ন,	
bhaisaho,	ভাইসহ,	ভাইসহ,	
drishi,	দৃশি,	দৃশ্যই,	
dhadhiye,	ধাধিয়ে,	ধাধিয়ে,	
dibate,	দিবাতে,	ডিবেট,	
nathivookto,	নাথিভক্ত,	নথিভুক্ত,	
dweepgoolotey,	দ্বিপপল্লোতে,	দ্বীপগুলোতে,	
shkalarashhipa,	শ্কালারাশিপ,	স্কলারশিপ,	
nimitte,	নিমিট্তে,	নিমিত্তে,	
katateo,	কাটাতেও,	কাটাতেও,	
asabhya,	অসাভ্য,	অসভ্য,	
bipradas,	বিপ্রাাস,	বিপ্রদাস,	
zubokder,	যুবকদের,	যুবকদের,	
directarate,	ডিরেক্টরাতে,	ডিরেক্টরেট,	
cena,	সেনা,	সিনা,	
abosan,	অবসান,	অবসান,	
ongshogrohoner,	অংশগ্রহণের,	অংশগ্রহনের,	
meghachchanno,	মেঘচঞ্চান্ন,	মেঘাচ্ছন্ন,	
cheef,	চিফ,	শেফ,	
milea,	মিলেয়া,	মাইলে,	
cholochchitraeeo,	চলচ্চিত্রায়,	চলচ্চিত্রেও,	
karir,	কারির,	কারীর,	
antercticker,	অ্যান্টারক্টাকের,	অ্যান্টার্কটিকের,	
joumana,	যৌমানা,	জুমানা,	
plasse,	প্লাসে,	প্লাসে,	
nartana,	নার্তানা,	নর্টন,	
bisshasi,	বিশ্বাসী,	বিশ্বাসী,	
assaciates,	অ্যাসাসাইটেস,	এসোসিয়েটস,	
poriharsoho,	পরিহারসহ,	পরিহারসহ,	
pratista,	প্রতিষ্টা,	প্রতিষ্টা,	
sotorkobhabey,	সতর্কভাবে,	সতর্কভাবে,	
confliqt,	কনফ্লিক্ট,	কনফ্লিক্ট,	
sepha,	সেফা,	শেফ,	
sthapona,	স্থাপনা,	স্থাপনা,	
supplenza,	সাপপলাজ্যান,	সাপলেঞ্জা,	
asamanyo,	অসামন্য,	অসামান্য,	
ponero,	পনেরও,	পনের,	
smarok,	স্মারক,	স্মারক,	
gardeen,	গার্ডিন,	গার্ডেন,	
orunima,	অরুনিমা,	অরুণিমা,	
ponjikar,	পঞ্জিকার,	পঞ্জিকার,	
megh,	মেঘ,	মেঘ,	
dristiheen,	দৃষ্টিহীন,	দৃষ্টিহীন,	
siropa,	সিরোপা,	শিরোপা,	
abti,	আবটি,	আবতি,	
bisheshshyer,	বিশেষ্য্যের,	বিশেষ্যের,	
varote,	ভারোতে,	ভারতে,	
maarmaader,	মারমাদের,	মারমাদের,	
hafej,	হাফেজ,	হাফেয,	
rudroke,	রুদ্রকে,	রুদ্রকে,	
acrolect,	অ্যাক্রোলেক্ট,	অ্যাক্রোলেক্ট,	
direqtareta,	ডিয়েরেক্টরটি,	ডিরেক্টরেট,	
raia,	রাইয়া,	রায়,	
ganohotyake,	গণহত্যকাকে,	গণহত্যাকে,	
pleena,	প্লিনা,	প্লেন,	
nathivukteer,	নাথিভুক্তির,	নথিভুক্তির,	
ingreziteo,	ইংরেজিতেও,	ইংরেজিতেও,	
krush,	ক্রুশ,	ক্রুশ,	
bojiye,	বজিয়ে,	বজিয়ে,	
backflipe,	ব্যাক্সল্পে,	ব্যাকফ্লিপে,	
zozyota,	যজ্যতা,	যোজ্যতা,	
medilek,	মেডিলেক,	মেডিলেক,	
ancholgoolir,	অঞ্চলগুলির,	অঞ্চলগুলির,	
proshadhoner,	প্রশাধনের,	প্রসাধনের,	
angibhutovabe,	অঙ্গিভাতভাবে,	অঙ্গীভূতভাবে,	
video,	ভিডিও,	ভিডিয়োও,	
satan,	সাতান,	শয়তান,	
rastagulikeo,	রাস্তাগুলিকেও,	রাস্তাগুলিকেও,	
shtona,	শ্তনা,	স্টোন,	
kharavel,	খারাভেল,	খারবেল,	
tateo,	টাতেও,	তাতেও,	
shanno,	শান্ন,	সান্নো,	
shunani,	শুনানি,	শুনানী,	
abdoone,	আব্যোন,	আবদুন,	
gandhariir,	গন্ধারীর,	গান্ধারীর,	
kanasarabheeshana,	কানাসর্রীসন,	কনসারভেশন,	
sangharshik,	সংশথর্িক,	সাংঘর্ষিক,	
seqtara,	সেক্তারা,	সেক্টর,	
porjotoker,	পর্যটকের,	পর্যটকের,	
protijogiider,	প্রতিযোগীদের,	প্রতিযোগীদের,	
pratisthanik,	প্রতিষ্ঠানিক,	প্রাতিষ্ঠানিক,	
crashlands,	ক্রাস্টাযান্ডস,	ক্র্যাশল্যান্ডস,	
ala,	আলা,	আলা,	
kailashrao,	কৈলশ্রাও,	কৈলাশরাও,	
jolbe,	জলবে,	জ্বলবে,	
bopoon,	বপুন,	বপন,	
mukhomandaley,	মুখমম্ডলে,	মুখমণ্ডলে,	
osthishondhi,	অস্থিসন্ধি,	অস্থিসন্ধি,	
kirke,	কিরকে,	কিরকে,	
janagononar,	জনগোননার,	জনগণনার,	
modhyekar,	মধ্যেকার,	মধ্যেকার,	
oncholshomuher,	অঞ্চলসমূহের,	অঞ্চলসমূহের,	
bandi,	বাঁদি,	বন্দী,	
dephinishion,	ডিফিনেশন,	ডেফিনেশন,	
vejjanno,	বেজজন্যান,	ভেজানো,	
qarlosa,	কারলোসা,	কার্লোস,	
chhintayikari,	ছিন্তারিকারী,	ছিনতাইকারী,	
dhanijomite,	ধনিজমমিতে,	ধানিজমিতে,	
patrol,	পাত্রল,	পেট্রোল,	
dormetori,	ডর্মেতরি,	ডরমিটরি,	
azaan,	আজান,	আজান,	
juktorastrer,	যুক্তরসস্ত্রের,	যুক্তরাষ্ট্রের,	
kormobuddhite,	কর্মবিদ্ধুতে,	কর্মবুদ্ধিতে,	
ummool,	উম্মুল,	উম্মুল,	
parisankhanvid,	পরিসংখ্যান্দিদ,	পরিসংখ্যানবিদ,	
futote,	ফুটোতে,	ফুটোতে,	
hevy,	হেভি,	হেভি,	
aviyojan,	অভিযয়াজন,	অভিযোজন,	
harbore,	হারবোরে,	হারবারে,	
kaansaat,	কাঁসাত,	কানসাট,	
sheets,	শিটস,	শীটস,	
farhetin,	ফারহেটিন,	ফারহেতিন,	
prakar,	প্রকার,	প্রকার,	
saarbharti,	সার্ভাত্তি,	সার্ভারটি,	
nirmol,	নির্মল,	নির্মল,	
tennys,	টেনিস,	টেনিস,	
forma,	ফোর্মা,	ফর্মা,	
dovaar,	ডোভার,	ডোভার,	
promodwara,	প্রমোদ্বারা,	প্রমদ্বারা,	
samajikotar,	সমাজিকতার,	সামাজিকতার,	
landin,	ল্যান্ডিন,	ল্যান্ডিং,	
dombhoke,	দম্ভকে,	দম্ভকে,	
booponer,	বুপনের,	বপনের,	
heteler,	হেটেলের,	হেটেলের,	
bipti,	বিপটি,	বিপ্তি,	
bisnoo,	বিস্নও,	বিষ্ণু,	
holding,	হোল্ডিং,	হোল্ডিং,	
sohokari,	সহকারী,	সহকারী,	
kayartara,	কায়ারটারা,	কোয়ার্টার,	
bishwaashshke,	বিশ্বাসককে,	বিশ্বাসকে,	
uchchotara,	উচ্চতারা,	উচ্চতর,	
chirantan,	চিরান্তন,	চিরন্তন,	
elaakati,	এলাকাটি,	এলাকাটি,	
korimkey,	করিমকে,	করিমকে,	
agaldar,	আগালদার,	আগলদার,	
hank,	হাঁক,	হাঙ্ক,	
chalochchitraeer,	চলচ্চিত্রায়ার,	চলচ্চিত্রের,	
aaeerese,	আইয়ারেস,	আইরেসে,	
ghurte,	ঘুরতে,	ঘুরতে,	
bishshaasho,	বিশ্বাশ,	বিশ্বাসও,	
tookror,	টুক্রর,	টুকরোর,	
airish,	আইরিশ,	আইরিস,	
maail,	মাইল,	মাইল,	
dubureer,	দুবুরীর,	ডুবুরির,	
nothibhukto,	নথিভুক্ত,	নথিভুক্ত,	
blacq,	ব্ল্যাক,	ব্ল্যাক,	
dhhaloor,	ঢালোর,	ঢালুর,	
jaunotar,	যৌনতার,	যৌনতার,	
subader,	সুবাদের,	সুবাদে,	
gratha,	গ্রাথা,	গ্রোথ,	
edic,	এডিসি,	এডিক,	
sarder,	সার্দের,	সরদার,	
patishapta,	পািতাসপত,	পাটিসাপটা,	
boudher,	বৌধের,	বৌদ্ধের,	
inziniyarsa,	ইনজিজিনারসা,	ইঞ্জিনিয়ার্স,	
buddhitii,	বুদ্ধিতই,	বুদ্ধিটিই,	
nirgomon,	নির্মোন,	নির্গমন,	
polashir,	পোলাশির,	পলাশীর,	
cheenja,	চিঞ্জা,	চেঞ্জ,	
cholocchitrer,	চলচ্িত্রের,	চলচ্চিত্রের,	
sqalastiqa,	স্কালাস্কিত,	স্কলাস্টিক,	
karmazog,	কার্মোগোগ,	কর্মযোগ,	
dipke,	ডিপকে,	দ্বীপকে,	
soomita,	সমমিতা,	সুমিতা,	
kode,	কোদে,	কোড,	
pulivendla,	পুলিভেন্ডলা,	পুলিভেন্ডলা,	
graminphonor,	গ্রামিংসননোর,	গ্রামীণফোনর,	
uzobekeestaan,	উজোবেকাস্তান,	উজবেকিস্তান,	
feemalee,	ফিমালে,	ফিমেল,	
roopmatro,	রূগমাত্র,	রূপমাত্র,	
songkulan,	সংকুলান,	সংকুলান,	
soolke,	সুলকে,	শুল্কে,	
courtcaser,	ক্র্টাকস্সের,	কোর্টকেসের,	
scholastik,	স্কলসাস্তিক,	স্কলাস্টিক,	
sharifpur,	শরিফপুর,	শরিফপুর,	
chakundite,	চাকুন্দিতে,	চাকুন্দিতে,	
byatikrami,	ব্যতিক্রমা,	ব্যতিক্রমী,	
dokan,	ডোকান,	দোকান,	
prakalpoguli,	প্রকাতলগগুলি,	প্রকল্পগুলি,	
raunanganey,	রৌননগানে,	রণাঙ্গনে,	
probeshkari,	প্রবেষকারী,	প্রবেশকারী,	
sima,	সিমা,	সীমা,	
moomtaj,	মৌমটাজ,	মুমতাজ,	
chaalkee,	চালকি,	চালকে,	
mausumeo,	মাসুমেও,	মৌসুমেও,	
temonvabe,	টেমোভাবে,	তেমনভাবে,	
muhuriganj,	মুহুরিগঞ্জ,	মুহুরীগঞ্জ,	
nothibhukteer,	নথিভুক্তির,	নথিভুক্তির,	
nirgoon,	নিরগোন,	নির্গুণ,	
pabo,	পাবো,	পাব,	
bosante,	বসান্তে,	বসন্তে,	
shrimoti,	শ্রীমতি,	শ্রীমতি,	
deool,	ডেওল,	দেউল,	
nek,	নেক,	নেক,	
janar,	জানার,	জানার,	
choudhursoho,	চৌধুরসহ,	চৌধুরসহ,	
anchalsaho,	অঞ্চলসহ,	অঞ্চলসহ,	
nichupattir,	নিচুৎপতির,	নিচুপট্টির,	
obhaarbhiu,	ওভারভি,	ওভারভিউ,	
juktorashtreo,	যুক্তরাষ্ট্রেও,	যুক্তরাষ্ট্রেও,	
societykey,	সোসিকটিকে,	সোসাইটিকে,	
bishasey,	বিশাসে,	বিশ্বাসে,	
kyathlik,	ক্যাথলিক,	ক্যাথলিক,	
ishtone,	ইষ্টনে,	স্টোন,	
tookrokey,	টুক্রকে,	টুকরোকে,	
manabmaner,	মানবম্যানের,	মানবমনের,	
phokser,	ফোকসের,	ফক্সের,	
sondhisthaponer,	সন্ধিস্থাপনের,	সন্ধিস্থাপনের,	
mardud,	মারদুদ,	মরদুদ,	
sanaktakaran,	সনক্তকরণ,	সনাক্তকরণ,	
braqe,	ব্রাকে,	ব্রেক,	
dormitory,	ডরমিটরি,	ডরমিটরি,	
kiuti,	কিউটি,	কিউটি,	
heavy,	হেভি,	হেভি,	
probolshoktio,	প্রবলসক্তিও,	প্রবলশক্তিও,	
ganoparibahaner,	গণপরিবহহননের,	গণপরিবহনের,	
chatrorai,	চাত্ররাই,	ছাত্ররাই,	
dojo,	দোজো,	ডোজো,	
kleentoner,	ক্লিনটনের,	ক্লিনটনের,	
tricksguli,	ট্রিকসগুলি,	ট্রিকসগুলি,	
machkabar,	মাচকাবার,	মাচকাবার,	
adorso,	আদরসো,	আর্দশ,	
kormyi,	কর্মই,	কর্মই,	
moonshi,	মোনশি,	মুন্সি,	
eporjonto,	এপর্যন্ত,	এপর্যন্ত,	
katui,	কাটুই,	কাতুই,	
dinifitian,	ডিনিফিইজেশন,	ডেফিনেশন,	
black,	ব্ল্যাক,	ব্ল্যাক,	
alexandar,	আলেক্সান্দ্র,	আলেকজান্ডার,	
saamaanya,	সমমন্য,	সামান্য,	
baipash,	বাইপাশ,	বাইপাস,	
irana,	ইরানা,	ইরান,	
chemjong,	চেমজং,	চেমজং,	
hozot,	হজট,	হজত,	
mele,	মেলে,	মাইল,	
monzushree,	মঞ্জুশ্রী,	মঞ্জুশ্রী,	
chhatrodiger,	ছাত্রদিগের,	ছাত্রদিগের,	
badhamuktovabe,	বাধামুক্তভাবে,	বাধামুক্তভাবে,	
carlos,	কার্লোস,	কার্লোস,	
orbeet,	অরবিট,	অরবিট,	
sadeep,	সদদিপ,	সদীপ,	
ddebet,	ডিবেট,	ডিবেট,	
jansa,	জানসা,	জন্স,	
korimer,	করিমের,	করিমের,	
mononiitoder,	মনোনিইতদের,	মনোনীতদের,	
bahjya,	বাহজায়,	বাহ্য,	
asommoti,	অসম্মতি,	অসম্মতি,	
uporoshtho,	উপরস্থ,	উপরস্থ,	
khalidke,	খালিদকে,	খালিদকে,	
sangsakti,	সংস্কটি,	সংসক্তি,	
dhanyi,	ধননই,	ধন্যি,	
jounotar,	যৌনতার,	যৌনতার,	
licenshe,	লিইসেন্স,	লাইসেন্স,	
utpotti,	উৎপত্তি,	উতপত্তি,	
modele,	মডেলে,	মডেলে,	
dokanei,	ডোকানেই,	দোকানেই,	
chire,	চিরে,	চিরে,	
kourabe,	কৌরবে,	কৌরবে,	
ovidhaner,	অভিধানের,	অভিধানের,	
nick,	নিক,	নিক্,	
uparjoner,	উপারজনের,	উপার্জনের,	
byatari,	ব্যাতারি,	ব্যাটারী,	
vitti,	ভিত্তি,	ভিত্তিই,	
ponchashjon,	পঞ্চাশজন,	পঞ্চাশজন,	
chenza,	চেঞ্জা,	চেঞ্জ,	
konorup,	কোনরূপ,	কোনরূপ,	
hijritey,	হিজ্রিতে,	হিজরীতে,	
tolemy,	টলেমি,	টলেমির,	
orbi,	অর্বি,	ওরবি,	
ganoporibahon,	গণপরিবহন,	গণপরিবহন,	
sector,	সেক্টর,	সেক্টর,	
madeling,	মেডেলিং,	মডেলিং,	
mag,	মাগ,	এমএজি,	
laiseensee,	লাইসিনসে,	লাইসেন্স,	
remission,	রেমিসন,	রিমিশন,	
bedantodhormo,	বেদনততধর্ম,	বেদান্তধর্ম,	
dorgaaho,	দোরগাহ,	দরগাহ,	
orhan,	অরহান,	ওরহান,	
chyeta,	চ্যেটা,	চ্যাট,	
sumita,	সুমিতা,	সুমিতা,	
vesselli,	ভেসেলি,	ভেসেলি,	
pleta,	প্লেটা,	প্লেটো,	
inphormeshon,	ইনশ্রমেশন,	ইনফরমেশন,	
ghotol,	ঘটটল,	ঘটল,	
nowel,	নোডেল,	নভেল,	
disni,	ডিসনি,	ডিজনী,	
taufiq,	তাফিক,	তৌফিক,	
deobonde,	ডিওবন্ডে,	দেওবন্দে,	
sarbhare,	সরভারে,	সার্ভারে,	
siddhantoke,	সিদ্ধান্তকে,	সিদ্ধান্তকে,	
bheenisa,	ভেনিসা,	ভেনিস,	
judge,	জুডলে,	জাজ,	
salmanul,	সালমানুল,	সালমানুল,	
deh,	দেহ,	দেহ্,	
raiji,	রাইজি,	রাইজি,	
poschime,	পশ্চিমে,	পশ্চিমে,	
senabahinikey,	সেনাবিহীনীকে,	সেনাবাহিনীকে,	
poorohitra,	পৌরহিত্রার,	পুরোহিতরা,	
nabyata,	নব্যতা,	নাব্যতা,	
grushko,	গ্রুষকো,	গ্রুশকো,	
bii,	বিইই,	বি,	
mousumeo,	মৌসুমেও,	মৌসুমেও,	
said,	সাইদ,	সাইদ,	
bojata,	বোজাতা,	বোজাটা,	
gotirodh,	গতিরোধ,	গতিরোধ,	
shudden,	শুদ্দেন,	সাডেন,	
dhyanastha,	ধ্যানস্থা,	ধ্যানস্থ,	
chhutochhooti,	ছুটোঘুটি,	ছুটোছুটি,	
ghatiti,	ঘটিটি,	ঘাঁটিটি,	
ukeliptash,	উকেলিপ্তাস,	ইউক্যালিপ্টাস,	
arsie,	আর্সি,	আরসিএ,	
heerani,	হিরানি,	হিরানি,	
sooya,	সৌয়া,	সোয়া,	
pratisthanikvabe,	প্রতিষ্ঠানিকভাবে,	প্রাতিষ্ঠানিকভাবে,	
associatis,	অ্যাসোসিয়ারিসিস,	এসোসিয়েটস,	
sheshardhe,	শেষার্ধে,	শেষার্ধে,	
sanaktokaron,	সানক্তকরণ,	সনাক্তকরণ,	
amarjito,	আমারজিত,	অমার্জিত,	
shangsthatikey,	শংস্থাতিকে,	সংস্থাটিকে,	
nederlande,	নেডারল্যান্ডে,	নেদারল্যান্ডে,	
icelands,	আইকেল্্যান্ড,	আইসল্যান্ডসহ,	
shilver,	শিলভের,	সিলভার,	
kanader,	কানাদের,	কণাদের,	
bhaangchur,	ভাংচুর,	ভাংচুর,	
jibnagore,	জীবনাগরে,	জীবননগর,	
licencer,	লিইসেন্সের,	লাইসেন্সের,	
pujito,	পুজিত,	পুজিত,	
gabinius,	গ্বিনিয়াস,	গাবিনিআস,	
mosjidsoho,	মসজিদসহ,	মসজিদসহ,	
oitijje,	ঐতিজ্যে,	ঐতিহ্যে,	
fishing,	ফিশিং,	ফিসিং,	
sylvi,	সালভি,	সিলভি,	
orgho,	অর্ঘ,	অর্ঘ্য,	
suisharke,	সুশৈরকে,	সুইশারকে,	
nehle,	নেহলে,	নেহলে,	
beekaargrasta,	বিকারগ্রাস্ত,	বিকারগ্রস্ত,	
bhenicer,	ভেনিসের,	ভেনিসের,	
bulichev,	বুলিছেব,	বুলিচেভ,	
abhidhaaneeck,	অভিধানয়ক,	অভিধানিক,	
toxoid,	টক্সোড,	টক্সয়েড,	
srivatsalakshanang,	শ্রীবাক্ষাম্্্াং,	শ্রীবৎসলক্ষণং,	
afrazuler,	আফরাজুলের,	আফরাজুলের,	
lotharan,	লথারান,	লুথেরান,	
musalmanderke,	মুসলম্নেদ্রকে,	মুসলমানদেরকে,	
browser,	ব্রোরসের,	ব্রাউজার,	
aamor,	আমোর,	আমর,	
kakhnoba,	কাখবাা,	কখনওবা,	
stoic,	স্টোইক,	স্টোয়িক,	
shahoshikatar,	শহশিকতার,	সাহসিকতার,	
baipass,	বাইপাসস,	বাইপাস,	
chaalaabi,	চালাবি,	চালাবে,	
taderek,	তাদেরেক,	তাদেরেক,	
pravritir,	প্রবৃতির,	প্রভৃতির,	
bharpur,	ভারপুর,	ভরপুর,	
bondishalatei,	বন্দিশালততেই,	বন্দিশালাতেই,	
rajtontre,	রাজতন্ত্রে,	রাজতন্ত্রে,	
janoganonar,	জনগোননার,	জনগণনার,	
musolmanera,	মুসোলমানেরা,	মুসলমানেরা,	
innahu,	ইনহানু,	ইন্নাহু,	
ishter,	ইশতের,	ইস্টের,	
aakkas,	আক্সাস,	আককাস,	
graambaaseeo,	গ্রামবাসিয়া,	গ্রামবাসীও,	
krus,	ক্রুস,	ক্রুশ,	
ministara,	মিনিস্তারা,	মিনিস্টার,	
digreeke,	দিগ্রিকে,	ডিগ্রিকে,	
jerusalemer,	জেরসসলামের,	জেরুজালেমের,	
qonflict,	কনফ্লিক্ট,	কনফ্লিক্ট,	
punosthaner,	পুনস্থানের,	পুনঃস্থানের,	
eukalyptus,	ইউকাল্ডগুস,	ইউক্যালিপ্টাস,	
bandra,	ব্যান্ড্রা,	বন্দীরা,	
hoteltite,	হোটেলটিতে,	হোটেলটিতে,	
drissotir,	দৃষ্টির,	দৃশ্যটির,	
nagorikke,	নাগরিককে,	নাগরিককে,	
halding,	হ্যালিং,	হোল্ডিং,	
deputee,	দেপুতে,	ডেপুটি,	
saseza,	সাসেজা,	সসেজ,	
daakten,	ডাকতেন,	ডাকতেন,	
diiptii,	দিইপটিই,	ডেপুটি,	
magical,	ম্যাজিকাল,	ম্যাজিকাল,	
peeri,	পিরি,	পেরি,	
shainyader,	শৈন্যদের,	সৈন্যদের,	
borkhastokritora,	বর্কাস্তকৃতারা,	বরখাস্তকৃতরা,	
kinsha,	কিনশা,	কিংস,	
uporitoler,	উপরিতলের,	উপরিতলের,	
koordira,	কোর্ডিরা,	কুর্দিরা,	
gudamjat,	গুদামজাত,	গুদামজাত,	
olympik,	অলিপ্পিক,	অলিম্পিক,	
bhuushito,	ভূষিত,	ভূষিত,	
dong,	ডং,	ডং,	
ankanshilpe,	অঙ্কাশশিল্পে,	অঙ্কনশিল্পে,	
teunar,	টেউনার,	টিউনার,	
serveray,	সারভারেও,	সার্ভারে,	
bisshonath,	বিশ্বনাথ,	বিশ্বনাথ,	
duple,	ডাপল,	ডুপ্লে,	
rotheen,	রোথিন,	রথীন,	
dighol,	দিঘল,	দীঘল,	
masjidke,	মাসজিদকে,	মসজিদকে,	
bitlaser,	বিতলাসের,	বিটলসের,	
playtey,	প্লেই,	প্লেটে,	
with,	উইত,	ভিত,	
biswashi,	বিশ্বাশি,	বিশ্বাসই,	
soinyora,	সৈন্যরা,	সৈন্যরা,	
sayatana,	সায়াতানা,	শয়তান,	
ritesh,	রিটেশ,	রিতেশ,	
chikittsar,	চিকিৎসার,	চিকিত্সার,	
obosorer,	অবসরের,	অবসরের,	
dinar,	দিনার,	ডিনার,	
jamkaalo,	জামকালো,	জমকালো,	
pharmesigulote,	ফার্মেসগুলিতে,	ফার্মেসীগুলোতে,	
somraatder,	সমরাত্রদের,	সম্রাটদের,	
mohajote,	মহাযোতে,	মহাজোট,	
ponchaashjon,	পঞ্চাচ্যজন,	পঞ্চাশজন,	
keuoi,	কেওয়,	কেউই,	
parijaner,	পরিজানের,	পরিজনের,	
uindoos,	উইনডোস,	উইন্ডোস,	
osamanno,	অসামান্য,	অসামান্য,	
khilaphat,	খিলাফাত,	খিলাফত,	
morodeho,	মরদেখো,	মরদেহ,	
borlen,	বরলেন,	বরলেন,	
ghoomachhe,	ঘোমাচেছে,	ঘুমাচ্ছে,	
shahabike,	শাহাবিকে,	সাহাবীকে,	
ghoomato,	গমমত,	ঘুমাতো,	
croak,	ক্রয়ক,	ক্রোক,	
heelser,	হেলসের,	হিলসের,	
residence,	রেসিডেন্সে,	রেসিডেন্স,	
meghacchonno,	মেঘাচ্ছন্ন,	মেঘাচ্ছন্ন,	
prokolpotike,	প্রকল্পটিকে,	প্রকল্পটিকে,	
ooporoshtho,	অপসর্থ,	উপরস্থ,	
boiporiityen,	বৈপরিত্যেন,	বৈপরীত্যেন,	
bikromei,	বিক্রমেই,	বিক্রমেই,	
shajano,	শাজানো,	সাজানো,	
indrani,	ইন্দ্রাণী,	ইন্দ্রাণী,	
khappar,	খাপপার,	খপ্পর,	
unitgulo,	ইউনিটগুলো,	ইউনিটগুলো,	
kram,	ক্রাম,	ক্রম,	
bosontoke,	বসন্তকে,	বসন্তকে,	
uthaney,	উঠানে,	উঠানে,	
ekla,	একলা,	একলা,	
purohitra,	পুরোহিত্র,	পুরোহিতরা,	
dorgah,	দোরগাহ,	দরগাহ,	
nirarthak,	নিরা্থক,	নিরর্থক,	
bohorompurer,	বহরমপুরের,	বহরমপুরের,	
gondogol,	গণ্ডগল,	গন্ডগোল,	
sahojlovyotar,	সহযোগ্যতার,	সহজলভ্যতার,	
manushsoho,	মনুষসহ,	মানুষসহ,	
bejiye,	বেজিয়ে,	বেজিয়ে,	
chhotogolper,	ছোটোগ্পের,	ছোটগল্পের,	
hert,	হার্ট,	হার্ট,	
bongshokey,	বংশকে,	বংশকে,	
rachanakal,	রচনাকাল,	রচনাকাল,	
eesa,	ইসাএএ,	আইএএস,	
pravura,	প্রভুরা,	প্রভুরা,	
durtomo,	দুর্তম,	দূরতম,	
obhijojan,	অভিযোজন,	অভিযোজন,	
gosthike,	গোষ্ঠিকে,	গোষ্ঠীকে,	
tuni,	টুনি,	টুনি,	
spredasita,	স্প্রেডসাটিটা,	স্প্রেডশীট,	
rushod,	রুশোদ,	রুশদ,	
terlarang,	টের্লারাং,	তেরলারং,	
baire,	বাইরে,	বাইরে,	
ganochien,	গণছেইন,	গণচীন,	
fiksing,	ফিকসিং,	ফিক্সিং,	
sadbi,	সাদবি,	সাধ্বী,	
guzober,	গুজবের,	গুজবের,	
krom,	ক্রম,	ক্রম,	
marketing,	মার্কেটিং,	মার্কেটিং,	
bokahoke,	বকাহকে,	বকাহকে,	
taroni,	তারোনি,	তরণী,	
jatata,	জাতাতা,	যতোটা,	
susamo,	সুসামো,	সুসম,	
elakaate,	এলাকাতে,	এলাকাতে,	
paroner,	প্যারোনের,	পারণের,	
prabhritite,	প্রভৃতিতে,	প্রভৃতিতে,	
bhandti,	ভাঁডটি,	ভাণ্ডটি,	
srk,	শাক্ক,	শাহরুখ,	
kholdhular,	খোলধুলার,	খোলধূলার,	
qirq,	কার্ক,	কার্ক,	
pratool,	প্রতোল,	প্রতুল,	
kkhur,	ক্ষুর,	ক্ষুর,	
pray,	প্রায়,	প্রায়,	
hurricane,	হুরিকেন,	হ্যারিকেন,	
sontoshpur,	সন্তশ্পুর,	সন্তোষপুর,	
paste,	পাস্টে,	পেষ্ট,	
songkoloney,	সংকোলনে,	সংকলনে,	
comoros,	কমোরোস,	কোমোরোস,	
awrbit,	আব্বিত,	অরবিট,	
janamukhi,	জননমুখী,	জনমুখী,	
abheedhaaneek,	অভিধানীক,	অভিধানিক,	
sofie,	সফি,	সোফি,	
sommotitey,	সম্মতিতে,	সম্মতিতে,	
nadike,	নাদিকে,	নদীকে,	
europia,	ইউরোপিয়া,	ইউরোপিয়া,	
chalochchitrei,	চালচ্চিত্রেই,	চলচ্চিত্রেই,	
rajyabhogi,	রাজ্যভাগী,	রাজ্যভোগী,	
jyesttha,	জ্যেষ্ঠা,	জ্যেষ্ঠা,	
echhti,	এচটি,	এছটি,	
dhaleshorii,	ধালেশরেই,	ধলেশ্বরী,	
maailkhanek,	মাইলখানেক,	মাইলখানেক,	
bosano,	বসানো,	বসানো,	
boiragirhat,	বৈরাগীরহাট,	বৈরাগিরহাট,	
swatantrata,	স্বততন্ত্রতা,	স্বতন্ত্রতা,	
drissogulote,	দৃশ্যগুলোতে,	দৃশ্যগুলোতে,	
tokeo,	টককও,	টোকেও,	
daaradaa,	দারাদা,	দারদা,	
tata,	তাতা,	তাতা,	
gaziipur,	গজিজিরুর,	গাজীপুর,	
shilbar,	শিলবার,	সিলভার,	
land,	ল্যান্ড,	ল্যান্ড,	
bisheshya,	বিশেষ্য,	বিশেষ্য,	
themekey,	থেমেকেও,	থিমকে,	
chhadura,	ছাদুরা,	ছাদুরা,	
primoo,	প্রিমোও,	প্রিমো,	
shikkharrthirao,	শিক্ষার্থ্যারও,	শিক্ষার্থীরাও,	
niroja,	নিরোজা,	নিরোজা,	
byabosthar,	ব্যবস্থার,	ব্যবস্থার,	
detik,	দেটিক,	দেতিক,	
dharmiyabhabei,	ধর্মিয়াভাবেই,	ধর্মীয়ভাবেই,	
america,	আমেরিকা,	আমেরিকা,	
jones,	জনেস,	জোন্স,	
ajeem,	আজিম,	আজিম,	
ceramicsh,	সেরামিকস,	সিরামিকস,	
peshto,	পেশতো,	পেষ্ট,	
onurbar,	অনুব্বার,	অনুর্বর,	
shiqara,	শিকারা,	শিকার,	
shikhra,	শিখরা,	শিখরা,	
dakteekiter,	ডাকটিকিতের,	ডাকটিকিটের,	
salapheeta,	সালাফিতা,	সালফেট,	
naazee,	নাজি,	নাত্সি,	
nachiketa,	নাচিকেটা,	নচিকেতা,	
iraner,	ইরানের,	ইরানের,	
jeelyaand,	জিল্যান্ড,	জিল্যান্ড,	
totokhon,	তৈটখন,	ততক্ষন,	
adorsho,	আদর্শ,	আর্দশ,	
cloring,	ক্লোরিং,	ক্লোরিং,	
bhushito,	ভূষিত,	ভূষিত,	
windo,	উইন্ডো,	উইন্ডো,	
chheher,	ছেহের,	ছেহের,	
ajeeboner,	আজিবনের,	আজীবনের,	
gazetted,	গেজেট্টেড,	গেজেটেড,	
ranangone,	রানাঙ্গনে,	রণাঙ্গনে,	
nobotomo,	নবতম,	নবতম,	
shilpojaat,	শিল্পজাত,	শিল্পজাত,	
jegulur,	জেগুলুর,	যেগুলুর,	
eevil,	ইভিল,	ইভিল,	
sthaponagulor,	স্থাপনগুলোর,	স্থাপনাগুলোর,	
sollallhu,	সোল্লাল্লুহ,	সল্লাল্লাহু,	
batikromi,	বাতিক্রমমি,	ব্যতিক্রমী,	
meridiane,	মেরিডিয়ানে,	মেরিডিয়ানে,	
shamshere,	শামশেরে,	শমসের,	
motke,	মোটকে,	মতকে,	
ray,	রায়,	রায়,	
mitro,	মিটরো,	মিত্র,	
nilkuthir,	নীলকুঠির,	নীলকুঠির,	
gej,	গেজ,	গেজ,	
upacharjo,	উপাচর্য,	উপাচার্য,	
ceramiker,	সেরামিকের,	সিরামিকের,	
kutubuddinke,	কুটুবুদ্দিনকে,	কুতুবুদ্দিনকে,	
protijogiitamulok,	প্রতিযোগিবলামূলক,	প্রতিযোগীতামূলক,	
mmadhuri,	ম্মাধুরী,	মাধুরী,	
buth,	বুথ,	বুথ,	
proboleme,	প্রবলেমে,	প্রবলেমে,	
antarctika,	অ্যান্টারককটা,	অ্যান্টার্কটিকা,	
ebhara,	ইভারা,	এভার,	
ghamta,	ঘমটা,	ঘোমটা,	
rodney,	রডনে,	রেডনি,	
kanuner,	কানুনের,	কানুনের,	
udor,	উদোর,	উদর,	
drissoteer,	দৃষ্টাির,	দৃশ্যটির,	
planey,	প্ল্যানে,	প্লেনে,	
poriikkhateo,	পরীক্ষাতেও,	পরীক্ষাতেও,	
surakarder,	সুরাকারদের,	সুরকারদের,	
emarjenshi,	এমারজেনশি,	এমার্জেন্সি,	
shem,	শেম,	সেম,	
firoza,	ফিরোজা,	ফিরোজা,	
phox,	ফোক্স,	ফক্স,	
bhenom,	ভেনম,	ভেনম,	
oncholeo,	অঞ্চলেও,	অঞ্চলেও,	
doorger,	ডোরগের,	দুর্গের,	
militaryr,	মিলিটারির,	মিলিটারির,	
barnis,	বারনিস,	বার্নিশ,	
municipal,	মুনিসিপাল,	মিউনিসিপ্যাল,	
chouhate,	চৌহাতে,	চৌহাটে,	
aakabar,	আকাবার,	আকাবার,	
deep,	ডিপ,	দীপ,	
addata,	আদদাতা,	আড্ডাটা,	
basakey,	বাসাকে,	বাসাকে,	
cholechi,	চলেছি,	চলেছি,	
omanisa,	ওমানিসা,	অমানিশা,	
nodiitei,	নদিতেই,	নদীতেই,	
jontrangshogulor,	যন্ত্রাংশগুলোর,	যন্ত্রাংশগুলোর,	
veenis,	ভেনিস,	ভেনিস,	
vorkendra,	ভরকেন্দ্র,	ভরকেন্দ্র,	
dalnata,	দলনাতা,	ডালনাটা,	
shilpikuler,	শিল্পীকুলের,	শিল্পীকুলের,	
fol,	ফলল,	ফল,	
taitela,	টাইতেলা,	টাইটেল,	
nirbachokder,	নির্বাচকদের,	নির্বাচকদের,	
gajano,	গজনা,	গজানো,	
popaike,	পোপাইকে,	পপাইকে,	
torutoler,	তরুতলের,	তরুতলের,	
casper,	ক্যাসপার,	ক্যাসপার,	
kortona,	কর্তনা,	করতনা,	
dhauto,	ধাওতো,	ধৌত,	
templet,	টেম্পলেট,	টেম্পলেট,	
koro,	করো,	করো,	
jontropatigulite,	যন্ত্রপাতিগুলিতে,	যন্ত্রপাতিগুলিতে,	
jakatke,	জাকাতকে,	যাকাতকে,	
bhangle,	ভাংলে,	ভাঙলে,	
lungiti,	লুঙ্গিটি,	লুঙ্গিটি,	
gorrer,	গোরের,	গোরের,	
nagorikkey,	নাগরিকককে,	নাগরিককে,	
phutbolarder,	ফুটবললাদের,	ফুটবলারদের,	
ghotleo,	ঘটলেও,	ঘটলেও,	
taatey,	টাতে,	তাতে,	
deefinition,	ডিফিননশন,	ডেফিনেশন,	
nirvaha,	নির্ভাহা,	নির্বাহ,	
gobeshokgon,	গবেষকগণ,	গবেষকগণ,	
alpa,	আলপা,	অল্প,	
porizoner,	পরিজনের,	পরিজনের,	
adhikartai,	অধিকারটাই,	অধিকর্তাই,	
hoonayin,	হুউনাইন,	হুনাইন,	
prapokkey,	প্রাপককে,	প্রাপককে,	
udbhaboni,	উদ্ভাবনী,	উদ্ভাবনী,	
bhenus,	ভেনুস,	ভেনাস,	
dapadpi,	দাপাপ্পি,	দাপাদপি,	
shangkalonti,	শংকললনটি,	সংকলনটি,	
proshikkhane,	প্রশিক্ষণে,	প্রশিক্ষণে,	
naper,	নাপের,	ন্যাপের,	
kanasarabhesana,	কাসাসররেশন,	কনসারভেশন,	
arthurer,	আর্থুরের,	আর্থারের,	
tinhazar,	তিনহজজার,	তিনহাজার,	
hastamathun,	হস্তানথুল,	হস্তমথুন,	
chhaikalo,	ছাইকালো,	ছাইকালো,	
setike,	সেতিকে,	সেটিকে,	
rakkhandurga,	রক্ষণবূর্গ,	রক্ষণদুর্গ,	
akatwa,	আকাত্ব,	একাত্ব,	
plak,	প্ল্যাক,	প্ল্যাক,	
sikkharrtheerao,	শিক্ষার্থারায়ও,	শিক্ষার্থীরাও,	
bhotomulyoke,	ভোটমুল্যকে,	ভোটমূল্যকে,	
porirshoder,	পরিদ্রদের,	পরির্ষদের,	
robot,	রোবোট,	রোবোট,	
renoo,	রেনো,	রেনো,	
govindarajan,	গোবিন্দরাজন,	গোবিন্দরাজন,	
creshcent,	ক্রেস্েন্ট,	ক্রিসেন্ট,	
mataram,	মাতারাম,	মাতরম,	
bodna,	বদনা,	বদনা,	
chilahatee,	চিলাহাটতে,	চিলাহাটি,	
michhilti,	মিছিলটি,	মিছিলটি,	
kul,	কুল,	কুল,	
shtonehenge,	শ্রনেহেনেগে,	স্টোনহেঞ্জ,	
fake,	ফাকে,	ফাকে,	
kusumeshu,	কুসুমেষু,	কুসুমেষু,	
idyi,	ইড্ি,	আইডিই,	
basturoi,	বাস্তুরই,	বস্তুরই,	
nobotom,	নববলম,	নবতম,	
chhutee,	ছুটি,	ছুটি,	
firti,	ফিরটি,	ফিরতি,	
kruser,	ক্রুসের,	ক্রুশের,	
beem,	বিম,	বিম,	
alumni,	আলুমনি,	অ্যালমনি,	
restuarant,	রেস্টারনাযান্ট,	রেষ্টুরেন্ট,	
monohputo,	মনোপপুত,	মনঃপুত,	
kaloniir,	কালনীর,	কালনীর,	
vool,	ভুল,	উল,	
armeeniyana,	আর্মিনিয়ানা,	আর্মেনিয়ান,	
thailand,	থাইলান্ড,	থাইল্যান্ড,	
rajnaiteek,	রাজনৈতিক,	রাজনৈতীক,	
manjushri,	মঞ্জুশ্রী,	মঞ্জুশ্রী,	
jhonkar,	ঝোঁকার,	ঝঙ্কার,	
sbaajan,	স্বজজন,	স্বজন,	
billaho,	বিল্লাহ,	বিল্লাহ,	
sthapanagulor,	স্থাপানগুলোর,	স্থাপনাগুলোর,	
scholarsip,	স্কলারসিপ,	স্কলারশিপ,	
chhuteete,	ছুটিতে,	ছুটিতে,	
vezano,	ভেজানো,	ভেজানো,	
udyem,	উদ্যেম,	উদ্যেম,	
khorsed,	খোরসেদ,	খোরশেদ,	
ekjoge,	একজোগে,	একযোগে,	
kinsa,	কিনসা,	কিংস,	
tonoo,	টোনো,	তনু,	
zohns,	জোন্স,	জন্স,	
votar,	ভোটার,	ভোটার,	
touraat,	টুরাত,	তওরাত,	
dito,	ডিটো,	দিতো,	
sikkharthirao,	শিক্ষার্থীরাও,	শিক্ষার্থীরাও,	
marpit,	মারপিট,	মারপিট,	
jontrototto,	যন্ত্রতত্ত্ব,	যন্ত্রতত্ত্ব,	
logic,	লোজিক,	লজিক,	
ghaghat,	ঘাঘাত,	ঘাঘট,	
sarboporee,	সার্বপরী,	সর্বোপরী,	
bairey,	বাইরে,	বাইরে,	
mailkhanek,	মাইলখানেক,	মাইলখানেক,	
soketgulor,	সকেতগুলোর,	সকেটগুলোর,	
maunchostho,	মাচচনস্থ,	মঞ্চস্থ,	
jerushalema,	জেরুশললামী,	জেরুসালেম,	
liseensee,	লিসিনসে,	লাইসেন্স,	
heart,	হির্ট,	হার্ট,	
oitijhyotike,	ঐতিহ্যতিকে,	ঐতিহ্যটিকে,	
hindutirtha,	হিন্দুতির্থ,	হিন্দুতীর্থ,	
sorting,	সর্টিং,	সর্টিং,	
debdebier,	দেবদেবীরের,	দেবদেবীর,	
duryogamoyee,	দুর্যগাময়ীয়,	দুর্যোগময়ী,	
bedanta,	বেদনটা,	বেদান্ত,	
wictor,	উইক্টর,	ভিক্টর,	
madhobi,	মাধবি,	মাধবী,	
habsi,	হাবসি,	হাবশী,	
sobaiderke,	সবাইদেরকে,	সবাইদেরকে,	
byapoktor,	ব্যাপক্তর,	ব্যাপকতর,	
sarjur,	সারজুর,	সরযূর,	
pothon,	পথন,	পঠন,	
hojurer,	হজুরের,	হজুরের,	
bornolikhon,	বর্ণলিখন,	বর্ণলিখন,	
chirkoot,	চিরকোট,	চিরকুট,	
mitrer,	মিট্রের,	মিত্রের,	
manob,	মানব,	মানব,	
maktum,	মাক্তুম,	মাকতুম,	
distibutor,	ডিস্টিবুটর,	ডিস্টিবিউটারের,	
lyaandeeng,	ল্যান্ডিং,	ল্যান্ডিং,	
laaishheshh,	লেইশেস,	লাইসেন্স,	
shurugulo,	শুরুগুলো,	শুরুগুলো,	
laaisheesh,	লাইশিস,	লাইসেন্স,	
remakri,	রেমাক্রী,	রেমাক্রী,	
furio,	ফুরিও,	ফুরিও,	
onupater,	অনুপাতের,	অনুপাতের,	
hariken,	হািকেন,	হ্যারিকেন,	
uqeliptas,	উকেলিটপাস,	ইউক্যালিপ্টাস,	
graambaashio,	গ্রামবাশিও,	গ্রামবাসীও,	
hadisti,	হাদিস্তি,	হাদিসটি,	
kabutorer,	কবুতরের,	কবুতরের,	
lambaate,	ল্যাম্বাট,	লম্বাটে,	
hosbaleke,	হোসবালেকে,	হোসবালেকে,	
vogno,	ভগগন,	ভগ্ন,	
footbalarer,	ফুটবালারের,	ফুটবলারের,	
hosney,	হোসনে,	হোসনে,	
treebhuj,	ত্রুভূজ,	ত্রিভূজ,	
abikaul,	আবিকাল,	অবিকল,	
vagini,	ভাগিনি,	ভগিনী,	
kathmandute,	কাঠমান্ুতে,	কাঠমান্ডুতে,	
artilary,	আর্টিলিরি,	আর্টিলারি,	
rayyalati,	রায়ললয়তি,	রয়্যালটি,	
ronodeep,	রোনোডিপ,	রণদীপ,	
porishongkhanbid,	পরিশংখ্যান্দি,	পরিসংখ্যানবিদ,	
female,	ফেমালে,	ফিমেল,	
karam,	কারাম,	কেরাম,	
oncholke,	অঞ্চলকে,	অঞ্চলকে,	
abhidhaanick,	অভিভাননক,	অভিধানিক,	
byaktigotovabeo,	ব্যক্তিগতভাবেও,	ব্যাক্তিগতভাবেও,	
musallati,	মুসললাটি,	মুসল্লাটি,	
panda,	পান্ডা,	পান্ডে,	
bikretaara,	বিক্রেতরা,	বিক্রেতারা,	
dekhso,	দেখসো,	দেখসো,	
zibonnogor,	জীবননগর,	জীবননগর,	
utpatti,	উৎপত্তি,	উতপত্তি,	
chereche,	চেরেছে,	ছেড়েছে,	
mumtazer,	মুমতাজের,	মুমতাজের,	
jumlalancer,	জুমলিলানেসের,	জুমলাল্যান্সার,	
shakar,	শাকার,	সকার,	
tokee,	টোক,	তকি,	
krema,	ক্রেমা,	ক্রাইম,	
teemothy,	টিমথি,	টিমোথি,	
katiusha,	কাতিসা,	কাতিউশা,	
santoshpore,	সান্তসমপরে,	সন্তোষপুর,	
fooloo,	ফুলো,	পোলো,	
mitrota,	মিত্রটা,	মিত্রতা,	
perry,	পেরি,	পেরি,	
protishtan,	প্রতিষ্টান,	প্রতিষ্টান,	
soundarja,	সৌন্দর্যা,	সৌর্ন্দয্য,	
thanvi,	থানভি,	থানভী,	
kaia,	কাইয়া,	কায়া,	
pyetarna,	প্যাতারনা,	প্যাটার্ন,	
bijito,	বিজিত,	বিজিত,	
anichchi,	অনিচ্ছি,	আনিচ্ছি,	
bhiktara,	ভিক্তারা,	ভিক্টর,	
ghotolen,	ঘটটেল,	ঘটলেন,	
distance,	ডিস্টান্স,	ডিসট্যান্স,	
shommotir,	শম্মতির,	সম্মতির,	
marmader,	মারমাদের,	মারমাদের,	
ship,	শিপ,	শিপ,	
shlok,	শ্লক,	শ্লোক,	
homeser,	হোমসের,	হোমসের,	
husni,	হুসনি,	হুসনি,	
habathu,	হাবাথু,	হাবাথু,	
manjushree,	মঞ্জুশ্রী,	মঞ্জুশ্রী,	
agomoney,	আগমমোনে,	আগমনে,	
sipa,	সিপা,	শিপ,	
tarkareer,	তারকারীর,	তরকারীর,	
reshmirekha,	রেশমিরেখা,	রেশমীরেখা,	
registrikrito,	রেজিস্ট্রিকৃত,	রেজিস্ট্রীকৃত,	
marodeho,	মারোদেহ,	মরদেহ,	
gatibege,	গতিবেগে,	গতিবেগে,	
byboshthar,	বুস্বথসার,	ব্যাবস্থার,	
dwipke,	দ্বিপকে,	দ্বীপকে,	
hetimganje,	হেটিমগঞ্জে,	হেতিমগঞ্জে,	
sahittopritite,	সাহিত্যপিত্তিতে,	সাহিত্যপ্রীতিতে,	
deil,	ডেইল,	ডেইল,	
site,	সিতে,	সিটে,	
shahurgulor,	শহুরগুলোর,	শহুরগুলোর,	
nanabornobishishto,	নানাবর্বিিষিষ্ট,	নানাবর্ণবিশিষ্ট,	
jatinke,	জাতিনকে,	যতীনকে,	
madhnagar,	মধনগর,	মাধনগরের,	
panchasjan,	পঞ্চাসজন,	পঞ্চাশজন,	
dhaleshwari,	ধলেশ্বরী,	ধলেশ্বরী,	
khaaneker,	খানেকের,	খানেকের,	
vittimul,	ভিট্তিমুল,	ভিত্তিমূল,	
adhyattikota,	অধ্যাত্তিকতা,	আধ্যাত্মিকতা,	
khagen,	খাগেন,	খগেন,	
carlosh,	কার্লোস,	কার্লোস,	
ralf,	রালফ,	রালফ,	
domone,	ডমনে,	দমনে,	
diibug,	ডিউবাগ,	ডিবাগ,	
vince,	ভিন্স,	ভিন্স,	
modelkey,	মডেলকে,	মডেলকে,	
lampot,	ল্যাম্পট,	লম্পট,	
eoki,	ইওকি,	এওকি,	
sommoteer,	সম্মতির,	সম্মতির,	
armshtrong,	আর্মশ্টররং,	আর্মস্ট্রং,	
byan,	বিয়ান,	ব্যাং,	
nutan,	নুতান,	নূতন,	
jerusalema,	জেরুসালেমা,	জেরুসালেম,	
bolvodro,	বলবোদ্র,	বলভদ্র,	
suhasini,	সুহাসিনি,	সুহাসিনী,	
bahubar,	বহুবার,	বহুবার,	
jhimochchilo,	ঝিমছচিল,	ঝিমোচ্ছিলো,	
chokhwala,	চোখবালা,	চোখওয়ালা,	
aamontrito,	আমোন্ত্রিত,	আমন্ত্রিত,	
saraiki,	সারাইকি,	সরাইকি,	
sahittekder,	সাহিত্যকেদের,	সাহিত্যেকদের,	
mulor,	মুলোর,	মুলোর,	
hondooras,	হন্ডররাস,	হন্ডুরাস,	
autopromotioner,	অটোপ্রমাইনের,	অটোপ্রমোশনের,	
shroddhabihin,	শ্রদ্ধাবিহীন,	শ্রদ্ধাবিহীন,	
shamijir,	শমিজীর,	স্বামীজীর,	
minishtarer,	মিনিস্টারের,	মিনিস্টারের,	
nutoner,	নুটনের,	নূতনের,	
moresbai,	মোরেসভাই,	মোরেসবাই,	
temonbhabe,	তেমনভাবে,	তেমনভাবে,	
lyaataa,	ল্যাটা,	ল্যাটা,	
fimela,	ফিইমেলা,	ফিমেল,	
jhumjhumita,	ঝুমঝুমিতা,	ঝুমঝুমিটা,	
parinati,	পািণতি,	পরিণতি,	
cs,	সিএসএস,	সিএস,	
byaboharkari,	ব্যবহারকারী,	ব্যবহারকারী,	
pathkrom,	পাযাক্ররম,	পাঠক্রম,	
shector,	শেক্টর,	সেক্টর,	
firozapure,	ফিরোজপুরে,	ফিরোজাপুরে,	
hupile,	হুপিলে,	হুপিলে,	
emargency,	এমারগেন্সি,	এমার্জেন্সি,	
antarctica,	অ্্ট্যান্টারিকা,	অ্যান্টার্কটিকা,	
anyorup,	অন্যরূপ,	অন্যরূপ,	
louhojato,	লৌহজাত,	লৌহজাত,	
dibya,	দিব্যা,	দিব্যা,	
ahalya,	আহাল্যা,	অহল্যা,	
shuchonakal,	শুচনকাল,	সূচনাকাল,	
oisamoyer,	ঐসাময়ের,	ঐসময়ের,	
choshon,	চোষন,	চোষণ,	
aholya,	আহল্য,	অহল্যা,	
shuri,	শুরী,	সুরি,	
tyap,	ত্যাপ,	ট্যাপ,	
sobchey,	সবচে,	সবচে,	
deepan,	দিপান,	দীপন,	
jalarong,	জ্যালারং,	জলরঙ,	
mulvitti,	মালভিটিটি,	মূলভিত্তি,	
somraat,	সমরাত,	সম্রাট,	
kajangale,	কাজানগালে,	কজঙ্গলে,	
navaratri,	নবরততারী,	নবরাত্রি,	
khudrokar,	ক্ষুদ্রকার,	ক্ষুদ্রকার,	
suporichita,	সুপরিচিত,	সুপরিচিত,	
gejeted,	গেজেটেড,	গেজেটেড,	
ganochin,	গণছিন,	গণচীন,	
cheento,	চেনটো,	চিনতো,	
bee,	বিআই,	বি,	
saptahokal,	সপ্তাখোলাল,	সপ্তাহকাল,	
meshmeshya,	মেশমেশ্য,	মেশহমেশহিইয়া,	
orthonitir,	অর্থনীতির,	অর্থনীতির,	
dadar,	দাদার,	দাদার,	
pratijogider,	প্রতিযোগীদের,	প্রতিযোগীদের,	
shikkhartheerao,	শিক্ষার্থারওও,	শিক্ষার্থীরাও,	
folleni,	ফল্লেনি,	ফলেনি,	
chalachchitrotike,	চলচ্চিত্রিতকে,	চলচ্চিত্রটিকে,	
ved,	ভেড,	বেদ,	
hosne,	হোসনে,	হোসনে,	
biplabeer,	বিপললবার,	বিপ্লবীর,	
paner,	পানের,	পানের,	
elbamtite,	এলমাবাটিতে,	এলবামটিতে,	
collaborators,	কলারবালার্স,	কলাবরেটরস,	
pratisthasaho,	প্রতিষ্ঠাসহ,	প্রতিষ্ঠাসহ,	
middleton,	মিডলটেন,	মিডলটন,	
pakistanira,	পাকিস্তানিরা,	পাকিস্তানীরা,	
dacope,	ডাকোপে,	দাকোপ,	
shahjapur,	শাহজাপুর,	শাহজাপুর,	
soleel,	সোলিল,	সলিল,	
joisttho,	জৈস্ট্য,	জ্যৈষ্ঠ,	
brahmanera,	ব্রহহ্মােরা,	ব্রাহ্মণেরা,	
kushumba,	কুশুমবা,	কুশুম্বা,	
chai,	চাই,	ছাই,	
shuperheiro,	শুপেরহেরও,	সুপারহিরো,	
gagee,	গাগি,	গেজ,	
monroe,	মনরো,	মনেরোর,	
aakaabar,	আকাবার,	আকাবার,	
sangbadmadhyome,	সংবাদমধধ্যমে,	সংবাদমাধ্যমে,	
gobeshonar,	গবেষণার,	গবেষনার,	
nikote,	নিকোতে,	নিকটে,	
taigara,	তাইগররা,	টাইগার,	
neerbahe,	নির্বাহে,	নির্বাহে,	
nirmolota,	নির্মলতা,	নির্মলতা,	
bane,	বানে,	বনে,	
engrejra,	এংগ্রেজরা,	ইংরেজরা,	
hizriite,	হিজিরিতে,	হিজরীতে,	
selim,	সেলিম,	সেলিম,	
nabatamo,	নববাতম,	নবতম,	
biplabee,	বিপললবায,	বিপ্লবী,	
kale,	কালে,	কালে,	
giitikobita,	গীতিবিকতা,	গীতিকবিতা,	
rubidiyaam,	রুবিদিয়ামাম,	রুবিডিয়াম,	
overholing,	ওভারহোলিং,	ওভারহোলিং,	
bishwaashshoi,	বিশ্বাসশই,	বিশ্বাসই,	
sausage,	সৌসগে,	সসেজ,	
notikotar,	নতিকতার,	নৈতিকতার,	
siddhante,	সিদ্ধান্তে,	সিদ্ধান্তে,	
hoondayi,	হোউন্ডাই,	হুন্দাই,	
kormopontha,	কর্মপন্থা,	কর্মপন্থা,	
bhandar,	ভান্ডার,	ভাণ্ডার,	
groth,	গ্রথ,	গ্রোথ,	
gamdan,	গামদান,	গামদান,	
bonnypran,	বন্পিরপ্রান,	বন্যপ্রাণ,	
sukumaree,	সুকুমারা,	সুকুমারী,	
phiksa,	ফিকসা,	ফিক্স,	
anchalei,	অঞ্চলেই,	অঞ্চলেই,	
chalochchitraeeo,	চলচ্চিত্রকায়,	চলচ্চিত্রেও,	
vins,	ভিনস,	ভিন্স,	
romantik,	রমান্তিক,	রোমান্টিক,	
barder,	বারদের,	বার্ডের,	
aqram,	আক্রাম,	আকরাম,	
chalochchitreei,	চলচ্চিত্রই,	চলচ্চিত্রেই,	
phutanta,	ফুটান্তা,	ফুটন্ত,	
ekirokom,	একিরকম,	একইরকম,	
orthisoho,	অর্থিসহ,	অর্থিসহ,	
patochitra,	পাটচিত্র,	পটচিত্র,	
dosha,	দোশা,	দোসা,	
dinara,	দিনারা,	ডিনার,	
songkolonti,	সংকল্নটি,	সংকলনটি,	
geographics,	জিগোর্ফিক্স,	জিওগ্রাফিকস,	
monzooshree,	মঞ্জযৌশ্যী,	মঞ্জুশ্রী,	
hafsa,	হাফসা,	হাফসা,	
sadadyarao,	সদদ্যারাও,	সদদ্যরাও,	
samley,	সামলে,	সামলে,	
akkheperi,	আক্ষেপেরই,	আক্ষেপেরই,	
mausumer,	মাসুমের,	মৌসুমের,	
rockibul,	রকিভুল,	রকিবুল,	
sharoker,	শারকের,	স্মারকের,	
batom,	বাতম,	বাটম,	
shakankti,	শককন্কি,	শকাঙ্কটি,	
foxcon,	ফক্সকন,	ফক্সকন,	
uddhrita,	উদ্ধৃত,	উদ্ধৃত,	
pleto,	প্লেটো,	প্লেটো,	
shatan,	শতন,	শয়তান,	
benojir,	বেনোজির,	বেনজীর,	
manoharpur,	মনোহারপুর,	মনোহরপুর,	
addhattikotar,	অদ্ধাত্তিকতার,	আধ্যাত্মিকতার,	
bisheshshyo,	বিশেষ্য্য,	বিশেষ্য,	
bhromoner,	ভ্রমণের,	ভ্রমণের,	
suparichito,	সুপারিচিত,	সুপরিচিত,	
sthaponagulo,	স্থাপনগুলো,	স্থাপনাগুলো,	
shulfate,	শুলফাতে,	সালফেট,	
gonona,	গননা,	গননা,	
sathik,	সাথিক,	সঠিক,	
mukhomandoler,	মুখমন্ডলের,	মুখমণ্ডলের,	
sportstar,	স্পোর্টস্টার,	স্পোর্টসস্টার,	
protinito,	প্রতিনিত,	প্রতিনিত,	
jamjomat,	জাম্বগত,	জমজমাট,	
dharavahiker,	ধারাভাহিকের,	ধারাবাহিকের,	
ernad,	এরনাদ,	এরনাড,	
udvabani,	উদ্ভাবানী,	উদ্ভাবনী,	
swarther,	স্বার্থের,	স্বার্থের,	
probeshan,	প্রবেশন,	প্রবেশন,	
shoodhooi,	শৌধই,	শুধুই,	
kod,	কোদ,	কোড,	
ghetu,	ঘেটু,	ঘেটু,	
cholochchitrake,	চলচ্চিত্রাকে,	চলচ্চিত্রকে,	
sthapanagulo,	স্থাপানগুলো,	স্থাপনাগুলো,	
emiratas,	এমিরাতাস,	এমিরেটাস,	
rajotta,	রাজততা,	রাজত্ব,	
chikitshar,	চিকিৎসার,	চিকিত্সার,	
akkharkey,	অক্ষারকে,	অক্ষরকে,	
sommotite,	সম্মতিতে,	সম্মতিতে,	
saqara,	সাকারা,	সাকার,	
bbiswashke,	বুব্বশস্বে,	বিশ্বাসকে,	
toroonra,	টরনরা,	তরুণরা,	
cholochchitro,	চলচ্চিত্র,	চলচ্চিত্র,	
nirobota,	নিরবতা,	নিরবতা,	
nariderke,	নারীদেরকে,	নারীদেরকে,	
rajdhani,	রাজধানি,	রাজধানি,	
qaro,	কারো,	কারো,	
muhurtati,	মুহূর্তটি,	মুহুর্তটি,	
satarkatar,	সতত্যকার,	সতর্কতার,	
dheke,	ধেকে,	ঢেকে,	
besooro,	বেসরর,	বেসুর,	
soceitytey,	সোসিট্যাট,	সোসাইটিতে,	
postac,	পোস্টাক,	পোস্টকে,	
vetrillocuism,	ভেট্রিলিকিজজি,	ভেট্রিলোকুইজম,	
nirdesika,	নির্দেশিকা,	নির্দেশিকা,	
dharabahikbhabe,	ধারাবাহিকভাবে,	ধারাবাহিকভাবে,	
bossoben,	বসববেন,	বসবেন,	
chamski,	চামস্কি,	চমস্কি,	
priseflex,	প্রিসেলফেক্স,	প্রাইজফ্লেক্স,	
dokaangoolote,	ডোকানগুলোতে,	দোকানগুলোতে,	
phuda,	ফুড়া,	ফুড,	
noitik,	নৈটিক,	নৈতিক,	
chorban,	চরবান,	চর্বন,	
patengar,	পাটেনগার,	পতেঙ্গার,	
torikher,	তরিকের,	তরিখের,	
saifullahil,	সাইফুল্লাহিল,	সাইফুল্লাহিল,	
dabarer,	দাবারের,	দাবারের,	
baarnis,	বার্নিস,	বার্নিশ,	
andon,	আন্দন,	আন্দোন,	
durgotsab,	দুর্গতসব,	দুর্গোৎসব,	
pathanatak,	পাঠানাটাক,	পথনাটক,	
chupani,	চুপানি,	চুপানি,	
xpose,	ক্যাপসে,	এক্সপোজ,	
shoreefer,	শরিফের,	শরিফের,	
rokkhonabekkhoner,	রক্ষণবক্ষেষণের,	রক্ষণাবেক্ষণের,	
ghumachhe,	ঘুমাচে,	ঘুমাচ্ছে,	
protyokkhovabey,	প্রত্যক্ষভাবে,	প্রত্যক্ষভাবে,	
bisheshyo,	বিশেষ্য,	বিশেষ্য,	
majdur,	মজদুর,	মজদুর,	
adhyatmik,	অধ্যাতমিক,	আধ্যাত্মিক,	
koyeeri,	কয়িরি,	কোয়েরি,	
milton,	মিলটন,	মিলটন,	
tikto,	টিকটো,	তিক্ত,	
binakar,	বিনাকার,	বিনাকার,	
goshthiti,	গোষ্ঠিতি,	গোষ্ঠীটি,	
tukroti,	টুক্রটি,	টুকরোটি,	
ganaparibahan,	গণপরিবহহন,	গণপরিবহন,	
obharbhiu,	ওভারভি,	ওভারভিউ,	
ghoshito,	ঘোষিত,	ঘোষিত,	
spredshiit,	স্প্রেশশিত,	স্প্রেডশীট,	
masto,	মাস্তো,	মাস্ত,	
jiland,	জিলান্দ,	জিল্যান্ড,	
nariderke,	নারীদেরকে,	নারিদেরকে,	
chhootochhuti,	ছোটঘুটি,	ছুটোছুটি,	
lisense,	লিসেন্সে,	লাইসেন্স,	
toler,	টোলার,	তালের,	
prachirer,	প্রাচিরের,	প্রাচিরের,	
vushito,	ভুশিত,	ভূষিত,	
sumi,	সুমি,	সুমি,	
dipti,	ডিপটি,	ডেপুটি,	
byabaharkarike,	ব্যবহারকারীকে,	ব্যবহারকারীকে,	
vobobibhuti,	ভববিভুতি,	ভববিভূতি,	
probhritike,	প্রভৃতিকে,	প্রভৃতিকে,	
swairacharibirodhi,	স্বৈরাচিরবিরোধী,	স্বৈরাচারীবিরোধী,	
toki,	টোকি,	তকি,	
asantosh,	অসন্তশ,	অসন্তোষ,	
seniar,	সেনিয়ার,	সিনিয়র,	
bajpa,	বাজপা,	বাজপা,	
toranganj,	তরঙ্গাঙ্জ,	তোরাবগঞ্জ,	
aborto,	অবর্ত,	আবর্ত,	
ajeejer,	আজেজের,	আজিজের,	
neck,	নেক,	নেক,	
taims,	টাইমস,	টাইমস্,	
abarte,	আবার্তে,	আবর্তে,	
pronoti,	প্রণটি,	প্রণতি,	
chakurijibirao,	চাকুরিজীবাবীও,	চাকুরীজীবীরাও,	
alonkaran,	আলোকাারণ,	অলঙ্করণ,	
meropenemer,	মেরোপেনমের,	মেরোপেনেমের,	
yak,	যাক,	ইয়াক,	
akheli,	আখেলি,	আখেলী,	
sinaake,	সিনাকে,	সিনাকে,	
oncholshomuh,	অঞ্চলসমূহ,	অঞ্চলসমূহ,	
injiniyarim,	ইঞ্জিনিরিরিম,	ইঞ্জিনিয়ারিং,	
chapchap,	চাপচাপ,	চাপচাপ,	
wishnu,	উইশনু,	বিষ্ণু,	
shangsthaner,	শংস্থানের,	সংস্থানের,	
deliver,	ডেলিভার,	ডেলিভার,	
amor,	আমোর,	আমর,	
dorun,	ডরুন,	দরুণ,	
bhimsen,	ভিমসেন,	ভীমসেন,	
graambasio,	গ্রামবাসিও,	গ্রামবাসীও,	
cantan,	ক্যান্টান,	ক্যান্টন,	
soteciety,	সটেসিয়েটি,	সোসাইটিতে,	
taler,	তালের,	তালের,	
samaptir,	সমাপ্তির,	সমাপ্তির,	
themeke,	থেমেকে,	থিমকে,	
bhalobasar,	ভালোবাসার,	ভালোবাসার,	
nikate,	নিকাতে,	নিকটে,	
prarthonakokkher,	প্রার্থনকক্ষকের,	প্রার্থনাকক্ষের,	
bo,	বো,	বু,	
daaktikite,	ডাকটিকিতে,	ডাকটিকিটে,	
songbadmadhyomer,	সংবাদমধ্যমের,	সংবাদমাধ্যমের,	
aairish,	আইরিশ,	আইরিস,	
brekthrough,	ব্রেক্রহোহ,	ব্রেকথ্রু,	
girilal,	গিরিলাল,	গিরিলাল,	
madrasi,	মদ্রাসি,	মাদ্রাজি,	
tennis,	টেনিস,	টেনিস,	
poketchorder,	পকেক্রদের,	পকেটচরদের,	
nirmalata,	নির্মালতা,	নির্মলতা,	
spredashita,	স্প্রেদশশিত,	স্প্রেডশীট,	
neemeette,	নিমিতে,	নিমিত্তে,	
marmaraa,	মারমারাও,	মারমারা,	
rajbondir,	রাজবন্দির,	রাজবন্দীর,	
upbrazillian,	আপ্রাযাজিয়ালিয়ান,	আপব্রাজিলিয়ান,	
alsaar,	আলসার,	আলসার,	
roopdaan,	রোপ্ডান,	রুপদান,	
jathartho,	যথার্থ,	যথার্থ,	
noteti,	নটেটি,	নোটটি,	
shikhbe,	শিখবে,	শিখবে,	
nottee,	নটটি,	নোটটি,	
achintopurer,	আচিন্তপুরের,	অচিন্তপুরের,	
rohasyer,	রোহাস্যের,	রহস্যের,	
kuresher,	কুরেশের,	কুরেশের,	
jolrong,	জলরং,	জলরঙ,	
atmobonchito,	আত্মোবনচিত,	আত্মবঞ্চিত,	
gujab,	গুজাব,	গুজব,	
guha,	গুহা,	গোহ,	
nothibhukta,	নথিভুক্ত,	নথিভুক্ত,	
bhangchur,	ভাংচুর,	ভাংচুর,	
kazianis,	কাজিয়ানিস,	কাজানিস,	
adhyatmikata,	অধ্যাতমিকতা,	আধ্যাত্মিকতা,	
sharansthal,	শরংস্থল,	শরণস্থল,	
lat,	ল্যাট,	লাট,	
chuti,	চুটি,	ছুটি,	
shaater,	শাতের,	শ্যুটার,	
obosan,	অবসান,	অবসান,	
vugorvey,	ভুগোরভে,	ভূগর্ভে,	
dobhara,	দোভারা,	ডোভার,	
bashoborty,	বাশব্্তি,	বশবর্তী,	
doorotaumo,	দূরততমম,	দূরতম,	
homshke,	হোমসকে,	হোমসকে,	
manatmulak,	মননাতমুলক,	মানতমূলক,	
welcome,	ওয়েলকম,	ওয়েলকাম,	
khalidkay,	খালিদকায়,	খালিদকে,	
alpo,	আল্প,	অল্প,	
kiandi,	কিয়ান্ডি,	ক্যান্ডি,	
chhutochhuti,	ছুটোচুটি,	ছুটোছুটি,	
poscater,	পোস্াটের,	পশ্চাতের,	
ekhate,	এখাতে,	একহাতে,	
as,	এসিএস,	অস,	
shamshernagar,	শমসেরনগর,	শমশেরনগর,	
chhedon,	ছেদন,	ছেদন,	
kyatgarite,	ক্যাটগারিতে,	ক্যাটগারিতে,	
neelkamal,	নীলকামাল,	নীলকমল,	
hena,	হেনা,	হেনা,	
bandhano,	বন্ধনও,	বাঁধানো,	
mangolic,	ম্যাঙ্গলিক,	মাঙ্গলিক,	
duburir,	দুবুরির,	ডুবুরির,	
sahachke,	সহচকে,	সাহাচকে,	
sharif,	শরিফ,	শরিফ,	
hepatitis,	হেপাটিটিস,	হেপাটাইটিস,	
chitlar,	চিতলার,	চিতলার,	
upobashii,	উপবাশিই,	উপবাসী,	
hock,	হোক,	হুক,	
mayily,	মাযাইলি,	মাইলি,	
beetloser,	বিটলোসের,	বিটলসের,	
debete,	দেবেতে,	ডিবেট,	
lagto,	ল্যাগটো,	লাগতো,	
baarbadoj,	বারবাদজ,	বার্বাডোজ,	
rajshri,	রাজশৃর,	রাজশ্রী,	
houzgulite,	হজযুগুলিতে,	হাউজগুলিতে,	
maudelti,	মাউডলেটি,	মডেলটি,	
samyuktha,	সম্যুক্ষা,	সামিউক্তা,	
oindrila,	ওন্ড্রিলা,	ঐন্দ্রিলা,	
prosadhoner,	প্রসাধনের,	প্রসাধনের,	
madrasa,	মদ্রাসা,	মাদ্রাসা,	
nirabota,	নিরাবতা,	নিরবতা,	
bisnuke,	বিস্নুকে,	বিষ্ণুকে,	
porinoti,	পরিনতি,	পরিণতি,	
konagoolo,	কোনাগোলো,	কণাগুলো,	
oiteejye,	ঐতিজ্যে,	ঐতিহ্যে,	
veenish,	ভেনিশ,	ভেনিস,	
byaktikegreptar,	ব্যাক্টেকিপেক্টরার,	ব্যক্তিকেগ্রেপ্তার,	
eekbalke,	ইকবালকে,	ইকবালকে,	
asociatis,	অ্যাসিওটিসিস,	এসোসিয়েটস,	
naobihar,	নওবিহার,	নৌবিহার,	
kathghera,	কথছেরা,	কাঠঘেরা,	
ranangane,	রানাঙ্গনে,	রণাঙ্গনে,	
bhalobaas,	ভালোবাস,	ভালোবাসা,	
plack,	প্ল্যাক,	প্ল্যাক,	
chikitsar,	চিকিৎসার,	চিকিত্সার,	
teenisa,	টিনিসা,	টেনিস,	
hakone,	হাকোনে,	হাকোনে,	
thailandsaho,	থাইলান্দসহ,	থাইল্যান্ডসহ,	
samanyai,	সামন্যই,	সামান্যই,	
ujobekeestaner,	উজয়বেক্স্তানের,	উজবেকিস্তানের,	
durgotsabe,	দুর্গতসভাবে,	দুর্গোৎসবে,	
byepass,	ব্যাপাস্যাস,	বাইপাস,	
plator,	প্ল্যাটোর,	প্লেটোর,	
daltyagi,	দলততাাগী,	দলত্যাগী,	
karmosansthan,	কর্মসংস্থান,	কর্মসংস্থান,	
weelcomee,	উইলকোম,	ওয়েলকাম,	
bboponer,	ব্যবপের,	বপনের,	
jotharthovabey,	যথার্থাভাবে,	যথার্থভাবে,	
lakshmir,	লক্ষ্মীর,	লক্ষ্মীর,	
ostheesandhi,	অস্থিসান্ধি,	অস্থিসন্ধি,	
tomader,	টমাদের,	তোমাদের,	
capsul,	ক্যাপসুল,	ক্যাপসুল,	
standards,	স্ট্যান্ডার্ডসহ,	স্টান্ডার্ডস,	
dienes,	ডাইনেস,	ডিএনএস,	
muchi,	মুচি,	মুচি,	
besirvagei,	বেসিরভাগেই,	বেশিরভাগেই,	
scoore,	স্কুরে,	স্কোর,	
grambaseer,	গ্রামবাসীর,	গ্রামবাসীর,	
toufiq,	তৌফিক,	তৌফিক,	
israelbahini,	ইসরাইলবাহিনি,	ইস্রায়েলবাহিনী,	
shudhui,	শুধুই,	শুধুই,	
dorneca,	ডর্নেকা,	ডরনেকা,	
tolemyr,	টলেমির,	টলেমির,	
turbine,	টারবিন,	টারবাইন,	
review,	রেভিয়েস,	রিভিউও,	
plato,	প্ল্যাটো,	প্লেটো,	
shrabostee,	শ্রাবস্তি,	শ্রাবস্তী,	
photanor,	ফটানোর,	ফোটানোর,	
firth,	ফির্থ,	ফার্থ,	
noitikota,	নৈতিকতা,	নৈতিকতা,	
ssahocorze,	সাহাকর্জে,	সাহচর্যে,	
degree,	ডিগ্রে,	ডিগ্রি,	
bojhao,	বোঝাও,	বোঝাও,	
kotibondhe,	কতিবন্ধে,	কটিবন্ধে,	
chalachchitra,	চলচ্চিত্র,	চলচ্চিত্র,	
enginiiring,	এঙ্জিনিয়ারিং,	ইঞ্জিনিয়ারিং,	
shithilata,	শিথিলতা,	শিথিলতা,	
premo,	প্রেমো,	প্রিমো,	
sudrishya,	সুদ্ধ্য,	সুদৃশ্য,	
maila,	মাইলা,	মাইল,	
mohit,	মহিত,	মুহিত,	
laat,	লট,	লাট,	
bhramapraban,	ভ্রমাপ্রবণ,	ভ্রমপ্রবণ,	
baaik,	বাইক,	বাইক,	
hajeerhatt,	হাজিরহাত্ত,	হাজিরহাট,	
nikela,	নিকেলা,	নিকেল,	
mane,	মানে,	মানে,	
johny,	জনি,	জনি,	
simons,	সিমনসস,	সিমন্স,	
ghuznavi,	ঘুজনাভি,	গজনভি,	
esoosiyetasa,	এসোইওসিযাটা,	এসোসিয়েটস,	
saoum,	সাওম,	সাওম,	
masjidtir,	মাসজিদটির,	মসজিদটির,	
samashtike,	সমাস্তিকে,	সমষ্টিকে,	
aziboner,	অজিবনের,	আজীবনের,	
adhunikkale,	আধুনিকালে,	আধুনিককালে,	
anektai,	অনেকটাই,	অনেকটাই,	
ekatto,	একাত্ত,	একাত্ব,	
irish,	ইরিশ,	আইরিস,	
audiotike,	অডিওটিকে,	অডিওটিকে,	
prokolpogulikei,	প্রকল্পগুলিকেই,	প্রকল্পগুলিকেই,	
jhamala,	ঝামালা,	ঝামালা,	
itastata,	ইতাস্তাটা,	ইতস্তত,	
gandhike,	গান্ধিকে,	গান্ধীকে,	
badaghat,	বাদাঘাট,	বাদাঘাট,	
nojder,	নজদের,	নজদের,	
bouddho,	বৌদ্ধ,	বৌদ্ধ,	
abhidhaanic,	অভিভানিস,	অভিধানিক,	
nepchooner,	নেপচননের,	নেপচুনের,	
tistar,	তিস্তার,	তিস্তার,	
jeebnagore,	জীবনগরে,	জীবননগর,	
gandhiio,	গানধধিও,	গান্ধীও,	
johor,	জোহর,	জহর,	
teksuser,	টেকসসসের,	টেক্সাসের,	
gaichhe,	গাইছে,	গাইছে,	
safin,	সাফিন,	সাফিন,	
armeenian,	আর্মিনিয়ান,	আর্মেনিয়ান,	
debeting,	ডেবেটিং,	ডিবেটিং,	
darji,	দার্জি,	দরজি,	
hizrite,	হিজরিতে,	হিজরীতে,	
soorsa,	সুরসা,	সোর্স,	
hazat,	হাজাত,	হজত,	
bishwasho,	বিশ্বাশ,	বিশ্বাসও,	
salmaner,	সালমানের,	সালমানের,	
balatkar,	বালাতকার,	বলাৎকার,	
dimbacriti,	ডিম্বাইকটি,	ডিম্বাকৃতি,	
directorate,	ডিরেক্টরটে,	ডিরেক্টরেট,	
bbosben,	ব্যাসববেন,	বসবেন,	
urey,	উরে,	ইউরি,	
seramiks,	সেরামিকস,	সিরামিকস,	
harbare,	হারবারে,	হারবারে,	
peethey,	পিথে,	পীঠে,	
shektore,	শেক্তরে,	সেক্টরে,	
kraim,	ক্রাইম,	ক্রাইম,	
kalenga,	কালেঙ্গা,	কালেঙ্গা,	
bohoodin,	বহদিন,	বহুদিন,	
somonwitobhabey,	সমন্নিতভাবে,	সমন্বিতভাবে,	
bibadey,	বিবাদেে,	বিবাদে,	
harishankar,	হরিশনকর,	হরিশংকর,	
nibobondhonkrito,	নিবনবন্ধকৃত,	নিববন্ধনকৃত,	
nirbachakder,	নির্বাচকদের,	নির্বাচকদের,	
khaschandpur,	খাসচন্দপুর,	খাসচাঁদপুর,	
sookumari,	সুকুমারি,	সুকুমারী,	
champa,	চম্পা,	চাঁপা,	
shasonkarta,	শাসনকর্তা,	শাসনকর্তা,	
dholeshwari,	ধলেশ্বরী,	ধলেশ্বরী,	
cheerontan,	চিরনটন,	চিরন্তন,	
chomski,	চমস্কি,	চমস্কি,	
steena,	স্তিনা,	স্টেন,	
dormroome,	ডরমোরমম,	ডর্মরুমে,	
gajetted,	গেজেট্টেড,	গেজেটেড,	
poripake,	পরিপাকে,	পরিপাকে,	
grooth,	গ্রুথ,	গ্রোথ,	
abheedhaneek,	অভিধানাক,	অভিধানিক,	
parswer,	পার্স্বের,	পার্শ্বের,	
ashankai,	আশানকাই,	আশঙ্কাই,	
upbasher,	উপবাশের,	উপবাসের,	
hoteltee,	হোটলিতে,	হোটেলটি,	
beatleser,	বিটল্সের,	বিটলসের,	
akeeb,	আকিব,	আকিব,	
sahab,	সহাব,	সাহাব,	
manushti,	মননুষ্টি,	মানুষটি,	
fand,	ফ্যান্ড,	ফান্ড,	
debholopar,	দেভোগার,	ডেভলপার,	
chet,	চেট,	চ্যাট,	
karmasampadon,	কর্মসংসম্মা,	কর্মসম্পাদন,	
danaqana,	দানাকানা,	ডানকান,	
dolu,	ডললু,	ডলু,	
shfingtar,	শুফফন্টার,	স্ফিংটার,	
sikarer,	সিকারের,	শিকারের,	
vaticaner,	ভ্যাটিকানের,	ভ্যাটিকানের,	
carlo,	কার্লো,	কার্লো,	
mosjidtir,	মোজদিত্রির,	মসজিদটির,	
atarkitey,	আতারকিতে,	অতর্কিতে,	
uporzon,	উপর্জন,	উপার্জন,	
torkarir,	তোরকারীর,	তরকারীর,	
mitrata,	মিত্রটা,	মিত্রতা,	
protishta,	প্রতিষ্টা,	প্রতিষ্টা,	
noiteek,	নৈটিক,	নৈতিক,	
qrisenta,	ক্রিসেন্টা,	ক্রিসেন্ট,	
horidbar,	হরিদ্বার,	হরিদ্বার,	
shekarone,	শেকারণে,	সেকারণে,	
bhorkendra,	ভরকেন্দ্র,	ভরকেন্দ্র,	
duuma,	দুইমা,	দুমা,	
zerusalemer,	জেরুসলেমের,	জেরুজালেমের,	
shikara,	শিকারা,	শিকার,	
sangbadmadhyame,	সংবাদমধধ্যমে,	সংবাদমাধ্যমে,	
shomser,	শমসের,	সমশের,	
fitarsaho,	ফিতারসহ,	ফিতরসহ,	
vittio,	ভিত্তিও,	ভিত্তিও,	
muktilav,	মুক্তিলাভ,	মুক্তিলাভ,	
tukrowti,	টুক্রটটি,	টুকরোটি,	
akar,	আকার,	একার,	
pinogbagke,	পিনোগবাজকে,	পিনগবাগকে,	
dhangsantup,	ধ্বংস্তুপ,	ধ্বংসন্তুপ,	
oyebjin,	ওয়েজবিন,	ওয়েবজিন,	
gannaprakasham,	গণ্্পর্বচাম,	গন্নাপ্রকাশম,	
shilpajata,	শিল্পাজতা,	শিল্পজাত,	
nagorikderkey,	নাগরিকদেরকে,	নাগরিকদেরকে,	
durgatsober,	দুর্গাতসবের,	দুর্গোৎসবে,	
nirbaahe,	নির্বাহে,	নির্বাহে,	
bhadaka,	ভাদাকা,	ভদকা,	
sealvi,	সেলভি,	সিলভি,	
wedanta,	ওয়েডন্টা,	বেদান্ত,	
lagche,	লাগছে,	লাগছে,	
chokrantosoho,	চক্রান্তসহ,	চক্রান্তসহ,	
bhagno,	ভাগনো,	ভগ্ন,	
chhayi,	ছাই,	ছাই,	
sheekar,	শেকার,	শিকার,	
times,	টিমেস,	টাইমস্,	
srabosty,	শ্রাবস্তি,	শ্রাবস্তী,	
rata,	রতা,	রত,	
mumtajer,	মুমতাজের,	মুমতাজের,	
dubaate,	দুবাতে,	ডুবাতে,	
bodhirta,	বোধিরটা,	বধিরতা,	
orthoneeti,	অর্থনিতি,	অর্থনীতির,	
horash,	হোরাশ,	হোরাস,	
kagbeni,	কাগবেনি,	কাগবেনি,	
deenesh,	দেনেশ,	দীনেশ,	
chaudhurider,	চৌধুরীদের,	চৌধুরীদের,	
manushe,	মনুষে,	মানুষে,	
stagecraft,	স্টোজেক্্যাক্যাক,	স্টেজক্রাফট,	
militarite,	মিলিটিরিতে,	মিলিটারিতে,	
mekon,	মেকন,	মেকং,	
ixprission,	আক্সপ্রিশন,	এক্সপ্রেশন,	
nathibhuktir,	নথিভুক্তির,	নথিভুক্তির,	
gujob,	গুজব,	গুজব,	
mukhya,	মুখ্যা,	মুখ্য,	
mach,	মাছ,	মাছ,	
swadesh,	স্বদেশ,	স্বদেশ,	
accountdharira,	অক্রুন্দ্ররার,	একাউন্টধারীরা,	
hames,	হামেস,	হোমস,	
indra,	ইন্দ্র,	ইন্দ্র,	
tigmanshu,	টিগমানশু,	তিগমংশু,	
kuttake,	কুট্টাকে,	কুত্তাকে,	
paikgachha,	পাইকগাছা,	পাইকগাছা,	
spashtotai,	স্পষ্টতাই,	স্পষ্টতই,	
mithener,	মিথেনের,	মিথেনের,	
zeeland,	জিলান্ড,	জিল্যান্ড,	
bhogno,	ভগ্ন,	ভগ্ন,	
venice,	ভেনিসে,	ভেনিস,	
jaandrel,	জাযান্ড্রেল,	জাঁদরেল,	
gronther,	গ্রন্থের,	গ্রন্থের,	
plate,	প্লেট,	প্লেট,	
musalmani,	মুসলমানি,	মুসলমানই,	
siqh,	সিক,	শিখ,	
zoubankal,	যৌবাকলা,	যৌবনকাল,	
tyapa,	ত্যাপা,	ট্যাপ,	
mozdur,	মজদুর,	মজদুর,	
dai,	ডাই,	দিই,	
chanoo,	চানোও,	চানু,	
shhepha,	শেফা,	শেফ,	
kei,	কেই,	কেই,	
baieq,	বাইয়েক,	বাইক,	
aakaabaar,	আকাবর,	আকাবার,	
aflatoxin,	আফলাটোকিক,	আ্যফ্ল্যাটক্সিন,	
teenej,	টেনিজ,	টিনেজ,	
assexe,	অ্যাসেটসে,	অ্যাসেক্সে,	
eupheike,	ইছেইউকে,	ইউফেইকে,	
canflikt,	ক্যাফফ্লিক্ট,	কনফ্লিক্ট,	
fatkabazare,	ফাতকাবাজারে,	ফাটকাবাজারে,	
ekspression,	এক্সপ্রেশন,	এক্সপ্রেশন,	
gobeshana,	গোবেশনা,	গবেষনা,	
treend,	ট্রেন্ড,	ট্রেন্ড,	
besirbhaagi,	বেশারবিগায়,	বেশিরভাগই,	
ghenshei,	ঘেনশেই,	ঘেঁষেই,	
hijri,	হিজরি,	হিজরী,	
iksaprishana,	ইক্সপারিশন,	এক্সপ্রেশন,	
muhaiminer,	মুহাইমিনের,	মুহাইমিনের,	
cinemapremider,	সিনেমাপ্রেমীদের,	সিনেমাপ্রেমীদের,	
edaningkale,	এডানিংকালে,	ইদানীংকালে,	
chilona,	চিলোনা,	ছিলনা,	
korush,	করুশ,	ক্রুশ,	
jhijhi,	ঝিঝি,	ঝিঝি,	
gronthoti,	গ্রন্থটি,	গ্রন্থটি,	
munsi,	মুনসি,	মুন্সী,	
choukato,	চৌকাতো,	চৌকাত,	
nothiboddho,	নথিবদ্ধ,	নথিবদ্ধ,	
aatto,	আটতো,	আত্ম,	
abheedhanik,	অভিধানিক,	অভিধানিক,	
sbajan,	স্বজন,	স্বজন,	
kuronir,	কুরনীর,	কুরনীর,	
deqe,	ডিকে,	ডেকে,	
dhache,	ধাছে,	ধাঁচে,	
shniper,	শ্নিপের,	স্নাইপার,	
teoner,	টেওনের,	টিওনার,	
infarmatian,	ইনফ্রামাইিয়ান,	ইনফরমেশন,	
blyaka,	ব্লাইকা,	ব্ল্যাক,	
artherer,	আর্থেরের,	আর্থারের,	
dijmarescu,	ডিজারসমেটু,	দিজমার্সাকু,	
conservetion,	কনভারসেশন,	কনসারভেশন,	
poddhotiteyi,	পদ্ধতিতেই,	পদ্ধতিতেই,	
fokskon,	ফক্সন,	ফক্সকন,	
pyor,	প্যার,	পিওর,	
vagni,	ভাগনি,	ভগ্নী,	
shnaipara,	শ্নাইপারা,	স্নাইপার,	
quota,	কুওয়াতা,	কোটা,	
sahozlabhbhotar,	সহযোজ্যভক্রা,	সহজলভ্যতার,	
elakai,	এলাকাই,	এলাকাই,	
juboke,	যুবকে,	যুবকে,	
faaj,	ফাজ,	ফাজ,	
neshnosh,	নেশনশ,	নেশনস,	
uthhaane,	উঠানে,	উঠানে,	
anagarikra,	অনাগরিকরা,	অনাগরিকরা,	
graambaashee,	গ্রামবাশী,	গ্রামবাসী,	
aieesha,	আইইস,	আইএএস,	
dala,	ডালা,	দলা,	
sumeeta,	সুমাত,	সুমিতা,	
horeepur,	হরিপুর,	হরিপুর,	
beila,	বেইলা,	বেইলা,	
capshule,	ক্যাসফুলে,	ক্যাপসুল,	
maley,	মালে,	মালে,	
bhittimul,	ভিত্তিমূল,	ভিত্তিমূল,	
dada,	দাদা,	দাদা,	
karmokarke,	কার্মকারকে,	কর্মকারকে,	
turista,	তুরিস্তা,	টুরিস্ট,	
daltagi,	দলতাগী,	দলত্যাগী,	
pujit,	পুজিত,	পুজিত,	
rohinibabu,	রোহিনিবাবু,	রোহিনীবাবু,	
jansha,	জননা,	জন্স,	
manab,	মানব,	মানব,	
bidhirnityang,	বিধির্নিতিয়াং,	বিধির্নিত্যং,	
grambaaseeder,	গ্রামবাসীদের,	গ্রামবাসীদের,	
omkar,	ওমকার,	ওঙ্কার,	
aabarte,	আবার্তে,	আবর্তে,	
mesenjjar,	মেসেঞ্জার,	মেসেঞ্জার,	
dooburir,	ডুবুরির,	ডুবুরির,	
premoronge,	প্রেমোরোগে,	প্রেমরঙে,	
scholars,	স্কোলার্স,	স্কলার্স,	
chalake,	চালাকে,	চালকে,	
akhandota,	আখন্দতা,	অখণ্ডতা,	
motabolombira,	মোতাবলম্বীরা,	মতাবলম্বীরা,	
cathalic,	ক্যাথালিক,	ক্যাথলিক,	
trutimatra,	ত্রুতিমাত্রার,	ত্রুটিমাত্র,	
naneer,	নানির,	নানীর,	
brindaboney,	বৃন্দাবনে,	বৃন্দাবনে,	
rahi,	রহি,	রাহী,	
tachnach,	তচ্চান,	তছনছ,	
dufresne,	ডাফারসেন,	ডুফরেস্ন,	
birishiritey,	বিরিশিরিতে,	বিরিশিরিতে,	
qulim,	কুলিম,	কুলিং,	
parshwer,	পার্শ্বের,	পার্শ্বের,	
bihar,	বিহার,	বিহার,	
shakara,	শাকারা,	সাকার,	
uddhritto,	উদ্ধৃত্ত,	উদ্ধৃত,	
dipankar,	দিপানকার,	দিপঙ্কর,	
nabotom,	নববো,	নবতম,	
iub,	আইব,	আইইউবি,	
nabbata,	নবববতা,	নাব্যতা,	
jotota,	যতটা,	যতোটা,	
otyacharito,	অত্যাচারিত,	অত্যাচারিত,	
ucchosito,	উচ্চািত,	উচ্ছসিত,	
qraima,	ক্রাইমা,	ক্রাইম,	
rajtantrey,	রাজতন্ত্রেও,	রাজতন্ত্রে,	
parka,	পারকা,	পার্ক,	
siima,	সিমা,	সীমা,	
sqalarashipa,	স্কালারাশিপা,	স্কলারশিপ,	
elakatike,	এলাকাটিকে,	এলাকাটিকে,	
aembed,	আ্বেড,	এম্বেড,	
pacbar,	পাযাবার,	পাঁচবার,	
batistambhatike,	বাতিস্তামতভাতে,	বাতিস্তম্ভটিকে,	
ikbaaler,	ইকবালের,	ইকবালের,	
swartho,	স্বার্থ,	স্বার্থ,	
lagchhe,	লাগছে,	লাগছে,	
hol,	হোল,	হোল,	
poddhotitei,	পদ্ধতিতেই,	পদ্ধতিতেই,	
aranyani,	অরণ্যননি,	অরণ্যানী,	
logotype,	লগোটিপ,	লোগোটাইপ,	
duiekdiner,	ডুয়ের্কিনের,	দুইএকদিনের,	
daktikit,	ডাক্তিকিত,	ডাকটিকিট,	
lahano,	লাহানো,	লাহানো,	
jeshh,	যেশ,	জেস,	
kaathhmaandute,	কাঠমানুুটকে,	কাঠমান্ডুতে,	
sampadon,	সম্পাদন,	সম্পাদন,	
deefinishion,	ডিফিশনশন,	ডেফিনেশন,	
dooburira,	ডুবুরিরা,	ডুবুরিরা,	
plusey,	প্লুসে,	প্লাসে,	
hul,	হুল,	হুল,	
rashedul,	রাশেদুল,	রাশিদুল,	
arashie,	আরাশিয়,	আরসিএ,	
quata,	কুয়াতা,	কোটা,	
teemothi,	তিমথি,	টিমোথি,	
konistho,	কনিষ্ঠ,	কনিষ্ঠ,	
korimpur,	করিমপুর,	করিমপুর,	
gandagol,	গণ্ডাগোলো,	গন্ডগোল,	
srisri,	শ্রীশ্রী,	শ্রীশ্রী,	
roktokhoron,	রক্ষকরণ,	রক্তক্ষরণের,	
nischitvabe,	নিশ্চিতভাবে,	নিশ্চিতভাবে,	
foxer,	ফক্সের,	ফক্সের,	
bupher,	বুফার,	বাফার,	
peterke,	পেটারকে,	পিটারকে,	
sallallahu,	সাল্লাল্লাহু,	সল্লাল্লাহু,	
daakticketer,	ডাক্টিকেটকের,	ডাকটিকিটের,	
jaanar,	জানার,	জানার,	
maudelgulo,	মাউদেলগুলো,	মডেলগুলো,	
nili,	নিলি,	নিলি,	
megacaldera,	মেগাকেলদরা,	মেগাক্যাল্ডেরা,	
elakayi,	এলাকায়,	এলাকাই,	
shukrabab,	শুক্রবাব,	শুক্রবাব,	
kayech,	কয়েছ,	কায়েছ,	
proteemar,	প্রতিমার,	প্রতিমার,	
anisa,	অনিসা,	আনিস,	
parikha,	পারিখা,	পরিখার,	
pluck,	প্লুক,	প্ল্যাক,	
nirbahey,	নির্বাহে,	নির্বাহে,	
shariba,	শরীবা,	শরিবা,	
glanio,	গ্লানিও,	গ্লানিও,	
swostir,	স্বস্তির,	স্বস্তির,	
samle,	সামলে,	সামলে,	
skolarsip,	স্কলার্িপ,	স্কলারশিপ,	
steeit,	স্টিইট,	স্টেইট,	
abheedhanic,	অভিধানিক,	অভিধানিক,	
tunaita,	টুনাইটা,	টুনাইট,	
indro,	ইন্ড্রো,	ইন্দ্র,	
qor,	করর,	কর,	
sangkoolan,	সংকোললান,	সংকুলান,	
bajhyo,	বাঝ্য,	বাহ্য,	
nisader,	নিসাদের,	নিষাদের,	
ipl,	ইইপিএল,	আইপিএল,	
fakhrul,	ফখরুল,	ফাখরুল,	
rakim,	রকিম,	রাকিম,	
somoodrotote,	সমরদত্ততে,	সমুদ্রতটে,	
saurce,	সার্সে,	সোর্স,	
patjata,	পাটজাতা,	পাটজাত,	
dushtogone,	দুষ্টগণে,	দুষ্টগণে,	
sorano,	সোরানো,	সরানো,	
debdebie,	দেবদেবী,	দেবদেবী,	
senior,	সেনিওর,	সিনিয়র,	
ji,	জিআইএ,	জি,	
niemond,	নিইমন্ড,	নিমন্ড,	
aizulke,	আইজুলকে,	আইজুলকে,	
sithilota,	সিথিলতা,	শিথিলতা,	
majlishpur,	মজ্লিশপুর,	মজলিশপুর,	
prime,	প্রিমে,	প্রাইম,	
vogiroth,	ভগিরথ,	ভগীরথ,	
horiddare,	হরিদ্দারে,	হরিদ্বারে,	
ceramicer,	সেরিমাসের,	সিরামিকের,	
brittakarey,	বৃত্তকারেও,	বৃত্তাকারে,	
breqathru,	ব্রেকারুর,	ব্রেকথ্রু,	
bharatey,	ভারাতে,	ভারতে,	
kaleo,	কালেও,	কালেও,	
sucre,	সাক্রে,	সাকার,	
baasaate,	বাসাতে,	বাসাতে,	
sossar,	সোসার,	সকার,	
oncoltike,	অনকোলিকে,	অঞ্চলটিকে,	
sangitanusthane,	সঙ্গীতান্ত্শনে,	সঙ্গীতানুষ্ঠানে,	
taufik,	তাউফিক,	তৌফিক,	
baait,	বাইত,	বাইট,	
prangulo,	প্রাণগুলো,	প্রানগুলো,	
shomostigoto,	শমস্তিগত,	সমষ্টিগত,	
asamorik,	আসামৌরিক,	অসামরিক,	
brittakar,	বৃত্তকার,	বৃত্তাকার,	
arthonitir,	অর্থনীতির,	অর্থনীতির,	
turkii,	তুরকিই,	তুর্কি,	
miraqela,	মিরাকেলা,	মিরাকেল,	
bakhyateet,	বাখ্যাতিত,	ব্যাখ্যাতীত,	
nabayug,	নবায়ুগ,	নবযুগ,	
neerbahi,	নির্বাহী,	নির্বাহি,	
scholastic,	স্কোলাস্টিক,	স্কলাস্টিক,	
aziza,	আজিজা,	আজিজা,	
chiroharit,	চিরহহারিত,	চিরহরিৎ,	
chetanagoto,	চেতানাগত,	চেতনাগত,	
mankisundar,	মান্কিসুন্দর,	মানকিসুন্দর,	
chitronattakar,	চিত্রনাত্রকার,	চিত্রনাট্যকার,	
eesosiyeetasa,	ইসসিওসিয়া,	এসোসিয়েটস,	
dhhaabi,	ধাবি,	ঢাবি,	
nirapattamulok,	নিরাপতত্মমূলক,	নিরাপত্তামূলক,	
shasankarta,	শাসনকর্তা,	শাসনকর্তা,	
neerbachoker,	নির্বাচকের,	নির্বাচকের,	
ujbekistaner,	উজ্েবিক্সেনের,	উজবেকিস্তানের,	
dakshinangsho,	দক্ষিণাংশ,	দক্ষিণাংশ,	
dhwajbhango,	ধ্বাজজন্গ,	ধ্বজভঙ্গ,	
survative,	সুরভাতিভ,	সারভেটিভ,	
grahoksebai,	গ্রাহকসসাইকেই,	গ্রাহকসেবায়,	
serup,	সেরুপ,	সেরূপ,	
reejideencee,	রিজিডিন্স,	রেসিডেন্স,	
eokee,	ইওক,	এওকি,	
volivoler,	ভলিভলের,	ভলিভলের,	
murader,	মুরাদের,	মুরাদের,	
koordider,	কোর্ডিদের,	কুর্দিদের,	
mathews,	ম্যাথেস,	ম্যাথিউস,	
nazad,	নাজাদ,	নাজাদ,	
siraju,	সিরাজু,	সিরাজু,	
siqhar,	সিখার,	শিকার,	
sharthe,	শার্থে,	স্বার্থে,	
drissoke,	দৃশ্যকে,	দৃশ্যকে,	
habol,	হাবল,	হাবোল,	
parqim,	পারকিম,	পার্কিং,	
hood,	হুড,	হুড,	
paripakey,	পািপাকে,	পরিপাকে,	
schilling,	স্কিলিং,	শিলিং,	
oporishodhito,	অপরিষিধত,	অপরিশোধিত,	
khoka,	খোকা,	খোকা,	
choddo,	চড্্য,	চোদ্দো,	
bouddha,	বৌদ্ধা,	বৌদ্ধ,	
phood,	ফুড,	ফুড,	
durotamo,	দুরততমামো,	দূরতম,	
dakope,	ডাকোপে,	দাকোপ,	
snehban,	স্নেহবান,	স্নেহবান,	
ramantic,	র্ম্যান্টিক,	রোমান্টিক,	
tapdei,	টাপদেই,	তাপড়েই,	
angshogrohon,	অংশগ্রহণ,	অংশগ্রহন,	
shorifer,	শরিফের,	শরিফের,	
santaa,	সান্তা,	সান্তা,	
prakalpatike,	প্রকল্পতিকে,	প্রকল্পটিকে,	
aashanka,	আশানকা,	আশংকা,	
ghoomachhilo,	ঘোমাছিল,	ঘুমাচ্ছিল,	
gondhe,	গন্ধে,	গন্ধে,	
aosafur,	আওসাফুর,	আওশাফুর,	
nosihote,	নসিহতে,	নসিহতে,	
pradoshik,	প্রাদশিক,	প্রাদশিক,	
tecno,	টেকনো,	টেকনো,	
satyaky,	সত্যাকি,	সাত্যকি,	
prosadhoni,	প্রসাধনি,	প্রসাধনী,	
engreziteo,	এংগ্রেজিতেও,	ইংরেজিতেও,	
fasi,	ফাসি,	ফাঁসী,	
jaaygata,	জায়গাতা,	জায়গাটা,	
ganosachetanata,	গণসচেতনতা,	গণসচেতনতা,	
bondhuvabaponyo,	বন্ধুভাবপা্য,	বন্ধুভাবাপন্ন,	
amarika,	আমারিকা,	আমেরিকা,	
graambasider,	গ্রামবাসীদের,	গ্রামবাসীদের,	
khargosher,	খার্োশের,	খরগোসের,	
mukhyo,	মুখ্য,	মুখ্য,	
jaanachhe,	জানাচে,	জানাচ্ছে,	
arasie,	আরাসিয়ে,	আরসিএ,	
neshadrabyer,	নেশাদ্রব্যের,	নেশাদ্রব্যের,	
bajite,	বাজিতে,	বাজিতে,	
songasthatike,	সংস্থাতটিকে,	সংস্থাটিকে,	
himchi,	হিমচি,	হিমচি,	
deputi,	ডিপুটি,	ডেপুটি,	
temanti,	টেমন্তি,	তেমনটি,	
monchosthol,	মঞ্চস্থল,	মঞ্চস্থল,	
felto,	ফেলটো,	ফেলত,	
ispredseet,	ইসপ্রেডিসট,	স্প্রেডশীট,	
prokolpogulor,	প্রকল্পগুলোর,	প্রকল্পগুলোর,	
monur,	মনুর,	মনুর,	
mooney,	মুনে,	মুনে,	
bhramarotsab,	ভ্রামারতসব,	ভ্রমরোৎসব,	
podotyagsongkranto,	পদত্যাংসংক্রান্ত,	পদত্যাগসংক্রান্ত,	
kaalaam,	কালাম,	কালাম,	
baarnish,	বার্নিশ,	বার্নিশ,	
malinga,	মালিঙ্গা,	মালিংগা,	
karuna,	কারুনা,	করুণা,	
kharar,	খারার,	খরার,	
reliance,	রিলিয়ান্স,	রিলায়েন্স,	
kani,	কানি,	কানি,	
deebug,	দেবুগ,	ডিবাগ,	
breel,	ব্রিল,	ব্রিল,	
aalaa,	আলা,	আলা,	
adhunikkaley,	অধুনিককালে,	আধুনিককালে,	
magar,	মাগার,	মাগার,	
oichchheek,	ঐচচচিক,	ঐচ্ছিক,	
path,	পাঁথ,	পাথ,	
edaning,	এডানিং,	ইদানিং,	
liaodong,	লিয়াওজং,	লিয়াওদং,	
abadamoner,	আবাদনমের,	অবদমনের,	
grambaasi,	গ্রাম্বাসী,	গ্রামবাসী,	
ghomta,	ঘোমটা,	ঘোমটা,	
rca,	আরএসএ,	আরসিএ,	
phising,	ফিসিং,	ফিসিং,	
besur,	বেসুর,	বেসুর,	
kindom,	কিন্দম,	কিংডম,	
machsoho,	মাচসহ,	মাছসহ,	
gitikobita,	গীতিবতিকা,	গীতিকবিতা,	
nanir,	নানির,	নানীর,	
chasee,	চাসে,	চেস,	
mercial,	মার্সিয়াল,	মার্শিয়াল,	
jibanto,	জীবন্ত,	জীবন্ত,	
puroheetder,	পুরোহিতদের,	পুরোহিতদের,	
nachar,	নাচার,	নাচার,	
caramiks,	কারামিক্স,	সিরামিকস,	
oncholgulir,	অঞ্চলগুলির,	অঞ্চলগুলির,	
digrir,	ডিগ্রির,	ডিগ্রির,	
prasadhoni,	প্রসাধনি,	প্রসাধনী,	
asthishondhi,	অস্থিসন্ধি,	অস্থিসন্ধি,	
ghumachche,	ঘুমাচ্ছে,	ঘুমাচ্ছে,	
shten,	শ্টেন,	স্টেন,	
zesa,	জেসা,	জেস,	
antorvukta,	অন্তর্ভুক্ত,	অন্তর্ভুক্ত,	
jerusaleme,	জেরুসালেমে,	জেরুসালেমে,	
bornanukrome,	বর্ণানুককর্মে,	বর্নানুক্রমে,	
ruble,	রুবলে,	রুবল,	
torunra,	টরুনার,	তরুণরা,	
juakhelar,	জুয়াখেলার,	জুয়াখেলার,	
tep,	টেপ,	ট্যাপ,	
niknayman,	নিকনায়মান,	নিকনেইমান,	
azimpur,	অজিমপুর,	আজিমপুর,	
dologuloo,	দলগুলো,	দলগুলোও,	
nutaner,	নুটানের,	নূতনের,	
manohputa,	মানসগুতা,	মনঃপুত,	
langhaner,	লঙ্ঘনের,	লংঘনের,	
godabari,	গোদাবারী,	গোদাবরী,	
euqalyptus,	ইউকাল্ডগুস,	ইউক্যালিপ্টাস,	
pushtee,	পুষ্টি,	পুষ্টি,	
uddharkarmirai,	উদ্ধারকারমুরাই,	উদ্ধারকর্মীরাই,	
yanqee,	যানকি,	ইয়াংকি,	
gonesher,	গনেশের,	গণেশের,	
purple,	পার্পল,	পার্পেল,	
protijogi,	প্রতিযোগী,	প্রতিযোগী,	
korkotkraantee,	কর্কক্ত্রন্ত্য,	কর্কটক্রান্তি,	
seguloi,	সেগুলোই,	সেগুলোই,	
porobortii,	পরবর্তই,	পরর্বতী,	
swadhinotatukui,	স্বাধীনততটুকুই,	স্বাধীনতাটুকুই,	
bone,	বনে,	বনে,	
chikkingsasoho,	চিক্সিংচসহ,	চিকিংসাসহ,	
prrajanankaal,	প্রজানকালাল,	প্রজননকাল,	
qyapasula,	ক্যাপাসুলা,	ক্যাপসুল,	
mukhmondole,	মুখমন্ডলে,	মুখমণ্ডলে,	
humner,	হামনার,	হামনার,	
manir,	মানির,	মনির,	
chargar,	চারগার,	চার্জার,	
helloin,	হেল্লিন,	হ্যালোইন,	
abhiyojan,	অভিয়াজন,	অভিযোজন,	
enjineers,	এঞজিনান্স,	ইঞ্জিনিয়ার্স,	
angsogrohone,	অংশগ্রহণে,	অংশগ্রহনের,	
eexpreession,	ইক্সপ্রিশনশন,	এক্সপ্রেশন,	
samanwitovabe,	সমান্তিবাবকে,	সমন্বিতভাবে,	
flexta,	ফ্লেক্সটা,	ফ্লেক্সটা,	
bojhe,	বোঝে,	বোঝে,	
generalissimo,	জেনারিলামিসিয়াম,	জেনারেলিসিমো,	
kash,	কাশ,	কাস,	
shourshe,	শৌর্শে,	সোর্স,	
gyada,	গ্যাদা,	গ্যাদা,	
kiibord,	কিউবার্ড,	কীবোর্ড,	
jonesh,	জনেশ,	জোন্স,	
udbhaboney,	উদ্ভাবনে,	উদ্ভাবনে,	
purborekorde,	পূর্বরককেরে,	পূর্বরেকর্ডে,	
mitroder,	মিত্রদের,	মিত্রদের,	
shikshagata,	শিক্ষাগতা,	শিক্ষাগত,	
farna,	ফারনা,	ফার্ন,	
adarsho,	আদার্শ,	আর্দশ,	
ansarir,	আনসারীর,	আনসারীর,	
toufik,	তৌফিক,	তৌফিক,	
kommandar,	কমম্যান্ডার,	কমাণ্ডার,	
munim,	মুনিম,	মুনিম,	
gyandaas,	জ্ঞানদাস,	জ্ঞানদাস,	
bolbo,	বলবো,	বলবো,	
dola,	দোলা,	দলা,	
carloos,	ক্যারলোস,	কার্লোস,	
jomoker,	জমকের,	জমকের,	
mmehonoti,	ম্মুহননতি,	মেহনতি,	
aaps,	এপিএস,	এএপিএস,	
ovinetar,	অভিনেতার,	অভিনেতার,	
khoor,	খোর,	ক্ষুর,	
aporishodhito,	অপরিষাধিত,	অপরিশোধিত,	
bangalore,	বাঙ্গালোরে,	ব্যাঙ্গালুরে,	
sangram,	সংগ্রাম,	সঙ্গ্রাম,	
toptoshele,	টপ্তশেলে,	তপ্তশেলে,	
probhur,	প্রভুর,	প্রভুর,	
youth,	যৌউথ,	ইয়ুথ,	
chhon,	ছোন,	ছোঁ,	
modhumotii,	মধুমতিই,	মধুমতী,	
korle,	করলে,	করলে,	
koyekbare,	কয়েকবারে,	কয়েকবারে,	
recondishon,	রেকন্দিশন,	রিকন্ডিশন,	
rakhtokkharone,	রাখতক্ষণণে,	রক্তক্ষরণে,	
showtey,	শুরে,	শোতে,	
kyatagorir,	ক্যাটাগরীর,	ক্যাটাগরির,	
byabostho,	ব্যবস্থ,	ব্যাবস্থা,	
jaubankal,	যৌবনকাল,	যৌবনকাল,	
shiter,	শীতের,	শীতের,	
probondhobhittik,	প্রবন্ধভিত্তিক,	প্রবন্ধভিত্তিক,	
scholarship,	স্কলারশিপ,	স্কলারশিপ,	
sushposhtolikhito,	সুষ্পশিল্খিত,	সুষ্পষ্টলিখিত,	
vobanipur,	ভবানিপুর,	ভবানীপুর,	
russad,	রুসাদ,	রুশদ,	
gaddaphii,	গডড্াফি,	গাদ্দাফী,	
anchalo,	অঞ্চললো,	অঞ্চলও,	
purbanchaler,	পূর্বাঞ্চলের,	পূর্বাঞ্চলের,	
laaz,	লাজ,	লাজ,	
rajashri,	রাজশ্রী,	রাজশ্রী,	
ishton,	ইশ্তন,	স্টোন,	
bulan,	বুলান,	বুলান,	
veniser,	ভেনিসের,	ভেনিসের,	
panchashjan,	পঞ্চাশজন,	পঞ্চাশজন,	
bardhitansh,	বার্ধিতা্স,	বর্ধিতাংশ,	
wrighter,	ওযাগথার,	রাইটের,	
thandabhabe,	থাঁটাভাবে,	ঠাণ্ডাভাবে,	
balatarin,	বালাতারিন,	বালাতারিয়ান,	
basermick,	বেসারমিক,	বেসারমিক,	
rinobodh,	ঋণবোধ,	ঋণবোধ,	
kayed,	কায়েদ,	কায়েদ,	
neemeetto,	নিমিত্তো,	নিমিত্ত,	
daaun,	ডাউন,	ডাউন,	
sift,	সিফ্ট,	শিফট,	
moshzidtike,	মসজিদিত্ে,	মসজিদটিকে,	
maner,	ম্যানার,	মানে,	
zonsa,	জনসা,	জোন্স,	
shekender,	শেকেন্দার,	সেকেন্ডের,	
grambaasheeo,	গ্রামবাশীয়,	গ্রামবাসীও,	
seekkhokbrindo,	সিক্ষককৃন্দ,	শিক্ষকবৃন্দ,	
dharavahik,	ধারাভাহিক,	ধারাবাহিক,	
varma,	ভারমা,	ভার্মা,	
spredsheet,	স্প্রেশশিত,	স্প্রেডশীট,	
shitei,	শিতেই,	শীতেই,	
prokolpoti,	প্রকল্পটি,	প্রকল্পটি,	
muktijuddhojato,	মুক্তিযুদ্ধাতাও,	মুক্তিযুদ্ধজাত,	
poschimey,	পশ্চিমে,	পশ্চিমে,	
biswashi,	বিশ্বাশি,	বিশ্বাসী,	
mukhamandoler,	মুখমন্ডলের,	মুখমণ্ডলের,	
byaptikaler,	ব্যাপ্তিকালের,	ব্যাপ্তিকালের,	
shhikara,	শিকারা,	শিকার,	
milayatane,	মিলায়াতনে,	মিলায়তনে,	
onshogrohoner,	অংশগ্রহণের,	অংশগ্রহনের,	
siddhantei,	সিদ্ধান্তেই,	সিদ্ধান্তেই,	
sakshatkarer,	সাক্ষাতকরের,	সাক্ষাৎকারের,	
suchanakal,	সুচানকাল,	সূচনাকাল,	
norpholk,	নরফলক,	নরফোক,	
eshtonia,	এস্তোনিয়া,	এস্তোনিয়া,	
sompadon,	সম্পাদন,	সম্পাদন,	
abhirupbabuke,	অভিরূপ্বাবুকে,	অভিরূপবাবুকে,	
deenes,	ডিনেস,	দীনেশ,	
chaudhuriyo,	চৌধুরীয়,	চৌধুরীও,	
kanshater,	কাশনাতের,	কানসাটের,	
bite,	বিতে,	বাইট,	
devolapar,	দেবলাপার,	ডেভলপার,	
muradke,	মুরাদকে,	মুরাদকে,	
taunship,	টাউনশিপ,	টাউনশিপ,	
shukraanoo,	শুক্রাওও,	শুক্রানু,	
sahinsatar,	সহিষ্নতার,	সহিংসতার,	
tochhnochh,	টচ্চন,	তছনছ,	
koota,	কোটা,	কোটা,	
heawy,	হেওয়,	হেভি,	
ghoorchen,	ঘোরছেন,	ঘুরেছেন,	
harza,	হার্জা,	হার্জ,	
poribahokotto,	পরিবাহকত্ত,	পরিবাহকত্ব,	
jarmaniteo,	জার্মানিতেও,	জার্মানিতেও,	
hosto,	হোস্তো,	হস্ত,	
aakkaash,	আক্ষাশ,	আককাস,	
manober,	মানোবের,	মানবের,	
aalkaatra,	আলকাত্রার,	আলকাতরা,	
summer,	সুম্মের,	সামার,	
akkaas,	আক্সাস,	আককাস,	
kanasharabheshhana,	কানাশারসেশন,	কনসারভেশন,	
osomorthito,	অসমর্থিত,	অসমর্থিত,	
bhageri,	ভাগেরই,	ভাগেরই,	
mette,	মেট্টে,	ম্যাট,	
chalachchitroke,	চালাচ্ছিত্রকে,	চলচ্চিত্রকে,	
oitijjha,	ঐতিহ্যা,	ঐতিহ্য,	
mutar,	মুতার,	মুতার,	
kanthar,	কান্থার,	কাঁথার,	
dhos,	ধোস,	ধস,	
bhabaponno,	ভাবামন্ন,	ভাবাপন্ন,	
kobulennechha,	কবুলেননেছা,	কবুলেন্নেছা,	
mukhobondho,	মুখবন্ধ,	মুখবন্ধ,	
anhu,	আনহু,	আনহু,	
maadla,	মাদলা,	মাদলা,	
kormoke,	কর্মকে,	কর্মকে,	
kadakhonchar,	কাদাখাঁচার,	কাদাখোঁচার,	
umb,	ইউএমবি,	ইউএমবি,	
boshoborti,	বসবত্তী,	বশবর্তী,	
nuhas,	নুহাস,	নুহাশ,	
seshardhe,	সেশার্ধে,	শেষার্ধে,	
thaanobhi,	থানোভি,	থানভী,	
mekong,	মেকং,	মেকং,	
chikitsanirbhar,	চিকিৎসানির্ভর,	চিকিৎসানির্ভর,	
jamseder,	জামসেদের,	জামসেদের,	
edseler,	এডসেলের,	এডসেলের,	
heepatitis,	হিপাটিটিস,	হেপাটাইটিস,	
lutharen,	লুথারেন,	লুথেরান,	
dembakreeti,	দেমবাকৃতি,	ডিম্বাকৃতি,	
shatoke,	শাতকে,	শতকে,	
simantarkkhibahinir,	সীমান্তারবিকর্মাহীর,	সীমান্তরক্ষীবাহিনীর,	
teoyana,	তেওয়ানা,	তাইওয়ান,	
bosben,	বসবেন,	বসবেন,	
prijon,	প্রিজন,	প্রিজন,	
amanisha,	আমানিশা,	অমানিশা,	
aditisaha,	আদিতিসহ,	অদিতিসহ,	
konisttha,	কোনিস্তা,	কনিষ্ঠ,	
chakrapani,	চক্রপানি,	চক্রপানী,	
beam,	বিআইএম,	বিম,	
titarer,	তিতারের,	তিতারের,	
chhooti,	ছোটি,	ছুটি,	
chetanagato,	চেতানাগত,	চেতনাগত,	
songasthatir,	সংস্থাতটির,	সংস্থাটির,	
shresthoshcho,	শ্রেষ্ঠস্চ,	শ্রেষ্ঠশ্চ,	
suchonakal,	সুচনকাল,	সূচনাকাল,	
niutrino,	নিউট্রিনো,	নিউট্রিনো,	
ramachandranke,	রামাচন্দ্রনকে,	রামাচন্দ্রনকে,	
monir,	মনির,	মনির,	
ase,	আসে,	আসে,	
dwijenbabuder,	দ্বিজেনবাদিদের,	দ্বিজেনবাবুদের,	
matis,	মাতিস,	ম্যাটিস,	
jonomukhi,	জনমুখী,	জনমুখী,	
dobhaar,	দোভার,	ডোভার,	
bhowanipur,	ভোবাইনপুর,	ভবানীপুর,	
riazuddin,	রিয়াজুদ্দিন,	রিয়াজউদ্দীন,	
postay,	পোস্তায়,	পোস্টে,	
labonaktatar,	লাবনাকততার,	লবণাক্ততার,	
breq,	ব্রেক,	ব্রেক,	
jor,	জরর,	জ্বর,	
mulyayonsapekkhe,	মূল্যয়েসংচর্থকে,	মূল্যায়নসাপেক্ষে,	
kaale,	কালে,	কালে,	
madhumati,	মধুমতি,	মধুমতী,	
prosadhaner,	প্রসাধননের,	প্রসাধনের,	
bibecchyo,	বিবেচ্য,	বিবেচ্য,	
sangkulaan,	সংকুলাল,	সংকুলান,	
pack,	প্যাক,	প্ল্যাক,	
nakkal,	নকককাল,	নক্কল,	
ragei,	রাগেই,	রাগেই,	
sausagee,	সৌসগী,	সসেজ,	
jonmobhumitir,	জন্মভূমিতির,	জন্মভূমিটির,	
naazi,	নাজি,	নাত্সি,	
poripakey,	পরিপাকে,	পরিপাকে,	
rakshanbhag,	রক্ষণভাগ,	রক্ষণভাগ,	
elakatite,	এলাকাটিতে,	এলাকাটিকে,	
feroza,	ফেরোজা,	ফিরোজা,	
daaoon,	ডাওয়ান,	ডাউন,	
ekghare,	একঘরে,	একঘরে,	
guzon,	গুজন,	গুজব,	
boshoborty,	বসব্য্ত্,	বশবর্তী,	
dayitta,	দায়িত্তা,	দায়িত্ব,	
hertj,	হার্টজ,	হার্জ,	
sikara,	সিকারা,	শিকার,	
choritrotakeo,	চরিত্রতাকেও,	চরিত্রটাকেও,	
adbhanced,	অ্যাডভান্সেড,	অ্যাডভান্সড,	
opohoron,	অপহরণ,	অপহরন,	
otyacharer,	অত্যাচারের,	অত্যাচারের,	
bhardwaj,	ভার্দবাজ,	ভরদ্বাজ,	
phormat,	ফরমাত,	ফরম্যাট,	
pakhtunistan,	পাখতুন্তাসন,	পাখতুনিস্তান,	
mase,	মেস,	মাসে,	
orrgho,	অর্ঘ,	অর্ঘ্য,	
bbiswasho,	বুব্বশ্ব,	বিশ্বাসও,	
durgatsabe,	দুর্গাতসভাবে,	দুর্গোৎসবে,	
tatey,	টাযাটে,	তাতে,	
nopdnodir,	নপ্্দনীর,	নদনদীর,	
makame,	মাকামে,	মাকামে,	
manobikotao,	মানবিকতাও,	মানবিকতাও,	
antarvuktimulak,	অন্তর্ভুকিকামুলক,	অন্তর্ভুক্তিমূলক,	
laesensh,	লেসেন্স,	লাইসেন্স,	
bhittitei,	ভিত্তিতেই,	ভিত্তিতেই,	
monjooshree,	মঞ্জযৌশ্যী,	মঞ্জুশ্রী,	
shishu,	শিশু,	শিশু,	
pranibigyani,	প্রাণীবিজ্ঞানী,	প্রাণীবিজ্ঞানী,	
arg,	আর্গ,	আর্গ,	
pleeta,	প্লিতা,	প্লেট,	
shhashtra,	শাষ্ট্রা,	শাস্ত্র,	
bangobandhu,	বাংবনবধধু,	বঙ্গবন্ধু,	
shommoteer,	শম্মতির,	সম্মতির,	
harees,	হারিস,	হ্যারিস,	
geja,	গেজা,	গেজ,	
bm,	বিএম,	বিএম,	
difinishion,	ডিফিনিশন,	ডেফিনেশন,	
tophaat,	টোফাত,	তফাৎ,	
sqolastiq,	স্কলকস্তিক,	স্কলাস্টিক,	
bharotchilo,	ভারতচিল,	ভারতছিল,	
shudhir,	শুধীর,	শুধীর,	
laesens,	লেসেন্স,	লাইসেন্স,	
shubhag,	শুভাগ,	শুভাগ,	
rahee,	রাহি,	রাহি,	
samajikatar,	সমাজিকতার,	সামাজিকতার,	
protectionism,	প্রটেকটিশিয়াম,	প্রোটেকশনিজম,	
erajyobasi,	এরজ্যবাসী,	এরাজ্যবাসী,	
sheshdinti,	শেষদিনটি,	শেষদিনটি,	
chintakarma,	চিন্তাকর্মা,	চিন্তাকর্ম,	
bifol,	বিফলল,	বিফল,	
everestey,	ইভারেস্টে,	এভারেস্টে,	
antorvuktimulak,	অন্তর্ভককিকুমূলক,	অন্তর্ভুক্তিমূলক,	
neshnos,	নেশনস,	নেশনস,	
shattoki,	শত্তকি,	সাত্যকি,	
chaudhurio,	চৌধুরিও,	চৌধুরীও,	
baganoto,	বাগানোটো,	বাগানত,	
disposes,	ডিসপোসেস,	ডিসপোজেস,	
ratishilatai,	রতিশীলতাই,	রতিশীলতায়,	
gronthowo,	গ্রন্থও,	গ্রন্থও,	
patigoniter,	পাটিগনিতের,	পাটিগণিতের,	
balabhadra,	বালাভাদরা,	বলভদ্র,	
kortam,	কর্তম,	করতাম,	
niphelheim,	নিফেলহিইম,	নিফেলহেইম,	
babare,	বাবারে,	বাবারে,	
mastarsa,	মাস্টারসা,	মাস্টার্স,	
dokaanei,	ডোকানেই,	দোকানেই,	
greep,	গ্রিপ,	গ্রিপ,	
vaider,	ভাইদের,	ভাইদের,	
nibeditar,	নিবেদিতার,	নিবেদিতার,	
machgulo,	মাছগুলো,	মাছগুলো,	
drishyogulotey,	দৃশ্যগুলোতে,	দৃশ্যগুলোতে,	
ashok,	আশোক,	আশোক,	
ched,	চেদ,	ছেদ,	
himsrot,	হিমস্রোট,	হিমস্রোত,	
ogovir,	অগোভির,	অগভীর,	
institutione,	ইনস্টিটনউউন,	ইনস্টিটিউশনে,	
mukharji,	মুখারজি,	মুখার্জী,	
laatimer,	লািমের,	লাটিমের,	
whole,	ফোল,	হোল,	
station,	স্টেশন,	ষ্টেশন,	
byabosthar,	ব্যবস্থার,	ব্যাবস্থার,	
rohosyo,	রহস্য,	রহস্য,	
byaboharkarike,	ব্যবহারকারীকে,	ব্যবহারকারীকে,	
sarsa,	সারসা,	সোর্স,	
uthe,	উঠে,	উঠে,	
nichols,	নিচলস,	নিকলস,	
paira,	পাইরা,	পাইরা,	
andra,	আন্দ্রা,	আন্ড্রা,	
agamane,	আগামানে,	আগমনে,	
dijijer,	দিজিজের,	ডিজিজের,	
teentir,	টেনটির,	তিনটির,	
sabrakamer,	সব্রকামের,	সবরকমের,	
nomo,	নম,	নমো,	
bayshorkarikarone,	বায়শ্রকীকরণেও,	বেসরকারিকরণ,	
taalaal,	তালাল,	তালাল,	
meloonborroner,	মেলনব্রনের,	মেলবোর্নের,	
qredita,	ক্রেডিটা,	ক্রেডিট,	
janghu,	জাংঘু,	জঙ্ঘু,	
rajendracholer,	রাজেন্দ্রকালের,	রাজেন্দ্রচোলের,	
oedipus,	ওডিপাস,	ইডিপাস,	
shasyadi,	শাস্যদি,	শস্যাদি,	
padee,	পাদ়ে,	পাড়ে,	
kada,	কাদা,	কোডা,	
haitasha,	হাইতাসা,	হাইটস,	
swasthohinotay,	স্বাস্থ্যহীনতায়,	স্বাস্থ্যহীনতায়,	
taposgoner,	টাপসগণের,	তাপসগণের,	
annimated,	অন্মিনাতেদ,	এনিমেটেড,	
bhenise,	ভেনিসে,	ভেনিসে,	
ispredsheet,	ইসপ্রেদ্থিত,	স্প্রেডশীট,	
dantahin,	দান্তাহীন,	দন্তহীন,	
chinto,	চিন্তো,	চিনতো,	
sikkhokder,	শিক্ষকদের,	শিক্ষকদের,	
uter,	উউটের,	উটের,	
cuti,	কিটি,	কিউটি,	
ghumunoi,	ঘুমুনোই,	ঘুমুনোই,	
nischitobhave,	নিশ্চিতভাবে,	নিশ্চিতভাবে,	
dharmadasbabu,	ধর্মদাসবাবু,	ধর্মদাসবাবু,	
prithibir,	পৃথিবির,	পৃথবীর,	
lajik,	লাজিক,	লজিক,	
sosoa,	সোসো,	শশা,	
gandogol,	গণ্ডগোল,	গন্ডগোল,	
addabaj,	আদ্দাবাজ,	আড্ডাবাজ,	
hughkey,	হুচকে,	হিউজকে,	
mookhomandoler,	মুখমাস্ডলের,	মুখমণ্ডলের,	
purohitder,	পুরোহিতদের,	পুরোহিতদের,	
balokarak,	বালকারক,	বলকারক,	
raiialati,	রাইয়ালিটি,	রয়্যালটি,	
chintamani,	চিন্তামনি,	চিন্তামনি,	
ateetkale,	আতিতকালে,	অতীতকালে,	
turkyder,	টার্কিয়াদের,	তুর্কিদের,	
laaisensh,	লাইসেন্স,	লাইসেন্স,	
foolkopi,	ফুককগি,	ফুলকপি,	
habshi,	হাবশি,	হাবশী,	
cholchhe,	চলছে,	চলছে,	
nischitobhabe,	নিশ্চিতভাবে,	নিশ্চিতভাবে,	
spreedashita,	স্পরিশ্বািত,	স্প্রেডশীট,	
chittronatyokar,	চিত্রনাত্রকারীর,	চিত্রনাট্যকার,	
podarthobidder,	পদার্থবিদদের,	পদার্থবিদদের,	
shoreefpur,	শরিফপুর,	শরিফপুর,	
bujhtepari,	বুঝতেপারী,	বুঝতেপারি,	
average,	আভেরাগে,	এভারেজ,	
bosonte,	বসন্তে,	বসন্তে,	
sexperter,	সেক্সপ্রেটার,	সেক্সপার্টের,	
ultrasonography,	উল্ট্রাসংগ্রাফি,	আলট্রাসনোগ্রাফিও,	
beshyasdone,	বেশ্যাসদনে,	বেশ্যাসদনে,	
rayyaleti,	রায়ললেতি,	রয়্যালটি,	
uponishad,	উপনিশাদ,	উপনিষদ,	
mail,	মাইল,	মাইল,	
miley,	মিলে,	মিলে,	
transhapharma,	ট্রান্শফামাম,	ট্রান্সফর্ম,	
fanding,	ফ্যান্ডিং,	ফান্ডিং,	
tecnokret,	টেকন্টরকে,	টেকনোক্র্যাট,	
vittiteo,	ভিত্তিতেও,	ভিত্তিতেও,	
taap,	টাপ,	ট্যাপ,	
salsa,	সালসা,	সালসা,	
directorete,	ডিরেক্টরটেে,	ডিরেক্টরেট,	
metropalitana,	মেট্রোপালিটানা,	মেট্রোপলিটন,	
jewellery,	জেওলেলির,	জুয়েলারির,	
akkelpure,	আক্কেলপুরে,	আক্কেলপুরে,	
tantubayer,	তন্তুবারের,	তন্তুবায়ের,	
banshite,	বাঁশিতে,	বাঁশিতে,	
sahozlabhbhatar,	সহযোজ্যভাতার,	সহজলভ্যতার,	
armori,	আরমোরি,	আরমোরি,	
mawdeel,	মাদারিল,	মডেল,	
prokar,	প্রকার,	প্রকার,	
bohudeen,	বহুদিন,	বহুদিন,	
sikkhagata,	সিক্ষাগত,	শিক্ষাগত,	
nagorikota,	নাগরিকতা,	নাগরিকতা,	
jeher,	জেহের,	জেহের,	
dolphiny,	ডলফিনি,	ডলফিনি,	
parking,	পারকিং,	পার্কিং,	
liedtke,	লিডটেকে,	লইডটক,	
seebiai,	সিবিয়াই,	সিবিআই,	
kalkarkhana,	কলকারখানা,	কলকারখানা,	
granthatyke,	গ্রান্টটাটকে,	গ্রন্থটিকে,	
lishenshe,	লিশেন্সে,	লাইসেন্স,	
miraclee,	মিরাকলি,	মিরাকেল,	
aairees,	আইরিস,	আইরিস,	
byke,	বিকে,	বাইক,	
rupert,	রুপার্ট,	রুপার্ট,	
ruptan,	রূপতান,	রূপটান,	
seoul,	সিওউল,	সোল,	
tiuning,	টিউনিং,	টিউনিং,	
nadnadeer,	নদদনীর,	নদনদীর,	
palteche,	পাল্টেছে,	পাল্টেছে,	
koreempoor,	করিমপুর,	করিমপুর,	
segular,	সেগুলার,	সেগুলোর,	
babona,	বাবনা,	বাবনা,	
iqbalke,	ইকবালকে,	ইকবালকে,	
doobate,	ডুবাটে,	ডুবাতে,	
dajjha,	দজজা,	দাহ্য,	
bisnukey,	বিস্নুকে,	বিষ্ণুকে,	
protijogitamulok,	প্রতিযোগিতামূলক,	প্রতিযোগীতামূলক,	
fastag,	ফাস্তাগ,	ফ্যাসট্যাগ,	
siddharther,	সিদ্ধার্থের,	সিদ্ধার্থের,	
kormokarer,	কর্মকারের,	কর্মকারের,	
fasir,	ফাসির,	ফাসীর,	
byaboharkariyi,	ব্যবহারককররীয়,	ব্যবহারকারীই,	
armashtram,	আর্মশ্্তরমম,	আর্মস্ট্রং,	
gejetade,	গেজেটেদে,	গেজেটেড,	
install,	ইনস্টাল,	ইন্সটল,	
samaveshke,	সমাভেশকে,	সমাবেশকে,	
duhsthanostho,	দুঃসস্থানস্থ,	দুঃস্থানস্থ,	
rasunkunchi,	রাসুনকুঞ্চি,	রসুনকুঁচি,	
orthobochorke,	অর্থবচরকে,	অর্থবছরকে,	
hunine,	হুনিনে,	হুনাইন,	
rijoor,	রিজোর,	রিজুর,	
miitar,	মিইটার,	মিত্র,	
abhidhaaner,	অভিধানের,	অভিধানের,	
informetion,	ইনফ্রোমেশন,	ইনফরমেশন,	
oxite,	অক্সিটে,	অক্সাইট,	
onkush,	অঙ্কুশ,	অংকুশ,	
chaiten,	চেইতেন,	চাইতেন,	
joubankal,	যৌবাকলা,	যৌবনকাল,	
tukrote,	টুকরোতে,	টুকরোতে,	
shumo,	শুমো,	সুমো,	
liceensee,	লিসিনসে,	লাইসেন্স,	
sayanaida,	সায়ানাদ়া,	সায়ানাইড,	
japanostho,	জাপানস্থ,	জাপানস্থ,	
laishensh,	লেইশেনসহ,	লাইসেন্স,	
degreeo,	ডিগ্রিও,	ডিগ্রিও,	
nabatarange,	নবতারঙ্গে,	নবতরঙ্গে,	
seeramiks,	সিরামিকস,	সিরামিকস,	
onchalti,	অঞ্চলটি,	অঞ্চলটি,	
kantajir,	কান্তাজির,	কান্তজির,	
naabyota,	নবব্যতা,	নাব্যতা,	
daqop,	ডাকোপ,	দাকোপ,	
shashtra,	শাষ্ট্রা,	শাস্ত্র,	
pratiyogita,	প্রতিয়গিতা,	প্রতিযোগীতা,	
sampadoner,	সম্পাদনের,	সম্পাদনের,	
sangaskritipreme,	সংস্কৃতিস্রেমে,	সংস্কৃতিপ্রেমে,	
hool,	হুল,	হুল,	
zerusalem,	জেরুসালেম,	জেরুজালেম,	
alexanderke,	আলেক্সান্ডরেকে,	আলেকজান্ডারকে,	
aasirbaad,	আসিরবাব,	আশির্বাদ,	
townshhip,	তৈশনশিপ,	টাউনশিপ,	
grambasheeo,	গ্রামববশীয়,	গ্রামবাসীও,	
seekkharthirao,	শিক্ষার্থীরাও,	শিক্ষার্থীরাও,	
protizogiita,	প্রতিযোগিতি,	প্রতিযোগীতা,	
mugdal,	মুগদল,	মুগডাল,	
elakasoho,	এলাকোসহ,	এলাকাসহ,	
blasterke,	ব্ল্সাটারকে,	ব্লাস্টারকে,	
byathapather,	ব্যথাপথের,	ব্যথাপথের,	
manushgulor,	মনুষগুলোর,	মানুষগুলোর,	
larson,	লারসোন,	লারসন,	
kekru,	কেকরু,	কেকরু,	
asamonjasyopurno,	অসামান্যস্পরূর্ণ,	অসামঞ্জস্যপূর্ণ,	
jolrang,	জলরাং,	জলরঙ,	
kraanti,	ক্রানটি,	ক্রান্তি,	
atmiyasulabh,	আত্মীয়ামুকাস,	আত্মীয়সুলভ,	
aansaareer,	আনসায়ার,	আনসারীর,	
utshahomulok,	উৎসাভূমূলক,	উৎসাহমূলক,	
somoibo,	সময়বো,	সমৈব,	
dalee,	ডালি,	ডালে,	
jens,	জেন্স,	জিন্স,	
swastir,	স্বস্তির,	স্বস্তির,	
joki,	জোকি,	জকি,	
unchuporjayer,	উঁচুজাসময়ের,	উঁচুপর্যায়ের,	
janmat,	জন্মত,	জন্মাত,	
cooda,	কোডা,	কোডা,	
aatmobishwasi,	আত্মবিশ্বাসী,	আত্মবিশ্বাসী,	
bishnoo,	বিষ্ণও,	বিষ্ণু,	
dhrubaker,	ধ্রুবাকের,	ধ্রুবকের,	
dakticket,	ডাক্িকেট,	ডাকটিকিট,	
sqirt,	স্কিট,	স্কার্ট,	
shpredshiit,	স্প্রেশ্টি,	স্প্রেডশীট,	
eucalyptus,	ইউকাল্্যাটস,	ইউক্যালিপ্টাস,	
manush,	মনুশ,	মানুষ,	
vobani,	ভোবানি,	ভবানী,	
sten,	স্টেন,	স্টেন,	
uporitale,	উপরিতলে,	উপরিতলে,	
crucer,	ক্রুসের,	ক্রুশের,	
rakkhanbhag,	রক্ষণভাগ,	রক্ষণভাগ,	
mojdur,	মজদুর,	মজদুর,	
avidur,	আভিদুর,	আভিদুর,	
ramnathbabur,	রামনাতবাবুর,	রামনাথবাবুর,	
shotodha,	শথধা,	শতধা,	
lettere,	লেট্রেরে,	লেটারে,	
daap,	ডাপ,	ড্যাপ,	
bokul,	বকুল,	বকুল,	
bikargrosto,	বিকারগ্রস্ত,	বিকারগ্রস্ত,	
cheentaikaree,	চিন্তাইকারী,	ছিনতাইকারী,	
neutrinoo,	নিউট্রিনো,	নিউট্রিনো,	
alpakichudin,	আল্পকিচুঞ্জি,	অল্পকিছুদিন,	
atorkitey,	অতরকিতে,	অতর্কিতে,	
kooshumba,	কুশুমবা,	কুশুম্বা,	
stonehenje,	স্টনেহেঞ্জে,	স্টোনহেঞ্জ,	
elgoridom,	এল্োগিড,	এলগরিদম,	
ekbakke,	একবাককে,	একবাক্যে,	
fibergulote,	ফিইবারগুলোতে,	ফাইবারগুলোতে,	
landing,	ল্যান্ডিং,	ল্যান্ডিং,	
osamarik,	অসামারিক,	অসামরিক,	
mulyabriddhikale,	মূল্যবির্দ্ধলে,	মূল্যবৃদ্ধিকালে,	
stona,	স্তনা,	স্টোন,	
kichutei,	কিছুটেই,	কিছুতেই,	
salphat,	সালফাট,	সালফেট,	
gotihin,	গতিহীন,	গতিহীন,	
sanghitar,	সংহীতার,	সংহিতার,	
danakana,	দানাকানা,	ডানকান,	
antennal,	অন্টেনান,	অ্যান্টেনাল,	
arekdol,	আরেকদল,	আরেকদল,	
elaaka,	এলাকা,	এলাকা,	
saver,	সাভের,	সেভার,	
jothartho,	যথার্থ,	যথার্থ,	
ukeliptas,	উকেলিপ্টাস,	ইউক্যালিপ্টাস,	
hitaishi,	হিতাইশি,	হিতৈষী,	
laishensha,	লেইশেসনা,	লাইসেন্স,	
brojomohun,	ব্রজমমহন,	ব্রোজোমোহন,	
ekekrokom,	একেক্রকম,	একেকরকম,	
shringgo,	শ্রিগ্গো,	শৃঙ্গ,	
chalochchitrogulor,	চলচ্চিত্রগুলোর,	চলচ্চিত্রগুলোর,	
bharotiyotar,	ভারতিয়তার,	ভারতীয়তার,	
upobaasee,	উপবাসী,	উপবাসী,	
kamla,	কামলা,	কামলা,	
inapharameshana,	ইনাফারামেশন,	ইনফরমেশন,	
inafarameshana,	ইনাফারহেশন,	ইনফরমেশন,	
gonjona,	গঞ্জনা,	গঞ্জনা,	
venus,	ভেনুস,	ভেনাস,	
konflict,	কনফ্লিক্ট,	কনফ্লিক্ট,	
taunsheep,	টাউনশিপ,	টাউনশিপ,	
romarder,	রোমারদের,	রোমারদের,	
sahapathike,	সহপাঠিকে,	সহপাঠীকে,	
bipajjanak,	বিপজ্জনক,	বিপজ্জনক,	
totokson,	টোটকসন,	ততক্ষন,	
stander,	স্ট্যান্ডার,	স্ট্যাণ্ডের,	
ronangane,	রোনাঙ্গানে,	রণাঙ্গনে,	
landey,	ল্যান্ডে,	ল্যান্ডে,	
edmiral,	এডমিয়াল,	এডমিরাল,	
ganonanatto,	গণনানাত্ত,	গণনাট্য,	
sonaktokaran,	সোনাক্তকরণ,	সনাক্তকরণ,	
paadee,	পাড়ে,	পাড়ে,	
gurmukh,	গুরমুখ,	গুরমুখ,	
transform,	ট্রান্সফোর্ম,	ট্রান্সফর্ম,	
moushum,	মৌশুম,	মৌসুম,	
soomitrar,	সমমিত্রার,	সুমিত্রার,	
niropekshtar,	নিরপপক্ষ্টার,	নিরপেক্ষতার,	
grootha,	গ্রুথা,	গ্রোথ,	
danata,	দানাটা,	ডোনাট,	
societyke,	সোসিকটিকে,	সোসাইটিকে,	
naabbota,	নবব্বতা,	নাব্যতা,	
alaul,	আলাউল,	আলাওল,	
akpaase,	এক্পাসে,	একপাশে,	
karecho,	কারেছো,	করেছ,	
sikha,	শিখা,	শিখ,	
rachonakal,	রচনাকল,	রচনাকাল,	
gaddaafee,	গডড়াফি,	গাদ্দাফী,	
mosharroph,	মোশার্রফ,	মশাররফ,	
zerusaleme,	জেরুসালেমে,	জেরুসালেমে,	
railliner,	রেলিননের,	রেললাইনের,	
dokkhinangsho,	দক্ষিণাংশ,	দক্ষিণাংশ,	
difinishian,	ডিফিনিশিয়ান,	ডেফিনেশন,	
domonmulok,	ডমননমুলক,	দমনমূলক,	
rajan,	রাজান,	রাজন,	
engrejer,	এংগ্রেজের,	ইংরেজের,	
byaboharkarir,	ব্যবহারকারীর,	ব্যবহারকারীর,	
eporzonto,	এপর্জনত,	এপর্যন্ত,	
delibhara,	দেলিভারা,	ডেলিভার,	
samajeek,	সমজজিক,	সামাজিক,	
cheess,	চেসস,	চেস,	
apad,	অপড়,	আপদ,	
shiropar,	শিরোপার,	শিরোপার,	
bhaibon,	ভাইবন,	ভাইবোন,	
asbab,	আসবাব,	আসবাব,	
yuro,	যুরও,	ইউরো,	
codee,	কোড,	কোডে,	
akhandata,	অখণ্ডতা,	অখণ্ডতা,	
firozaa,	ফিরোজাও,	ফিরোজা,	
direectoratee,	ডিরাইক্টরটি,	ডিরেক্টরেট,	
pragreesa,	প্রাগ্রিসা,	প্রগ্রেস,	
panthar,	পান্থার,	পন্থার,	
kheylechen,	খেয়েছেল,	খেলেছেন,	
jipiusamriddha,	জিপিয়াসাৃদ্ধ,	জিপিউসমৃদ্ধ,	
dai,	ডাই,	ডে,	
bohudin,	বহুদিন,	বহুদিন,	
pachak,	পাচক,	পাচক,	
prakalpagulor,	প্রকালপগুলোর,	প্রকল্পগুলোর,	
jubokti,	যুবকটি,	যুবকটি,	
baibosthar,	বৈবস্থার,	ব্যবস্থার,	
bethikata,	বেথিকাটা,	বেঠিকতা,	
kandy,	কান্ডি,	ক্যান্ডি,	
qarqa,	কার্কা,	কার্ক,	
chalai,	চালাই,	চালাবে,	
dhormoprobortokder,	ধর্মপ্রতাব্রদের,	ধর্মপ্রবর্তকদের,	
dhani,	ধানি,	ধানি,	
obdee,	ওব্দি,	অব্দি,	
nirikho,	নিরিখো,	নিরিখ,	
poroborti,	পরবর্তী,	পরর্বতী,	
marri,	মারি,	ম্যারি,	
akkhunno,	অক্ষুন্য,	অক্ষুণ্ণ,	
nirikhe,	নিরিখে,	নিরিখ,	
porbotmala,	পরবত্মালা,	পর্বতমালা,	
noiteekotar,	নৈতিকতার,	নৈতিকতার,	
oncholtee,	অঞ্চলতি,	অঞ্চলটি,	
gloria,	গ্লোরিয়া,	গ্লোরিয়া,	
licencedhari,	লিইসেন্েরা,	লাইসেন্সধারী,	
highcomissione,	হিইভভিক্সানে,	হাইকমিশনে,	
nothivuktir,	নথিভুক্তির,	নথিভুক্তির,	
myari,	ম্যারি,	ম্যারি,	
chhanada,	ছানাড়া,	ছানাদা,	
sobche,	সবকে,	সবচে,	
prarthitao,	প্রার্থীরাও,	প্রার্থীতাও,	
catholicder,	ক্যাথোলিসদের,	ক্যাথলিকদের,	
peeth,	পিথ,	পীঠ,	
abhidhaner,	অভিধানের,	অভিধানের,	
bhromonkaale,	ভ্রমণকালে,	ভ্রমণকালে,	
damodar,	দামোদার,	দামদর,	
provritike,	প্রভৃতিকে,	প্রভৃতিকে,	
raagee,	রাগি,	রাগী,	
graambasi,	গ্রাম্বাসি,	গ্রামবাসী,	
bondi,	বন্ডি,	বন্দী,	
anutpadanshil,	অনুতাপ্তিচাীন,	অনুৎপাদনশীল,	
pretty,	প্রেটি,	প্রিটি,	
purushika,	পুরুষিকা,	পুরুষিকা,	
soinyo,	সৈন্য,	সৈন্য,	
konoroop,	কোনরূপ,	কোনরূপ,	
siitei,	সিউটেই,	শীতেই,	
taunasipa,	তৌনসীপা,	টাউনশিপ,	
jeten,	জেটেন,	জেতেন,	
daayitto,	ডায়িত্ত,	দায়িত্ব,	
abeganuvutir,	আবেগানুকুতির,	আবেগানুভূতির,	
parkin,	পারকিন,	পার্কিং,	
deaubande,	ডিউবান্ডে,	দেওবন্দে,	
bhyaatikaner,	ভ্যাতিকানের,	ভ্যাটিকানের,	
ebham,	ইভাম,	ইভিএম,	
digree,	ডিগ্রি,	ডিগ্রি,	
meloonborrone,	মেলনব্রনেও,	মেলবোর্নে,	
khalid,	খালিদ,	খালিদ,	
kathla,	কাঠলা,	কাঠলা,	
conflikt,	কনফ্লিক্ট,	কনফ্লিক্ট,	
boikalyo,	বৈকালয়,	বৈকল্য,	
aireshe,	এয়ারেশে,	আইরেসে,	
gronthao,	গ্রন্থাও,	গ্রন্থও,	
definition,	ডিফিনেশন,	ডেফিনেশন,	
argead,	আর্জেড,	আর্জিদ,	
anubhutimalar,	অনুভূতিমূলরা,	অনুভূতিমালার,	
nirvachaker,	নির্ভাচকের,	নির্বাচকের,	
gostigulo,	গোস্তিগুলো,	গোষ্ঠীগুলো,	
turky,	টার্কি,	তুর্কি,	
byabaharkareederke,	ব্যবহারকারীদেরকে,	ব্যবহারকারীদেরকে,	
kaferder,	কাফেরদের,	কাফেরদের,	
upobaashee,	উপবাশী,	উপবাসী,	
songrahak,	সংগ্রহক,	সংগ্রাহক,	
duio,	দুইও,	দুইও,	
tinage,	টিনাগে,	টিনেজ,	
vaibon,	ভাইবন,	ভাইবোন,	
uparzoner,	উপারজনের,	উপার্জনের,	
sithilotar,	সিথিলতার,	শিথিলতার,	
chandil,	চাঁদিল,	চান্ডিল,	
ekbai,	একবাই,	একবাই,	
karlei,	কারলেই,	করলেই,	
hugeke,	হুগেকে,	হিউজকে,	
ardasha,	আরদাশা,	আর্দশ,	
windos,	উইনডোস,	উইন্ডোস,	
khali,	খালি,	খালি,	
bodhirota,	বোধিরতা,	বধিরতা,	
segulo,	সেগুলো,	সেগুলো,	
antarbhutto,	অন্তর্ভূত্ত,	অন্তর্ভুক্ত,	
poscime,	পোস্সিমে,	পশ্চিমে,	
ashanka,	আশানকা,	আশংকা,	
ghomtaa,	ঘোমটা,	ঘোমটা,	
gaj,	গাজ,	গেজ,	
gabeshonar,	গ্বেশনার,	গবেষনার,	
jaruri,	জারুরি,	জরূরী,	
osommotite,	অসম্বতিতে,	অসম্মতি,	
basaake,	বাসাকে,	বাসাকে,	
bandhan,	বনঁধন,	বাঁধন,	
sweety,	স্বিটি,	সুইটি,	
parishram,	পািশ্রম,	পরিশ্রম,	
oitijhya,	ঐতিহ্য্য,	ঐতিহ্য,	
licensin,	লিইসেনসিন,	লাইসেন্সিং,	
abdan,	আবদান,	আব্দান,	
cholochchitra,	চলচ্চিত্র,	চলচ্চিত্র,	
durlabhatwang,	দুর্লাভাত্মাম,	দুর্লভত্বং,	
khoakshir,	খোয়াক্ষির,	খোয়াক্ষীর,	
aasar,	আসার,	আসর,	
khanabale,	খানাবালে,	খানাবলে,	
ganosochetonota,	গণসচেতনতা,	গণসচেতনতা,	
proteemake,	প্রতিমাকে,	প্রতিমাকে,	
abanishankar,	অবনিশঙ্করর,	অবনিশংকর,	
dip,	ডিপ,	দীপ,	
lavta,	লাভটা,	লাভটা,	
jhalkanite,	ঝালকানিতে,	ঝলকানীতে,	
jini,	জিনি,	যিনি,	
tintikey,	তিনটিকে,	তিনটিকে,	
jatinkey,	জাতিনকে,	যতীনকে,	
apolokbhabe,	অপলকভাবে,	অপলকভাবে,	
chandanara,	চন্দনারা,	চন্দনারা,	
vabuk,	ভাবুক,	ভাবুক,	
keyboarder,	কেয়ব্রদের,	কীবোর্ডের,	
zeland,	জেলান্ড,	জিল্যান্ড,	
lobbytey,	লববাইট,	লবিতে,	
ghatla,	ঘটলা,	ঘটল,	
pacchi,	পাচ্চি,	পাচ্ছি,	
jitpur,	জিতপুর,	জিতপুরের,	
chhutir,	ছুটির,	ছুটির,	
shef,	শেফ,	শেফ,	
sanstha,	সংস্থ,	সংস্থা,	
batsmanei,	বাতসম্মানেই,	ব্যাটসম্যানই,	
poorohitder,	পৌরহিতদের,	পুরোহিতদের,	
bhejaano,	ভেজানো,	ভেজানো,	
vault,	ভাল্ট,	ভল্ট,	
sachetanvabe,	সচেতনাভাবে,	সচেতনভাবে,	
ooipoka,	উপইপকা,	উইপোকা,	
bhittow,	ভিত্তো,	ভিত্তিও,	
sorsa,	সর্সা,	সোর্স,	
flirt,	ফ্লির্ট,	ফ্লার্ট,	
bhogni,	ভোগনি,	ভগ্নী,	
khuizza,	খুইজজা,	খুইজ্জা,	
prakare,	প্রকারে,	প্রকারে,	
phonekari,	ফোনেকারি,	ফোনকারী,	
pathanirdeshona,	পাঠানির্দেশনা,	পথনির্দেশনা,	
marathi,	মারাথি,	মরাঠি,	
dhangsachchi,	ধ্বংসাচ্ছি,	ধ্বংসাচ্ছি,	
annorup,	অন্যরূপ,	অন্যরূপ,	
rajnikant,	রাজনীকান্ত,	রাজনীকান্ত,	
tanu,	তানু,	তনু,	
prodiiper,	প্রদিপিয়ের,	প্রদীপের,	
sobrakomer,	সব্রকামের,	সবরকমের,	
jesh,	যেশ,	জেস,	
byaboharkarie,	ব্যবহারকারী,	ব্যবহারকারীই,	
magrey,	ম্যাগ্রে,	ম্যাগ্রে,	
jakso,	জাকসো,	যক্ষ,	
aaireshe,	আইরেশে,	আইরেসে,	
alimpiqa,	অলিমপিকা,	অলিম্পিক,	
sarbhaarti,	সরভারটি,	সার্ভারটি,	
gandhiir,	গন্ধীর,	গান্ধীর,	
donat,	ডোনাত,	ডোনাট,	
sursur,	সুরসুর,	সুরসুর,	
bhabanir,	ভাবানির,	ভবানীর,	
gazeetteed,	গেজিট্ডি,	গেজেটেড,	
venush,	ভেনশু,	ভেনাস,	
bim,	বিআম,	বিম,	
kaalengaa,	কালেঙ্গা,	কালেঙ্গা,	
mimgulor,	মিমগুলোর,	মিমগুলোর,	
beshakbar,	বেশকবার,	বেশকবার,	
gyandas,	জ্ঞানদাস,	জ্ঞানদাস,	
maritimer,	মারিটিমের,	মেরিটাইমের,	
aarke,	আরকে,	আরকে,	
gaandaas,	গন্ডাস,	জ্ঞানদাস,	
nibirbhabe,	নিবির্ভাবে,	নিবিরভাবে,	
colgirl,	কলগির,	কলগার্ল,	
bhabatarini,	ভাবাতারিনী,	ভবতারিণী,	
anchalgulir,	অঞ্চলগুলির,	অঞ্চলগুলির,	
choudhurike,	চৌধুরীকে,	চৌধুরীকে,	
somonnitobhabe,	সমন্নিতভাবে,	সমন্বিতভাবে,	
chopal,	চোপাল,	চপল,	
prottokkhovabe,	প্রত্যক্ষভাবে,	প্রত্যক্ষভাবে,	
krisenta,	ক্রিসেন্টা,	ক্রিসেন্ট,	
platform,	প্ল্যাটফর্ম,	প্লাটফর্ম,	
nodiiteyi,	নদিউটিয়েই,	নদীতেই,	
chrystal,	ক্রিস্টাল,	ক্রাইস্টাল,	
sombhobonaao,	সম্ভবনাও,	সম্ভবনাও,	
abosare,	অবসারে,	অবসরে,	
becha,	বেচ,	বেচা,	
kirti,	কিরটি,	কীর্তি,	
keyu,	কেউ,	কেউ,	
zubokra,	যুবকরা,	যুবকরা,	
haridware,	হরিদ্বারে,	হরিদ্বারে,	
mah,	মাহ,	মাহে,	
title,	টিটল,	টাইটেল,	
karaponner,	কারাপন্নের,	কারাপণ্যের,	
proshtutkarok,	প্রশ্তুতাকাক,	প্রস্তুতকারক,	
matorom,	মাতররম,	মাতরম,	
harja,	হার্জা,	হার্জ,	
ahong,	আহং,	অহং,	
shikare,	শিকারে,	শিকারে,	
kalirkhal,	কালিরখাল,	কালিরখাল,	
gaphiloti,	গাছিলতি,	গাফিলতি,	
qyantana,	ক্যান্তনা,	ক্যান্টন,	
pachattar,	পাচাত্তার,	পাচাত্তার,	
headquartus,	হেডকার্যাকাস,	হেডকোয়ার্টাস,	
baugey,	বাউগে,	বাগে,	
karim,	কারিম,	করিম,	
idipasha,	ইদিপাশা,	ইডিপাস,	
ardasho,	আর্দশশ,	আর্দশ,	
bonbhumi,	বনভুমি,	বনভূমি,	
masjidsaho,	মাসজিদসহ,	মসজিদসহ,	
rezidence,	রেজিডেন্স,	রেসিডেন্স,	
jotinkey,	জটিনকে,	যতীনকে,	
udbhabaney,	উদ্ভাবনে,	উদ্ভাবনে,	
shift,	শিফ্ট,	শিফট,	
nirgaman,	নির্গামান,	নির্গমন,	
antarctica,	অ্্ট্যান্টারিকা,	অ্যান্টার্কটিকার,	
maradeha,	মারাদেহা,	মরদেহ,	
ganakantha,	গণকান্থ,	গণকণ্ঠ,	
shcholastic,	স্কোলাস্টিক,	স্কলাস্টিক,	
bairer,	বাইরের,	বাইরের,	
nagarikera,	নাগারিকেরা,	নাগরিকেরা,	
gunje,	গুঞ্জে,	গুঁজে,	
sures,	সুরেস,	সুরেশ,	
chaloke,	চালকে,	চালকে,	
fotanor,	ফটানার,	ফোটানোর,	
tottorat,	তত্রতাত,	তওরাত,	
krechi,	ক্রেচি,	করেছি,	
tanshree,	তানশ্রী,	তানশ্রী,	
chat,	চাট,	চ্যাট,	
shatokeo,	শাতকেও,	শতকেও,	
debdebyr,	দেবদেবীর,	দেবদেবীর,	
gemske,	গেমসককে,	জেমসকে,	
bhabaaponno,	ভাবাপন্ন,	ভাবাপন্ন,	
bojhaao,	বোঝাও,	বোঝাও,	
yaq,	য়ক,	ইয়াক,	
sombhobonao,	সম্ভবনাও,	সম্ভবনাও,	
norfolk,	নরফলক,	নরফোক,	
granada,	গ্রানাদা,	গ্র্যানাডা,	
suparharo,	সুপাহহাও,	সুপারহিরো,	
emerjency,	এমারজেন্সি,	এমার্জেন্সি,	
pratishthanik,	প্রতিষ্ঠানিক,	প্রাতিষ্ঠানিক,	
bijepi,	বিজেপি,	বিজেপি,	
ghumacchilo,	ঘুমাচিল্লো,	ঘুমাচ্ছিল,	
rudrasagar,	রুদ্রসাগর,	রুদ্রসাগরের,	
hijrite,	হিজরিতে,	হিজরীতে,	
teennis,	টেনিসি,	টেনিস,	
hingsar,	হিংসার,	হিংসার,	
waal,	ওয়াল,	উল,	
rahee,	রাহি,	রাহী,	
madhuri,	মধুরি,	মাধুরী,	
omarader,	ওমারাদের,	ওমারাদের,	
deeares,	ডিয়ারেস,	ডিআরএস,	
bisshas,	বিশ্বাস,	বিশ্বাস,	
bhutbhut,	ভুতভুত,	ভুটভুট,	
charpanch,	চরপাঞ্চ,	চারপাঁচ,	
utsahi,	উৎসাহী,	উৎসাহী,	
shloker,	শ্লকের,	শ্লোকের,	
shikkhadikkhay,	শিক্ষাদক্ষীয়,	শিক্ষাদিক্ষায়,	
dhila,	ধিলা,	ঢিলা,	
nagorikra,	নাগরিকরা,	নাগরিকেরা,	
beauby,	বিউবি,	বিউবি,	
windows,	উইনডোস,	উইন্ডোস,	
phareeksa,	ফারিকসা,	ফরেক্স,	
perri,	পেরি,	পেরি,	
loombinee,	লুমবিনন,	লুম্বিনী,	
nationalser,	নাইটোসালসের,	ন্যাশনালসের,	
barbadoj,	বারবাদজ,	বার্বাডোজ,	
talgach,	তালগাছ,	তালগাছ,	
asaciates,	অসযাসিয়াটেস,	এসোসিয়েটস,	
heena,	হেনা,	হেনা,	
ponchaasjon,	পঞ্চাচ্যজন,	পঞ্চাশজন,	
bizito,	বিজিত,	বিজিত,	
ramchander,	রামচন্দের,	রামচন্দরের,	
shite,	শিতে,	শীতে,	
rubala,	রুবালা,	রুবল,	
tahalo,	তাহালো,	তাহলো,	
bowie,	বইবি,	বওই,	
bisshasyi,	বিশ্বাসী,	বিশ্বাসই,	
andamana,	আন্দামানা,	আন্দামান,	
eshiyetika,	এশিয়েকিটা,	এশিয়াটিক,	
dep,	ডিপ,	ডেপ,	
byabaharkareer,	ব্যবহাকারীর,	ব্যবহারকারীর,	
promothesh,	প্রমথেশ,	প্রমথেশ,	
laiseensim,	লাইসিসিং,	লাইসেন্সিং,	
chandrimaa,	চন্দ্রীমাও,	চন্দ্রিমা,	
shingping,	শিংপিং,	শিংপিং,	
bikargrasta,	বিকারগ্রাস্তা,	বিকারগ্রস্ত,	
vortuki,	ভর্তুকি,	ভর্তুকি,	
ashiatic,	অ্যাশিয়াটিক,	এশিয়াটিক,	
shrabosty,	শ্রাবস্তি,	শ্রাবস্তী,	
dibet,	ডিবেট,	ডিবেট,	
yatharthabhabe,	যথারথাভাবে,	যথার্থভাবে,	
blacker,	ব্ল্যাকার,	ব্ল্যাকের,	
moddhyoshtho,	মধ্যস্থথ,	মধ্যস্থ,	
sangbadmadhyamgulote,	সংবাদমাধ্যমগুলোতে,	সংবাদমাধ্যমগুলোতে,	
byabaharkariderke,	ব্যবহারকারীদেরকে,	ব্যবহারকারীদেরকে,	
baffer,	বাফার,	বাফার,	
vushi,	ভুশি,	ভুষি,	
scorey,	স্কোও,	স্কোরে,	
commissionvogider,	কমিসমিইজন্ডাদের,	কমিশনভোগীদের,	
mumtaz,	মুমতাজ,	মুমতাজ,	
khamotagulor,	ক্ষমতাগুলোর,	ক্ষমতাগুলোর,	
gazipur,	গাজিপুর,	গাজিপুর,	
dara,	দারা,	দারা,	
potka,	পোটকা,	পটকা,	
relance,	রিলান্স,	রিলায়েন্স,	
jandrel,	জন্দ্রেল,	জাঁদরেল,	
victor,	ভিক্টর,	ভিক্টর,	
dibi,	ডিবি,	দিবি,	
ajibon,	অ্যাজিবন,	আজীবন,	
vugoley,	ভুগোলে,	ভূগোলে,	
kloud,	ক্লোড,	ক্লাউড,	
corymb,	করিম্ব,	করিম,	
dharavassokar,	ধারাবস্কার,	ধারাভাষ্যকার,	
nathivukta,	নাথিভুক্ত,	নথিভুক্ত,	
sompadonkaree,	সম্পাদনকারী,	সম্পাদনকারী,	
drishyer,	দৃশ্যের,	দৃশ্যের,	
heze,	হেজে,	হেজ,	
saatzoner,	সাতজনের,	সাতজনের,	
kanar,	কানার,	কণার,	
somsher,	সমশের,	সমশের,	
pranidero,	প্রাণীদেরও,	প্রানীদেরও,	
nischoy,	নিশ্চয়,	নিশ্চয়,	
taholo,	তাহোলো,	তাহলো,	
arthanitike,	অর্থনীতিকে,	অর্থনীতিকে,	
atmabishvashi,	আত্মবিভাবশী,	আত্মবিশ্বাসী,	
dharabahiktite,	ধারাবাহিকটিতে,	ধারাবাহিকটিতে,	
konruup,	কননুরূপ,	কোনরূপ,	
kartona,	কার্তনা,	করতনা,	
awatar,	আবাতার,	অবতার,	
naajii,	নাজিই,	নাত্সি,	
skolastik,	স্কলকস্তিক,	স্কলাস্টিক,	
ateetkaale,	আতিতকালে,	অতীতকালে,	
yaak,	যাক,	ইয়াক,	
poriskoron,	পরিস্করণ,	পরিষ্করণ,	
bangladesh,	বাংলাদেশ,	বঙ্গালাদেস,	
angkita,	অঙ্কিতা,	অঙ্কিতা,	
pariyech,	পরিয়েছ,	পরিয়েছ,	
sutir,	সুতির,	সুতির,	
khude,	খ্ষেদ,	ক্ষুদে,	
bonobhumi,	বনভূমি,	বনভূমি,	
brixfield,	ব্রিক্সফ্লোড,	ব্রিক্সফিল্ড,	
byomkesh,	ব্যাকমেক,	ব্যোমকেশ,	
palestine,	পালেস্টিনে,	প্যালেস্টাইনে,	
keui,	কেউ,	কেউই,	
sahocorje,	সহকর্জে,	সাহচর্যে,	
abhijitda,	অভিযাদিত,	অভিজিতদা,	
elakatir,	এলাকাটির,	এলাকাটির,	
safiin,	সাফিইন,	সাফিন,	
uddhrito,	উদ্ধৃত,	উদ্ধৃত,	
suri,	সুরি,	সুরি,	
akpashe,	আক্পাশে,	একপাশে,	
grotha,	গ্রথা,	গ্রোথ,	
suiza,	সুইজা,	সুইজা,	
lyandim,	ল্যান্ডিম,	ল্যান্ডিং,	
juktarashtrasaha,	যুক্তারস্বরস্থা,	যুক্তরাষ্ট্রসহ,	
trabuco,	ট্রাবিকো,	ট্র্যাবুকো,	
foloshrutite,	ফলশ্রুটিতে,	ফলশ্রুতিতে,	
corsin,	কর্সিন,	করসিন,	
thailandshoho,	থাইলান্দসহ,	থাইল্যান্ডসহ,	
saabyastha,	সাব্যস্থ,	সাব্যস্থ,	
abheedhaaneeck,	অভিধাননক,	অভিধানিক,	
qlauda,	ক্লোউডা,	ক্লাউড,	
chongar,	চোঙ্গার,	চোঙ্গার,	
harasta,	হারাস্তা,	হারাস্তা,	
ghatleo,	ঘাটলেও,	ঘটলেও,	
oncoleo,	অনকোলেও,	অঞ্চলেও,	
balithubar,	বালিথুবার,	বালিথুবার,	
akreetokarjo,	আক্রিতকর্য্য,	অকৃতকার্য,	
chadake,	চাদাকে,	চড়াকে,	
rajnoitik,	রাজনৈতিক,	রাজনৈতীক,	
uindos,	উইনডডস,	উইন্ডোস,	
mathieu,	মাথিউউ,	ম্যাথিউ,	
mandondo,	মন্দন্দ,	মানদণ্ড,	
khelechen,	খেলেছেন,	খেলেছেন,	
birmuktijoddhagan,	বিরমুক্তিয্ধর্ধলল,	বীরমুক্তিযোদ্ধাগণ,	
bachai,	বাচাই,	বাছাই,	
bostubad,	বস্তুবাদ,	বস্তুবাদ,	
prasadhoner,	প্রসাধনের,	প্রসাধনের,	
talaal,	তালাল,	তালাল,	
rena,	রেনা,	রেনো,	
jaatti,	যাত্তি,	জাতটি,	
maailey,	মাইলে,	মাইলে,	
bhenasha,	ভেনাশা,	ভেনাস,	
kadam,	কাদাম,	কদম,	
rabo,	রাবো,	রব,	
kanshat,	কাশনাত,	কানসাট,	
progresh,	প্রোগ্রেশ,	প্রগ্রেস,	
jund,	জুন্ড,	জুন্দ,	
wilderske,	উইলডারসেকে,	উইল্ডার্সকে,	
soundorjotakei,	সৌন্দর্যটাকেই,	সৌন্দর্যটাকেই,	
parther,	পার্থের,	পার্থের,	
eenameela,	ইনামিলা,	এনামেল,	
azijer,	আজিজের,	আজিজের,	
safiha,	সফিহা,	সাফিহা,	
barrageke,	বারাগেজকে,	ব্যারেজকে,	
difinision,	ডিফিনিশন,	ডেফিনেশন,	
pnouchute,	প্ঞাচুুতে,	পৌঁছুতে,	
hari,	হারি,	হরি,	
avetar,	আভেতার,	অবতার,	
encidablu,	এনসিড্বাগু,	এনসিডাব্লু,	
attorkite,	অ্যাট্টরকে,	অতর্কিতে,	
binee,	বিনি,	বেনি,	
tiunara,	টিউনারা,	টিউনার,	
gobeshakgon,	গবেষকগণ,	গবেষকগণ,	
pyatarne,	প্যারাত্নে,	প্যাটার্নে,	
yathaarthabhaabe,	যথারথারভাবে,	যথার্থভাবে,	
rohosyoti,	রহস্যটি,	রহস্যটি,	
doneta,	ডোনেটা,	ডোনাট,	
horidwar,	হরিদ্বার,	হরিদ্বার,	
elakatikay,	এলাকাটিকা,	এলাকাটিকে,	
shasankorta,	শাসনকর্তা,	শাসনকর্তা,	
holdim,	হোল্ডিম,	হোল্ডিং,	
oikhan,	ঐখন,	ঐখান,	
nirmolotaa,	নির্মলতাও,	নির্মলতা,	
longhan,	লংহান,	লংঘন,	
trenda,	ট্রেন্ডা,	ট্রেন্ড,	
carbus,	কার্বাস,	কারবাস,	
madhabike,	মাধাবিকে,	মাধবীকে,	
ganesh,	গণেশ,	গণেশ,	
gorjon,	গর্নন,	গর্জন,	
jinsa,	জিনসা,	জিন্স,	
mumtaj,	মুমতাজ,	মুমতাজ,	
kurdira,	কুর্দিরা,	কুর্দিরা,	
morathee,	মোরাথে,	মরাঠি,	
aanaan,	আনান,	আনান,	
aro,	আরো,	আরও,	
jeebanjapon,	জীবনজা্পন,	জীবনযাপন,	
transformaarer,	ট্রান্সফোমামারের,	ট্রান্সফরমারের,	
uddhritir,	উদ্ধৃতির,	উদ্ধৃতির,	
doula,	ডালা,	দৌলা,	
sawam,	সাওয়াম,	সাওম,	
ekroop,	একররপ,	একরূপ,	
asif,	অসিফ,	আসিফ,	
nirmankaaj,	নির্মাকাজ্জ,	নির্মাণকাজ,	
planeti,	প্লানেতি,	প্লেনটি,	
sangbadmadhyomgulote,	সংবাদমাধ্যমগুলোতে,	সংবাদমাধ্যমগুলোতে,	
deputy,	ডিপুটি,	ডেপুটি,	
fevarite,	ফেভারিতে,	ফেভারিট,	
suparahiro,	সুপারহহিরও,	সুপারহিরো,	
jamanataswarup,	জমনাতাস্বরূপ,	জামানতস্বরূপ,	
hajirhat,	হাজিরহাট,	হাজিরহাট,	
kantojir,	কান্ডজির,	কান্তজির,	
munshiji,	মুন্সিজি,	মুনশীজি,	
bolatkar,	বলাটকার,	বলাৎকার,	
ishahak,	ইশাহাক,	ইসাহাক,	
chal,	চাল,	চাল,	
sip,	সিপ,	শিপ,	
dharmantor,	ধর্মনত্র,	ধর্মান্তর,	
toching,	টচিং,	টোচিং,	
palashir,	পালাশির,	পলাশীর,	
mahafezkhanar,	মহহােঞ্চারার,	মহাফেজখানার,	
seo,	সিও,	সেও,	
nibondhocheler,	নিবন্দচেলের,	নিবন্ধছেলের,	
osoborno,	অসবর্ণ,	অসবর্ণ,	
smarak,	স্মারক,	স্মারক,	
esasiyetasa,	এসাসিয়েসাটা,	এসোসিয়েটস,	
laicenshe,	লেইসেন্স,	লাইসেন্স,	
bonvumi,	বনভুমি,	বনভূমি,	
murali,	মুরালি,	মুরলী,	
antorbhuktimulak,	অন্তর্ভকিকসমূলক,	অন্তর্ভুক্তিমূলক,	
lakkhero,	লক্ষেরও,	লক্ষেরও,	
nisshongotake,	নিশ্ংগতাকে,	নিঃসঙ্গতাকে,	
krusher,	ক্রুশের,	ক্রুশের,	
chhuteer,	ছুটির,	ছুটির,	
harbur,	হারবুর,	হারবার,	
ponera,	পোনেরা,	পনের,	
rojapalaner,	রোজাপলানের,	রোজাপালনের,	
highcommissionay,	হিইভমিসংকামীয়,	হাইকমিশনে,	
purbancoler,	পূর্বানকলের,	পূর্বাঞ্চলের,	
anandamahale,	আনন্দমহলে,	আনন্দমহলে,	
karore,	কাররে,	কারোর,	
uponeesoder,	উপনিসদের,	উপনিষদের,	
mahakabi,	মহাকাবি,	মহাকবি,	
sahajlabhbhotar,	সহাকমার্কতার,	সহজলভ্যতার,	
militarir,	মিলিটিরির,	মিলিটারির,	
prajanankal,	প্রজানকাল,	প্রজননকাল,	
senabahineekey,	সেনাবাহিনীকে,	সেনাবাহিনীকে,	
laaishenshh,	লেইশেনস,	লাইসেন্স,	
bonvumitey,	বনভুমিটি,	বনভূমিতে,	
saralya,	সারাল্য,	সারল্য,	
lutherana,	লুথেরানা,	লুথেরান,	
olpo,	অল্প,	অল্প,	
nariider,	নারিদের,	নারীদের,	
matthews,	ম্যাথেেস,	ম্যাথিউস,	
kuthibarike,	কুথিবারিকে,	কুঠিবাড়ীকে,	
mohammadi,	মোহাম্মদি,	মুহাম্মদী,	
rinattak,	ঋণতত্তক,	ঋনাত্মক,	
dhonni,	ধ্বনি,	ধন্যি,	
artore,	আর্তোর,	আর্টরে,	
okkhorke,	অক্ষরকে,	অক্ষরকে,	
drissogulo,	দৃশ্যগুলো,	দৃশ্যগুলো,	
dhanche,	ধনচে,	ধাঁচে,	
torunosomriddho,	তরুণসম্দৃদ্ধ,	তরুণসমৃদ্ধ,	
paab,	পাব,	পাব,	
kathmandu,	কাঠমন্দু,	কাঠমান্ডু,	
ingrezeeteo,	ইংরেজিতেও,	ইংরেজিতেও,	
makong,	মাকোং,	মেকং,	
sardar,	সারদার,	সরদার,	
protizogii,	প্রতিযোগীই,	প্রতিযোগী,	
dekaner,	ডেকানের,	দেকানের,	
show,	শু,	শো,	
akmato,	আকমত,	একমত,	
protiakromonei,	প্রতিরকল্মমানেই,	প্রতিআক্রমণেই,	
agora,	অগোরা,	আগোরা,	
bandhubhaabaapanna,	বন্ধুভাবানন্ম,	বন্ধুভাবাপন্ন,	
oswasteekor,	অস্বাস্তিকর,	অস্বস্তিকর,	
haripur,	হরিপুর,	হরিপুর,	
orbit,	অরবিত,	অরবিট,	
elakaatite,	এলাকাটিতে,	এলাকাটিকে,	
ghumachchila,	ঘুমাচ্ছিলা,	ঘুমাচ্ছিল,	
gopalrao,	গোপালরাও,	গোপালরাও,	
dipgulote,	ডিপগুলোতে,	দ্বীপগুলোতে,	
baharamporer,	বহরামপর্যের,	বহরমপুরের,	
latsaheb,	লাতসাহেব,	লাটসাহেব,	
iuro,	ইউরো,	ইউরো,	
bbiseshyer,	বুসিবেশ্যের,	বিশেষ্যের,	
nirgamon,	নির্গমন,	নির্গমন,	
saqara,	সাকারা,	সকার,	
ahmed,	আহমেদ,	আহামদ,	
roy,	রয়,	রায়,	
tintir,	তিনটির,	তিনটির,	
enamela,	এনামেলা,	এনামেল,	
quary,	কোয়ারি,	কোয়েরি,	
deraa,	দেরা,	ডেরা,	
peerry,	পিরি,	পেরি,	
graambashee,	গ্রামবাশী,	গ্রামবাসী,	
procharjontrogulo,	প্রচারজন্্রতগুলো,	প্রচারযন্ত্রগুলো,	
daraider,	দারাইদের,	দরাইদের,	
contemporary,	কন্টমমপারির,	কন্টেম্পোরারি,	
hillse,	হিলসে,	হিলসে,	
bhagnekeo,	ভাগনেকেও,	ভাগ্নেকেও,	
yuroo,	যুরোও,	ইউরো,	
probhuder,	প্রভুদের,	প্রভুদের,	
ajibooner,	অজিবনের,	আজীবনের,	
bamni,	বামনি,	বামনী,	
elaakaa,	এলাকাক,	এলাকা,	
cholochchitrer,	চলচ্চিত্রের,	চলচ্চিত্রের,	
shikkhakram,	শিক্ষাক্রম,	শিক্ষাক্রম,	
saria,	সারিয়া,	সরিয়া,	
aansareer,	আনসারীর,	আনসারীর,	
amar,	আমার,	আমর,	
goora,	গোরা,	গোর,	
debate,	দেবাতে,	ডিবেট,	
internship,	ইন্টারশিপ,	ইন্টার্নশিপ,	
pancbaar,	পাঁবার,	পাঁচবার,	
rashider,	রাশিদের,	রশিদের,	
krishibigyani,	কৃষ্টিপীনামী,	কৃষিবিজ্ঞানী,	
ramonar,	রামনার,	রমনার,	
booksar,	বুকসার,	বুক্সার,	
turkeyder,	টুর্কেদের,	তুর্কিদের,	
taateo,	টাতেও,	তাতেও,	
niropekkho,	নিরপতক্ষ,	নিরপেক্ষ,	
scuvi,	স্কিভি,	স্কুভি,	
rajbandir,	রাজবন্দির,	রাজবন্দীর,	
parq,	পার্ক,	পার্ক,	
satarkakari,	সতরককারী,	সতর্ককারী,	
catholicbad,	ক্যাথোলিস্কা,	ক্যাথলিকবাদ,	
bonke,	বনকে,	বনকে,	
tarunra,	তরুনারা,	তরুণরা,	
barack,	ব্যারাক,	বারাক,	
masjidsaha,	মাসজিদসহ,	মসজিদসহ,	
myat,	ম্যাট,	ম্যাট,	
atibiplabi,	অতিবিপ্বলি,	অতিবিপ্লবি,	
komanera,	কমানেরা,	কমানেরা,	
ooipokar,	উপয়কার,	উইপোকার,	
dankaan,	ডানকান,	ডানকান,	
basab,	বাসাব,	বাসাব,	
shaddhi,	শাদধধি,	সাধ্বী,	
dakten,	ডাকতেন,	ডাকতেন,	
karaa,	কারা,	কারো,	
meshenjar,	মেশেঞ্জার,	মেসেঞ্জার,	
uponeeshod,	উপনিশো,	উপনিষদ,	
ajij,	আজিজ,	আজিজ,	
bishashke,	বিশাশকে,	বিশ্বাসকে,	
bosontokke,	বসন্তককে,	বসন্তকে,	
diniphition,	ডিনিফিটন,	ডেফিনেশন,	
oxfordey,	অক্সফোর্ডে,	অক্সফোর্ডে,	
sahooseekotar,	সহহিসতরার,	সাহসিকতার,	
kalnir,	কালনির,	কালনীর,	
pracharanamulak,	প্রচারমামূলক,	প্রচারণামূলক,	
khitkar,	খিতকার,	ক্ষিতকর,	
naagaalyand,	নাগাল্যাং্ড,	নাগাল্যান্ড,	
bollov,	বললভ,	বল্লভ,	
brail,	ব্রেইল,	ব্রেইল,	
obosore,	অবসরে,	অবসরে,	
sinakey,	সিনাকে,	সিনাকে,	
soheensotar,	সহিসন্তার,	সহিংসতার,	
danab,	দানাব,	দানব,	
serology,	সেরোলজি,	সেরোলজি,	
jaistho,	জাযাশ্থ,	জ্যৈষ্ঠ,	
aprasangikbhabei,	অপ্রসংগীক্ষবাকেই,	অপ্রাসঙ্গিকভাবেই,	
bidghootey,	বিধ্যতে,	বিদঘুটে,	
ashamarthita,	অসমার্থিত,	অসমর্থিত,	
doloo,	দললো,	ডলু,	
atighataner,	অতিঘাতনের,	অতিঘটনের,	
dabliudabliui,	দাবলিউদ্দিমাই,	ডাব্লিউডাব্লিউই,	
shekarmani,	শেকারমানি,	শেকরমানি,	
kamti,	কামটি,	কমতি,	
amittrakkhor,	অমিত্রাক্ষকর,	অমিত্রাক্ষর,	
niurolaji,	নিউরোলাজি,	নিউরোলজি,	
supreetira,	সুপ্রিতিরা,	সুপ্রীতিরা,	
taxikeo,	ট্যাক্সিকেও,	ট্যাক্সিকেও,	
foks,	ফকস,	ফক্স,	
shahidputra,	শহিদপুত্র,	শহীদপুত্র,	
sectore,	সেক্টরে,	সেক্টরে,	
boudhher,	বৌধের,	বৌদ্ধের,	
jonosomaj,	জনসমাজ,	জনসমাজ,	
fongli,	ফংলি,	ফংলি,	
eshtoniya,	এস্তনীয়,	এস্তোনিয়া,	
rushad,	রুশাদ,	রুশদ,	
korijachilen,	করিজিলালেন,	করিযাছিলেন,	
phiqsa,	ফিকসা,	ফিক্স,	
yura,	য়রা,	ইউরো,	
pharanyeta,	ফারানারেটা,	ফরম্যাট,	
ganoporibahoner,	গণপরিবহহনের,	গণপরিবহনের,	
hooq,	হুক,	হুক,	
monjurul,	মঞ্জুরুল,	মনজুরুল,	
pinglateo,	পিংলাতেও,	পিংলাতেও,	
cheekitshar,	চিকিৎসার,	চিকিত্সার,	
maudelder,	মাউডলদের,	মডেলদের,	
puding,	পুডিং,	পুডিং,	
okritokarjo,	অকৃতকর্জ্য,	অকৃতকার্য,	
byabaharkaree,	ব্যবহাকারী,	ব্যবহারকারী,	
societytey,	সোসিওটিতে,	সোসাইটিতে,	
ajuhath,	অজুহাথ,	অজুহাত,	
choson,	চোনন,	চোষণ,	
flux,	ফ্লেক্স,	ফ্লাস্ক,	
kosambir,	কোসাম্বির,	কোসাম্বীর,	
macbeth,	ম্যাকবেথ,	ম্যাকবেথ,	
brake,	ব্রাকে,	ব্রেক,	
piulir,	পিউলির,	পিউলির,	
conflict,	কনফ্লিক্ট,	কনফ্লিক্ট,	
deares,	ডিয়ারেস,	ডিআরএস,	
myathiou,	ম্যাথুও,	ম্যাথিউ,	
redcrosser,	রেডক্রসসের,	রেডক্রসের,	
itostatah,	ইতস্তাথা,	ইতস্ততঃ,	
dalip,	ডালিপ,	দালিপ,	
shipley,	শিপলে,	শিপলে,	
baman,	বামান,	বামন,	
dakkhinkare,	দক্ষিণককরে,	দক্ষিণকরে,	
codeti,	কোডেটি,	কোডটি,	
dishani,	দিশানি,	দিশানি,	
panchadadu,	পঞ্চদাদু,	পঞ্চাদাদু,	
mirakela,	মিরাকেলা,	মিরাকেল,	
nutunotto,	নুটনূত্ত,	নতুনত্ব,	
gingbhalobasen,	গিংকভামালে,	গিংভালোবাসেন,	
firalem,	ফিরালেম,	ফিরালেম,	
mokhmoley,	মখমলে,	মখমলে,	
cxt,	সিসিসিটি,	সিএক্সটি,	
anusvara,	অনুসভারা,	অনুস্বার,	
bitertrate,	বিতারেট্রেট,	বাইটারট্রেট,	
oitijjo,	ঐতিহ্য,	ঐতিহ্য,	
amiretus,	অমিরেরিস,	এমিরেটাস,	
prachando,	প্রাচন্ড,	প্রচণ্ড,	
jonoikaa,	জনৈকায়া,	জনৈকা,	
aarmstrong,	আর্মস্ট্রং,	আর্মস্ট্রং,	
fuss,	ফুসস,	ফাস,	
maryir,	মার্যার,	ম্যারির,	
veemsen,	ভেমসেন,	ভীমসেন,	
gafeeloti,	গ্যাফিলি,	গাফিলতি,	
jins,	জিনস,	জিন্স,	
auttacharer,	অট্টাচারের,	অত্যাচারের,	
chowdhuryke,	চৌবুদুরকে,	চৌধুরীকে,	
ashociatesh,	অসোসিয়াথেস,	এসোসিয়েটস,	
gaje,	গাজে,	গেজ,	
aakik,	আকিক,	আকিক,	
ajuhat,	অজুহাত,	অজুহাত,	
marketin,	মার্কেটিন,	মার্কেটিং,	
bagicha,	বাগিচা,	বাগিচা,	
pouchute,	পৌছুতে,	পৌঁছুতে,	
brookoleen,	ব্রকুললিন,	ব্রুকলিন,	
poripaker,	পরিপাকের,	পরিপাকের,	
rajbandi,	রাজবন্দী,	রাজবন্দী,	
ghurechen,	ঘুরেছেন,	ঘুরেছেন,	
sthapanar,	স্থাপনার,	স্থাপনার,	
postar,	পোস্তার,	পোস্টের,	
lendal,	লেন্ডাল,	লেন্ডল,	
queri,	কুয়েরি,	কোয়েরি,	
protijogii,	প্রতিযোগীই,	প্রতিযোগী,	
atwobishvashi,	আত্ববিভ্বাসী,	আত্মবিশ্বাসী,	
karmakarke,	কর্মকারকে,	কর্মকারকে,	
aajeej,	আজেজ,	আজিজ,	
mukherjee,	মুখরিজ্যে,	মুখার্জী,	
gavaskar,	গাভাস্কার,	গাভাস্কার,	
vangley,	ভ্যাংলে,	ভাঙলে,	
abodamaner,	অবদানমের,	অবদমনের,	
achintyabhedaved,	আচিন্তাহারবেদেব,	অচিন্ত্যভেদাভেদ,	
si,	সিআইএ,	এসআই,	
oblivion,	অবিলভিয়ান,	অবলিভিয়ন,	
madrasake,	মাদ্রাসাকে,	মাদ্রাসাকে,	
ap,	এপিএফ,	আপ,	
kadapaker,	কাদাপাকের,	কড়াপাকের,	
sambatsarkal,	সাম্বত্রকাল,	সম্বৎসরকাল,	
tooku,	টুকু,	টুকু,	
somratra,	সমরাত্রার,	সম্রাটরা,	
thyachara,	থ্যাচারা,	থ্যাচার,	
mirina,	মিরিনা,	মিরিনা,	
goodamjato,	গুডাম্জাত,	গুদামজাত,	
kisti,	কিস্তি,	কিস্তি,	
juddhahato,	যুদ্ধাাত,	যুদ্ধাহত,	
sainyader,	সৈন্যাদের,	সৈন্যদের,	
drishyogulote,	দৃশ্যগুলোতে,	দৃশ্যগুলোতে,	
zerusalem,	জেরুসালেম,	জেরুসালেম,	
ahalyar,	আহাল্যার,	অহল্যার,	
timathi,	তিমথি,	টিমোথি,	
paramartha,	পরমরর্থা,	পরমার্থ,	
nirvachokder,	নির্ভাচকদের,	নির্বাচকদের,	
gasthii,	গাস্থিই,	গোষ্ঠীই,	
mahbunur,	মাহবুনুর,	মাহবুনুর,	
jonee,	জনন,	জনি,	
supparak,	সুপ্রাাক,	সুপ্পারক,	
rahimed,	রহিমেদ,	রহিমেদ,	
hoil,	হইল,	হইল,	
beshirbhaagei,	বেশিরভাগেই,	বেশিরভাগেই,	
zeebonto,	জীবন্ত,	জীবন্ত,	
francine,	ফ্রান্সিন,	ফ্রান্সিন,	
romancha,	রোমাঞ্চা,	রোমাঞ্চ,	
iling,	ইলিং,	ইলিং,	
choopi,	চোপি,	চুপি,	
chandrima,	চন্দ্রীমা,	চন্দ্রিমা,	
seekkhaou,	শিক্ষাও,	শিক্ষাও,	
chalochchitraeei,	চলচ্চিত্রকাই,	চলচ্চিত্রেই,	
metropolitan,	মেট্রোপেটিনাল,	মেট্রোপলিটন,	
daaktikit,	ডাক্তিকিত,	ডাকটিকিট,	
fatakesto,	ফটাকেস্ত,	ফাটাকেষ্ট,	
lutheerana,	লুথারিনা,	লুথেরান,	
qarpeta,	কারপেটা,	কার্পেট,	
saras,	সারাস,	সরস,	
unchiyechilo,	উঁচিয়েছিল,	উঁচিয়েছিল,	
fastara,	ফাস্তারা,	ফস্টার,	
graambasheeo,	গ্রামবাশিও,	গ্রামবাসীও,	
existing,	এক্সিস্টিং,	এক্সিসটিং,	
manibhaijaner,	মনিভাজারের,	মণিভাইজানের,	
dhaanche,	ধাঁচে,	ধাঁচে,	
engrezder,	এংগ্রেজদের,	ইংরেজদের,	
dii,	ডিআই,	দিই,	
jwar,	জ্বার,	জ্বর,	
suraaropeeto,	সুরারাপ্ত,	সুরারোপিত,	
deciliter,	ডিকিলিটের,	ডেসিলিটার,	
shabkam,	শাবকাম,	শবকাম,	
bondira,	বন্দীরা,	বন্দীরা,	
cheerokoomari,	চিরোকামরি,	চিরকুমারী,	
sikarder,	সিকারদের,	শিকারদের,	
katbe,	কাটবে,	কাটবে,	
madhoboir,	মাধবীর,	মাধবীর,	
shikshagato,	শিক্ষাগত,	শিক্ষাগত,	
brindabane,	বৃন্দববানে,	বৃন্দাবনে,	
mahasava,	মহাসাভা,	মহাসভা,	
elaakaati,	এলাকাটি,	এলাকাটি,	
ikboler,	ইকবলের,	ইকবলের,	
roopdan,	রোপ্ডান,	রুপদান,	
teter,	টেটার,	টেটের,	
prokalpagulo,	প্রকালাপগুলো,	প্রকল্পগুলো,	
cbi,	সিবিআই,	সিবিআই,	
sanghar,	সংহর,	সংহার,	
rilayensha,	রিলাই়ানস,	রিলায়েন্স,	
ramantika,	রামন্তিকা,	রোমান্টিক,	
markeetim,	মারকিটিং,	মার্কেটিং,	
wodka,	ওড়াকা,	ভদকা,	
shikkharthirao,	শিক্ষার্থীরাও,	শিক্ষার্থীরাও,	
darjiling,	ডারজিলিং,	দার্জিলিং,	
klaud,	ক্লাউড,	ক্লাউড,	
lettar,	লেট্টার,	লেটার,	
shchalastic,	স্কালাস্টিক,	স্কলাস্টিক,	
pisach,	পিশাচ,	পিশাচ,	
vodqa,	ভোডকা,	ভদকা,	
moushumei,	মৌশুমেই,	মৌসুমেই,	
moshjidke,	মোসজিদকে,	মসজিদকে,	
pet,	পেট,	পেত,	
bhabotarini,	ভাবতারিণী,	ভবতারিণী,	
golimodhye,	গলিমধ্যে,	গলিমধ্যে,	
attacharito,	অত্যাচািত,	অত্যাচারিত,	
sohinsotar,	সোহিস্ততার,	সহিংসতার,	
saifai,	সাইফাই,	সাইফাই,	
aalkatraa,	আলকাত্রার,	আলকাতরা,	
dewaben,	দেওবাবেন,	দেওয়াবেন,	
prokolpow,	প্রকল্পও,	প্রকল্পও,	
esprito,	এসপ্রিতো,	এস্পিরিটো,	
turbiner,	টারবিনের,	টারবাইনের,	
munjur,	মুঞ্জুর,	মুনজুর,	
garora,	গারোরা,	গারোরা,	
dharavahikbhabe,	ধারাভাতিকভাবে,	ধারাবাহিকভাবে,	
chhadite,	ছাড়িতে,	ছড়িতে,	
rahshahi,	রহশাহী,	রাহশাহী,	
turisht,	তুরিশ্ত,	টুরিস্ট,	
harysoner,	হার্সনের,	হ্যারিসনের,	
farid,	ফারিদ,	ফরিদ,	
muradpur,	মুরাদপুর,	মুরাদপুর,	
narsaari,	নারসারি,	নার্সারি,	
dharmee,	ধর্মী,	ধর্মী,	
kareer,	কারির,	কারীর,	
saom,	সাওম,	সাওম,	
votarer,	ভোটারের,	ভোটারের,	
rohasyati,	রোহাস্যটি,	রহস্যটি,	
agomonke,	আগমমনকে,	আগমনকে,	
aachhis,	আছিস,	আছিস,	
shikhaboudi,	শিখাবৌদি,	শিখাবৌদি,	
nathivookteer,	নাথিভক্তরর,	নথিভুক্তির,	
chiraharit,	চিরাহিরিত,	চিরহরিৎ,	
bastubad,	বাস্তুবাদ,	বস্তুবাদ,	
bhittiti,	ভিত্তিটি,	ভিত্তিটি,	
badargaji,	বদরগাজী,	বদরগাজী,	
spredashiita,	স্প্রেদশশিত,	স্প্রেডশীট,	
prothati,	প্রথাটি,	প্রথাটি,	
moreecha,	মরিচা,	মরিচা,	
durbhagya,	দুর্ভাগ্য,	দূর্ভাগ্য,	
chapal,	চাপাল,	চপল,	
pillai,	পিল্লাই,	পিল্লাই,	
crime,	ক্রিইম,	ক্রাইম,	
utsahamulak,	উৎসামমূলক,	উৎসাহমূলক,	
bhaandar,	ভান্দার,	ভাণ্ডার,	
chaaktir,	চক্তির,	চাকতির,	
hilser,	হিলসের,	হিলসের,	
digri,	ডিগ্রি,	ডিগ্রি,	
aagera,	আগেরা,	আগোরা,	
shibraj,	শিবরাজ,	শিবরাজ,	
nagorikra,	নাগরিকরা,	নাগরিকরা,	
valobasen,	ভালোবাসেন,	ভালোবাসেন,	
shoori,	শুরি,	সুরি,	
melborrone,	মেলব্রোনে,	মেলবোর্নে,	
weenis,	ওইনিস,	ভেনিস,	
kompeeto,	কম্পিত,	কম্পিত,	
grambaashio,	গ্রামবাশীও,	গ্রামবাসীও,	
torkareer,	তরকারীর,	তরকারীর,	
groundta,	গ্রুউন্ডটা,	গ্রাউন্ডটা,	
monchostho,	মঞ্চস্থ,	মঞ্চস্থ,	
philipiner,	ফিলিপিনের,	ফিলিপাইনের,	
jacksonke,	জ্যাকসনকে,	জ্যাকসনকে,	
bamon,	বামোন,	বামন,	
dwibidho,	দ্বিবিধো,	দ্বিবিধ,	
samany,	সামানি,	সামান্য,	
dei,	দেই,	দিই,	
chalochchitro,	চলচ্চিত্র,	চলচ্চিত্র,	
sarboshokteeman,	সার্বশক্তিমাণ,	সর্বশক্তিমান,	
tongaa,	টোঙ্গা,	টোঙ্গা,	
rajtantro,	রাজতন্ত্র,	রাজতন্ত্র,	
vimsen,	ভিমসেন,	ভীমসেন,	
teta,	টেট,	টেটা,	
phund,	ফান্ড,	ফান্ড,	
jani,	জানি,	জনি,	
sikkhakromer,	শিক্ষাক্রমের,	শিক্ষাক্রমের,	
bhoutikeshu,	ভৌতেকিশু,	ভৌতিকেষু,	
kk,	কেভি,	কেকে,	
saramukhe,	সরমুখে,	সারামুখে,	
evereste,	ইভারেস্টে,	এভারেস্টে,	
ciima,	সিয়ামা,	সীমা,	
ponthaar,	পন্থার,	পন্থার,	
fatakasto,	ফটাসক্ত,	ফাটাকেষ্ট,	
saranor,	সারানোর,	সরানোর,	
daybhager,	দাওমাগের,	দায়ভাগের,	
akten,	আকতেন,	অকটেন,	
basaalt,	বাসাল্ট,	ব্যাসল্ট,	
bagdadii,	বাগদাদী,	বাগদাদী,	
epiela,	এপিইলা,	আইপিএল,	
nyata,	ন্যাতা,	ম্যাট,	
romjaner,	রোমজানের,	রমযানের,	
sangasthagulo,	সংস্থাগুলো,	সংস্থাগুলো,	
aamoode,	আমোদে,	আমুদে,	
pitiler,	পিতিলের,	পিটিলের,	
chahidapotrer,	চাহিদপত্রের,	চাহিদাপত্রের,	
souripurang,	সৌরিপূর্গ,	সৌরিপুরং,	
durgatsob,	দুর্গাতসব,	দুর্গোৎসব,	
jacksoner,	জ্যাকসনের,	জ্যাকসনের,	
kramp,	ক্রাম্প,	ক্র্যাম্প,	
procharona,	প্রচারণা,	প্রচারণা,	
proshtotto,	প্রশ্তত্ব,	প্রস্ত্তত,	
giitikobitar,	গীতিবিতাকার,	গীতিকবিতার,	
odeb,	ওডেব,	ওদেব,	
jamarate,	জামারাতে,	জামারাতে,	
siddhanter,	সিদ্ধান্তের,	সিদ্ধান্তের,	
arifin,	আরিফিন,	আরিফিন,	
kuldip,	কুলদিপ,	কুলদীপ,	
motkey,	মোটকে,	মতকে,	
modelgulo,	মডেলগুলো,	মডেলগুলো,	
kaamij,	কামিজ,	কামিজ,	
thare,	থারে,	থরে,	
gasthi,	গাস্থি,	গোষ্ঠী,	
shucharita,	শুচারিতা,	সুচরিতা,	
ghotaibe,	ঘোটাইবে,	ঘটাইবে,	
khuliechilam,	খুলিয়েছিলাম,	খুলিয়েছিলাম,	
quartar,	কুয়ারটার,	কোয়ার্টার,	
karadando,	কারাদন্দ,	কারাদণ্ড,	
diznee,	ডিজনি,	ডিজনী,	
zommu,	জম্মু,	জম্মু,	
batikromshalee,	বাতিক্রমাশলয়,	ব্যতিক্রমধর্মী,	
pettern,	পেটার্ন,	প্যাটার্ন,	
pratiyogitar,	প্রতিয়গিতার,	প্রতিযোগীতার,	
bondiira,	বন্দিরার,	বন্দীরা,	
protistha,	প্রতিষ্ঠা,	প্রতিষ্টা,	
eeksapreeshana,	ইক্সপ্রিরাশন,	এক্সপ্রেশন,	
thabai,	থাবাই,	থাবাই,	
dokaangulotey,	ডোকানগুলোতে,	দোকানগুলোতে,	
qaferder,	কাফেরদের,	কাফেরদের,	
chhooteer,	ছোটির,	ছুটির,	
bhujangta,	ভূজাঙ্গটা,	ভুজঙ্গটা,	
bodhukeo,	বধুকেও,	বধুকেও,	
joubanbatee,	যৌবনবাতায়,	যৌবনবতী,	
makhno,	মাখনো,	মাখনো,	
reetesh,	রেটেশ,	রিতেশ,	
udvaboney,	উদ্ভাবনে,	উদ্ভাবনে,	
kade,	কাদে,	কোড,	
reflex,	রেফলেক্স,	রিফ্লেক্স,	
srichoitonnodeb,	শ্রীচৈতননন্দেব,	শ্রীচৈতন্যদেব,	
mookhomaundoler,	মুখমান্ডললের,	মুখমণ্ডলের,	
messengerer,	মেসেঞ্জেরের,	মেসেঞ্জারের,	
graambaaseer,	গ্রামবাসিয়ার,	গ্রামবাসীর,	
shhow,	শোয়,	শো,	
bagdad,	বাগদাদ,	বাগদাদে,	
licensedhari,	লিইসেন্েধারী,	লাইসেন্সধারী,	
uttor,	উত্তর,	উওর,	
qonfliqt,	কনফ্লিক্ট,	কনফ্লিক্ট,	
mangoleek,	মাঙ্গলিক,	মাঙ্গলিক,	
tawnship,	তাউনশিপ,	টাউনশিপ,	
phaltu,	ফালটু,	ফালতু,	
ancholgoolote,	অঞ্চলগুলোতে,	অঞ্চলগুলোতে,	
jahangirbad,	জাহাগ্রীরাবা,	জাহাঙ্গীরবাদ,	
bhupal,	ভুপাল,	ভূপাল,	
oshtader,	ওষ্টাদের,	ওস্তাদের,	
bedey,	বেদে,	বেদে,	
vandar,	ভান্দার,	ভাণ্ডার,	
grauth,	গ্রাউথ,	গ্রোথ,	
expreshshion,	এক্সপ্রেশন,	এক্সপ্রেশন,	
protul,	প্রতুল,	প্রতুল,	
madhukori,	মধুকোরী,	মাধুকরী,	
udbodhani,	উদ্বোধনী,	উদ্বোধনী,	
mukhabandha,	মুখবন্ধ,	মুখবন্ধ,	
kinto,	কিন্তো,	কিনত,	
armshtronj,	আর্মশ্ট্রোঞ্জ,	আর্মস্ট্রং,	
matt,	ম্যাট,	ম্যাট,	
hariner,	হরিনের,	হরিণের,	
fulkapi,	ফুলকাপি,	ফুলকপি,	
nirbahe,	নির্বাহে,	নির্বাহে,	
byaboharkareer,	ব্যবহারকারীর,	ব্যবহারকারীর,	
lutharan,	লুথারান,	লুথেরান,	
madhuree,	মধুরে,	মাধুরী,	
niketaner,	নিকেতানের,	নিকেতনের,	
chowdhurir,	চৌবুধির,	চৌধুরীর,	
oncholsomuho,	অঞ্চলসমূহ,	অঞ্চলসমূহ,	
mandope,	ম্যান্ডপপে,	মন্ডপে,	
dupleks,	ডাপলেক্স,	ডুপ্লে,	
ekbakye,	একবাককে,	একবাক্যে,	
mochlekha,	মোচলেখা,	মোছলেখা,	
milekhanek,	মিলেখানেক,	মাইলখানেক,	
hukar,	হুকার,	হুকার,	
goonoman,	গুনমান,	গুণমান,	
deejeejer,	দিজিজের,	ডিজিজের,	
jetam,	জেতাম,	যেতাম,	
battery,	ব্যাটারি,	ব্যাটারী,	
pooshteer,	পুষ্টির,	পুষ্টির,	
damakalkarmirao,	দমকল্লকামীরাও,	দমকলকর্মীরাও,	
dhalur,	ধালুর,	ঢালুর,	
janosamaj,	জনসমাজ,	জনসমাজ,	
saainyo,	সৈন্য,	সৈন্য,	
bongsho,	বংশ,	বংশ,	
setikey,	সেতিকে,	সেটিকে,	
koruna,	করুনা,	করুণা,	
kaash,	কাশ,	কাস,	
michir,	মিচির,	মিচির,	
konar,	কোনার,	কণার,	
ruby,	রুবী,	রুবী,	
dianes,	ডায়েনস,	ডিএনএস,	
shansthagulo,	শাংসতাগুলো,	সংস্থাগুলো,	
jalbe,	জলবে,	জ্বলবে,	
rejidens,	রেজিডেনস,	রেসিডেন্স,	
rubidium,	রুবিডিউম,	রুবিডিয়াম,	
laishenshim,	লেইশিসশিং,	লাইসেন্সিং,	
murad,	মুরাদ,	মুরাদ,	
difinisian,	ডিফিনিসিয়ান,	ডেফিনেশন,	
lambi,	লাম্বি,	লম্বি,	
yucalyptus,	য্কুরলাল্টাস,	ইউক্যালিপ্টাস,	
shoriph,	শরিফ,	শরিফ,	
bojhey,	বোঝে,	বোঝে,	
argho,	আর্ঘ,	অর্ঘ্য,	
rajtontro,	রাজতন্ত্র,	রাজতন্ত্র,	
timoothi,	তিমোথি,	টিমোথি,	
samajik,	সমাজিক,	সামাজিক,	
upobasee,	উপবাসী,	উপবাসী,	
deefinision,	ডিফিনিশন,	ডেফিনেশন,	
senabahineeow,	সেনাবাহিনীয়,	সেনাবাহিনীও,	
shektor,	শেক্তর,	সেক্টর,	
chakradhare,	চাকরাধারে,	চক্রধরে,	
alaol,	আলাওল,	আলাওল,	
pingna,	পিংনা,	পিংনা,	
poderthobid,	পদের্থবিদ,	পদার্থবিদ,	
gonohotyakey,	গণহাত্যকে,	গণহত্যাকে,	
bonnopran,	বন্যপ্রাণ,	বন্যপ্রাণ,	
fising,	ফিসিং,	ফিসিং,	
hydrological,	হাইড্রোলিক্যাল,	হাইড্রোলজিক্যাল,	
augustine,	অগ্সিটাইন,	অগাস্টিন,	
kinenni,	কিনেননি,	কিনেননি,	
mozlis,	মজলিস,	মজলিশ,	
caroline,	ক্যারোলিন,	ক্যরোলিন,	
protisthan,	প্রতিষ্ঠান,	প্রতিষ্টান,	
pratijogira,	প্রতিযোগীরা,	প্রতিযোগীরা,	
chirkut,	চিরকুট,	চিরকুট,	
helly,	হেল্,	হিলি,	
bhumija,	ভূমিজা,	ভূমিজ,	
ramolino,	রামোলিনো,	রামোলিনো,	
neelfamarir,	নীলফামারীর,	নীলফামারীর,	
dadapur,	দাদাপুর,	দাদাপুর,	
drabyatah,	দ্রব্যতা,	দ্রব্যতঃ,	
rajotwo,	রাজত্ব,	রাজত্ব,	
hattey,	হাততে,	হাঁটতে,	
wagadada,	ওয়াগাদাড়া,	বাগদাদ,	
bbiswashi,	বুব্বশ্বি,	বিশ্বাসই,	
karecho,	কারেছো,	করেছো,	
paolasthi,	পাওলাস্থি,	পাওলাসথি,	
ancholsomuho,	অঞ্চলসমূহ,	অঞ্চলসমূহ,	
pharn,	ফার্ন,	ফার্ন,	
pustir,	পুস্তির,	পুষ্টির,	
moshahidur,	মোশাহিদুর,	মোশাহিদুর,	
arthonitite,	অর্থনীতিতে,	অর্থনীতিতে,	
provur,	প্রভুর,	প্রভুর,	
ovidhanik,	অভিধানিক,	অভিধানিক,	
vedanta,	ভেদানটা,	বেদান্ত,	
shalook,	শালোক,	শালুক,	
mukhomandal,	মুখোমনদল,	মুখমণ্ডল,	
satarkabhabey,	সতর্কভাবে,	সতর্কভাবে,	
nirbaho,	নির্বাহ,	নির্বাহ,	
shit,	শিত,	শীত,	
subade,	সুবাদে,	সুবাদে,	
olympic,	অলিপ্পিক,	অলিম্পিক,	
tigre,	টিগ্রে,	টাইগার,	
golghare,	গোলঘরে,	গোলঘরে,	
nazranar,	নজরানার,	নাজরানার,	
rupantarer,	রূপান্তরের,	রুপান্তরের,	
ganaporibahaner,	গণপরিবহহনের,	গণপরিবহনের,	
lyaanding,	ল্যান্ডিং,	ল্যান্ডিং,	
ponchasjon,	পঞ্চাসজন,	পঞ্চাশজন,	
dhanak,	ধানাক,	ধানক,	
vabnakey,	ভাবনাকে,	ভাবনাকে,	
samratder,	সমরত্রের,	সম্রাটদের,	
rakhtokkharoner,	রাখতক্ষণণের,	রক্তক্ষরণের,	
mahibur,	মহিবুর,	মহিবুর,	
steen,	স্টিন,	স্টেন,	
yukeliptash,	যুকেলপেত্স,	ইউক্যালিপ্টাস,	
gaujano,	গজজনও,	গজানো,	
bhugol,	ভুগল,	ভূগোল,	
phutonta,	ফুটোনটা,	ফুটন্ত,	
krisenter,	ক্রিসেন্টার,	ক্রিসেন্টের,	
churger,	চুর্গের,	চার্জের,	
ajijer,	আজিজের,	আজিজের,	
tetela,	টেটেলা,	টাইটেল,	
surke,	সুরকে,	সুরকে,	
bahati,	বাহাটি,	বাহাতি,	
dhojovongo,	ধ্বজন্গ,	ধ্বজভঙ্গ,	
siit,	সিইট,	শীত,	
rekhapat,	রেখাপাত,	রেখাপাত,	
sangosrobomukto,	সংস্রামবুক্ত,	সংস্রবমুক্ত,	
labonaaktotaar,	লাবনাকততারকার,	লবণাক্ততার,	
amburi,	আম্বুরি,	আম্বুরি,	
cn,	সিএনএন,	সিএন,	
kalki,	কালকি,	কালকি,	
vaisoho,	বাইসহ,	ভাইসহ,	
noditei,	নদিতেই,	নদীতেই,	
erythrian,	এরিথ্রিয়ান,	এরিথ্রিয়ান,	
jamjamat,	জাম্মাত,	জমজমাট,	
goolen,	গুলেন,	গুলেন,	
dumaa,	ডুমাও,	দুমা,	
jatotaa,	যাতোতাও,	যতোটা,	
armstronz,	আর্মস্ট্র্য,	আর্মস্ট্রং,	
jokkher,	যক্ষের,	যক্ষের,	
metrikoleshana,	মেট্রিকোমেশনা,	মেট্রিকোলেশন,	
edipass,	এডিপাস্স,	ইডিপাস,	
grontho,	গ্রন্থ,	গ্রন্থ,	
kachhakaachhi,	কাছাখাছি,	কাছাকাছি,	
sarajibonbyapi,	সারজিবন্দ্বলি,	সারাজীবনব্যাপী,	
sanaktokaran,	সানক্তকরণ,	সনাক্তকরণ,	
torabganj,	টররাগগঞ্জ,	তোরাবগঞ্জ,	
nothivukta,	নথিভুক্ত,	নথিভুক্ত,	
tarkale,	তারকালে,	তারকালে,	
query,	কোয়েরি,	কোয়েরি,	
bishaashke,	বিশাশকে,	বিশ্বাসকে,	
langhoner,	লঙ্ঘনের,	লংঘনের,	
atak,	আটাক,	আটক,	
jolaatonko,	জলাাত্ন,	জলাতঙ্ক,	
durgotshob,	দুর্গতসভ,	দুর্গোৎসব,	
ongkush,	অংশুখ,	অংকুশ,	
karpeter,	কারপেটের,	কার্পেটের,	
kheshar,	খেশার,	খেশার,	
sulfatee,	সুলফাতে,	সালফেট,	
sumitrar,	সুমিত্রার,	সুমিত্রার,	
kkomandar,	ক্বমানদার,	কমাণ্ডার,	
lendol,	লেন্ডল,	লেন্ডল,	
taronee,	তারনি,	তরণী,	
niharkantibabu,	নিহারকান্তবাবু,	নিহারকান্তিবাবু,	
spreadshiit,	স্প্রেশশিত,	স্প্রেডশীট,	
masjidti,	মাসজিদটি,	মসজিদটি,	
onucheeder,	অনুচিদের,	অনুচ্ছেদের,	
nirbahi,	নির্বাহী,	নির্বাহি,	
bachhaikrito,	বাচাইকৃত,	বাছাইকৃত,	
gandhikey,	গান্ধিকে,	গান্ধীকে,	
mile,	মিলে,	মিলে,	
poste,	পোস্টে,	পোস্টে,	
booroon,	বুরুন,	বোরন,	
shandra,	শান্দ্রা,	শান্দ্রার,	
lokhindorer,	লোখিন্দরের,	লখিন্দরের,	
ayantarqatiqa,	আযন্ত্রতাকিকা,	অ্যান্টার্কটিকা,	
indrakanan,	ইন্দ্রকানান,	ইন্দ্রকানন,	
akhando,	আখান্দ,	অখন্ড,	
dreeshtiheen,	দৃষ্টিখান,	দৃষ্টিহীন,	
probhura,	প্রভুরা,	প্রভুরা,	
pohnpeic,	পোনজেসি,	ফোনপেইক,	
hights,	হিটফস,	হাইটস,	
lebina,	লেবিনা,	লেবিনা,	
balaruma,	বালারুমা,	বলরুম,	
krimlin,	ক্রিইলিন,	ক্রিমলিন,	
oxforde,	অক্সফোর্ডে,	অক্সফোর্ডে,	
daktickete,	ডাক্িকেটকে,	ডাকটিকিটে,	
shikshakbrinda,	শিক্ষাস্ক্র্দা,	শিক্ষকবৃন্দ,	
hypar,	হাইপার,	হাইপার,	
bhikkharthe,	ভিক্ষার্থে,	ভিক্ষার্থে,	
bolechile,	বলেছিলে,	বলেছিলে,	
edmeeral,	এডমিরাল,	এডমিরাল,	
kuhelika,	কুহেলিকা,	কুহেলিকা,	
phartha,	ফার্থা,	ফার্থ,	
sangkalanti,	সংকল্নটি,	সংকলনটি,	
machhti,	মাছটি,	মাছটি,	
spenser,	স্পেনসের,	স্পেন্সার,	
kormokarke,	কর্মকারকে,	কর্মকারকে,	
dhamshrenite,	ধ্বশ্রেণিতে,	ধামশ্রেণীতে,	
dibug,	দিবুগ,	ডিবাগ,	
mandanda,	মন্দনদা,	মানদণ্ড,	
nogore,	নগরে,	নগরে,	
pooshti,	পুষ্টি,	পুষ্টি,	
asovyo,	অসব্য,	অসভ্য,	
goteehin,	গতিহীন,	গতিহীন,	
avinetar,	অভিনেতার,	অভিনেতার,	
kobutorer,	কবুতরের,	কবুতরের,	
philo,	ফিলো,	ফিলো,	
ostad,	অস্তাদ,	ওস্তাদ,	
dhormokorme,	ধর্মকর্মে,	ধর্মকর্মে,	
turkamena,	টুর্কমেনা,	তুর্কমেন,	
torkarite,	টর্কারিতে,	তরকারিতে,	
parisankhanbid,	পরিসংখ্যান্দিদ,	পরিসংখ্যানবিদ,	
mukhomondoler,	মুখমন্ডলের,	মুখমণ্ডলের,	
bonshi,	বনশি,	বংশী,	
gaaddafee,	গডডাফাই,	গাদ্দাফী,	
bunot,	বুনোট,	বুনট,	
favorite,	ফাভরিতে,	ফেভারিট,	
kaferderke,	কাফেরদেরকে,	কাফেরদেরকে,	
huk,	হুক,	হুক,	
asiatic,	অ্যাসিয়াটিক,	এশিয়াটিক,	
mukhbondho,	মুখবন্ধ,	মুখবন্ধ,	
palbongsher,	পালমংশের,	পালবংশের,	
chakti,	চক্তি,	চাকতি,	
kumbhalnar,	কুম্ভলনার,	কুম্ভালনার,	
prashikkhane,	প্রশিক্ষণে,	প্রশিক্ষণে,	
panchbar,	পাঁচবার,	পাঁচবার,	
mulbhitti,	মুলভিত্তি,	মূলভিত্তি,	
ingrejra,	ইংরেজরা,	ইংরেজরা,	
bibechyo,	বিবেচ্য,	বিবেচ্য,	
gore,	গোরে,	গোর,	
muchlima,	মুছলিমা,	মুছলিমা,	
forex,	ফরেক্স,	ফরেক্স,	
ansareer,	আনসারীর,	আনসারীর,	
jounatar,	যৌনাতার,	যৌনতার,	
nazad,	নাজাদ,	নজদ,	
musabbirul,	মুসাব্বিরুল,	মুসাব্বিরুল,	
brekethru,	ব্রেকেরথুরা,	ব্রেকথ্রু,	
shamuker,	শমমুকের,	শামুকের,	
monzeele,	মঞ্জিলে,	মঞ্জিলে,	
venuser,	ভেনুসের,	ভেনাসের,	
brittakare,	বৃত্তকারে,	বৃত্তাকারে,	
graambaasheeo,	গ্রামবাশীয়,	গ্রামবাসীও,	
streegon,	স্ট্রীগণ,	স্ত্রীগণ,	
utkhaat,	উৎকাত,	উত্খাত,	
fostar,	ফস্তার,	ফস্টার,	
faskari,	ফাসকারী,	ফাঁসকারী,	
palbongser,	পালমনসের,	পালবংশের,	
nilfamarir,	নীলফামারীর,	নীলফামারীর,	
kushakhali,	কুশখালি,	কুশাখালি,	
ekghore,	একঘরে,	একঘরে,	
narbur,	নারবুর,	নরবুর,	
thyachar,	থ্যাচার,	থ্যাচার,	
suparichiti,	সুপারিচিতি,	সুপরিচিতি,	
pratijogitamulak,	প্রতিযোগিতামূলক,	প্রতিযোগীতামূলক,	
nyeta,	ন্যেতা,	ম্যাট,	
pyore,	প্যারোর,	পিওর,	
parikhar,	পারিখার,	পরিখার,	
ekoirokom,	একোরকম,	একইরকম,	
camerapersoner,	ক্যামেরাপ্রেসনের,	ক্যামেরাপার্সনের,	
jyesthaa,	জ্যেষ্ঠাও,	জ্যেষ্ঠা,	
gananatyo,	গণনাত্য,	গণনাট্য,	
bhyatikaner,	ভ্যাটিকানের,	ভ্যাটিকানের,	
khelaphate,	খেলাফাতে,	খেলাফতে,	
langhangulir,	লঙ্ঘাগুলির,	লঙ্ঘনগুলির,	
bbosonto,	ব্যবস্ত,	বসন্ত,	
samoshtigato,	সমশ্তিগত,	সমষ্টিগত,	
bage,	বাগে,	বাগে,	
freekeh,	ফ্রিকেহ,	ফ্রিকেহ,	
chalaabi,	চালাবি,	চালাবে,	
mandape,	ম্যান্ডপে,	মন্ডপে,	
munot,	মুনোট,	মুনোট,	
kaaferder,	কাফেরদের,	কাফেরদের,	
eduardo,	এডুয়ার্ডো,	এডুয়ার্দো,	
niketon,	নিকেটন,	নিকেতন,	
nodimatrik,	নদীমত্রিক,	নদীমাতৃক,	
soommita,	সমমিতা,	সুমিতা,	
vabaponno,	ভাবামন্ন,	ভাবাপন্ন,	
kottar,	কতটার,	কট্টর,	
taranee,	তারানী,	তরণী,	
stana,	স্তানা,	স্টোন,	
onchalgulir,	অঞ্চাগুলির,	অঞ্চলগুলির,	
bhimsenkei,	ভিমসেনকেই,	ভীমসেনকেই,	
madhoori,	মাধুরি,	মাধুরী,	
prothakey,	প্রথাকে,	প্রথাকে,	
mexicoteo,	মেক্সিকেটেও,	মেক্সিকোতেও,	
mishal,	মিশাল,	মিশাল,	
temone,	টেমোন,	তেমনই,	
dhyana,	ধ্যানা,	ধ্যান,	
coons,	কোউন্স,	কুনস,	
chaanoo,	চানো,	চানু,	
fansi,	ফানসি,	ফাঁসী,	
satarka,	সতরকা,	সতর্ক,	
greenald,	গ্রিনাল্ড,	গ্রিনল্ড,	
cheekitsar,	চিকিৎসার,	চিকিত্সার,	
kokeyin,	কোকেইন,	কোকেইন,	
poste,	পোস্টে,	পোষ্টে,	
kichudinpar,	কিছুজিন্নুর,	কিছুদিনপর,	
jyaqasana,	জ্যাকাসনা,	জ্যাকসন,	
tirmijii,	তির্মিজিই,	তিরমিজি,	
pyaleshtainer,	প্যালেশনটেলের,	প্যালেস্টাইনের,	
khanonkaj,	খননকাজন,	খননকাজ,	
anyarup,	অন্যরূপ,	অন্যরূপ,	
arke,	আরকে,	আরকে,	
faltu,	ফলতু,	ফালতু,	
byomkes,	বায্মকেস,	ব্যোমকেশ,	
nirbaaho,	নির্বাহ,	নির্বাহ,	
upobasher,	উপবাশের,	উপবাসের,	
shringey,	শ্রিংগে,	শৃঙ্গে,	
freelancerra,	ফ্রিলেন্সরা,	ফ্রিল্যান্সাররা,	
shikshakbrindo,	শিক্ষাস্ত্রিযা,	শিক্ষকবৃন্দ,	
sponsorshipe,	স্পন্শশররিপে,	স্পন্সরশীপে,	
dajhyo,	দাঝ্য,	দাহ্য,	
shishupalgarh,	শিশুপালঘর,	শিশুপালগড়ে,	
futonta,	ফুটোনটা,	ফুটন্ত,	
concerter,	কনসারটার,	কানসাটের,	
jothon,	যথন,	যথন,	
cinematographar,	সিনেমালাপ্রাফর,	সিনেমাটোগ্রাফার,	
songasthaner,	সংস্থানের,	সংস্থানের,	
sohojlovyotar,	সহযোগ্যতার,	সহজলভ্যতার,	
hisaber,	হিসাবের,	হিসাবের,	
venkates,	ভেঙ্কাটেস,	ভেঙ্কটেশ,	
plaiin,	প্লাইন,	প্লেন,	
lyataa,	ল্যাটা,	ল্যাটা,	
melbourner,	মেলবোর্নের,	মেলবোর্নের,	
thaii,	থাই,	থাই,	
desiseyer,	ডিসিয়েসের,	ডিজিজের,	
bouddher,	বৌদ্ধের,	বৌদ্ধের,	
teamothy,	টিমহটি,	টিমোথি,	
laga,	লাগা,	লগ,	
chorchita,	চরচিতা,	চর্চিত,	
grambaashi,	গ্রামবাশী,	গ্রামবাসী,	
cloudbook,	ক্লোড়বক,	ক্লাউডবুক,	
ekoghore,	একঘরে,	একঘরে,	
baikalyo,	বাইকাল্য,	বৈকল্য,	
azin,	আজিন,	আজিন,	
shikshakrom,	শিক্ষাক্রম,	শিক্ষাক্রম,	
modyer,	মড্যের,	মদ্যের,	
change,	চাঙ্গে,	চেঞ্জ,	
vabook,	ভাবুক,	ভাবুক,	
kormoi,	কর্মই,	কর্মই,	
somraatra,	সমরাত্রার,	সম্রাটরা,	
oncolsoho,	অন্কলসহ,	অঞ্চলসহ,	
humira,	হুমিরা,	হুমিরা,	
madraser,	মাদ্রাসের,	মাদ্রাজের,	
narishwar,	নারীশ্বর,	নারীশ্বরের,	
torabgonj,	টররাগগঞ্জ,	তোরাবগঞ্জ,	
shho,	শোয়া,	শো,	
madhobeer,	মাধবীর,	মাধবীর,	
jorury,	জরুরি,	জরূরী,	
kaalki,	কালকি,	কালকি,	
maladabha,	মালাবাভা,	মলদোভা,	
bade,	বাদে,	বাদে,	
superheiroo,	সুপারহহিয়ারো,	সুপারহিরো,	
bayii,	বাইয়েই,	বাঈ,	
canservatian,	ক্যানসারভাশিয়ান,	কনসারভেশন,	
tikta,	টিকটা,	তিক্ত,	
deilee,	দেইলে,	ডেইলি,	
senabahinio,	সেনাবাহিনীও,	সেনাবাহিনীও,	
boikolyo,	বৈকক্য,	বৈকল্য,	
footbalarra,	ফুটবলারারা,	ফুটবলাররা,	
chinito,	চিনিতো,	চিনতো,	
umedpoor,	উমেদপুর,	উমেদপুর,	
durarohini,	দুরারিহিনী,	দুরারোহিণী,	
akai,	আকাই,	একাই,	
sumoo,	সুমো,	সুমো,	
notey,	নটে,	নোটে,	
torunderke,	টরুন্ডারকে,	তরুণদেরকে,	
prothar,	প্রথার,	প্রথার,	
uposhthit,	উপশ্থিত,	উপস্থিত,	
prasadhani,	প্রসাধানি,	প্রসাধনী,	
pothnirdeshona,	পথ্নির্দেশনা,	পথনির্দেশনা,	
mashtarsha,	মাষ্টারসহ,	মাস্টার্স,	
samratra,	সমরত্র,	সম্রাটরা,	
shangkulaan,	শংকুলাল,	সংকুলান,	
madelim,	মাদেলিম,	মডেলিং,	
hastantar,	হস্তান্তর,	হস্তান্তর,	
satjaner,	সাতজানের,	সাতজনের,	
stanahenja,	স্তনাহেজ্জা,	স্টোনহেঞ্জ,	
meshintao,	মেশিনটাও,	মেশিনটাও,	
mesenjarer,	মেসেঞ্জারের,	মেসেঞ্জারের,	
rifleksa,	রিফল্সকা,	রিফ্লেক্স,	
mojlish,	মজলিশ,	মজলিশ,	
amanisa,	আমানিসা,	অমানিশা,	
projanankal,	প্রজানকালন,	প্রজননকাল,	
rajtantra,	রাজতন্ত্র,	রাজতন্ত্র,	
semai,	সেমাই,	সেমাই,	
swajan,	স্বজন,	স্বজন,	
sheetke,	শিতকে,	শীতকে,	
jonoshongjog,	জনশংযোগ,	জনসংযোগ,	
karu,	কারু,	কারু,	
ujobekeestan,	উজয়বেক্তসন,	উজবেকিস্তান,	
shchalastik,	স্কালাস্তিক,	স্কলাস্টিক,	
popke,	পোপকে,	পোপকে,	
kidambi,	কিদম্বী,	কিদম্বি,	
udbodhaney,	উদ্বোধনে,	উদ্বোধনে,	
jomjamat,	জোম্যামাত,	জমজমাট,	
omeettrakkhor,	অবিত্তারক্ষর,	অমিত্রাক্ষর,	
laps,	ল্যাপস,	ল্যাপস,	
homsher,	হোমশের,	হোমসের,	
baibasthaar,	বৈবস্থার,	ব্যবস্থার,	
obdi,	অব্দি,	অব্দি,	
elaakaate,	এলাকাতে,	এলাকাতে,	
faase,	ফেস,	ফাঁসে,	
vange,	ভ্যাঙ্গে,	ভাঙ্গে,	
lidars,	লিডার্স,	লিডার্স,	
huqa,	হুকা,	হুক,	
annanere,	অন্যানেরে,	অন্যানেরে,	
ekshoti,	একশতি,	একশোটি,	
hamburgey,	হাম্বুরগে,	হামবুর্গে,	
cholochchitrai,	চলচ্চিত্রায়,	চলচ্চিত্রই,	
firoze,	ফিরোজে,	ফিরোজ,	
koomarir,	কোমারির,	কুমারীর,	
nirmankarmisaha,	নির্মানকুরমাসহ,	নির্মাণকর্মীসহ,	
kaande,	কান্ডে,	কাণ্ডে,	
tahorir,	তাহরীর,	তাহরীর,	
ddheela,	ঢেলা,	ঢিলা,	
kolkarkhana,	কলকারখানা,	কলকারখানা,	
kaatbey,	কাটবে,	কাটবে,	
borendroke,	বরেন্ড্রকে,	বরেন্দ্রকে,	
volapuk,	ভোলাপুক,	ভোলাপুক,	
chotogolper,	চটটলল্পের,	ছোটগল্পের,	
chalchhe,	চালছে,	চলছে,	
remacry,	রিমাক্সি,	রেমাক্রী,	
romnar,	রোমনার,	রমনার,	
lopjonito,	লো্জনিত,	লোপজনিত,	
calabe,	ক্যালাবে,	চালাবে,	
sthitiko,	স্থিতিকও,	স্থিতিকো,	
chhuti,	ছুটি,	ছুটি,	
zarniz,	জার্নিজ,	জারনিজ,	
dhandu,	ধন্দু,	ধন্দু,	
satarkokari,	সতত্করকারী,	সতর্ককারী,	
jahara,	জাহারা,	যাহরা,	
ul,	উলল,	উল,	
qanasarabheshana,	কানাসর্েশন,	কনসারভেশন,	
baptics,	ব্যাপটিস,	ব্যাপটিকস,	
chalachchitrer,	চলচ্চিত্রের,	চলচ্চিত্রের,	
qara,	কারা,	কর,	
lesense,	লেসেন্সে,	লাইসেন্স,	
valobase,	ভালোবাসে,	ভালোবাসে,	
silabhara,	সিলাভারা,	সিলভার,	
nanilalke,	নানিলালকে,	ননীলালকে,	
songbadmadhyame,	সংবাদমধ্যমে,	সংবাদমাধ্যমে,	
joones,	জুনেস,	জোন্স,	
bike,	বিকে,	বাইক,	
ghamtaa,	ঘামটা,	ঘোমটা,	
chaka,	চাকা,	চাকা,	
ekatitto,	একাটিত্ব,	একাতিত্ব,	
utotoro,	উততর,	উততর,	
raagei,	রাগেই,	রাগেই,	
asaktibandhan,	অসাক্তিবন্ধন,	আসক্তিবন্ধন,	
daqten,	ড্যাক্েন,	ডাকতেন,	
hisabagyan,	হিসাবাগ্ঞান,	হিসাবজ্ঞান,	
anchalgoolir,	অঞ্চলগুলির,	অঞ্চলগুলির,	
ispreedshiit,	ইসপ্রিদিশিত,	স্প্রেডশীট,	
konnoder,	কন্যদের,	কন্যদের,	
manbe,	মানবে,	মানবে,	
zakharovar,	জখরাাার,	জাখারোভার,	
phiksim,	ফিক্সিম,	ফিক্সিং,	
teestar,	টেস্টার,	তিস্তার,	
hepatetisa,	হেপাটেটিসা,	হেপাটাইটিস,	
minister,	মিনিস্টের,	মিনিস্টার,	
chalachchitro,	চলচ্চিত্র,	চলচ্চিত্র,	
charban,	চারবান,	চর্বন,	
saalsa,	সালসা,	সালসা,	
biplobi,	বিপ্লবি,	বিপ্লবী,	
dakter,	ডাক্টার,	ডাকতের,	
bapio,	বাপিও,	বাপিও,	
shrabastee,	শ্রবস্তি,	শ্রাবস্তী,	
jocqey,	জোক,	জকি,	
cholchhee,	চলচি,	চলছে,	
uporitaley,	উপরিতলেে,	উপরিতলে,	
eigulor,	এইগুলোর,	এইগুলোর,	
transapharma,	ট্রান্সফামাম,	ট্রান্সফর্ম,	
ivil,	ইভিল,	ইভিল,	
abdi,	আবদি,	অব্দি,	
bsnleu,	বিএসএনইএল,	বিএসএনএলইইউ,	
peengna,	পেং্গা,	পিংনা,	
starker,	স্টারকের,	স্টার্কের,	
prosadhani,	প্রসাধানি,	প্রসাধনী,	
eura,	ইউরা,	ইউরো,	
nimnosakkharkari,	নিম্নস্থকাকারী,	নিম্নস্বাক্ষরকারী,	
chalochchitreer,	চলচ্চিত্রীর,	চলচ্চিত্রের,	
pachchi,	পাচ্ছি,	পাচ্ছি,	
alaoler,	আলালেের,	আলাওলের,	
bbiswash,	বুব্বশ্ব,	বিশ্বাস,	
zaire,	জায়ের,	জাইরে,	
uparjon,	উপারজজন,	উপার্জন,	
aaziz,	আজিজ,	আজিজ,	
residensa,	রেসিডেনসা,	রেসিডেন্স,	
phakay,	ফাকায়,	ফাকে,	
towraat,	তৈরাত,	তওরাত,	
bhogiroth,	ভগিরত,	ভগীরথ,	
jibonnogor,	জীবননগর,	জীবননগর,	
mythological,	মার্থিগোফিকাল,	মাইথলজিকাল,	
asovya,	অসব্য,	অসভ্য,	
lirikti,	লিরিকটি,	লিরিকটি,	
sudrissho,	সুদ্ৃশ,	সুদৃশ্য,	
noditir,	নদিটির,	নদীটির,	
aholyar,	আহল্যার,	অহল্যার,	
kalakushalir,	কালাকুশালীর,	কলাকুশলীর,	
elakaai,	এলাকাই,	এলাকাই,	
shansthaner,	শান্সথানের,	সংস্থানের,	
shatodha,	শতধো,	শতধা,	
spancer,	স্প্যান্সের,	স্পেন্সার,	
teliha,	তেলিহা,	তেলিহা,	
parqa,	পারকা,	পার্ক,	
aswasteekor,	অস্বস্তিকর,	অস্বস্তিকর,	
ragee,	রাগী,	রাগী,	
narsinghomgulor,	নরসিংহামগুলোর,	নার্সিংহোমগুলোর,	
jhanjra,	ঝাঁজরা,	ঝাঁজরা,	
atwabishvashi,	আত্ববিভাবাশী,	আত্মবিশ্বাসী,	
hitlere,	হিটলারে,	হিটলারে,	
tookrote,	টুক্রোতে,	টুকরোতে,	
salchak,	সালচক,	সালচাক,	
pichte,	পিচতে,	পিছতে,	
capsule,	ক্যাপসুলে,	ক্যাপ্সুল,	
madhabi,	মাধবি,	মাধবী,	
kaathhaamaandu,	কথনামুদা,	কাঠমান্ডু,	
bishhnu,	বিষ্ণু,	বিষ্ণু,	
bhabarlaler,	ভাবরললের,	ভবরলালের,	
graambaaseeder,	গ্রামবাসীদের,	গ্রামবাসীদের,	
atmira,	আত্মীরা,	আত্মীরা,	
ramzaner,	রামজনের,	রমযানের,	
bujhechhila,	বুঝেছিলা,	বুঝেছিল,	
breakthrough,	ব্রেকরররোম,	ব্রেকথ্রু,	
khabarsoho,	খাবারসহ,	খাবারসহ,	
boner,	বনের,	বনের,	
mmadhukkori,	ম্মাধুক্করী,	মাধুকরী,	
parabortee,	পারারবত্তি,	পরর্বতী,	
mujuru,	মুজুরু,	মুজুরু,	
chirontan,	চিরণটান,	চিরন্তন,	
alankorana,	আলাকনারনা,	অলঙ্করণ,	
chalachchitroi,	চলচ্চিত্রই,	চলচ্চিত্রই,	
sazanor,	সাজানোর,	সাজানোর,	
karmojog,	কার্মযোগ,	কর্মযোগ,	
rajpur,	রাজপুর,	রাজপুর,	
marry,	মার্ি,	ম্যারি,	
pretti,	প্রেট্তি,	প্রিটি,	
afzol,	আফজল,	আফজল,	
milekhaanek,	মিলেখানেক,	মাইলখানেক,	
sheepha,	শিফা,	শেফ,	
kingsh,	কিংশ,	কিংস,	
bhoolapuka,	ভোলাপুকা,	ভোলাপুক,	
kaley,	কালে,	কালে,	
ovarview,	ওভারভিয়েরিভ,	ওভারভিউ,	
satarkabhabe,	সতরকাভাবে,	সতর্কভাবে,	
kodorer,	কোদের,	কদরের,	
venisey,	ভেনিসে,	ভেনিসে,	
ekok,	একক,	একক,	
biphal,	বিফাল,	বিফল,	
ghoshanapatratio,	ঘোষণাপত্রতিও,	ঘোষণাপত্রটিও,	
ashonkai,	আশনকাই,	আশঙ্কাই,	
hitokor,	হিতকর,	হিতকর,	
neemitte,	নিমিটি,	নিমিত্তে,	
sarollo,	সারোলো,	সারল্য,	
thechar,	থেচার,	থ্যাচার,	
soori,	সোরী,	সুরি,	
minilosar,	মিনিলোসার,	মিনিলোসার,	
bosantake,	বসান্তাকে,	বসন্তকে,	
plainey,	প্লেইনে,	প্লেনে,	
rakhete,	রাখেতে,	রাখেতে,	
syfy,	সিফি,	সাইফাই,	
vvimsenn,	ভাভমিসেন,	ভীমসেন,	
sokkhomotabriddhi,	সক্ষমত্তৃদ্ধি,	সক্ষমতাবৃদ্ধি,	
suhayeler,	সুহায়েলের,	সুহায়েলের,	
bosturoi,	বস্তুরই,	বস্তুরই,	
reshidensha,	রেশিদেশসা,	রেসিডেন্স,	
simaa,	সিমা,	সীমা,	
ghoor,	ঘোর,	ঘুর,	
nishad,	নিশাদ,	নিষাদ,	
khudhartara,	ক্ষুধারতারা,	ক্ষুধার্তরা,	
bossonte,	বস্নতে,	বসন্তে,	
bosoben,	বসবেন,	বসবেন,	
gabhaskaar,	গভভস্কার,	গাভাস্কার,	
rudiger,	রুডিগের,	রুদিগের,	
osthisondhi,	অস্থিসন্ধি,	অস্থিসন্ধি,	
huka,	হুকা,	হুক,	
shasheja,	শাষেজা,	সসেজ,	
protisthar,	প্রতিষ্ঠার,	প্রতিষ্ঠার,	
rokibul,	রোকিবুল,	রকিবুল,	
adwanced,	অ্যাডবাযান্সেড,	অ্যাডভান্সড,	
pare,	প্যারে,	পাড়ে,	
riphleksa,	রিফ্লেসকা,	রিফ্লেক্স,	
neker,	নেকের,	নেকের,	
siramikasa,	সিরামিকাসা,	সিরামিকস,	
nodnodeer,	নদ্্দীর,	নদনদীর,	
chilahaati,	চিলাহাটি,	চিলাহাটি,	
istoone,	ইস্তোন,	স্টোন,	
zoojyota,	জৌজ্যতা,	যোজ্যতা,	
shommotite,	শম্মতিতে,	সম্মতিতে,	
karadandey,	কারাদন্ডে,	কারাদণ্ডে,	
lekhaksattwar,	লেখকস্তাস্তর,	লেখকসত্ত্বার,	
onker,	অঙ্কের,	ওঙ্কার,	
emarjensi,	এমারজেন্সি,	এমার্জেন্সি,	
amorendro,	অমরেন্দ্র,	অমরেন্দ্র,	
sambhabonao,	সম্ভাবনাও,	সম্ভবনাও,	
holuder,	হলুদের,	হলুদের,	
horipur,	হরিপুর,	হরিপুর,	
shardotsobei,	শার্দতসবােই,	শারদোৎসবেই,	
ayumi,	আইমু,	আয়ুমি,	
doorotomo,	দূরতম,	দূরতম,	
sachetonvabe,	সচেতনভাবে,	সচেতনভাবে,	
ancholtike,	অ্যাংকলিকে,	অঞ্চলটিকে,	
shapad,	শাপাদ,	শ্বাপদ,	
telakucha,	তেলাকুচা,	তেলাকুচা,	
proo,	প্রু,	প্রো,	
tukroke,	টুকরককে,	টুকরোকে,	
elaakate,	এলাকাতে,	এলাকাতে,	
suiti,	সুইটি,	সুইটি,	
sikkhakbrinda,	শিক্ষাক্র্্দ,	শিক্ষকবৃন্দ,	
olympicer,	অলিপ্পিসের,	অলিম্পিকের,	
jaadrel,	জাদরেল,	জাঁদরেল,	
neermol,	নির্মল,	নির্মল,	
hundai,	হুন্ডাই,	হুন্দাই,	
oswastikor,	অস্বাস্তিকর,	অস্বস্তিকর,	
sadeena,	সদদিনা,	সাডেন,	
konroop,	কনোরূপ,	কোনরূপ,	
khiladirao,	খিলাদীরাও,	খিলাড়িরাও,	
juboksoho,	যুবকসহ,	যুবকসহ,	
rakkhanvag,	রক্ষণভাগ,	রক্ষণভাগ,	
elakaasoho,	এলাকাসহ,	এলাকাসহ,	
naubom,	নওবম,	নবম,	
jommu,	জম্মু,	জম্মু,	
vromonkaley,	ভ্রমণকললে,	ভ্রমণকালে,	
bangulzai,	বাঙ্গুল্জাই,	বঙ্গুলিজাই,	
karima,	কারিমা,	করিম,	
hossne,	হোস্ন,	হোসনে,	
mukhomandaler,	মুখমম্ডলের,	মুখমণ্ডলের,	
muradkey,	মুরাদকে,	মুরাদকে,	
literacy,	লিটারিক,	লিটারেসি,	
welaqama,	ওয়ালাকামা,	ওয়েলকাম,	
sahojatprobritti,	সহযাতব্যবস্তিটি,	সহজাতপ্রবৃত্তি,	
siddhanto,	সিদ্ধান্ত,	সিদ্ধান্তও,	
prity,	প্রীটি,	প্রিটি,	
sthapanatir,	স্থাপনাটির,	স্থাপনাটির,	
bibader,	বিবাদের,	বিবাদের,	
avisongson,	অভিসংসন,	অভিশংসন,	
siddhantoo,	সিদ্ধান্ত,	সিদ্ধান্তও,	
ganokantha,	গণকান্থ,	গণকণ্ঠ,	
tasminer,	তাসমিনের,	তাসমিনের,	
mukhoshdharir,	মুখশোধারীর,	মুখোশধারীর,	
gara,	গারা,	গোর,	
baaiq,	বাইক,	বাইক,	
ceramiksh,	সেরামিক্স,	সিরামিকস,	
mentither,	মেন্টিথের,	মেনটিথের,	
godamjato,	গদমাজাত,	গুদামজাত,	
drissogoolote,	দৃশ্যগুলোতে,	দৃশ্যগুলোতে,	
aniyantrita,	অনিয়ন্ত্রিত,	অনিয়ন্ত্রিত,	
audioguloke,	অডিওগুলোকে,	অডিওগুলোকে,	
horippur,	হরিপুর,	হরিপুর,	
sedikei,	সেদিকেই,	সেদিকেই,	
parjotaker,	পার্যতাকের,	পর্যটকের,	
shootar,	শততার,	শ্যুটার,	
