ganaparibahan,	গণপরিবহহ,	গণপরিবহন,	
prasadhoner,	প্রসাধনের,	প্রসাধনের,	
boner,	বনের,	বনের,	
judge,	জুডজে,	জাজ,	
alpakichudin,	অল্পকিউদিদিন,	অল্পকিছুদিন,	
besirvagei,	বেসিরভাগেই,	বেশিরভাগেই,	
rasunkunchi,	রসুঙ্কুঞ্চি,	রসুনকুঁচি,	
mandanda,	মন্দন্দ,	মানদণ্ড,	
palteche,	পালটেছে,	পাল্টেছে,	
khagen,	খাগেন,	খগেন,	
jandrel,	জান্দ্রেল,	জাঁদরেল,	
ronangane,	রোনাঙ্গানে,	রণাঙ্গনে,	
uparzoner,	উপারজনের,	উপার্জনের,	
ingrezeeteo,	ইংরেজিতেও,	ইংরেজিতেও,	
soomita,	সুমিতা,	সুমিতা,	
swairacharibirodhi,	স্বৈরেচররবিরোধী,	স্বৈরাচারীবিরোধী,	
bakhyateet,	বাখ্যাতিৎ,	ব্যাখ্যাতীত,	
rajtontro,	রাজতন্ত্র,	রাজতন্ত্র,	
goolen,	গুলেন,	গুলেন,	
maley,	ম্যালি,	মালে,	
baarnis,	বার্নিস,	বার্নিশ,	
ostad,	অস্তাদ,	ওস্তাদ,	
jhamala,	ঝামালা,	ঝামালা,	
shector,	শেক্টর,	সেক্টর,	
bhiktara,	ভিক্তারা,	ভিক্টর,	
dapadpi,	দাপদীপী,	দাপাদপি,	
jounatar,	যৌনাটার,	যৌনতার,	
muradkey,	মুরাদকে,	মুরাদকে,	
cholochchitrai,	চলচ্চিত্রায়,	চলচ্চিত্রই,	
footballerra,	ফুটবলাররা,	ফুটবলাররা,	
gaddaphii,	গড়্যাফি,	গাদ্দাফী,	
eshtonia,	এসতোনিয়া,	এস্তোনিয়া,	
akkharkey,	অক্ষরকে,	অক্ষরকে,	
nagorikota,	নাগরিকতা,	নাগরিকতা,	
badhamuktovabe,	বাধামুক্তভাবে,	বাধামুক্তভাবে,	
qrisenta,	ক্রিসেন্টা,	ক্রিসেন্ট,	
amar,	আমার,	আমর,	
boiporiityen,	বৈপরিহীতেন,	বৈপরীত্যেন,	
goora,	গুরা,	গোর,	
fanding,	ফ্যান্ডিং,	ফান্ডিং,	
atwabishvashi,	অত্ববিশাশী,	আত্মবিশ্বাসী,	
parikha,	পরিকখা,	পরিখার,	
karir,	কারির,	কারীর,	
swatantrata,	স্বতন্ত্র্ত,	স্বতন্ত্রতা,	
average,	এভারেজ,	এভারেজ,	
prapokkey,	প্রাপক্কে,	প্রাপককে,	
benojir,	বেনোজির,	বেনজীর,	
dimbacriti,	ডিম্বার্িটি,	ডিম্বাকৃতি,	
kaalaam,	কালাম,	কালাম,	
heerani,	হিরানী,	হিরানি,	
laishensha,	লাশেনেস,	লাইসেন্স,	
angkita,	অঙকিতা,	অঙ্কিতা,	
tantubayer,	তান্তুবায়ের,	তন্তুবায়ের,	
falak,	ফালাক,	ফলক,	
kayartara,	কায়ারতারা,	কোয়ার্টার,	
loombinee,	লুম্িনি,	লুম্বিনী,	
beekaargrasta,	বেকররগ্রাস্ত,	বিকারগ্রস্ত,	
janagononar,	জানগনননার,	জনগণনার,	
nowel,	নোয়েল,	নভেল,	
durarohini,	দুরারোহিনী,	দুরারোহিণী,	
poste,	পোস্টে,	পোস্টে,	
bangalore,	ব্যাঙ্গালোর,	ব্যাঙ্গালুরে,	
kanasharabheshhana,	কনশরশেশন,	কনসারভেশন,	
haripur,	হরিপুর,	হরিপুর,	
taateo,	টাটেও,	তাতেও,	
khanonkaj,	খননককাজ,	খননকাজ,	
dinifitian,	ডিনিফিটাইন,	ডেফিনেশন,	
mumtazer,	মুমতাজের,	মুমতাজের,	
gamdan,	গমমদান,	গামদান,	
bhejaano,	ভেজানো,	ভেজানো,	
qulim,	কুলিম,	কুলিং,	
primoo,	প্রিওমু,	প্রিমো,	
purohitra,	পুরোহিত্র,	পুরোহিতরা,	
selim,	সেলিম,	সেলিম,	
firozaa,	ফিরোজা,	ফিরোজা,	
qarpeta,	কারপেটা,	কার্পেট,	
sangkulaan,	সংকুলন,	সংকুলান,	
edmeeral,	এডমিরাল,	এডমিরাল,	
byaboharkarir,	ব্যবহারকারীর,	ব্যবহারকারীর,	
vromonkaley,	ভ্রমণকালে,	ভ্রমণকালে,	
beshirbhaagei,	বেশিরভাগেই,	বেশিরভাগেই,	
sumeeta,	সুমিতা,	সুমিতা,	
landing,	ল্যান্ডিং,	ল্যান্ডিং,	
hights,	হাইটিস,	হাইটস,	
mashtarsha,	মাষ্টরশশ,	মাস্টার্স,	
nyata,	ন্যাটা,	ম্যাট,	
sombhobonao,	সম্ভবনাও,	সম্ভবনাও,	
gandhikey,	গাঁধধীকে,	গান্ধীকে,	
joki,	জককি,	জকি,	
somraatra,	সম্রাত্রা,	সম্রাটরা,	
nothibhukteer,	নথিভুক্তির,	নথিভুক্তির,	
musalmani,	মুসলমানি,	মুসলমানই,	
valobase,	ভালোবাসে,	ভালোবাসে,	
songkoloney,	সংকলনে,	সংকলনে,	
ponchasjon,	পঞ্চাসন,	পঞ্চাশজন,	
mele,	মেলে,	মাইল,	
dharavahiker,	ধারাভাহিকের,	ধারাবাহিকের,	
karaa,	কারা,	কারো,	
nodnodeer,	নদ্নদির,	নদনদীর,	
urey,	উরে,	ইউরি,	
ragei,	রাজেই,	রাগেই,	
asiatic,	অ্যাসিয়াটিক,	এশিয়াটিক,	
popaike,	পপাইকে,	পপাইকে,	
hamburgey,	হ্যামবার্গে,	হামবুর্গে,	
saria,	সারিয়া,	সরিয়া,	
ayumi,	আয়ুমী,	আয়ুমি,	
hariken,	হারিকেন,	হ্যারিকেন,	
mulbhitti,	মুলভিত্তি,	মূলভিত্তি,	
sotorkobhabey,	সতর্কভাবে,	সতর্কভাবে,	
seekkhaou,	শিক্ষাও,	শিক্ষাও,	
omeettrakkhor,	অমিত্রাক্ষ্র,	অমিত্রাক্ষর,	
venus,	ভেনাস,	ভেনাস,	
mukhamandoler,	মুখমাণ্ডলের,	মুখমণ্ডলের,	
milekhaanek,	মিলেখানকে,	মাইলখানেক,	
matt,	ম্যাট,	ম্যাট,	
foolkopi,	ফুলকপি,	ফুলকপি,	
asthishondhi,	অস্থিনোধি,	অস্থিসন্ধি,	
proteemake,	প্রতিমাকে,	প্রতিমাকে,	
digree,	ডিগরি,	ডিগ্রি,	
dooburir,	ডুবুরির,	ডুবুরির,	
blasterke,	ব্লাস্টারকে,	ব্লাস্টারকে,	
udbodhaney,	উদ্বোধানে,	উদ্বোধনে,	
chaudhurio,	চৌধুরিও,	চৌধুরীও,	
adorsho,	আদর্শ,	আর্দশ,	
nirvaha,	নির্ভাহা,	নির্বাহ,	
ray,	তায়ে,	রায়,	
krema,	ক্রেমা,	ক্রাইম,	
shikkhakram,	শিক্ষাক্ম,	শিক্ষাক্রম,	
asabhya,	অসভ্যা,	অসভ্য,	
inphormeshon,	ইনফোরমেশন,	ইনফরমেশন,	
cn,	সিএন,	সিএন,	
jokkher,	যক্ষের,	যক্ষের,	
dipke,	ডিপকে,	দ্বীপকে,	
ruby,	রুবি,	রুবী,	
baarnish,	বার্নিশ,	বার্নিশ,	
shroddhabihin,	শ্রদ্ধাবিহীন,	শ্রদ্ধাবিহীন,	
cocaine,	কোকেইন,	কোকেইন,	
surakarder,	সুরকরদের,	সুরকারদের,	
tukrowti,	তুকরোটি,	টুকরোটি,	
vince,	ভিন্সে,	ভিন্স,	
prokolpotike,	প্রকল্পটিকে,	প্রকল্পটিকে,	
literacy,	লিটারেসি,	লিটারেসি,	
ucchosito,	উচ্চসিত,	উচ্ছসিত,	
pratiyogitar,	প্রতিযোগিতার,	প্রতিযোগীতার,	
poschimey,	পশ্চিমে,	পশ্চিমে,	
zeeland,	জিল্যান্ড,	জিল্যান্ড,	
durotamo,	দূরতমো,	দূরতম,	
kuttake,	কুট্টাকে,	কুত্তাকে,	
qaferderkey,	কাফের্ডারকে,	কাফেরদেরকে,	
plaiin,	প্লেইন,	প্লেন,	
jontrototto,	যন্ত্রতত্ত্ব,	যন্ত্রতত্ত্ব,	
srivatsalakshanang,	শ্রীবশৎলকক্তংং,	শ্রীবৎসলক্ষণং,	
soommita,	সমম্মিতা,	সুমিতা,	
kantojir,	কান্তজীর,	কান্তজির,	
bisheshyo,	বিশেষ্য,	বিশেষ্য,	
abhirupbabuke,	অভিরূপবাবুকে,	অভিরূপবাবুকে,	
qonfliqt,	কনফ্লিক্ট,	কনফ্লিক্ট,	
tottorat,	তত্তরাত,	তওরাত,	
dombhoke,	দম্ভকে,	দম্ভকে,	
procharona,	প্রচারণা,	প্রচারণা,	
hukar,	হুকার,	হুকার,	
sooya,	সোয়া,	সোয়া,	
rajnikant,	রাজনীকান্ত,	রাজনীকান্ত,	
nagarikera,	নগরীকেরা,	নাগরিকেরা,	
mitrer,	মিত্রের,	মিত্রের,	
cheess,	চেস,	চেস,	
shekarmani,	শেকরমণি,	শেকরমানি,	
jaanachhe,	যানাচ্ছে,	জানাচ্ছে,	
dooburira,	ডুবুরিরা,	ডুবুরিরা,	
inafarameshana,	ইনাফরমেশন,	ইনফরমেশন,	
deilee,	ডেইলি,	ডেইলি,	
jerusalemer,	জেরুসালেমের,	জেরুজালেমের,	
uparjoner,	উপার্জনের,	উপার্জনের,	
souripurang,	সৌরিপূরং,	সৌরিপুরং,	
aansaareer,	আনসারীর,	আনসারীর,	
daaoon,	দাওন,	ডাউন,	
mojdur,	মজদুর,	মজদুর,	
gunje,	গুঞ্জে,	গুঁজে,	
shasonkarta,	শাসনকর্তা,	শাসনকর্তা,	
saralya,	সরলল্য,	সারল্য,	
kul,	কুল,	কুল,	
adarsho,	আদর্শ,	আর্দশ,	
bibadey,	বিবদে,	বিবাদে,	
potka,	পোটোকা,	পটকা,	
bhenise,	ভেনিস,	ভেনিসে,	
lendal,	লেন্ডাল,	লেন্ডল,	
bhaangchur,	ভাংচুর,	ভাংচুর,	
senabahineeow,	সেনাবাহিনিহ,	সেনাবাহিনীও,	
suhayeler,	সুহায়েলের,	সুহায়েলের,	
chasee,	চাস,	চেস,	
hooq,	হুক,	হুক,	
sokkhomotabriddhi,	সক্ষমদারবৃদ্ধি,	সক্ষমতাবৃদ্ধি,	
hoondayi,	হুনডায়ি,	হুন্দাই,	
prrajanankaal,	প্রজানানকাল,	প্রজননকাল,	
phiksa,	ফিকসা,	ফিক্স,	
jackey,	জ্যাকে,	জকি,	
prime,	প্রাইম,	প্রাইম,	
laatimer,	লাতিমের,	লাটিমের,	
sayatana,	সায়াতানা,	শয়তান,	
uddharkarmirai,	উদ্ধররকর্মীরাই,	উদ্ধারকর্মীরাই,	
marmaraa,	মারমারা,	মারমারা,	
marketin,	মার্কেটিন,	মার্কেটিং,	
niketaner,	নিকেতানের,	নিকেতনের,	
ala,	আলা,	আলা,	
madrasa,	মাদ্রাসা,	মাদ্রাসা,	
chilona,	চিলোনা,	ছিলনা,	
thyachara,	ণ্যাচারা,	থ্যাচার,	
kod,	কোড,	কোড,	
obdee,	ওবদি,	অব্দি,	
shite,	শীতে,	শীতে,	
mayily,	মায়িলি,	মাইলি,	
nibobondhonkrito,	নিবনবন্ধকৃত,	নিববন্ধনকৃত,	
daybhager,	দা়ভাগের,	দায়ভাগের,	
abhijitda,	অভিজিতদা,	অভিজিতদা,	
basaake,	বাসাকে,	বাসাকে,	
chalai,	চালাই,	চালাবে,	
ebhara,	এভারা,	এভার,	
konnoder,	কন্যদের,	কন্যদের,	
kheshar,	খেশার,	খেশার,	
sompadon,	সম্পাদন,	সম্পাদন,	
nogore,	নগরে,	নগরে,	
dakticket,	ডাক্টিকেট,	ডাকটিকিট,	
bedanta,	বেদান্ত,	বেদান্ত,	
sqolastiq,	স্কোলাসিক্ট,	স্কলাস্টিক,	
bikargrasta,	বিকারগ্রস্ত,	বিকারগ্রস্ত,	
koomarir,	কোমারির,	কুমারীর,	
shoreefpur,	শরীফপুর,	শরিফপুর,	
sthapanatir,	স্থাপনাটির,	স্থাপনাটির,	
byaboharkarike,	ব্যবহারকারীকে,	ব্যবহারকারীকে,	
reliance,	রেলিয়ান্স,	রিলায়েন্স,	
deliver,	ডেলিভার,	ডেলিভার,	
bisshaskey,	বিশ্বস্কে,	বিশ্বাসকে,	
mukhbondho,	মুখবন্ধ,	মুখবন্ধ,	
brittakarey,	বৃত্তকরে,	বৃত্তাকারে,	
muradke,	মুরাদকে,	মুরাদকে,	
nanilalke,	নানিলালকে,	ননীলালকে,	
protiakromonei,	প্রতিয়ক্রমণেই,	প্রতিআক্রমণেই,	
chakrapani,	চক্রপাণি,	চক্রপানী,	
aqram,	আক্রাম,	আকরাম,	
buth,	বুথ,	বুথ,	
themeke,	থেমেকে,	থিমকে,	
churger,	চার্গের,	চার্জের,	
vezano,	ভেজানো,	ভেজানো,	
roopmatro,	রূপমাত্র,	রূপমাত্র,	
amontronkarider,	অমন্ত্রনাকারীদের,	আমন্ত্রণকারীদের,	
chongar,	চোঙ্গার,	চোঙ্গার,	
binee,	বিনি,	বেনি,	
porishongkhanbid,	পরিশংখ্যানবিদ,	পরিসংখ্যানবিদ,	
bulan,	বুলান,	বুলান,	
alaoler,	অলাওলের,	আলাওলের,	
arashie,	আরাশি,	আরসিএ,	
planey,	প্লেন,	প্লেনে,	
bibechyo,	বিবেচ্য,	বিবেচ্য,	
romarder,	রোমারদের,	রোমারদের,	
kisti,	কিস্তি,	কিস্তি,	
kei,	কেই,	কেই,	
abheedhaneek,	অভিধানিক,	অভিধানিক,	
sthapanagulo,	স্থাপাণগুলো,	স্থাপনাগুলো,	
magical,	ম্যাজিকাল,	ম্যাজিকাল,	
antorvukta,	অন্তর্ভুক্ত,	অন্তর্ভুক্ত,	
akar,	আকার,	একার,	
sithilotar,	সিথিলতার,	শিথিলতার,	
hattey,	হ্যাটে,	হাঁটতে,	
mukhoshdharir,	মুখোশধারীর,	মুখোশধারীর,	
taholo,	তাহলো,	তাহলো,	
madhoboir,	মাধবর,	মাধবীর,	
dolphiny,	ডলফিনি,	ডলফিনি,	
somosto,	সমস্ত,	সমস্ত,	
ekekrokom,	একেকরোক,	একেকরকম,	
thailandshoho,	থাইলন্দশহ,	থাইল্যান্ডসহ,	
pluck,	প্লাক,	প্ল্যাক,	
rubidiyaam,	রুবিদিয়াম,	রুবিডিয়াম,	
masjidke,	মসসীদকে,	মসজিদকে,	
eenameela,	ইনামিলা,	এনামেল,	
garora,	গারোরা,	গারোরা,	
porjotoker,	পর্যটকের,	পর্যটকের,	
treend,	ট্রিন্ড,	ট্রেন্ড,	
lagchhe,	লাগছে,	লাগছে,	
siraju,	সিরাজু,	সিরাজু,	
bikretaara,	বিক্রেটরা,	বিক্রেতারা,	
grambaashio,	গ্রামবাশীও,	গ্রামবাসীও,	
skirt,	স্কির্ট,	স্কার্ট,	
prosadhoner,	প্রসাধনের,	প্রসাধনের,	
zerusaleme,	জেরাসুলমে,	জেরুসালেমে,	
choudhursoho,	চৌধুরসহ,	চৌধুরসহ,	
krus,	কুরস,	ক্রুশ,	
anubhutimalar,	অনুভূতিমালার,	অনুভূতিমালার,	
doloo,	দলু,	ডলু,	
bhogno,	ভগ্ন,	ভগ্ন,	
mekon,	মেকন,	মেকং,	
pathanatak,	পাঠানাটক,	পথনাটক,	
neemitte,	নিমিতে,	নিমিত্তে,	
sanghitar,	সংঘিতার,	সংহিতার,	
sookkho,	সুক্ষ,	সুক্ষ্ম,	
shatodha,	শতোধা,	শতধা,	
nazad,	নাজাদ,	নাজাদ,	
chamski,	চমস্কি,	চমস্কি,	
khappar,	খপ্পার,	খপ্পর,	
chetanagoto,	চেতনাগত,	চেতনাগত,	
pratiyogita,	প্রতিযোগিতা,	প্রতিযোগীতা,	
dalip,	ডালিপ,	দালিপ,	
kabutorer,	কাবুতরের,	কবুতরের,	
akpaase,	আকপাসে,	একপাশে,	
nariider,	নারীদের,	নারীদের,	
koordider,	কুর্দিদের,	কুর্দিদের,	
avisongson,	অভিসংসন,	অভিশংসন,	
eokee,	এইকি,	এওকি,	
chhutochhuti,	ছুটোচুটি,	ছুটোছুটি,	
hena,	হেনা,	হেনা,	
balithubar,	বলিতবাবার,	বালিথুবার,	
shchalastic,	শ্ল্যাক্সিক,	স্কলাস্টিক,	
sahojatprobritti,	সহজাতপ্রবৃত্তি,	সহজাতপ্রবৃত্তি,	
deraa,	দেরা,	ডেরা,	
degreeo,	ডিগ্রিও,	ডিগ্রিও,	
oswastikor,	অস্বাস্তিকর,	অস্বস্তিকর,	
firoza,	ফিরোজা,	ফিরোজা,	
saarbharti,	সার্ভর্তী,	সার্ভারটি,	
rubidium,	রেবিডিয়াম,	রুবিডিয়াম,	
protibedokrao,	প্রতিবেদকরাও,	প্রতিবেদকরাও,	
peengna,	পিংংা,	পিংনা,	
gosthike,	গোষ্ঠীকে,	গোষ্ঠীকে,	
shithilata,	শিথিলতা,	শিথিলতা,	
antennal,	অ্যান্টেন্যাল,	অ্যান্টেনাল,	
andon,	আন্দোন,	আন্দোন,	
nirgoon,	নিরগুন,	নির্গুণ,	
mukhomandoler,	মুখমন্ডলের,	মুখমণ্ডলের,	
chhon,	ছোন,	ছোঁ,	
duple,	ডুপল,	ডুপ্লে,	
wilderske,	উইলডার্সকে,	উইল্ডার্সকে,	
sangram,	সংগ্রাম,	সঙ্গ্রাম,	
nadnadeer,	নদননদির,	নদনদীর,	
postar,	পোস্টার,	পোস্টের,	
dakteekiter,	ডাক্তিকিতের,	ডাকটিকিটের,	
rajtantro,	রাজতন্ত্র,	রাজতন্ত্র,	
deefinision,	ডিফিশিশন,	ডেফিনেশন,	
phiqsa,	ফিকস,	ফিক্স,	
difinisian,	ডিফিশিনিনা,	ডেফিনেশন,	
monzushree,	মনজুশ্রী,	মঞ্জুশ্রী,	
lokhindorer,	লখিন্দরের,	লখিন্দরের,	
mulyabriddhikale,	মূল্যবিক্ধায়েলকে,	মূল্যবৃদ্ধিকালে,	
remission,	রেমিশন,	রিমিশন,	
jamjomat,	জমমজমাত,	জমজমাট,	
probondhobhittik,	প্রবন্ধভিত্তিক,	প্রবন্ধভিত্তিক,	
shaater,	সাতের,	শ্যুটার,	
aembed,	এম্বেড,	এম্বেড,	
proo,	প্রু,	প্রো,	
chokrantosoho,	চক্রান্তসহ,	চক্রান্তসহ,	
poripake,	পরিপাকে,	পরিপাকে,	
rajyotiro,	রাজ্যতিরও,	রাজ্যটিরও,	
vandar,	ভান্দার,	ভাণ্ডার,	
disposes,	ডিস্পোস,	ডিসপোজেস,	
firozapure,	ফিরোজাপুরে,	ফিরোজাপুরে,	
leaders,	লিডারস,	লিডার্স,	
phokser,	ফকসের,	ফক্সের,	
maarmaader,	মারমাদের,	মারমাদের,	
barnis,	বার্নিস,	বার্নিশ,	
akkhunno,	অক্ষুণ্য,	অক্ষুণ্ণ,	
dienes,	ডায়েনস,	ডিএনএস,	
morodeho,	মরদেহ,	মরদেহ,	
emerjency,	এমারজেন্সি,	এমার্জেন্সি,	
hijrite,	হিজরিতে,	হিজরীতে,	
camerapersoner,	ক্যামেরাপারসনের,	ক্যামেরাপার্সনের,	
kolkarkhana,	কলকরাখানা,	কলকারখানা,	
agomonke,	আগমনকে,	আগমনকে,	
surke,	সুরকে,	সুরকে,	
pooshteer,	পুষ্টির,	পুষ্টির,	
niropekshtar,	নিরপেক্ষটার,	নিরপেক্ষতার,	
sinakey,	সিনাকে,	সিনাকে,	
pakhtunistan,	পাখতুনিস্তান,	পাখতুনিস্তান,	
paroner,	পারনের,	পারণের,	
jotsna,	জটস্না,	জ্যোৎস্না,	
spreadshiit,	স্প্রেডশিট,	স্প্রেডশীট,	
protyokkhovabey,	প্রত্যক্ষভাবে,	প্রত্যক্ষভাবে,	
charban,	চারবান,	চর্বন,	
dhojovongo,	ধগযোভঙ্গ,	ধ্বজভঙ্গ,	
ultrasonography,	আল্ট্রান্টস্রাফি,	আলট্রাসনোগ্রাফিও,	
kantajir,	কন্তাজির,	কান্তজির,	
sosoa,	সোসোয়া,	শশা,	
black,	ব্ল্যাক,	ব্ল্যাক,	
ghoshito,	ঘোষিত,	ঘোষিত,	
senior,	সেনিওর,	সিনিয়র,	
dolu,	দলু,	ডলু,	
gananatyo,	গণনাত্য,	গণনাট্য,	
prottokkhovabe,	প্রত্যক্ষভাবে,	প্রত্যক্ষভাবে,	
sector,	সেক্টর,	সেক্টর,	
bhogiroth,	ভোগররথ,	ভগীরথ,	
chalochchitraeei,	চলচ্চিত্রীয়,	চলচ্চিত্রেই,	
bosante,	বসান্তে,	বসন্তে,	
elakatir,	এলাকাটির,	এলাকাটির,	
mast,	মাস্ট,	মাস্ত,	
boudhher,	বৌধের,	বৌদ্ধের,	
beam,	বিইএম,	বিম,	
avetar,	আভেতার,	অবতার,	
dai,	দাই,	দিই,	
eporjonto,	এপর্যন্ত,	এপর্যন্ত,	
chai,	চাই,	ছাই,	
phakay,	ফাকা,	ফাকে,	
emiratas,	এমিরাটাস,	এমিরেটাস,	
moddhyoshtho,	মধ্যস্থ,	মধ্যস্থ,	
monjurul,	মনজুরুল,	মনজুরুল,	
eekbalke,	একবালকে,	ইকবালকে,	
asantosh,	আসন্তোষ,	অসন্তোষ,	
madraser,	মাদ্রাসের,	মাদ্রাজের,	
gandogol,	গান্ডোগোল,	গন্ডগোল,	
groundta,	গ্রুন্ডটা,	গ্রাউন্ডটা,	
naitikatavodh,	নৈতিকাতাবোধ,	নৈতিকতাবোধ,	
pichte,	পিছতে,	পিছতে,	
fotanor,	ফটানোর,	ফোটানোর,	
sarboporee,	সর্বপরী,	সর্বোপরী,	
raiji,	রাইজি,	রাইজি,	
rushod,	রুশদ,	রুশদ,	
chandanara,	চান্দানারা,	চন্দনারা,	
pratishthanik,	প্রতিষ্ঠানিক,	প্রাতিষ্ঠানিক,	
internship,	ইন্টারশ্পিপ,	ইন্টার্নশিপ,	
shumo,	শুমো,	সুমো,	
somsher,	সম্শের,	সমশের,	
shikshakbrindo,	শিক্ষাবৃৃ্্দ,	শিক্ষকবৃন্দ,	
mekapgulo,	মেকাপগুলো,	মেকআপগুলো,	
mohajot,	মহাজত,	মহাজোট,	
amittrakkhor,	অমিত্রক্ষ্র,	অমিত্রাক্ষর,	
sommoteer,	সম্মটির,	সম্মতির,	
machsoho,	মাচসহ,	মাছসহ,	
oncoltike,	অঙ্কলটিকে,	অঞ্চলটিকে,	
abheedhanic,	অভিমানিক,	অভিধানিক,	
deqe,	দেকে,	ডেকে,	
pray,	প্রায়ে,	প্রায়,	
minishtarer,	মিনিসটারের,	মিনিস্টারের,	
nirbachakder,	নির্বাচকদের,	নির্বাচকদের,	
varma,	ভার্মা,	ভার্মা,	
bishwasho,	বিশ্বাশও,	বিশ্বাসও,	
byathapather,	ব্যথাপথের,	ব্যথাপথের,	
nothibhukta,	নথিভুক্ত,	নথিভুক্ত,	
obdi,	ওবদি,	অব্দি,	
matis,	মাতিস,	ম্যাটিস,	
ashok,	অশোক,	আশোক,	
hastamathun,	হস্তমথুন,	হস্তমথুন,	
bhyatikaner,	ভ্যাটিকানের,	ভ্যাটিকানের,	
mishal,	মিশাল,	মিশাল,	
shikhbe,	শিখবে,	শিখবে,	
skolarsip,	স্কোরোসিপ,	স্কলারশিপ,	
peeth,	পিথ,	পীঠ,	
laiseensim,	লাইসেনসিম,	লাইসেন্সিং,	
bosben,	বসসেন,	বসবেন,	
creshcent,	ক্রেশেেন্ট,	ক্রিসেন্ট,	
itastata,	ইৎস্টাটা,	ইতস্তত,	
snehban,	স্নেহবান,	স্নেহবান,	
supplenza,	সাপমেলজা,	সাপলেঞ্জা,	
janosamaj,	জনসমাজ,	জনসমাজ,	
siit,	সিইট,	শীত,	
kinto,	কিন্তো,	কিনত,	
chaalaabi,	চালাবি,	চালাবে,	
direectoratee,	ডিরিকটরটি,	ডিরেক্টরেট,	
chaloke,	চালোকে,	চালকে,	
abeganuvutir,	আবেগানুভুতির,	আবেগানুভূতির,	
chalachchitroke,	চলচ্চিত্রকে,	চলচ্চিত্রকে,	
joones,	জুনেস,	জোন্স,	
rokibul,	রকিবুল,	রকিবুল,	
pragreesa,	প্রাগরিজা,	প্রগ্রেস,	
ase,	আসে,	আসে,	
cholochchitra,	চলচ্চিত্র,	চলচ্চিত্র,	
artherer,	আর্থেরের,	আর্থারের,	
emarjenshi,	এমারজেনশি,	এমার্জেন্সি,	
tecnokret,	টেকনোকেট,	টেকনোক্র্যাট,	
awrbit,	আর্বিট,	অরবিট,	
bbiswashke,	বিবিস্বাসকে,	বিশ্বাসকে,	
shasankarta,	শাসনকর্তা,	শাসনকর্তা,	
karuna,	করুনা,	করুণা,	
promothesh,	প্রমথেশ,	প্রমথেশ,	
nanabornobishishto,	নানাবর্ষবিশিষ্ট,	নানাবর্ণবিশিষ্ট,	
nirgaman,	নির্গামান,	নির্গমন,	
dhanyi,	ধনি,	ধন্যি,	
gronthao,	গ্রন্থাও,	গ্রন্থও,	
aakkas,	আক্কাস,	আককাস,	
ganaporibahaner,	গণপরিবাহনের,	গণপরিবহনের,	
borkhastokritora,	বরখাস্তকৃতরা,	বরখাস্তকৃতরা,	
oikhan,	ঐখান,	ঐখান,	
abhidhanick,	অভিধানিক,	অভিধানিক,	
seniar,	সেনিয়ার,	সিনিয়র,	
ekghore,	একঘরে,	একঘরে,	
sinaake,	সিনাকে,	সিনাকে,	
byabosthar,	ব্যবস্থার,	ব্যাবস্থার,	
chyeta,	চ্যুটা,	চ্যাট,	
bhabotarini,	ভাবতারিনি,	ভবতারিণী,	
hundai,	হুন্ডাই,	হুন্দাই,	
telakucha,	তেলাকুচা,	তেলাকুচা,	
vushi,	ভুশী,	ভুষি,	
horidwar,	হরিদ্বার,	হরিদ্বার,	
songkulan,	সংকুলান,	সংকুলান,	
suisharke,	সুইশারকে,	সুইশারকে,	
notti,	নোটি,	নোটটি,	
baikalyo,	বাইকাল্য,	বৈকল্য,	
dharmee,	ধর্মী,	ধর্মী,	
ghetu,	ঘেটু,	ঘেটু,	
jolaatonko,	জলাতনকো,	জলাতঙ্ক,	
eesa,	এসা,	আইএএস,	
cholocchitrer,	চলচ্চিত্রের,	চলচ্চিত্রের,	
cxt,	সিক্টিটি,	সিএক্সটি,	
mase,	মাসে,	মাসে,	
capshule,	কাপশুলে,	ক্যাপসুল,	
bharotchilo,	ভারতছিল,	ভারতছিল,	
deejeejer,	দিজেজের,	ডিজিজের,	
dhrubaker,	ধ্রুবাকের,	ধ্রুবকের,	
bedantodhormo,	বেদান্ধরর্ম,	বেদান্তধর্ম,	
ooipoka,	উপকা,	উইপোকা,	
orbeet,	অরবিট,	অরবিট,	
megacaldera,	মেগাক্লেদারা,	মেগাক্যাল্ডেরা,	
debdebie,	দেবদেবি,	দেবদেবী,	
thandabhabe,	ঠা্ডাভাবে,	ঠাণ্ডাভাবে,	
mathieu,	মাথিয়ে,	ম্যাথিউ,	
abheedhaaneek,	অভিধানিক,	অভিধানিক,	
jatata,	জাতাটা,	যতোটা,	
adorso,	আদর্শো,	আর্দশ,	
byapoktor,	ব্যাপকতর,	ব্যাপকতর,	
mythological,	মিথোলজিক্যাল,	মাইথলজিকাল,	
refleks,	রিফ্লেক্স,	রিফ্লেক্স,	
byatikrami,	ব্যতিক্রমী,	ব্যতিক্রমী,	
totokson,	টোটকসন,	ততক্ষন,	
kanar,	কানার,	কণার,	
beauby,	বিউবি,	বিউবি,	
laps,	ল্যাপস,	ল্যাপস,	
bhagno,	ভাগনো,	ভগ্ন,	
kuronir,	কুরোনির,	কুরনীর,	
karam,	কারাম,	কেরাম,	
bishesyo,	বিশেষ্য,	বিশেষ্য,	
ghumunoi,	ঘুমুনোই,	ঘুমুনোই,	
danab,	দানাব,	দানব,	
salmaner,	স্যালমেনের,	সালমানের,	
ansarir,	আনসারির,	আনসারীর,	
maila,	মাইলা,	মাইল,	
perry,	পেরি,	পেরি,	
apad,	আপাদ,	আপদ,	
bhittiti,	ভিত্তিটি,	ভিত্তিটি,	
gejetade,	গেজেটাদে,	গেজেটেড,	
besirbhaagi,	বেসিরভাগী,	বেশিরভাগই,	
lahano,	লাহানো,	লাহানো,	
kinenni,	কিনেননি,	কিনেননি,	
dufresne,	ডুফ্রেনি,	ডুফরেস্ন,	
dalnata,	দলনাটা,	ডালনাটা,	
bhogni,	ভোগনি,	ভগ্নী,	
soinyo,	সৈনি,	সৈন্য,	
humner,	হুমনার,	হামনার,	
dacope,	ড্যাকোপ,	দাকোপ,	
shpredshiit,	স্প্রেডশিট,	স্প্রেডশীট,	
ancholgoolote,	অঞ্চলগুলোতে,	অঞ্চলগুলোতে,	
dewaben,	দেওবায়েন,	দেওয়াবেন,	
torkareer,	তরকারীর,	তরকারীর,	
iub,	আইব,	আইইউবি,	
gopalrao,	গোপালরাও,	গোপালরাও,	
osoborno,	অসবর্ণ,	অসবর্ণ,	
proshtutkarok,	প্রস্তুতাকরক,	প্রস্তুতকারক,	
deh,	দেহ,	দেহ্,	
poketchorder,	পকেতচর্দের,	পকেটচরদের,	
jaubankal,	যৌবনকাল,	যৌবনকাল,	
bii,	বুইটিএ,	বি,	
choudry,	চৌদরি,	চৌধুরী,	
vins,	ভিনস,	ভিন্স,	
feemalee,	ফিমালি,	ফিমেল,	
dharavahik,	ধারাভাহিক,	ধারাবাহিক,	
bangladesh,	বাংলাদেশ,	বঙ্গালাদেস,	
shekarone,	শেকারণে,	সেকারণে,	
breq,	বির্ক,	ব্রেক,	
soheensotar,	সহহনসতার,	সহিংসতার,	
sadadyarao,	সদাদ্যারও,	সদদ্যরাও,	
mohit,	মহিত,	মুহিত,	
scholastic,	স্কলাস্টিক,	স্কলাস্টিক,	
sikkhakbrinda,	শিক্ষাকবৃন্দ,	শিক্ষকবৃন্দ,	
shikkhartheerao,	শিক্ষার্থীরাও,	শিক্ষার্থীরাও,	
nabayug,	নবায়গু,	নবযুগ,	
dorneca,	ডর্েনা,	ডরনেকা,	
odeb,	ওডেব,	ওদেব,	
reetesh,	রেটেশ,	রিতেশ,	
patishapta,	পতিশপ্ত,	পাটিসাপটা,	
seekkharthirao,	শীক্ষার্থীরাও,	শিক্ষার্থীরাও,	
soleel,	সোলিল,	সলিল,	
monzooshree,	মনজুশ্রী,	মঞ্জুশ্রী,	
niphelheim,	নিফেলেহিম,	নিফেলহেইম,	
cholchhe,	চলচ্ছে,	চলছে,	
samoshtigato,	সমষ্টিগত,	সমষ্টিগত,	
goteehin,	গতিহীন,	গতিহীন,	
militaryr,	মিলিটারির,	মিলিটারির,	
larson,	লরনসন,	লারসন,	
satarkabhabey,	সতর্কভাবে,	সতর্কভাবে,	
anyorup,	অন্যরূপ,	অন্যরূপ,	
longhan,	লংহান,	লংঘন,	
saramukhe,	সরমুখে,	সারামুখে,	
bongshokey,	বংশকে,	বংশকে,	
pratista,	প্রতিস্তা,	প্রতিষ্টা,	
masjidti,	মসসিদটি,	মসজিদটি,	
toler,	টোলের,	তালের,	
ovarview,	ওভারভভিইজ,	ওভারভিউ,	
aachhis,	আছিস,	আছিস,	
sikkharrtheerao,	শিক্ষার্থীরীরাও,	শিক্ষার্থীরাও,	
ghoshanapatratio,	ঘোষণাপাত্রটিও,	ঘোষণাপত্রটিও,	
arthurer,	আর্থুরের,	আর্থারের,	
nirbahi,	নির্বাহী,	নির্বাহি,	
addhattikotar,	অদ্ধাত্তিকতার,	আধ্যাত্মিকতার,	
saalsa,	সালসা,	সালসা,	
orunima,	ওরুণিমা,	অরুণিমা,	
asaktibandhan,	অসৎক্ষিবন্ধন,	আসক্তিবন্ধন,	
karpeter,	কারপেটের,	কার্পেটের,	
suraropito,	সুরারপিত,	সুরারোপিত,	
bongsho,	বংশ,	বংশ,	
mozdoor,	মজদুর,	মজদুর,	
prokar,	প্রকার,	প্রকার,	
victor,	ভিক্টর,	ভিক্টর,	
naazi,	নাজি,	নাত্সি,	
parjotaker,	পার্যটাকের,	পর্যটকের,	
shikara,	শিকারা,	শিকার,	
onkush,	অঙ্কুশ,	অংকুশ,	
nirobota,	নিরবতা,	নিরবতা,	
forma,	ফরমা,	ফর্মা,	
sanaktokaran,	সননক্তকরণ,	সনাক্তকরণ,	
existing,	এক্সিস্টিং,	এক্সিসটিং,	
hurricane,	হ্যারিচানে,	হ্যারিকেন,	
bishshasho,	বিশশাস,	বিশ্বাসও,	
shahanara,	শাহানারা,	শাহানারা,	
nathivukteer,	নথিভুক্তির,	নথিভুক্তির,	
manushsoho,	মানুষসহ,	মানুষসহ,	
michhilti,	মিছিলটি,	মিছিলটি,	
utpotti,	উৎপত্তি,	উতপত্তি,	
duiekdiner,	ডুইইকেনিির,	দুইএকদিনের,	
mahafezkhanar,	মহাফেজ্ানার,	মহাফেজখানার,	
pleeta,	প্লিটা,	প্লেট,	
motke,	মোটকে,	মতকে,	
kaferderke,	কাফেরদেরকে,	কাফেরদেরকে,	
meghacchonno,	মেঘাচ্ছন্ন,	মেঘাচ্ছন্ন,	
jansha,	জংশা,	জন্স,	
akai,	আকাই,	একাই,	
aaziz,	আজিজ,	আজিজ,	
samanyai,	সামান্যই,	সামান্যই,	
manober,	মানবের,	মানবের,	
pleto,	প্লেটো,	প্লেটো,	
vodqa,	ভোদকা,	ভদকা,	
zoojyota,	যৌজ্যতা,	যোজ্যতা,	
madhukori,	মধুকরী,	মাধুকরী,	
onucheeder,	অনুচিদের,	অনুচ্ছেদের,	
hojurer,	হজুরের,	হজুরের,	
paste,	পাস্তে,	পেষ্ট,	
bee,	বি,	বি,	
tyapa,	ত্যাপ,	ট্যাপ,	
orthanitike,	অর্থানীতিকে,	অর্থনীতিকে,	
olpo,	ওল্প,	অল্প,	
bifol,	বিফোল,	বিফল,	
cathalic,	ক্যাথালিক,	ক্যাথলিক,	
durgotshob,	দুর্গতশব,	দুর্গোৎসব,	
uporitoler,	উপরিতলের,	উপরিতলের,	
doobate,	দুবাতে,	ডুবাতে,	
aro,	আরো,	আরও,	
narbur,	নরবুর,	নরবুর,	
ghoorchen,	ঘুরছেন,	ঘুরেছেন,	
utkhaat,	উৎকাত,	উত্খাত,	
playtey,	প্লেইট,	প্লেটে,	
madhabi,	মাধবী,	মাধবী,	
irana,	ইরানা,	ইরান,	
anchalgoolir,	অঞ্চলগুলির,	অঞ্চলগুলির,	
saurce,	সোর্স,	সোর্স,	
bizito,	বিজিত,	বিজিত,	
shishu,	শিশু,	শিশু,	
krishibigyani,	কৃষিবিজ্ঞানী,	কৃষিবিজ্ঞানী,	
indrani,	ইন্দ্রানী,	ইন্দ্রাণী,	
protizogii,	প্রতিযোগী,	প্রতিযোগী,	
chet,	চেট,	চ্যাট,	
obosore,	অবসরে,	অবসরে,	
ji,	জিআই,	জি,	
dakkhinkare,	দক্ষিণকারে,	দক্ষিণকরে,	
pravura,	প্রভুরা,	প্রভুরা,	
cheento,	চেন্তো,	চিনতো,	
upobaasee,	উপবাসী,	উপবাসী,	
pharn,	ফার্ন,	ফার্ন,	
jansa,	জানসা,	জন্স,	
vangley,	ভ্যাংলি,	ভাঙলে,	
nachar,	নাচার,	নাচার,	
serveray,	সার্ভেরা,	সার্ভারে,	
parijaner,	পারিজানের,	পরিজনের,	
harris,	হারিস,	হ্যারিস,	
bhageri,	ভাগেরি,	ভাগেরই,	
manbe,	মানবে,	মানবে,	
yura,	যুরা,	ইউরো,	
laesens,	লেইসেন্স,	লাইসেন্স,	
indrakanan,	ইন্দ্রকানান,	ইন্দ্রকানন,	
lakshmir,	লক্ষ্মীর,	লক্ষ্মীর,	
sheshardhe,	শেষার্ধে,	শেষার্ধে,	
oporishodhito,	অপরিশধিত,	অপরিশোধিত,	
themekey,	থেমেকে,	থিমকে,	
sahajlabhbhotar,	সহজলভ্ভতার,	সহজলভ্যতার,	
samashtike,	সমষ্টিকে,	সমষ্টিকে,	
harbur,	হারবুর,	হারবার,	
ostheesandhi,	অস্থিসন্ধি,	অস্থিসন্ধি,	
bagdadii,	বাগদাদী,	বাগদাদী,	
ponero,	পনেরও,	পনের,	
farid,	ফারিদ,	ফরিদ,	
teentir,	তেনটির,	তিনটির,	
mosharroph,	মশাররোফ,	মশাররফ,	
uponeeshod,	উপনিশদ,	উপনিষদ,	
seo,	সেও,	সেও,	
sarajibonbyapi,	সারাজীবন্যাপী,	সারাজীবনব্যাপী,	
krisenta,	ক্রিসেন্টা,	ক্রিসেন্ট,	
pleena,	প্লেনা,	প্লেন,	
faltu,	ফাল্টু,	ফালতু,	
byaboharkareer,	ব্যবহারকারীর,	ব্যবহারকারীর,	
marry,	মাযারির,	ম্যারি,	
bosonte,	বসন্তে,	বসন্তে,	
abosare,	অবসারে,	অবসরে,	
keyu,	কেয়ু,	কেউ,	
maktum,	মককতুম,	মাকতুম,	
phutonta,	ফুটনটা,	ফুটন্ত,	
shainyader,	শৈন্যদের,	সৈন্যদের,	
progresh,	প্রোগ্রেশ,	প্রগ্রেস,	
firti,	ফিরটি,	ফিরতি,	
porobortii,	পরবর্তী,	পরর্বতী,	
byaptikaler,	ব্যাপ্তিকালের,	ব্যাপ্তিকালের,	
prokalpagulo,	প্রকল্পগুলো,	প্রকল্পগুলো,	
motkey,	মতকে,	মতকে,	
tecno,	টেকনো,	টেকনো,	
bosantake,	বসন্তাকে,	বসন্তকে,	
stoic,	স্টোয়াক,	স্টোয়িক,	
ghatla,	ঘাটলা,	ঘটল,	
atmobonchito,	আত্মবঞ্চিত,	আত্মবঞ্চিত,	
konorup,	কোনরূপ,	কোনরূপ,	
rajotta,	রাজত্বা,	রাজত্ব,	
pack,	প্যাক,	প্ল্যাক,	
thare,	থায়ে,	থরে,	
pushtee,	পুষ্টি,	পুষ্টি,	
sikara,	সিকারা,	শিকার,	
tricksguli,	ট্রিকসগুলি,	ট্রিকসগুলি,	
bitertrate,	বিতের্র্রেট,	বাইটারট্রেট,	
rockibul,	রকিবুল,	রকিবুল,	
vushito,	ভুষিত,	ভূষিত,	
gaddaafee,	গড়্ডাফি,	গাদ্দাফী,	
kani,	কানী,	কানি,	
ganoparibahaner,	গণপরিবাহনের,	গণপরিবহনের,	
colgirl,	কোলিগল,	কলগার্ল,	
megh,	মেঘ,	মেঘ,	
bojata,	বোজাতা,	বোজাটা,	
bishshaasho,	বিশ্বাশো,	বিশ্বাসও,	
grambaasi,	গ্রামবাসী,	গ্রামবাসী,	
niharkantibabu,	নীহারকান্তিবাবু,	নিহারকান্তিবাবু,	
aalaa,	অলয়া,	আলা,	
matthews,	ম্যাথেজস,	ম্যাথিউস,	
oncholshomuh,	অঞ্চলসমূহ,	অঞ্চলসমূহ,	
footbalarer,	ফুটবলারের,	ফুটবলারের,	
capsul,	ক্যাপসুল,	ক্যাপসুল,	
sossar,	সোসার,	সকার,	
holuder,	হলুদের,	হলুদের,	
spredshiit,	স্প্রেডশিট,	স্প্রেডশীট,	
laaz,	লাজ,	লাজ,	
redcrosser,	রেডক্রসের,	রেডক্রসের,	
baffer,	বাফার,	বাফার,	
rojapalaner,	রোজাপালনের,	রোজাপালনের,	
mardud,	মারদুদ,	মরদুদ,	
nabotom,	নাবতম,	নবতম,	
lobbytey,	লবিটি,	লবিতে,	
mile,	মিলে,	মিলে,	
akheli,	আখেলি,	আখেলী,	
rahimed,	রহিমেদ,	রহিমেদ,	
liedtke,	লিইডেককে,	লইডটক,	
pratool,	প্রাতুল,	প্রতুল,	
shektor,	শেকটোর,	সেক্টর,	
poddhotitei,	পদ্ধতিতেই,	পদ্ধতিতেই,	
okritokarjo,	অক্রতকার্য,	অকৃতকার্য,	
breqathru,	ব্রেকা্রু,	ব্রেকথ্রু,	
byabaharkareederke,	ব্যবহারকারীদেরকে,	ব্যবহারকারীদেরকে,	
jommu,	জম্মু,	জম্মু,	
fibergulote,	ফাইবারগুলোতে,	ফাইবারগুলোতে,	
soketgulor,	সোকেটগুলোর,	সকেটগুলোর,	
biphal,	বিফল,	বিফল,	
quata,	কোয়াতা,	কোটা,	
chopol,	চপল,	চপল,	
dankaan,	ডাককান,	ডানকান,	
farhetin,	ফররহেটিন,	ফারহেতিন,	
aakaabar,	আকাবার,	আকাবার,	
hert,	হার্ট,	হার্ট,	
gonona,	গণনা,	গননা,	
pitiler,	পিতিলের,	পিটিলের,	
oitijjha,	ঐতিহ্ঝা,	ঐতিহ্য,	
bamni,	বামনি,	বামনী,	
hank,	হ্যাংক,	হাঙ্ক,	
sumita,	সুমিতা,	সুমিতা,	
bisshonath,	বিশ্বনাথ,	বিশ্বনাথ,	
udbhaboni,	উদ্ভাবনী,	উদ্ভাবনী,	
chhotogolper,	ছোটগোলপের,	ছোটগল্পের,	
rajendracholer,	রাজেন্দ্রললের,	রাজেন্দ্রচোলের,	
udor,	উদোর,	উদর,	
samajik,	সমাজিক,	সামাজিক,	
autopromotioner,	অটোপ্রোমেশনের,	অটোপ্রমোশনের,	
teamothy,	টিমথথি,	টিমোথি,	
brake,	ব্র্যাক,	ব্রেক,	
sorsa,	সর্সা,	সোর্স,	
cholochchitraeeo,	চলচ্চিত্রীয়,	চলচ্চিত্রেও,	
grotha,	গ্রথা,	গ্রোথ,	
amanisha,	আমানিসা,	অমানিশা,	
lotharan,	লোথারান,	লুথেরান,	
arsie,	আরসি,	আরসিএ,	
zerusalem,	জেরুসালেম,	জেরুসালেম,	
sangbadmadhyome,	সংবাদমাধ্যমে,	সংবাদমাধ্যমে,	
mousumeo,	মৌসুমেও,	মৌসুমেও,	
bisshasyi,	বিশ্বস্,	বিশ্বাসই,	
venice,	ভেনিস,	ভেনিস,	
definition,	ডিফাইনিশন,	ডেফিনেশন,	
tennys,	টেনিস,	টেনিস,	
sten,	স্টেন,	স্টেন,	
siddhanto,	সিদ্ধান্ত,	সিদ্ধান্তও,	
sikarder,	শিকরদের,	শিকারদের,	
homsher,	হোমশের,	হোমসের,	
vaibon,	ভাইবন,	ভাইবোন,	
nabyata,	নব্যটা,	নাব্যতা,	
sarder,	সারদের,	সরদার,	
elakaatite,	এলাকাটিতে,	এলাকাটিকে,	
rohasyati,	রোহস্যাটি,	রহস্যটি,	
registaner,	রেজিস্টানের,	রেগিস্তানের,	
katiusha,	কতিউশা,	কাতিউশা,	
tookrote,	টুক্রতে,	টুকরোতে,	
bondira,	বন্দিরা,	বন্দীরা,	
danakana,	ডানাকানা,	ডানকান,	
uindos,	উইন্ডস,	উইন্ডোস,	
soomitrar,	সুমিত্রার,	সুমিত্রার,	
pisach,	পিসাচ,	পিশাচ,	
sardar,	সারদার,	সরদার,	
bhagnekeo,	ভাগনেকেও,	ভাগ্নেকেও,	
chopal,	চোপাল,	চপল,	
ministara,	মিনিস্টার,	মিনিস্টার,	
zakharovar,	জখরাভোর,	জাখারোভার,	
daebug,	ডাবুগ,	ডিবাগ,	
zubokra,	যুবক্রা,	যুবকরা,	
difinishian,	ডিফিইশিইনিয়ান,	ডেফিনেশন,	
sangsakti,	সংসক্তি,	সংসক্তি,	
uparjon,	উপার্জন,	উপার্জন,	
jalbe,	জালবে,	জ্বলবে,	
hari,	হারি,	হরি,	
pharmesigulote,	ফার্মেসিগুলোতে,	ফার্মেসীগুলোতে,	
foks,	ফককস,	ফক্স,	
plator,	প্ল্যাটর,	প্লেটোর,	
suiza,	সুইজা,	সুইজা,	
taxikeo,	ট্যাক্সিকেও,	ট্যাক্সিকেও,	
deenesh,	দীনেশ,	দীনেশ,	
fol,	ফলল,	ফল,	
rajnaiteek,	রাজনৈতিক,	রাজনৈতীক,	
ashiatic,	এ্যাসেয়াটিক,	এশিয়াটিক,	
bisnukey,	বিস্যুকে,	বিষ্ণুকে,	
mercial,	মার্সিয়াল,	মার্শিয়াল,	
nationalser,	নেশনালসের,	ন্যাশনালসের,	
ganohotyake,	গণহত্যাকে,	গণহত্যাকে,	
bbiswasho,	বিবিস্বাশও,	বিশ্বাসও,	
aarke,	আর্কে,	আরকে,	
kiuti,	কিউটি,	কিউটি,	
santoshpore,	সন্তোষ্পরে,	সন্তোষপুর,	
jhimochchilo,	ঝিমচ্ছিল,	ঝিমোচ্ছিলো,	
uttor,	উত্তর,	উওর,	
prijon,	প্রিজন,	প্রিজন,	
shtonehenge,	শ্তনেহিঙ্গে,	স্টোনহেঞ্জ,	
grahoksebai,	গ্রাহকসেবাই,	গ্রাহকসেবায়,	
kanuner,	কানুনের,	কানুনের,	
licencer,	লাইসেন্সের,	লাইসেন্সের,	
jaatti,	যাত্তি,	জাতটি,	
helloin,	হেলোইন,	হ্যালোইন,	
torunra,	তরুণরা,	তরুণরা,	
ancholgoolir,	অঞ্চলগুলির,	অঞ্চলগুলির,	
akkheperi,	অক্ষেপীরই,	আক্ষেপেরই,	
ardasha,	আরদাশা,	আর্দশ,	
mach,	মাছ,	মাছ,	
salchak,	সালচক,	সালচাক,	
jocqey,	জককে,	জকি,	
aditisaha,	আদিতিসহ,	অদিতিসহ,	
konar,	কোনার,	কণার,	
mahibur,	মহিবুর,	মহিবুর,	
shekender,	সেখেন্দার,	সেকেন্ডের,	
dubaate,	ডুবাতে,	ডুবাতে,	
karadandey,	কারাদন্ডে,	কারাদণ্ডে,	
veniser,	ভেনিসের,	ভেনিসের,	
uzobekeestaan,	উজোবেকস্তান,	উজবেকিস্তান,	
mosjidsoho,	মসজিদসহ,	মসজিদসহ,	
toroonra,	তরুরা,	তরুণরা,	
shrimoti,	শ্রীমতি,	শ্রীমতি,	
shingping,	সিংপিং,	শিংপিং,	
scorey,	স্কোরে,	স্কোরে,	
fanse,	ফানসসে,	ফাঁসে,	
bajite,	বাজিতে,	বাজিতে,	
wictor,	উইক্টর,	ভিক্টর,	
johor,	জহর,	জহর,	
karore,	কারোর,	কারোর,	
laga,	লাগা,	লগ,	
hakone,	হাকনে,	হাকোনে,	
debdebier,	দেবদেবিয়ের,	দেবদেবীর,	
dayitta,	দায়িত্ব,	দায়িত্ব,	
uqeliptas,	ইকেলিপ্টস,	ইউক্যালিপ্টাস,	
windows,	উনিড্যস,	উইন্ডোস,	
ghoomachhilo,	ঘুমাছিল,	ঘুমাচ্ছিল,	
haitasha,	হাইতাশা,	হাইটস,	
nirbachokder,	নির্বাচকদের,	নির্বাচকদের,	
shaddhi,	শাদধধি,	সাধ্বী,	
shalook,	শালুক,	শালুক,	
bonnopran,	বন্যপ্রাণ,	বন্যপ্রাণ,	
sbaajan,	স্বাজান,	স্বজন,	
kraim,	ক্রেম,	ক্রাইম,	
habol,	হাবল,	হাবোল,	
torkarir,	তরকারির,	তরকারীর,	
monroe,	মনরো,	মনেরোর,	
aborto,	আবর্ত,	আবর্ত,	
fooloo,	ফুলু,	পোলো,	
poripakey,	পরিপাকে,	পরিপাকে,	
oncholgulir,	অঞ্চলগুলির,	অঞ্চলগুলির,	
spredashita,	স্প্রেদাশিতা,	স্প্রেডশীট,	
jyaqasana,	জ্যাকাসন,	জ্যাকসন,	
avinetar,	অভিনেতার,	অভিনেতার,	
chatrorai,	ছাত্ররাই,	ছাত্ররাই,	
upacharjo,	উপাচর্য,	উপাচার্য,	
chire,	চিরে,	চিরে,	
canflikt,	ক্যাংফ্লিক্ট,	কনফ্লিক্ট,	
kurdider,	কুর্দিদের,	কুর্দিদের,	
lekhaksattwar,	লেখকসতাত্বর,	লেখকসত্ত্বার,	
taranee,	তরনী,	তরণী,	
ikboler,	ইকবলের,	ইকবলের,	
yathaarthabhaabe,	থাথারাংভাবে,	যথার্থভাবে,	
panchasjan,	পঞ্চসজন,	পঞ্চাশজন,	
venuser,	ভেনুসের,	ভেনাসের,	
nibirbhabe,	নিবিরভাবে,	নিবিরভাবে,	
grambaashi,	গ্রামবাশী,	গ্রামবাসী,	
iuro,	ইউরো,	ইউরো,	
niropekkho,	নিরপেক্ষ,	নিরপেক্ষ,	
zubokder,	যুবকদের,	যুবকদের,	
nabatamo,	নবামা,	নবতম,	
shasankorta,	শাসনকর্তা,	শাসনকর্তা,	
protisthan,	প্রতিষ্ঠান,	প্রতিষ্টান,	
swastir,	স্বস্তির,	স্বস্তির,	
mag,	ম্যাগ,	এমএজি,	
dibi,	দিবি,	দিবি,	
sausagee,	সৌসগে,	সসেজ,	
disni,	ডিসনি,	ডিজনী,	
panchbar,	পাঁচবার,	পাঁচবার,	
dharavahikbhabe,	ধারাভাশিকভাবে,	ধারাবাহিকভাবে,	
orthonitir,	অর্থনীতির,	অর্থনীতির,	
boiragirhat,	বৈরাগীরহাট,	বৈরাগিরহাট,	
balatarin,	ব্যালাটারিন,	বালাতারিয়ান,	
saamaanya,	সমমন্য,	সামান্য,	
vittio,	ভিত্তিও,	ভিত্তিও,	
mercedes,	মার্সেডস,	মার্সেডেস,	
sobchey,	সবচে,	সবচে,	
asommoti,	অসম্মতি,	অসম্মতি,	
oshtader,	অষ্টাদের,	ওস্তাদের,	
faaj,	ফায,	ফাজ,	
welcome,	ওয়েলমো,	ওয়েলকাম,	
titarer,	তিতারের,	তিতারের,	
asamanyo,	অসামান্য,	অসামান্য,	
nirmankaaj,	নির্মাণকাজ,	নির্মাণকাজ,	
dhaleshwari,	ধলেশ্বরী,	ধলেশ্বরী,	
lungiti,	লুঙ্গিটি,	লুঙ্গিটি,	
torabganj,	তরাবগঞ্জ,	তোরাবগঞ্জ,	
zarniz,	জার্নিজ,	জারনিজ,	
chotogolper,	চোটগল্পের,	ছোটগল্পের,	
jahangirbad,	জাহাঙ্গীরবাদ,	জাহাঙ্গীরবাদ,	
shabkam,	শবকাম,	শবকাম,	
johny,	জাসনি,	জনি,	
tahorir,	তাহরীর,	তাহরীর,	
bhoolapuka,	ভুলাপুকা,	ভোলাপুক,	
ooipokar,	উপকার,	উইপোকার,	
anutpadanshil,	অনুৎপদ্নশশীল,	অনুৎপাদনশীল,	
khamotagulor,	ক্ষমতাগুলোর,	ক্ষমতাগুলোর,	
protinito,	প্রতিনিত,	প্রতিনিত,	
gudamjat,	গুদাজমত,	গুদামজাত,	
safiin,	স্ফাইন,	সাফিন,	
madhoori,	মধুরি,	মাধুরী,	
pacchi,	পাচচি,	পাচ্ছি,	
cholochchitrake,	চলচ্চিত্রাকে,	চলচ্চিত্রকে,	
khoka,	খোকা,	খোকা,	
bodhirta,	বোধিরটা,	বধিরতা,	
chaiten,	চাইতেন,	চাইতেন,	
saraiki,	সরাইকি,	সরাইকি,	
bayii,	বাই,	বাঈ,	
chitlar,	চিটলার,	চিতলার,	
nariderke,	নারীদেরকে,	নারীদেরকে,	
bandhan,	বানধধন,	বাঁধন,	
eshtoniya,	এসতনিয়া,	এস্তোনিয়া,	
abhidhaaner,	অভিধানের,	অভিধানের,	
geographics,	জিওগ্রোফিসস,	জিওগ্রাফিকস,	
bejiye,	বেজিয়ে,	বেজিয়ে,	
shitei,	শিতেই,	শীতেই,	
afzol,	আফজল,	আফজল,	
artilary,	আর্টিলারি,	আর্টিলারি,	
debdebyr,	ডেবদেবির,	দেবদেবীর,	
ujbekistaner,	উজবেকিস্তানের,	উজবেকিস্তানের,	
koyeeri,	কয়েরি,	কোয়েরি,	
dai,	দাই,	ডে,	
tennis,	টেনিস,	টেনিস,	
bowie,	বোই,	বওই,	
minilosar,	মিনিলোসার,	মিনিলোসার,	
chakundite,	চাকুন্ডিতে,	চাকুন্দিতে,	
kuldip,	কুল্ডিপ,	কুলদীপ,	
madhabike,	মাধাবিকে,	মাধবীকে,	
seqtara,	সেকটারা,	সেক্টর,	
residensa,	রেসিডেনস,	রেসিডেন্স,	
lendl,	লেন্ডল,	লেন্ডল,	
eduardo,	এডুওয়ারদো,	এডুয়ার্দো,	
satjaner,	সাতজনের,	সাতজনের,	
alraji,	অলরাজি,	আলরাজী,	
vool,	ভূল,	উল,	
sima,	সীমা,	সীমা,	
prothati,	প্রথাটি,	প্রথাটি,	
miraqela,	মিরাকেলা,	মিরাকেল,	
daktikit,	ডককটিকিট,	ডাকটিকিট,	
kaatbey,	কাটবে,	কাটবে,	
bhaandar,	ভান্দর,	ভাণ্ডার,	
foxer,	ফক্সের,	ফক্সের,	
shikh,	শীখ,	শিখ,	
jotinkey,	জতিনকে,	যতীনকে,	
korush,	করুশ,	ক্রুশ,	
durgotsab,	দুর্গোৎসব,	দুর্গোৎসব,	
chhayi,	ছাই,	ছাই,	
samley,	সামলে,	সামলে,	
tinage,	টিনেজ,	টিনেজ,	
poste,	পোস্টে,	পোষ্টে,	
rakkhanvag,	রক্ষণভাগ,	রক্ষণভাগ,	
oindrila,	ঐন্দ্রিলা,	ঐন্দ্রিলা,	
bosoben,	বসবেন,	বসবেন,	
machhti,	মাছটি,	মাছটি,	
remacri,	রিমেক্রি,	রেমাক্রী,	
madhuree,	মধুরী,	মাধুরী,	
suraaropito,	সুরারপিত,	সুরারোপিত,	
cinemapremider,	সিনেমাপ্রমিদিদের,	সিনেমাপ্রেমীদের,	
hunine,	হুনিন,	হুনাইন,	
quartar,	কোয়ারটার,	কোয়ার্টার,	
sudrishya,	সুদৃশ্য,	সুদৃশ্য,	
ukeliptas,	ইকেলিপ্টাস,	ইউক্যালিপ্টাস,	
tuleche,	তুলেছে,	তুলেছে,	
bangulzai,	বাঙ্গুলাই,	বঙ্গুলিজাই,	
poriharsoho,	পরিহারসহ,	পরিহারসহ,	
norfolk,	নরফলোক,	নরফোক,	
sorano,	সোরানো,	সরানো,	
obosan,	অবসান,	অবসান,	
peethey,	পিথে,	পীঠে,	
engrezder,	এংজেরদের,	ইংরেজদের,	
brittakar,	বৃত্তকার,	বৃত্তাকার,	
survative,	সার্ভেটিভ,	সারভেটিভ,	
batom,	বাতোম,	বাটম,	
planeti,	প্লেনেটি,	প্লেনটি,	
shikshakrom,	শিক্ষাক্মম,	শিক্ষাক্রম,	
biprodas,	বিপ্রদাস,	বিপ্রদাস,	
romancha,	রোমাঞ্চ,	রোমাঞ্চ,	
pulivendla,	পুলিভেন্ডলা,	পুলিভেন্ডলা,	
rezidence,	রেজিডেন্স,	রেসিডেন্স,	
kobutorer,	কবুতরের,	কবুতরের,	
sayanaida,	সায়াইদাদা,	সায়ানাইড,	
fatkabazare,	ফতকবাজারারে,	ফাটকাবাজারে,	
teennis,	টিনিস,	টেনিস,	
vange,	ভ্যাঞ্জে,	ভাঙ্গে,	
meropenemer,	মেরোপেনমের,	মেরোপেনেমের,	
teemothy,	তিমথি,	টিমোথি,	
siddhante,	সিদ্ধান্তে,	সিদ্ধান্তে,	
epiela,	এপিওলা,	আইপিএল,	
pettern,	পেটার্ন,	প্যাটার্ন,	
shilbar,	শিলবার,	সিলভার,	
durbhagya,	দুর্ভাগ্য,	দূর্ভাগ্য,	
zesa,	জেস,	জেস,	
besooro,	বেসরর,	বেসুর,	
choukato,	চৌকাতো,	চৌকাত,	
birmuktijoddhagan,	বীরমুক্ধিযোদ্ধাগণ,	বীরমুক্তিযোদ্ধাগণ,	
darji,	দার্জী,	দরজি,	
peterke,	পেটেরকে,	পিটারকে,	
daltyagi,	দল্যাাগী,	দলত্যাগী,	
arthonitite,	অর্থনীতিতে,	অর্থনীতিতে,	
tikta,	টিকটা,	তিক্ত,	
shrabastee,	শ্রাবস্তি,	শ্রাবস্তী,	
holdim,	হোল্ডিম,	হোল্ডিং,	
bonnypran,	বনিযপ্রাণ,	বন্যপ্রাণ,	
shho,	শো,	শো,	
masjidsaho,	মসসিদাসহ,	মসজিদসহ,	
mangolic,	ম্যাঙ্গোলিক,	মাঙ্গলিক,	
labonaaktotaar,	লবনোকতাতার,	লবণাক্ততার,	
komanera,	কমানেরা,	কমানেরা,	
kathla,	কাঠলা,	কাঠলা,	
suporichita,	সুপরিচিতা,	সুপরিচিত,	
ongshogrohoner,	অংশগ্রহণের,	অংশগ্রহনের,	
kazianis,	কাজিয়ানিস,	কাজানিস,	
kichutei,	কিছুতেই,	কিছুতেই,	
echhti,	এছতি,	এছটি,	
bojhe,	বোঝে,	বোঝে,	
khudhartara,	ক্ষুধার্তারা,	ক্ষুধার্তরা,	
seekkhokbrindo,	শিক্ষকবৃন্দ,	শিক্ষকবৃন্দ,	
kuhelika,	কুহেলিকা,	কুহেলিকা,	
bhandar,	ভান্ডার,	ভাণ্ডার,	
wedanta,	ওয়েদানটা,	বেদান্ত,	
bojiye,	বজিয়ে,	বজিয়ে,	
addata,	আদ্দাটা,	আড্ডাটা,	
highcommissionay,	হাইক্মংশেশা,	হাইকমিশনে,	
graambaaseeder,	গ্রামবাসীদের,	গ্রামবাসীদের,	
hevy,	হেভি,	হেভি,	
kachhakaachhi,	কথচাচি,	কাছাকাছি,	
metrikoleshana,	মেট্রিকোলেশন,	মেট্রিকোলেশন,	
greep,	গ্রীপ,	গ্রিপ,	
shniper,	শ্নীপের,	স্নাইপার,	
mimgulor,	মিমগুলোর,	মিমগুলোর,	
granthatyke,	গ্রান্থাটিকে,	গ্রন্থটিকে,	
bohudeen,	বহুদীন,	বহুদিন,	
paolasthi,	পাওলস্থী,	পাওলাসথি,	
korle,	কর্লে,	করলে,	
fud,	ফুদ,	ফুড,	
contemporary,	কন্টেমপারারি,	কন্টেম্পোরারি,	
hughkey,	হুগকে,	হিউজকে,	
kortona,	কর্তনা,	করতনা,	
shomser,	শমসের,	সমশের,	
horiddare,	হরিদ্দারে,	হরিদ্বারে,	
sip,	সিপ,	শিপ,	
kram,	ক্রম,	ক্রম,	
anchalsaho,	অঞ্চলসহ,	অঞ্চলসহ,	
lampot,	ল্যাম্প,	লম্পট,	
attacharito,	অত্টাচারিত,	অত্যাচারিত,	
towraat,	টৌরাত,	তওরাত,	
graambaashee,	গ্রামবশী,	গ্রামবাসী,	
scoore,	স্কুর,	স্কোর,	
fakhrul,	ফকরুল,	ফাখরুল,	
anektai,	অনেকটাই,	অনেকটাই,	
ganosachetanata,	গণসচেতনাটা,	গণসচেতনতা,	
gazetted,	গ্যাজেট্ড,	গেজেটেড,	
olympic,	অলিম্পিক,	অলিম্পিক,	
madeling,	ম্যাডিলিং,	মডেলিং,	
raagee,	নাগী,	রাগী,	
baju,	বজু,	বাজু,	
elakaate,	এলাকাতে,	এলাকাতে,	
bibecchyo,	বিবেচ্চয়,	বিবেচ্য,	
patrol,	প্যাটরোল,	পেট্রোল,	
doltyagi,	দল্যাাগী,	দলত্যাগী,	
hizriite,	হিজরিতিতে,	হিজরীতে,	
ebham,	ইভাম,	ইভিএম,	
nili,	নিলী,	নিলি,	
uchchotara,	উচ্চতারা,	উচ্চতর,	
hisaber,	হিসাবের,	হিসাবের,	
hepatitis,	হেপাটাইটিস,	হেপাটাইটিস,	
kamla,	কামলা,	কামলা,	
shamuker,	শামুকের,	শামুকের,	
bhabaaponno,	ভাবনন্য,	ভাবাপন্ন,	
paira,	পাইরা,	পাইরা,	
auttacharer,	অত্টাচারের,	অত্যাচারের,	
degree,	ডিগরি,	ডিগ্রি,	
vaticaner,	ভ্যাটিকেনের,	ভ্যাটিকানের,	
tata,	টাট,	তাতা,	
nathibhuktir,	নথিভুক্তির,	নথিভুক্তির,	
iling,	ইলিং,	ইলিং,	
forex,	ফরেক্স,	ফরেক্স,	
nojder,	নজদের,	নজদের,	
kokeyin,	কোকেইন,	কোকেইন,	
chalachchitroi,	চলচ্চিত্রই,	চলচ্চিত্রই,	
nakkal,	নকক্কাল,	নক্কল,	
taap,	তাপ,	ট্যাপ,	
shansthagulo,	শান্থাগুলো,	সংস্থাগুলো,	
tiunara,	টিউনারা,	টিউনার,	
accountdharira,	অ্যাকাউন্টারিরা,	একাউন্টধারীরা,	
highcomissione,	হাইক্িকশনে,	হাইকমিশনে,	
planea,	প্লেনিয়া,	প্লেনে,	
muktilav,	মুক্তিলাভ,	মুক্তিলাভ,	
sectore,	সেক্টরে,	সেক্টরে,	
jotharthovabey,	যথার্থবাবে,	যথার্থভাবে,	
myat,	ম্যাট,	ম্যাট,	
kodorer,	কদরের,	কদরের,	
swasthohinotay,	স্বাস্থ্যহীনতায়,	স্বাস্থ্যহীনতায়,	
taigara,	তাইগারা,	টাইগার,	
pare,	পায়েরে,	পাড়ে,	
aarmstrong,	অ্যার্ম্ট্রং,	আর্মস্ট্রং,	
oxite,	অক্সিতে,	অক্সাইট,	
chahidapotrer,	চাহিদাপত্রের,	চাহিদাপত্রের,	
nadike,	নাদিকে,	নদীকে,	
ajibon,	অজিবন,	আজীবন,	
panchashjan,	পঞ্চাশজন,	পঞ্চাশজন,	
bonshi,	বনশি,	বংশী,	
senabahineekey,	সেনাবাহিনীকে,	সেনাবাহিনীকে,	
parking,	পারকিং,	পার্কিং,	
orbit,	অরবিট,	অরবিট,	
sahittekder,	সাহিত্যেদদের,	সাহিত্যেকদের,	
udyem,	উদয়েম,	উদ্যেম,	
shaahaabiike,	শাহাইবিকে,	সাহাবীকে,	
salmanul,	সালমানুল,	সালমানুল,	
yaak,	যাক,	ইয়াক,	
amudey,	আমুদে,	আমুদে,	
dighol,	দিঘল,	দীঘল,	
bondhukey,	বন্ধুকে,	বন্ধুকে,	
gazeetteed,	গািত্দ,	গেজেটেড,	
mawdeel,	মওপিল,	মডেল,	
karu,	করু,	কারু,	
teenisa,	তিনিসা,	টেনিস,	
ramchander,	রামচন্দের,	রামচন্দরের,	
harja,	হারজা,	হার্জ,	
abhidhaanic,	অভিধানিক,	অভিধানিক,	
brahmanera,	ব্রাহ্মণেরা,	ব্রাহ্মণেরা,	
alsaar,	আলসার,	আলসার,	
bhuushito,	ভূষষিত,	ভূষিত,	
yaq,	য্ক,	ইয়াক,	
erokomer,	এরকমের,	এরকমের,	
manabmaner,	মানবমানের,	মানবমনের,	
shikkharrthirao,	শিক্ষার্থীরাও,	শিক্ষার্থীরাও,	
domonmulok,	দমন্মূলক,	দমনমূলক,	
moonshi,	মুনশি,	মুন্সি,	
hafsa,	হাফসা,	হাফসা,	
dormroome,	ডর্মরুমে,	ডর্মরুমে,	
klaud,	ক্লাউড,	ক্লাউড,	
nirmol,	নির্মল,	নির্মল,	
durlabhatwang,	দুর্লভত্বং,	দুর্লভত্বং,	
carbus,	কার্বাস,	কারবাস,	
mojlish,	মজলিশ,	মজলিশ,	
turisht,	টুরিংস্ট,	টুরিস্ট,	
homshke,	হোমশকে,	হোমসকে,	
madhobeer,	মাধবীর,	মাধবীর,	
musabbirul,	মুসাব্বিরুল,	মুসাব্বিরুল,	
daqop,	ডাকোপ,	দাকোপ,	
chenza,	চেনজা,	চেঞ্জ,	
shchalastik,	শ্ছালস্তিক,	স্কলাস্টিক,	
sakshatkarer,	সাক্ষাতকারের,	সাক্ষাৎকারের,	
lebina,	লেবিনা,	লেবিনা,	
udbhabaney,	উদ্ভবনে,	উদ্ভাবনে,	
dhadhiye,	ধাধিয়ে,	ধাধিয়ে,	
karmazog,	কর্মোোগ,	কর্মযোগ,	
poribahokotto,	পরিবাবক্ত,	পরিবাহকত্ব,	
giitikobita,	গীতিকিবতি,	গীতিকবিতা,	
dipon,	ডিপন,	দীপন,	
paner,	পানের,	পানের,	
cheekitsar,	চিকিৎসার,	চিকিত্সার,	
qirq,	কিরক,	কার্ক,	
ixprission,	ইক্সপ্রিসন,	এক্সপ্রেশন,	
rokkhonabekkhoner,	রক্ষণাবেক্ষণের,	রক্ষণাবেক্ষণের,	
grambasheeo,	গ্রামবাশীও,	গ্রামবাসীও,	
aholyar,	অহল্যার,	অহল্যার,	
gate,	গাতে,	গ্যেটে,	
azaan,	আজান,	আজান,	
jaunotar,	যৌনতার,	যৌনতার,	
louhojato,	লৌহযাত,	লৌহজাত,	
tikto,	টিক্ত,	তিক্ত,	
gondhe,	গন্ধে,	গন্ধে,	
courtcaser,	কোর্টকাসের,	কোর্টকেসের,	
oitijjo,	ঐতিজ্য,	ঐতিহ্য,	
phund,	ফান্ড,	ফান্ড,	
mochlekha,	মোছেলখা,	মোছলেখা,	
byaboharkariyi,	ব্যবহারকারী,	ব্যবহারকারীই,	
batsmanei,	ব্যাটসম্যানেই,	ব্যাটসম্যানই,	
fatakesto,	ফাতাকেস্তো,	ফাটাকেষ্ট,	
dologuloo,	দলগুলো,	দলগুলোও,	
bbosonto,	ব্বসন্ত,	বসন্ত,	
upobashii,	উপবাশী,	উপবাসী,	
nibeditar,	নিবেদিতার,	নিবেদিতার,	
huk,	হুক,	হুক,	
bangobandhu,	বঙ্গবন্ধু,	বঙ্গবন্ধু,	
bupher,	বুফার,	বাফার,	
ekatto,	একাত্ত,	একাত্ব,	
damodar,	দামোদার,	দামদর,	
spredasita,	স্প্রেডসিনা,	স্প্রেডশীট,	
songkolonti,	সংকলনটি,	সংকলনটি,	
ekbai,	একবাই,	একবাই,	
jeten,	জেতেন,	জেতেন,	
rudrasagar,	রুদ্রসাগর,	রুদ্রসাগরের,	
nirmolotaa,	নির্মলতা,	নির্মলতা,	
remakri,	রিমাক্রী,	রেমাক্রী,	
atmira,	আত্মিরা,	আত্মীরা,	
azin,	অজিন,	আজিন,	
unchiyechilo,	উঁচিয়েছিল,	উঁচিয়েছিল,	
nathivookteer,	নথিভুক্তির,	নথিভুক্তির,	
farna,	ফার্না,	ফার্ন,	
sutir,	সুতির,	সুতির,	
ghenshei,	ঘেনশেই,	ঘেঁষেই,	
labonaktatar,	লবোকাততার,	লবণাক্ততার,	
ceramiker,	সেরামিকের,	সিরামিকের,	
shorifer,	শরীফের,	শরিফের,	
tookrokey,	টুক্রকে,	টুকরোকে,	
digreeke,	ডিগ্রিকে,	ডিগ্রিকে,	
prachirer,	প্রাচীরের,	প্রাচিরের,	
lajik,	লাজিক,	লজিক,	
piulir,	পিওলির,	পিউলির,	
residence,	রেসিডেন্স,	রেসিডেন্স,	
fulkapi,	ফুলকাপি,	ফুলকপি,	
korimer,	করিমের,	করিমের,	
protishtan,	প্রতিষ্টান,	প্রতিষ্টান,	
parqim,	পারকিম,	পার্কিং,	
koyekbare,	কয়েকবারে,	কয়েকবারে,	
deares,	ডিয়ারস,	ডিআরএস,	
kharavel,	খারাভেল,	খারবেল,	
gandhariir,	গানধধারীর,	গান্ধারীর,	
dwipke,	দ্বিপকে,	দ্বীপকে,	
tenishe,	তেনিশে,	টেনিসে,	
nirapattamulok,	নিরাপত্তমূলক,	নিরাপত্তামূলক,	
nabatarange,	নবতরঙ্গে,	নবতরঙ্গে,	
elakatikay,	এলাকাটিকায়,	এলাকাটিকে,	
spenser,	স্পেন্সের,	স্পেন্সার,	
vugorvey,	ভুগর্ভে,	ভূগর্ভে,	
heteler,	হেটেলের,	হেটেলের,	
jamanataswarup,	জমমানবস্বরূপ,	জামানতস্বরূপ,	
prarthonakokkher,	প্রার্থনাক্ষকের,	প্রার্থনাকক্ষের,	
remacry,	রিমেক্রি,	রেমাক্রী,	
mandarbani,	মন্দরবাণী,	মন্দারবাণী,	
monzeele,	মনজিলে,	মঞ্জিলে,	
teter,	টেটের,	টেটের,	
lambaate,	ল্যামবে,	লম্বাটে,	
niurolaji,	নিরোলাজী,	নিউরোলজি,	
neelkamal,	নেলকামাল,	নীলকমল,	
satyaky,	সত্যককি,	সাত্যকি,	
shoreefer,	শরীফর,	শরিফের,	
beshakbar,	বেশকবার,	বেশকবার,	
cheekitshar,	চিকিৎশার,	চিকিত্সার,	
dhaanche,	ধাঁচে,	ধাঁচে,	
khali,	খালি,	খালি,	
chinito,	চিনিতো,	চিনতো,	
dinar,	দিনার,	ডিনার,	
chikitshar,	চিকিৎশার,	চিকিত্সার,	
graambasio,	গ্রামবাসীও,	গ্রামবাসীও,	
akreetokarjo,	আক্রতাকর্য্য,	অকৃতকার্য,	
batikromshalee,	বাতিক্রশল্লল,	ব্যতিক্রমধর্মী,	
kaaferder,	কাফেরদের,	কাফেরদের,	
agomone,	আগমমে,	আগমনে,	
kagbeni,	কাগবেনি,	কাগবেনি,	
corsin,	কর্সিন,	করসিন,	
cinematographar,	সিনেমোত্রাগফার,	সিনেমাটোগ্রাফার,	
bachhaikrito,	বাচাইকৃত,	বাছাইকৃত,	
blyaka,	ব্লাযাকা,	ব্ল্যাক,	
ganokantha,	গণকণ্ঠ,	গণকণ্ঠ,	
bibader,	বিবাদের,	বিবাদের,	
korimkey,	করিমকে,	করিমকে,	
buddhitii,	বুদ্ধিটিই,	বুদ্ধিটিই,	
pujit,	পুজিত,	পুজিত,	
saqara,	সাকারা,	সাকার,	
bijito,	বিজিত,	বিজিত,	
nathivookto,	নথিভুক্ত,	নথিভুক্ত,	
nagorikke,	নাগরিককে,	নাগরিককে,	
anhu,	আনহু,	আনহু,	
stonehenje,	স্তনেজেঞ্জে,	স্টোনহেঞ্জ,	
purohitder,	পুরোহিতদের,	পুরোহিতদের,	
protijogiider,	প্রতিযোগীদের,	প্রতিযোগীদের,	
prothakey,	প্রথাকে,	প্রথাকে,	
sqalarashipa,	স্কলারশিপা,	স্কলারশিপ,	
phaltu,	ফালটু,	ফালতু,	
helly,	হেলি,	হিলি,	
basermick,	বেসরমিক,	বেসারমিক,	
elaakate,	এলাকাতে,	এলাকাতে,	
pracharanamulak,	প্রচারণামূলক,	প্রচারণামূলক,	
laishensh,	লাশেন্স,	লাইসেন্স,	
siddhanter,	সিদ্ধান্তের,	সিদ্ধান্তের,	
jhanjra,	ঝঞ্জরা,	ঝাঁজরা,	
soceitytey,	সোসেইটি,	সোসাইটিতে,	
kruser,	ক্রুসের,	ক্রুশের,	
abarte,	আবারতে,	আবর্তে,	
gorjon,	গর্জন,	গর্জন,	
shikkhadikkhay,	শিক্ষাদিক্ষায়,	শিক্ষাদিক্ষায়,	
koro,	করো,	করো,	
bade,	বাদে,	বাদে,	
oiteejye,	ঐতিজ্ঞে,	ঐতিহ্যে,	
anandamahale,	আনন্দমহলে,	আনন্দমহলে,	
timathi,	তিমাথি,	টিমোথি,	
chaka,	চাকা,	চাকা,	
proteemar,	প্রতিমার,	প্রতিমার,	
noditir,	নদীটির,	নদীটির,	
chiraharit,	চিরাহারিত,	চিরহরিৎ,	
shoriph,	শরিফ,	শরিফ,	
rajnoitik,	রাজনৈতিক,	রাজনৈতীক,	
rinattak,	ঋতিততাক,	ঋনাত্মক,	
bipti,	বিপ্তি,	বিপ্তি,	
shasonamoleri,	শাসনামলেরই,	শাসনামলেরই,	
musolmanera,	মুসলমোনেরা,	মুসলমানেরা,	
latsaheb,	লৎসসাহেব,	লাটসাহেব,	
manatmulak,	মনতমমূলক,	মানতমূলক,	
dokaangoolote,	ডোকাঙগুলোতে,	দোকানগুলোতে,	
aasirbaad,	আশির্বাদ,	আশির্বাদ,	
dei,	দেই,	দিই,	
sarollo,	সারলো,	সারল্য,	
deelibhara,	তিলিভরা,	ডেলিভার,	
phutanta,	ফুটান্ত,	ফুটন্ত,	
chakradhare,	চক্রধারে,	চক্রধরে,	
kash,	কাশ,	কাস,	
norpholk,	নরফফোলক,	নরফোক,	
pratijogitamulak,	প্রতিযোগিতামূলক,	প্রতিযোগীতামূলক,	
qonflict,	কনফ্লিক্ট,	কনফ্লিক্ট,	
mulvitti,	মুলভিত্তি,	মূলভিত্তি,	
vittimul,	ভিত্তিমূল,	ভিত্তিমূল,	
vobobibhuti,	ভববিভূটি,	ভববিভূতি,	
lambi,	ল্যাম্বি,	লম্বি,	
bandhano,	বানধানো,	বাঁধানো,	
moshzidtike,	মস্ষিদটিকে,	মসজিদটিকে,	
kartona,	করততো,	করতনা,	
byan,	ব্যান,	ব্যাং,	
harasta,	হারাস্তা,	হারাস্তা,	
modyer,	মদদায়ার,	মদ্যের,	
transhapharma,	ট্রান্সফার্মা,	ট্রান্সফর্ম,	
hool,	হুল,	হুল,	
ekghare,	একঘরে,	একঘরে,	
lyaataa,	লাটা,	ল্যাটা,	
daraider,	দরাইদের,	দরাইদের,	
niemond,	নিইমন্ড,	নিমন্ড,	
chhintayikari,	ছিন্তায়কারী,	ছিনতাইকারী,	
elakai,	এলাকাই,	এলাকাই,	
mujuru,	মুজুরু,	মুজুরু,	
pet,	পেট,	পেত,	
lutharen,	লুথারেন,	লুথেরান,	
elaaka,	এলাকা,	এলাকা,	
mooney,	মুনি,	মুনে,	
monchosthol,	মঞ্চস্থল,	মঞ্চস্থল,	
ekbakke,	একবাককে,	একবাক্যে,	
khitkar,	খিতকার,	ক্ষিতকর,	
humira,	হুমিরা,	হুমিরা,	
mukherjee,	মুখের্জী,	মুখার্জী,	
jonoshongjog,	জনশঙ্গগ,	জনসংযোগ,	
dekaner,	দেকানের,	দেকানের,	
oyebjin,	ওয়েবজিন,	ওয়েবজিন,	
temone,	তেমনে,	তেমনই,	
geejeeteeda,	গিজেটিড,	গেজেটেড,	
aflatoxin,	আফ্লাটক্সিন,	আ্যফ্ল্যাটক্সিন,	
carlo,	কার্লো,	কার্লো,	
shem,	শেম,	সেম,	
tanu,	তনু,	তনু,	
balokarak,	বালোকারক,	বলকারক,	
ramnathbabur,	রামনাথবাবুর,	রামনাথবাবুর,	
peerry,	পিরি,	পেরি,	
adhyatmikata,	আধ্যাতমিকতা,	আধ্যাত্মিকতা,	
russad,	রুসাদ,	রুশদ,	
sambhabonao,	সম্ভাবনাও,	সম্ভবনাও,	
fasi,	ফাসি,	ফাঁসী,	
proshadhoner,	প্রশাধনের,	প্রসাধনের,	
kormopontha,	কর্মপন্থা,	কর্মপন্থা,	
aabarte,	আবারতে,	আবর্তে,	
tirmijii,	তিরমিজী,	তিরমিজি,	
soundarja,	সৌন্দর্য,	সৌর্ন্দয্য,	
drabyatah,	দ্রব্যাহ,	দ্রব্যতঃ,	
dhangsantup,	ধ্বংসাতূপ,	ধ্বংসন্তুপ,	
chhutochhooti,	ছুটোচুটি,	ছুটোছুটি,	
shatoke,	শতকে,	শতকে,	
adhunikkale,	আধুনিককালে,	আধুনিককালে,	
prabhritite,	প্রভৃতিতে,	প্রভৃতিতে,	
mausumeo,	মাসুমেও,	মৌসুমেও,	
dwibidho,	দ্বিবিধ,	দ্বিবিধ,	
flux,	ফ্লাক্স,	ফ্লাস্ক,	
alpa,	অল্পা,	অল্প,	
opohoron,	অপহরণ,	অপহরন,	
shashtra,	শা্ত্রা,	শাস্ত্র,	
prithibir,	পৃথিবীর,	পৃথবীর,	
hoonayin,	হুনাইয়িন,	হুনাইন,	
pachchi,	পাচ্ছি,	পাচ্ছি,	
mangoleek,	মঙ্গলিক,	মাঙ্গলিক,	
dokaanei,	দোকানেই,	দোকানেই,	
quota,	কোয়াটা,	কোটা,	
rajbondir,	রাজবন্দির,	রাজবন্দীর,	
huqa,	হুকা,	হুক,	
mukhmondole,	মুখমন্ডলে,	মুখমণ্ডলে,	
anusvara,	অনুশ্বর,	অনুস্বার,	
asovyo,	আসোভ্য,	অসভ্য,	
sainyader,	সৈন্যাদের,	সৈন্যদের,	
mahakabi,	মহাকাবী,	মহাকবি,	
kosambir,	কোসম্বীর,	কোসাম্বীর,	
riphleksa,	রিফ্লেক্সা,	রিফ্লেক্স,	
kaamij,	কামিজ,	কামিজ,	
huka,	হুকা,	হুক,	
proshikkhane,	প্রশিক্ষণে,	প্রশিক্ষণে,	
dito,	ডিটো,	দিতো,	
granada,	গ্র্নাডা,	গ্র্যানাডা,	
meshmeshya,	মেশমেষ্য,	মেশহমেশহিইয়া,	
ooporoshtho,	ঔপর্ষ্য,	উপরস্থ,	
baharamporer,	বাহারামপরের,	বহরমপুরের,	
hupile,	হুপিলে,	হুপিলে,	
firalem,	ফিরালেম,	ফিরালেম,	
ashanka,	আশাঙ্কা,	আশংকা,	
beetloser,	বিটলসের,	বিটলসের,	
billaho,	বিল্লাহো,	বিল্লাহ,	
gabeshonar,	গবেষণার,	গবেষনার,	
reejideencee,	রেজিডিন্সে,	রেসিডেন্স,	
elaakaati,	এলাকাটি,	এলাকাটি,	
amarika,	আমারিকা,	আমেরিকা,	
sazanor,	সাজানোর,	সাজানোর,	
dara,	ডারা,	দারা,	
pradoshik,	প্রদোশিক,	প্রাদশিক,	
nothibhukto,	নথিভুক্ত,	নথিভুক্ত,	
edseler,	এ্ডসেলের,	এডসেলের,	
bandi,	বান্দি,	বন্দী,	
dijmarescu,	দিজমারেক্রু,	দিজমার্সাকু,	
korkotkraantee,	কর্কতকর্নটি,	কর্কটক্রান্তি,	
nabbata,	নব্বাতা,	নাব্যতা,	
ekla,	একলা,	একলা,	
puding,	পুডিং,	পুডিং,	
suri,	সুরি,	সুরি,	
dipgulote,	ডিপগুলোতে,	দ্বীপগুলোতে,	
dajjha,	দাজ্া,	দাহ্য,	
prokolpogulikei,	প্রকল্পগুলিকেই,	প্রকল্পগুলিকেই,	
jhonkar,	ঝোঁকার,	ঝঙ্কার,	
habshi,	হাবশি,	হাবশী,	
carlos,	কার্লো,	কার্লোস,	
segular,	সেগুলার,	সেগুলোর,	
shulfate,	শুলফাতে,	সালফেট,	
jonosomaj,	জনসমাজ,	জনসমাজ,	
nirdesika,	নির্দেসিকা,	নির্দেশিকা,	
dakope,	ডাকোপ,	দাকোপ,	
aniyantrita,	অনিযন্ত্রিত,	অনিয়ন্ত্রিত,	
afrazuler,	আফ্রাজুলের,	আফরাজুলের,	
lyandim,	ল্যান্ডমি,	ল্যান্ডিং,	
shapad,	শাপাদ,	শ্বাপদ,	
orbi,	অরবি,	ওরবি,	
jomjamat,	জোমজামাত,	জমজমাট,	
amburi,	আম্বুরি,	আম্বুরি,	
batistambhatike,	বতিস্তমমাাীকে,	বাতিস্তম্ভটিকে,	
seconder,	সেকন্ডার,	সেকেন্ডের,	
logotype,	লোোটিপে,	লোগোটাইপ,	
promodwara,	প্রমোদ্বারা,	প্রমদ্বারা,	
mutar,	মুতার,	মুতার,	
sipa,	সিপা,	শিপ,	
poripaker,	পরিপাকের,	পরিপাকের,	
daaktikit,	ডাকটিকিট,	ডাকটিকিট,	
samratra,	সম্রত্র,	সম্রাটরা,	
mitroder,	মিত্রদের,	মিত্রদের,	
shrichaitanyadev,	শ্রীচৈতান্যদব,	শ্রীচৈতন্যদেব,	
dristiheen,	দৃষ্টিহীন,	দৃষ্টিহীন,	
anchalei,	আঞ্চলেই,	অঞ্চলেই,	
cena,	সেনা,	সিনা,	
gazipur,	গজজিপুর,	গাজিপুর,	
maailey,	মাইলে,	মাইলে,	
karmosansthan,	কর্মসাস্থান,	কর্মসংস্থান,	
bagicha,	বাগিচা,	বাগিচা,	
informetion,	ইনফরমেশন,	ইনফরমেশন,	
jinsa,	জিনসা,	জিন্স,	
muhuriganj,	মুহুরীগঞ্জ,	মুহুরীগঞ্জ,	
dhanak,	ধনক,	ধানক,	
karaponner,	কারাপন্নের,	কারাপণ্যের,	
aranyani,	অরণ্যানি,	অরণ্যানী,	
ashirbadatri,	আশির্বাদর্রী,	আশীর্বাদাত্রী,	
booksar,	বুকসার,	বুক্সার,	
jeher,	জেহের,	জেহের,	
obosorer,	অবসরের,	অবসরের,	
salafeta,	সালাফেটা,	সালফেট,	
laaisens,	লাইসেন্স,	লাইসেন্স,	
songasthatir,	সং্গস্থাটির,	সংস্থাটির,	
saver,	সাভার,	সেভার,	
gaphiloti,	গাফিলতি,	গাফিলতি,	
magar,	মাগার,	মাগার,	
joumana,	জোমানা,	জুমানা,	
horeepur,	হরিপুর,	হরিপুর,	
lishenshe,	লিশেন্স,	লাইসেন্স,	
philipiner,	ফিলিপিনের,	ফিলিপাইনের,	
mukhabandha,	মুখবন্ধ,	মুখবন্ধ,	
said,	সাইদ,	সাইদ,	
plasse,	প্লাসে,	প্লাসে,	
provur,	প্রভুর,	প্রভুর,	
ekoirokom,	একৈরকম,	একইরকম,	
booponer,	বুপনের,	বপনের,	
taffsherer,	তফভেরের,	তাফসীরের,	
teunar,	টেউনার,	টিউনার,	
himsrot,	হিমস্রোট,	হিমস্রোত,	
marathi,	মারাঠি,	মরাঠি,	
musalmanderke,	মুসলমান্দরকে,	মুসলমানদেরকে,	
karmake,	কারমাকে,	কর্মকে,	
avidur,	আভিদুর,	আভিদুর,	
protijogitamulok,	প্রতিযোগিতামূলক,	প্রতিযোগীতামূলক,	
chhuti,	ছুটি,	ছুটি,	
oxfordey,	অক্সফ্রে,	অক্সফোর্ডে,	
timoothi,	তিমুথি,	টিমোথি,	
bossoben,	বস্ববেন,	বসবেন,	
kajangale,	কাজংগালে,	কজঙ্গলে,	
habathu,	হাথাথু,	হাবাথু,	
uponishad,	উপনিশাদ,	উপনিষদ,	
duryogamoyee,	দুর্যোগামী,	দুর্যোগময়ী,	
khuliechilam,	খুলিয়েছিলাম,	খুলিয়েছিলাম,	
barrageke,	বারাজেকে,	ব্যারেজকে,	
toufiq,	তৌফিক,	তৌফিক,	
satan,	সাতান,	শয়তান,	
malinga,	মালিঙ্গা,	মালিংগা,	
onchalti,	অঞ্চলটি,	অঞ্চলটি,	
dharavassokar,	ধারাবাস্কার,	ধারাভাষ্যকার,	
sahab,	সাহাব,	সাহাব,	
dhalur,	ধালুর,	ঢালুর,	
deeares,	ডিয়ারস,	ডিআরএস,	
achintopurer,	অচিন্তপুরের,	অচিন্তপুরের,	
guzon,	গুজোন,	গুজব,	
motabolombira,	মতাবলম্বীরা,	মতাবলম্বীরা,	
grooth,	গ্রোথ,	গ্রোথ,	
chalochchitraeeo,	চলচ্চিত্রীয়,	চলচ্চিত্রেও,	
evereste,	এভারসেস্টে,	এভারেস্টে,	
qyantana,	ক্যান্ানা,	ক্যান্টন,	
shhikara,	শিকারা,	শিকার,	
daqten,	ডাকটেন,	ডাকতেন,	
shrabosty,	শ্রাযাশ্টটি,	শ্রাবস্তী,	
muchi,	মুচি,	মুচি,	
proshtotto,	প্রশ্তত্ত,	প্রস্ত্তত,	
nilkuthir,	নীলকুঠির,	নীলকুঠির,	
jaaygata,	জায়গাতা,	জায়গাটা,	
palashir,	পালাশির,	পলাশীর,	
joubankal,	যৌবনকাল,	যৌবনকাল,	
bhenkates,	ভেঙকাটেস,	ভেঙ্কটেশ,	
amanisa,	আমানিসা,	অমানিশা,	
toching,	টোচিং,	টোচিং,	
husni,	হুসনি,	হুসনি,	
zommu,	জোম্মু,	জম্মু,	
tigre,	টিগরে,	টাইগার,	
coons,	কিংস,	কুনস,	
sharansthal,	শারস্থল,	শরণস্থল,	
tigmanshu,	তিজমানশু,	তিগমংশু,	
doorotomo,	দূরতম,	দূরতম,	
dweepgoolotey,	ড্বিপগোতে,	দ্বীপগুলোতে,	
qanasarabheshana,	কনসরাশেশন,	কনসারভেশন,	
katbe,	কাটবে,	কাটবে,	
saqara,	সাকারা,	সকার,	
bhangchur,	ভাংচুর,	ভাংচুর,	
lutharan,	লুথার,	লুথেরান,	
prakar,	প্রাকর,	প্রকার,	
thakeni,	থাকেনি,	থাকেনি,	
baaik,	বাইক,	বাইক,	
orhan,	ওরহান,	ওরহান,	
siima,	সিমা,	সীমা,	
arthanitike,	অর্থনীতিকে,	অর্থনীতিকে,	
yanqee,	জ্যাংকি,	ইয়াংকি,	
barack,	ব্যারাক,	বারাক,	
chalochchitraeer,	চলচ্চিত্রীরার,	চলচ্চিত্রের,	
sthapona,	স্থাপনা,	স্থাপনা,	
gaichey,	গাইছে,	গাইছে,	
chalachchitra,	চলচ্চিত্র,	চলচ্চিত্র,	
kichudinpar,	কিছুদিনপর,	কিছুদিনপর,	
raia,	রায়া,	রায়,	
restuarant,	রেস্টুহার্ট,	রেষ্টুরেন্ট,	
sheets,	শিটস,	শীটস,	
eigulor,	এইগুলোর,	এইগুলোর,	
shootar,	শুতার,	শ্যুটার,	
kiandi,	কিয়ান্দি,	ক্যান্ডি,	
kloud,	ক্লোউড,	ক্লাউড,	
dholeshwari,	ধোলেশ্বরী,	ধলেশ্বরী,	
ghoomato,	ঘুমত,	ঘুমাতো,	
hajirhat,	হাজিরহাট,	হাজিরহাট,	
sheepha,	শেফা,	শেফ,	
shotodha,	শতধা,	শতধা,	
sanaktakaran,	সনক্তকরণ,	সনাক্তকরণ,	
shasyadi,	শাস্দদি,	শস্যাদি,	
rakhtokkharone,	রাখতাক্রণণে,	রক্তক্ষরণে,	
valobasen,	ভালোবাসেন,	ভালোবাসেন,	
foreks,	ফরেক্স,	ফরেক্স,	
kindom,	কিন্দম,	কিংডম,	
bolechile,	বলেছিলে,	বলেছিলে,	
phiksim,	ফিকসিম,	ফিক্সিং,	
neerbahi,	নিরবাহী,	নির্বাহি,	
khabarsoho,	খাবারসহ,	খাবারসহ,	
rodney,	রডনে,	রেডনি,	
harysoner,	হ্যারিসনের,	হ্যারিসনের,	
nichupattir,	নিচুপাত্তির,	নিচুপট্টির,	
dovaar,	দোভার,	ডোভার,	
qarlosa,	কারলোসা,	কার্লোস,	
songbadmadhyame,	সংবাদমাধ্যমে,	সংবাদমাধ্যমে,	
assaciates,	অ্যাসাসিয়াটস,	এসোসিয়েটস,	
lidars,	লিডার্স,	লিডার্স,	
dharabahikotitey,	ধারাবাহিক্তিতে,	ধারাবাহিকটিতে,	
mmadhuri,	ম্মাধুরী,	মাধুরী,	
dokaangulotey,	ডোকানগুলোতে,	দোকানগুলোতে,	
rilayensha,	রিলায়েনশ,	রিলায়েন্স,	
hosbaleke,	হোসবালেকে,	হোসবালেকে,	
relance,	রিলাযান্স,	রিলায়েন্স,	
poorohitder,	পুরোহিতদের,	পুরোহিতদের,	
distibutor,	ডিস্টিবিউটর,	ডিস্টিবিউটারের,	
shilpikuler,	শিল্পিকুলের,	শিল্পীকুলের,	
sampadon,	সম্পাদন,	সম্পাদন,	
ekbakye,	একবাক্যে,	একবাক্যে,	
salsa,	সালসা,	সালসা,	
kk,	কেকে,	কেকে,	
graambaashio,	গ্রামবাশীও,	গ্রামবাসীও,	
tanshree,	তনশ্রী,	তানশ্রী,	
sallallahu,	সাল্লাল্লাহু,	সল্লাল্লাহু,	
krush,	ক্রুশ,	ক্রুশ,	
gore,	গোরে,	গোর,	
chalachchitrer,	চলচ্চিত্রের,	চলচ্চিত্রের,	
vortuki,	ভর্তুকি,	ভর্তুকি,	
panthar,	পান্থার,	পন্থার,	
shibraj,	শিবরাজ,	শিবরাজ,	
samle,	সামলে,	সামলে,	
ashonkai,	আশনকাই,	আশঙ্কাই,	
bishasey,	বিষাসে,	বিশ্বাসে,	
mumtaj,	মুমতাজ,	মুমতাজ,	
vogiroth,	ভোগররথ,	ভগীরথ,	
mirakela,	মিরাকেলা,	মিরাকেল,	
bhittow,	ভিত্তউ,	ভিত্তিও,	
ishahak,	ইশাহাক,	ইসাহাক,	
ddebet,	ডিডেব,	ডিবেট,	
foloshrutite,	ফলশ্রুটিতে,	ফলশ্রুতিতে,	
bollov,	বল্ভ,	বল্লভ,	
hoteltite,	হোটেলটিতে,	হোটেলটিতে,	
bheenisa,	ভিনিসা,	ভেনিস,	
indra,	ইন্দ্রা,	ইন্দ্র,	
dong,	ডং,	ডং,	
shikshagata,	শিক্ষগত,	শিক্ষাগত,	
nek,	নেক,	নেক,	
uponeesoder,	উপনিসদের,	উপনিষদের,	
gardeen,	গার্ডিন,	গার্ডেন,	
premoronge,	প্রেমরঙ্গে,	প্রেমরঙে,	
becha,	বেচা,	বেচা,	
vvimsenn,	ভিভিসেন,	ভীমসেন,	
samany,	সামানি,	সামান্য,	
rajdhani,	রাজধানি,	রাজধানি,	
ghatleo,	ঘাটলেও,	ঘটলেও,	
achintyabhedaved,	অচিন্ত্যভেদেভ,	অচিন্ত্যভেদাভেদ,	
rotheen,	রথিন,	রথীন,	
byboshthar,	বিবশ্থার,	ব্যাবস্থার,	
basaalt,	বাসাল্ট,	ব্যাসল্ট,	
teman,	তেমান,	তেমন,	
kalkarkhana,	কলকরখানা,	কলকারখানা,	
shahoshikatar,	শংশিকাতার,	সাহসিকতার,	
rajtantrey,	রাজতন্ত্রে,	রাজতন্ত্রে,	
blogarra,	ব্লোগাররা,	ব্লগাররা,	
seramiks,	সেরামিকস,	সিরামিকস,	
veemsen,	ভিমসেন,	ভীমসেন,	
annanere,	আন্নানেরে,	অন্যানেরে,	
ciima,	সিইমা,	সীমা,	
sahachke,	সহচকে,	সাহাচকে,	
kaleo,	কালেও,	কালেও,	
prachando,	প্রচান্ডো,	প্রচণ্ড,	
vetrillocuism,	ভেট্রিলিকুলিজম,	ভেট্রিলোকুইজম,	
tahalo,	তাহালো,	তাহলো,	
francine,	ফ্রানসিন,	ফ্রান্সিন,	
dala,	দালা,	দলা,	
silabhara,	সীলাভারা,	সিলভার,	
societytey,	স্িটিইট,	সোসাইটিতে,	
browser,	ব্রসার,	ব্রাউজার,	
qredita,	ক্রেডিটা,	ক্রেডিট,	
monchostho,	মঞ্চস্থ,	মঞ্চস্থ,	
khilaphat,	খিলাফত,	খিলাফত,	
railliner,	রেলিনের,	রেললাইনের,	
samyuktha,	সম্যুক্থ,	সামিউক্তা,	
rajtantra,	রাজতন্ত্র,	রাজতন্ত্র,	
kathmandute,	কাঠমণ্ডুতে,	কাঠমান্ডুতে,	
aireshe,	আইরেসে,	আইরেসে,	
bolbo,	বলবো,	বলবো,	
bujhechhila,	বুঝেছিলা,	বুঝেছিল,	
prosadhaner,	প্রসাধানের,	প্রসাধনের,	
miraclee,	মিরাক্লি,	মিরাকেল,	
confliqt,	কনফ্লিক্ট,	কনফ্লিক্ট,	
shahabike,	শাহাবিকে,	সাহাবীকে,	
jorury,	জরুরি,	জরূরী,	
babona,	বাবনা,	বাবনা,	
sausage,	সৌসাগে,	সসেজ,	
plak,	প্ল্ক,	প্ল্যাক,	
pohnpeic,	পোহ্নপিক,	ফোনপেইক,	
bhikkharthe,	ভিক্ষার্থে,	ভিক্ষার্থে,	
bodhir,	বধির,	বধির,	
musallati,	মুসল্লাটি,	মুসল্লাটি,	
ashamarthita,	আশামর্থিত,	অসমর্থিত,	
khaschandpur,	খাসচন্দ্ুর,	খাসচাঁদপুর,	
gajiipur,	গজিপুর,	গাজীপুর,	
naobihar,	নওবিহার,	নৌবিহার,	
directorete,	ডারের্টটরে,	ডিরেক্টরেট,	
satarkakari,	সতর্ককারী,	সতর্ককারী,	
concerter,	কনসার্টার,	কানসাটের,	
harza,	হারজা,	হার্জ,	
mesenjjar,	মেসেজজজজার,	মেসেঞ্জার,	
onshogrohoner,	অন্গগ্রহণের,	অংশগ্রহনের,	
byabaharkarike,	ব্যবহারকারীকে,	ব্যবহারকারীকে,	
ajeeboner,	আজিবনের,	আজীবনের,	
gyandas,	জ্ঞানদাস,	জ্ঞানদাস,	
banglota,	বাংলোটা,	বাংলোটা,	
turkyder,	টার্কিদের,	তুর্কিদের,	
parisankhanbid,	পরিসং্গনবিদ,	পরিসংখ্যানবিদ,	
skolastik,	স্কোলাস্তিক,	স্কলাস্টিক,	
monohputo,	মনোপপুতো,	মনঃপুত,	
jamaanor,	জামানোর,	জমানোর,	
ajeejer,	আজিজের,	আজিজের,	
munot,	মুনোট,	মুনোট,	
stona,	স্তোনা,	স্টোন,	
munjur,	মুনজুর,	মুনজুর,	
spreedashita,	স্প্রীদাশিতা,	স্প্রেডশীট,	
cloudbook,	ক্লাদবুক,	ক্লাউডবুক,	
moshjidke,	মস্িদকে,	মসজিদকে,	
khalidke,	খালিদকে,	খালিদকে,	
sarjur,	সার্জুর,	সরযূর,	
hoil,	হইল,	হইল,	
ajijer,	আজিজের,	আজিজের,	
lubitz,	লুবিইজ,	লুবিৎজ,	
hertj,	হার্টজ,	হার্জ,	
panda,	পাণ্ড,	পান্ডে,	
dhhaabi,	ঢাবি,	ঢাবি,	
samajikotar,	সমাজিকতার,	সামাজিকতার,	
vabnakey,	ভবনাকে,	ভাবনাকে,	
parikhar,	পরিখর,	পরিখার,	
bhabanipur,	ভবনীপুর,	ভবানীপুর,	
nirikh,	নিরিখ,	নিরিখ,	
kyatagorir,	ক্যাটগগরির,	ক্যাটাগরির,	
jonee,	জনী,	জনি,	
hock,	হকক,	হুক,	
antorvuktimulak,	অন্তর্ভুতিকুলক,	অন্তর্ভুক্তিমূলক,	
proboleme,	প্রবলেমে,	প্রবলেমে,	
konflict,	কনস্লিক্ট,	কনফ্লিক্ট,	
ghomta,	ঘোমটা,	ঘোমটা,	
adbhanced,	অ্যাডভান্স,	অ্যাডভান্সড,	
gitikobita,	গীতিকবিতা,	গীতিকবিতা,	
grauth,	গ্রুথ,	গ্রোথ,	
sulfatee,	সুলফাটি,	সালফেট,	
samanwitovabe,	সমানবিতভাবে,	সমন্বিতভাবে,	
chhadite,	ছাড়িতে,	ছড়িতে,	
ancholsomuho,	অঞ্চলসমূহ,	অঞ্চলসমূহ,	
votar,	ভোটার,	ভোটার,	
dhhaloor,	ঢালুর,	ঢালুর,	
digrir,	ডিগ্রির,	ডিগ্রির,	
madaspushto,	মাদাসপুষ্ট,	মদদপুষ্ট,	
oitijje,	ঐতিজ্যে,	ঐতিহ্যে,	
smarok,	স্মারক,	স্মারক,	
orgho,	অর্ঘ,	অর্ঘ্য,	
raghubar,	রঘুবার,	রঘুবীর,	
sikkhokder,	শিক্ষকদের,	শিক্ষকদের,	
nirgomon,	নির্গমন,	নির্গমন,	
nazranar,	নজরানার,	নাজরানার,	
upobasee,	উপবাসী,	উপবাসী,	
ghaghat,	ঘাঘাট,	ঘাঘট,	
daaun,	ডাউন,	ডাউন,	
bohoodin,	বহুদিন,	বহুদিন,	
srabosty,	স্রাবস্টি,	শ্রাবস্তী,	
boshoborty,	বশবর্তী,	বশবর্তী,	
gurmukh,	গুরমুখ,	গুরমুখ,	
bamon,	বামোন,	বামন,	
oitijhyotike,	ঐতিহ্যটিকে,	ঐতিহ্যটিকে,	
sylvi,	সিলভি,	সিলভি,	
manushti,	মানুষটি,	মানুষটি,	
ghurechen,	ঘুরেছেন,	ঘুরেছেন,	
roopdaan,	রূপডান,	রুপদান,	
welaqama,	ওয়েলাামা,	ওয়েলকাম,	
majlishpur,	মজলিশপুর,	মজলিশপুর,	
gobeshakgon,	গবেষককগণ,	গবেষকগণ,	
sangaskritipreme,	সংস্কৃতিপ্রেমে,	সংস্কৃতিপ্রেমে,	
elgoridom,	এলগোরিডম,	এলগরিদম,	
beatleser,	বিটেেসের,	বিটলসের,	
chal,	চাল,	চাল,	
siddhantoo,	সিদ্ধান্মও,	সিদ্ধান্তও,	
firth,	ফির্থ,	ফার্থ,	
rajpur,	রাজপুর,	রাজপুর,	
gandhiir,	গাঁধীীর,	গান্ধীর,	
prajanankal,	প্রজননকাল,	প্রজননকাল,	
bandra,	বান্দ্রা,	বন্দীরা,	
janamukhi,	জনামুখী,	জনমুখী,	
byke,	বিকে,	বাইক,	
suchonakal,	সুচনাকাল,	সূচনাকাল,	
donat,	দোনাত,	ডোনাট,	
fastag,	ফাস্তাগ,	ফ্যাসট্যাগ,	
kadapaker,	কাদাপকের,	কড়াপাকের,	
choddo,	চোদ্দো,	চোদ্দো,	
peri,	পেরি,	পেরি,	
bodhirota,	বোধিরতা,	বধিরতা,	
byomkes,	ব্যামকেস,	ব্যোমকেশ,	
ajij,	আজিজ,	আজিজ,	
upbrazillian,	আপ্চারিলায়ালিন,	আপব্রাজিলিয়ান,	
hul,	হুল,	হুল,	
serology,	সেরোলজি,	সেরোলজি,	
mugdha,	মুগ্ধা,	মুগ্ধ,	
nodiiteyi,	নোদিতেয়ী,	নদীতেই,	
projanankal,	প্রজানাকনাল,	প্রজননকাল,	
probeshkari,	প্রবেশকারী,	প্রবেশকারী,	
probhritike,	প্রভৃতিকে,	প্রভৃতিকে,	
dajhyo,	দাঝ্য,	দাহ্য,	
pratisthasaho,	প্রতিষ্ঠাসহ,	প্রতিষ্ঠাসহ,	
asamorik,	অসামরিক,	অসামরিক,	
serup,	সেরূপ,	সেরূপ,	
eukalyptus,	ইউকল্্চাপাইম,	ইউক্যালিপ্টাস,	
duhsthanostho,	দুঃস্থানস্থ,	দুঃস্থানস্থ,	
abheedhanik,	অভিধানিক,	অভিধানিক,	
suraaropeeto,	সুরাপপিত,	সুরারোপিত,	
magrey,	ম্যাগররে,	ম্যাগ্রে,	
ghotolen,	ঘটলেন,	ঘটলেন,	
gronther,	গ্রন্টের,	গ্রন্থের,	
veenish,	ভিনিশ,	ভেনিস,	
flirt,	ফ্লির্ট,	ফ্লার্ট,	
keyboarder,	কীবোয়র্ডের,	কীবোর্ডের,	
prakalpagulor,	প্রকল্পগুলোর,	প্রকল্পগুলোর,	
bosontokke,	বসন্তককে,	বসন্তকে,	
kalenga,	কালেঙ্গা,	কালেঙ্গা,	
byabostho,	ব্যবস্থ,	ব্যাবস্থা,	
palestine,	প্যালেস্টাইন,	প্যালেস্টাইনে,	
dhila,	ধিলা,	ঢিলা,	
chandrima,	চন্দ্রিমা,	চন্দ্রিমা,	
jothartho,	যথার্থ,	যথার্থ,	
ruptan,	রূপতান,	রূপটান,	
breel,	ব্রিল,	ব্রিল,	
sookumari,	শুকুমারি,	সুকুমারী,	
juboke,	যুবকে,	যুবকে,	
ipl,	আইপিএল,	আইপিএল,	
greenald,	গ্রিনাল্ড,	গ্রিনল্ড,	
bopoon,	বপুন,	বপন,	
chalchhe,	চলচ্ছে,	চলছে,	
video,	ভিডেও,	ভিডিয়োও,	
moushumei,	মৌশুমেই,	মৌসুমেই,	
nilfamarir,	নীলফামারির,	নীলফামারীর,	
karmakarke,	কর্মকারকে,	কর্মকারকে,	
khelechen,	খেলেছেন,	খেলেছেন,	
suparichiti,	সুপারিচিটি,	সুপরিচিতি,	
shift,	শিফ্ট,	শিফট,	
nutan,	নুতান,	নূতন,	
varote,	ভারোতে,	ভারতে,	
falasrutite,	ফালাস্রুটিতে,	ফলশ্রুতিতে,	
harbore,	হারবোর,	হারবারে,	
digri,	ডিগ্রি,	ডিগ্রি,	
biplabeer,	বিপ্লবীর,	বিপ্লবীর,	
somabeshti,	সমাবেশটি,	সমাবেশটি,	
borlen,	বর্লেন,	বরলেন,	
godamjato,	গোদাজাত,	গুদামজাত,	
shangkulaan,	শংকুলান,	সংকুলান,	
rohosyoti,	রোহস্যটি,	রহস্যটি,	
vejjanno,	ভেজজন্ন,	ভেজানো,	
ghotleo,	ঘটলেও,	ঘটলেও,	
alonkaran,	অলঙকরণ,	অলঙ্করণ,	
doneta,	দনেটা,	ডোনাট,	
gobeshokgon,	গবেষকগণ,	গবেষকগণ,	
societykey,	স্িটিকে,	সোসাইটিকে,	
bhimsenkei,	ভিমসেনকেই,	ভীমসেনকেই,	
chhooti,	ছুটি,	ছুটি,	
jati,	জাতি,	যাতি,	
steena,	স্টিনা,	স্টেন,	
champa,	চম্পা,	চাঁপা,	
madelim,	ম্দেলিম,	মডেলিং,	
rashedul,	রাশেদুল,	রাশিদুল,	
rca,	আরসিএসএ,	আরসিএ,	
toroonraa,	তরুণরা,	তরুণরা,	
shikare,	শিকারে,	শিকারে,	
poriskoron,	পরিস্করণ,	পরিষ্করণ,	
kanshater,	কাশশাটের,	কানসাটের,	
chhatrodiger,	ছাত্রদীগের,	ছাত্রদিগের,	
lyataa,	ল্যাটা,	ল্যাটা,	
crashlands,	ক্রাসল্যান্ডস্,	ক্র্যাশল্যান্ডস,	
oncholtee,	অঞ্চলটি,	অঞ্চলটি,	
keui,	কেই,	কেউই,	
khaaneker,	খানেকের,	খানেকের,	
antarctica,	অ্যান্টার্কটিকা,	অ্যান্টার্কটিকার,	
rahshahi,	রাহশাহী,	রাহশাহী,	
dipankar,	দীপঙ্কর,	দিপঙ্কর,	
ayantarqatiqa,	অন্তরনক্রিতা,	অ্যান্টার্কটিকা,	
turkamena,	তুর্কমেনা,	তুর্কমেন,	
ekshoti,	একশটি,	একশোটি,	
shudden,	শুদ্দেন,	সাডেন,	
khanabale,	খানাবালে,	খানাবলে,	
ship,	শিপ,	শিপ,	
moorali,	মুরালি,	মুরলী,	
gannaprakasham,	গণ্নপ্রাকমষ,	গন্নাপ্রকাশম,	
dii,	ডইই,	দিই,	
sealvi,	সিলভি,	সিলভি,	
sangasthagulo,	সংস্থাগুলো,	সংস্থাগুলো,	
romjaner,	রমজানের,	রমযানের,	
jesh,	যেশ,	জেস,	
deputee,	ডিপিটি,	ডেপুটি,	
patininda,	পতিিনিন্দা,	পতিনিন্দ,	
moomtaj,	মুমতাজ,	মুমতাজ,	
emarjensi,	ইমারজেন্সি,	এমার্জেন্সি,	
patochitra,	পাটচিত্র,	পটচিত্র,	
votarer,	ভোটারের,	ভোটারের,	
qarqa,	কারকা,	কার্ক,	
licensedhari,	লাইসেন্সধারী,	লাইসেন্সধারী,	
streegon,	স্ত্রীগণ,	স্ত্রীগণ,	
guzober,	গুজোবের,	গুজবের,	
debete,	দেবেতে,	ডিবেট,	
janghu,	জঙ্গু,	জঙ্ঘু,	
antorbhuktimulak,	অন্তর্ভুত্তিমূলক,	অন্তর্ভুক্তিমূলক,	
steeit,	স্টিইট,	স্টেইট,	
mookhomandoler,	মৌখনম্দলের,	মুখমণ্ডলের,	
attorkite,	অ্যাটোরকিকে,	অতর্কিতে,	
volivoler,	ভলিভোলের,	ভলিভলের,	
difinision,	ডিফিশনশন,	ডেফিনেশন,	
laat,	লাত,	লাট,	
chhutir,	ছুটির,	ছুটির,	
kanasarabheeshana,	কনসর্ভেশন,	কনসারভেশন,	
jins,	জিন্স,	জিন্স,	
sadeep,	সাদিপ,	সদীপ,	
bapokotor,	বাপকতর,	ব্যাপকতর,	
okkhorke,	অক্ষরকে,	অক্ষরকে,	
durgatsabe,	দুর্গোৎসবে,	দুর্গোৎসবে,	
aizulke,	আজজুলকে,	আইজুলকে,	
gaziipur,	গজিপুর,	গাজীপুর,	
bajhyo,	বাঝ্য,	বাহ্য,	
sondhisthaponer,	সন্ধিস্থাপনের,	সন্ধিস্থাপনের,	
dadapur,	দাদাপুরের,	দাদাপুর,	
gasthii,	গাস্থি,	গোষ্ঠীই,	
homeser,	হোমেসের,	হোমসের,	
laesensh,	লেসেন্স,	লাইসেন্স,	
chapal,	চাপাল,	চপল,	
tinhazar,	তিনহাজার,	তিনহাজার,	
bidhirnityang,	বিধির্নিত্যাং,	বিধির্নিত্যং,	
oedipus,	ওডিপাস,	ইডিপাস,	
saifullahil,	সাইফুল্লাহিল,	সাইফুল্লাহিল,	
murali,	মুরালি,	মুরলী,	
habsi,	হাবসি,	হাবশী,	
ponchashjon,	পঞ্চাশন,	পঞ্চাশজন,	
shommoteer,	শম্মটির,	সম্মতির,	
monur,	মনুর,	মনুর,	
songasthaner,	সং্গস্থানের,	সংস্থানের,	
ghurte,	ঘুরতে,	ঘুরতে,	
reshidensha,	রেশিদেনশা,	রেসিডেন্স,	
horiddar,	হরিদ্দার,	হরিদ্বার,	
yukeliptash,	যুকিলিপপ্ষা,	ইউক্যালিপ্টাস,	
audiotike,	অডিওটিকে,	অডিওটিকে,	
sommotitey,	সম্মতিতে,	সম্মতিতে,	
saazano,	সাজানো,	সাজানো,	
rajbandi,	রাজবন্দি,	রাজবন্দী,	
obhijojan,	অভিজোজন,	অভিযোজন,	
bhaibon,	ভাইবন,	ভাইবোন,	
thailandsaho,	থাইলান্ডসহ,	থাইল্যান্ডসহ,	
abdan,	আবদান,	আব্দান,	
elakaai,	এলাকাই,	এলাকাই,	
annorup,	অন্নরূপ,	অন্যরূপ,	
naazee,	নাজি,	নাত্সি,	
pranibigyani,	প্রাণীবিজ্ঞানী,	প্রাণীবিজ্ঞানী,	
gloria,	গ্লোরিয়া,	গ্লোরিয়া,	
ganoporibahon,	গণপরিবাহন,	গণপরিবহন,	
chalochchitrogulor,	চালচ্ছিত্রগুলোর,	চলচ্চিত্রগুলোর,	
balaruma,	বালারুমা,	বলরুম,	
salapheeta,	সালাফিটা,	সালফেট,	
zeebonto,	জীবন্ত,	জীবন্ত,	
indro,	ইন্দ্রো,	ইন্দ্র,	
dharmiyabhabei,	ধর্মিয়ভাবেই,	ধর্মীয়ভাবেই,	
kandy,	কান্ডি,	ক্যান্ডি,	
sift,	সিফ্ট,	শিফট,	
pathkrom,	পাঠক্রম,	পাঠক্রম,	
neelfamarir,	নিলফামারির,	নীলফামারীর,	
niroja,	নিরোজা,	নিরোজা,	
kaley,	কালে,	কালে,	
manibhaijaner,	মণিভাজেননের,	মণিভাইজানের,	
nobotom,	নবতম,	নবতম,	
rudiger,	রুদিগের,	রুদিগের,	
dibya,	দিব্য,	দিব্যা,	
poriikkhateo,	পরীক্ষাতেও,	পরীক্ষাতেও,	
bondiira,	বন্দীয়া,	বন্দীরা,	
batikromee,	বাতিক্রমী,	ব্যতিক্রমী,	
zonsa,	জোনসা,	জোন্স,	
lisense,	লিসেস্স,	লাইসেন্স,	
ingrejra,	ইংরেজরা,	ইংরেজরা,	
ghotaibe,	ঘটাইবে,	ঘটাইবে,	
mathews,	ম্যাথেস,	ম্যাথিউস,	
deciliter,	ডিসিলাইটের,	ডেসিলিটার,	
paab,	পাব,	পাব,	
machkabar,	মাচকাবার,	মাচকাবার,	
osamarik,	অসামারিক,	অসামরিক,	
shringey,	শ্রিগে,	শৃঙ্গে,	
ujobekeestan,	উজোবেকস্তান,	উজবেকিস্তান,	
onchalgulir,	অঞ্চালগুলির,	অঞ্চলগুলির,	
toki,	টকি,	তকি,	
zerusalemer,	জেরুসালেমের,	জেরুজালেমের,	
turista,	তুরিস্তা,	টুরিস্ট,	
kaferder,	কাফেরদের,	কাফেরদের,	
shiqara,	শিকারা,	শিকার,	
parq,	পার্ক,	পার্ক,	
ahalya,	আহাল্য,	অহল্যা,	
cholchhee,	চলচি,	চলছে,	
poddhotiteyi,	পদ্ধতিতেই,	পদ্ধতিতেই,	
ovidhanik,	অভিধানিক,	অভিধানিক,	
aosafur,	আইসফুর,	আওশাফুর,	
asaciates,	অ্যাসাসিয়াটস,	এসোসিয়েটস,	
starker,	স্টার্কের,	স্টার্কের,	
bulichev,	বুলিচেভ,	বুলিচেভ,	
parisankhanvid,	পরিসং্ণশবিদ,	পরিসংখ্যানবিদ,	
gostigulo,	গোস্টিগুলো,	গোষ্ঠীগুলো,	
tarkale,	তারকালে,	তারকালে,	
srisri,	শ্রীশরী,	শ্রীশ্রী,	
neemeette,	নিমুতে,	নিমিত্তে,	
ramzaner,	রামজানের,	রমযানের,	
sadeena,	সাদেনা,	সাডেন,	
keuoi,	কেওয়ো,	কেউই,	
nazad,	নাজাদ,	নজদ,	
armashtram,	আর্মশ্ত্রাম,	আর্মস্ট্রং,	
jibonnogor,	জীবন্যগর,	জীবননগর,	
ranangane,	রণঙ্গনে,	রণাঙ্গনে,	
jontropatigulite,	যন্ত্রপাতিগুলিতে,	যন্ত্রপাতিগুলিতে,	
oncolsoho,	অঙ্কলসহ,	অঞ্চলসহ,	
elahabade,	এলাহাবাদে,	এলাহাবাদে,	
cholochchitratike,	চলচ্চিত্রটিকে,	চলচ্চিত্রটিকে,	
philo,	ফিলো,	ফিলো,	
expreshshion,	এক্সপ্রেশন,	এক্সপ্রেশন,	
gonjona,	গঞ্জনা,	গঞ্জনা,	
abti,	আবটি,	আবতি,	
jaanar,	জানার,	জানার,	
delibhara,	দেলিভারা,	ডেলিভার,	
omanisa,	ওমানিসা,	অমানিশা,	
maladabha,	মালাদভা,	মলদোভা,	
bodna,	বোননা,	বদনা,	
raunanganey,	রানুঙ্গানে,	রণাঙ্গনে,	
nutaner,	নুতানের,	নূতনের,	
suparichito,	সুপারিচিত,	সুপরিচিত,	
heawy,	হুইভি,	হেভি,	
ceramicsh,	সেরামিক্স,	সিরামিকস,	
lat,	লাত,	লাট,	
rupantarer,	রূপান্তরের,	রুপান্তরের,	
shloker,	শ্লোকের,	শ্লোকের,	
graambaaseeo,	গ্রামবাসীও,	গ্রামবাসীও,	
orthanitir,	অর্থানীতির,	অর্থনীতির,	
byaktigotovabeo,	ব্যক্তিগতভাবেও,	ব্যাক্তিগতভাবেও,	
jonoikaa,	জনোকা,	জনৈকা,	
songrahak,	সংগ্রাহক,	সংগ্রাহক,	
spredsheet,	স্প্রেডশিট,	স্প্রেডশীট,	
shuri,	শুরি,	সুরি,	
porizoner,	পরিজোনের,	পরিজনের,	
eoki,	এইকি,	এওকি,	
teta,	তেট,	টেটা,	
dhaleshorii,	ধলেশরী,	ধলেশ্বরী,	
dibug,	দিবুগ,	ডিবাগ,	
samaveshke,	সমাভেশকে,	সমাবেশকে,	
ralf,	রালফ,	রালফ,	
deaubande,	ডিউবান্ডে,	দেওবন্দে,	
protisthar,	প্রতিষ্ঠার,	প্রতিষ্ঠার,	
kathghera,	কাঠখেরা,	কাঠঘেরা,	
hosney,	হোসন,	হোসনে,	
torkarite,	তরকারিতে,	তরকারিতে,	
madhumati,	মধুমতি,	মধুমতী,	
plate,	প্লেট,	প্লেট,	
drissogulo,	দৃশ্যগুলো,	দৃশ্যগুলো,	
songbadmadhyomer,	সংবাদমাধ্যমের,	সংবাদমাধ্যমের,	
kaloniir,	কালনীর,	কালনীর,	
osamanno,	ওসামান্য,	অসামান্য,	
rachonakal,	রচনাকাল,	রচনাকাল,	
impaction,	ইম্প্যাশশন,	ইমপ্যাকশন,	
moushum,	মৌশুম,	মৌসুম,	
marketing,	মার্কেটিং,	মার্কেটিং,	
saatzoner,	স্যাটজনের,	সাতজনের,	
ceramicer,	সেরামিসের,	সিরামিকের,	
maner,	মানের,	মানে,	
bike,	বিকে,	বাইক,	
hillse,	হিলসে,	হিলসে,	
panchashjon,	পঞ্চাশজন,	পঞ্চাশজন,	
jamjamat,	জমমজমত,	জমজমাট,	
tomader,	তোমাদের,	তোমাদের,	
purbancoler,	পূর্বাঞ্কলের,	পূর্বাঞ্চলের,	
chargar,	চারগর,	চার্জার,	
soundorjotakei,	সৌন্দর্যতাকেই,	সৌন্দর্যটাকেই,	
binakar,	বিনাকার,	বিনাকার,	
hooldim,	হোল্ডিং,	হোল্ডিং,	
sithilota,	সিথিলোটা,	শিথিলতা,	
manushe,	মানুষে,	মানুষে,	
mandape,	মণ্ডপে,	মন্ডপে,	
shikkharthirao,	শিক্ষার্থীরাও,	শিক্ষার্থীরাও,	
anagarikra,	অনাগারিকরা,	অনাগরিকরা,	
byepass,	ব্যাপেস,	বাইপাস,	
shilpajata,	শিল্পজাতা,	শিল্পজাত,	
raagei,	রাজেই,	রাগেই,	
santaa,	সান্টা,	সান্তা,	
bouddha,	বৌদ্ধ,	বৌদ্ধ,	
shakara,	শাকারা,	সাকার,	
shommotite,	ষম্মটিতে,	সম্মতিতে,	
bodhukeo,	বোধুকেও,	বধুকেও,	
seguloi,	সেগুলোই,	সেগুলোই,	
senabahinio,	সেনাবাহিনিও,	সেনাবাহিনীও,	
sanstha,	সানসাথা,	সংস্থা,	
bite,	বিতে,	বাইট,	
probhuder,	প্রভুদের,	প্রভুদের,	
jibanto,	জীবন্ত,	জীবন্ত,	
baipash,	বাইপাশ,	বাইপাস,	
ranangone,	রণনাঙ্গনে,	রণাঙ্গনে,	
arasie,	আরাসি,	আরসিএ,	
ajeem,	আজিম,	আজিম,	
sthapanar,	স্থাপানার,	স্থাপনার,	
sahozlabhbhatar,	সহজলভাভাতার,	সহজলভ্যতার,	
omkar,	ওমকার,	ওঙ্কার,	
peeri,	পিরি,	পেরি,	
kormyi,	কর্মী,	কর্মই,	
favorite,	ফ্যাভোরিতে,	ফেভারিট,	
nikate,	নিকাতে,	নিকটে,	
sofie,	সোফি,	সোফি,	
nirvachokder,	নির্ভাচকদের,	নির্বাচকদের,	
ghamtaa,	ঘামটা,	ঘোমটা,	
keu,	কেউ,	কেউ,	
blacker,	ব্ল্যাকের,	ব্ল্যাকের,	
baait,	বাইত,	বাইট,	
phuda,	ফুদা,	ফুড,	
bhebechili,	ভেবেছিলি,	ভেবেছিলি,	
neerbahe,	নির্বাহে,	নির্বাহে,	
aatmobishwasi,	আত্মবিশ্বাসী,	আত্মবিশ্বাসী,	
bagdad,	বাগদাদ,	বাগদাদে,	
beila,	বেইলা,	বেইলা,	
reflex,	রিফ্লেক্স,	রিফ্লেক্স,	
karmoi,	কর্ময়,	কর্মই,	
spredashiita,	স্প্রেদাশিটা,	স্প্রেডশীট,	
tukrote,	তুকরোতে,	টুকরোতে,	
gobeshonar,	গবেষণার,	গবেষনার,	
nothivukta,	নথিভুক্ত,	নথিভুক্ত,	
kheylechen,	খেয়েছেন,	খেলেছেন,	
augustine,	অগাস্টাইন,	অগাস্টিন,	
mirina,	মিরিনা,	মিরিনা,	
goodamjato,	গুদ়জমত,	গুদামজাত,	
ghotleyo,	ঘটলেও,	ঘটলেও,	
aholya,	আহল্যা,	অহল্যা,	
fimela,	ফিমেলা,	ফিমেল,	
carzar,	ক্যারজার,	চার্জার,	
charukala,	চারুকালা,	চারুকলা,	
gyandaas,	জ্ঞানদাস,	জ্ঞানদাস,	
firoze,	ফিরোজে,	ফিরোজ,	
chaudhurider,	চৌধুরীদের,	চৌধুরীদের,	
female,	ফেমালে,	ফিমেল,	
tukroke,	তুক্রকে,	টুকরোকে,	
talgach,	তালগাছ,	তালগাছ,	
maaktoome,	মাক্ুমে,	মাকতুম,	
shattoki,	শাত্তকি,	সাত্যকি,	
asbab,	আসবাব,	আসবাব,	
bhalobasar,	ভালোবাসার,	ভালোবাসার,	
mesenjarer,	মেসেঞজারের,	মেসেঞ্জারের,	
sambatsarkal,	সম্বাতসরকাল,	সম্বৎসরকাল,	
mukhomandal,	মুখমান্ডল,	মুখমণ্ডল,	
sarbhare,	সার্ভারে,	সার্ভারে,	
sqirt,	স্কাইট,	স্কার্ট,	
saptahokal,	সপ্তাহকাল,	সপ্তাহকাল,	
kotibondhe,	কতিবন্ধে,	কটিবন্ধে,	
manjushri,	মঞ্জুষ্রী,	মঞ্জুশ্রী,	
dharmantor,	ধর্মন্তর,	ধর্মান্তর,	
otyacharito,	অত্যাচারিত,	অত্যাচারিত,	
kyatgarite,	ক্যাটগারিতে,	ক্যাটগারিতে,	
matrirup,	মাতৃরূপ,	মাতৃরূপ,	
mehsus,	মেহসস,	মেহসুস,	
mozlis,	মজলিস,	মজলিশ,	
scholarship,	স্কলারশিপ,	স্কলারশিপ,	
booroon,	বুরুন,	বোরন,	
sponsorshipe,	স্পন্সর্শপে,	স্পন্সরশীপে,	
tintir,	তিনটির,	তিনটির,	
ddheela,	ঢেলা,	ঢিলা,	
jibnagore,	জীবনাগরে,	জীবননগর,	
nutunotto,	নুতুনত্ব,	নতুনত্ব,	
bhadaka,	ভদ়াকা,	ভদকা,	
gajetted,	গাজেত্দ,	গেজেটেড,	
edmiral,	এদমিরাল,	এডমিরাল,	
mukhomandaley,	মুখমান্ডলে,	মুখমণ্ডলে,	
drissoke,	দৃর্সকে,	দৃশ্যকে,	
sanghatakder,	সংঘাৎকদের,	সংঘটকদের,	
shhepha,	শেফা,	শেফ,	
ghumacchilo,	ঘুমাচ্ছিল,	ঘুমাচ্ছিল,	
bhotomulyoke,	ভোটমূল্যকে,	ভোটমূল্যকে,	
koordira,	কুর্দিরা,	কুর্দিরা,	
calabe,	কালাবে,	চালাবে,	
adhyatmik,	আধ্যাতমিক,	আধ্যাত্মিক,	
pratisthanikvabe,	প্রতিষ্ঠানিকভাবে,	প্রাতিষ্ঠানিকভাবে,	
jaadrel,	জাদরেল,	জাঁদরেল,	
hajeerhatt,	হাজিরহাট্ট,	হাজিরহাট,	
siddharther,	সিদ্ধার্থের,	সিদ্ধার্থের,	
ponjikar,	পঞ্জিকর,	পঞ্জিকার,	
chetanagato,	চেতনাগত,	চেতনাগত,	
rifleksa,	রিফ্লেক্সা,	রিফ্লেক্স,	
engreziteo,	এনরেজিতেও,	ইংরেজিতেও,	
langhangulir,	লঙ্গাংগুলির,	লঙ্ঘনগুলির,	
ekirokom,	একিরকম,	একইরকম,	
phonekari,	ফোনেকারি,	ফোনকারী,	
prasadhani,	প্রসাধনী,	প্রসাধনী,	
choson,	চোসন,	চোষণ,	
lutheerana,	লুথেরানা,	লুথেরান,	
nimnosakkharkari,	নিম্নপাককাক্রারী,	নিম্নস্বাক্ষরকারী,	
kyathlik,	ক্যালথিক,	ক্যাথলিক,	
gemske,	গেমসকে,	জেমসকে,	
artore,	আরতোরে,	আর্টরে,	
arke,	আরকে,	আরকে,	
shhashtra,	শাষ্ট্রা,	শাস্ত্র,	
milayatane,	মিলায়াতনে,	মিলায়তনে,	
gorrer,	গোরের,	গোরের,	
punosthaner,	পুনস্থানের,	পুনঃস্থানের,	
prokolpow,	প্রকল্পফু,	প্রকল্পও,	
injiniyarim,	ইনজিিনিয়ারিম,	ইঞ্জিনিয়ারিং,	
popke,	পপকে,	পোপকে,	
diiptii,	দীপটিই,	ডেপুটি,	
uindoos,	উইন্ডুস,	উইন্ডোস,	
sarboshokteeman,	সর্বশক্তিমান,	সর্বশক্তিমান,	
jatinkey,	জাতিনকে,	যতীনকে,	
bouddho,	বৌদ্ধ,	বৌদ্ধ,	
sangharshik,	সংঘর্শিক,	সাংঘর্ষিক,	
tasminer,	তাসমিনের,	তাসমিনের,	
bolvodro,	বলভদ্র,	বলভদ্র,	
with,	উইথ,	ভিত,	
bhoutikeshu,	ভৌতিকেষু,	ভৌতিকেষু,	
spancer,	স্প্যান্সের,	স্পেন্সার,	
kaande,	কান্ডে,	কাণ্ডে,	
talaa,	তালা,	তালা,	
torunosomriddho,	তরুণসমৃদ্ধ,	তরুণসমৃদ্ধ,	
sthaponagulor,	স্থাপনাগুলোর,	স্থাপনাগুলোর,	
baman,	বামান,	বামন,	
landey,	ল্যান্ডি,	ল্যান্ডে,	
bisnuke,	বিস্নুকে,	বিষ্ণুকে,	
taderek,	তাদেরেক,	তাদেরেক,	
basturoi,	বাস্তুরই,	বস্তুরই,	
sangkoolan,	সংকুলান,	সংকুলান,	
nisshongotake,	নিঃসংগতাকে,	নিঃসঙ্গতাকে,	
nikela,	নিকেলা,	নিকেল,	
hoteltee,	হোটেলটি,	হোটেলটি,	
trutimatra,	ত্রুতিমাত্র,	ত্রুটিমাত্র,	
futonta,	ফুটনটা,	ফুটন্ত,	
baasaate,	বাসাতে,	বাসাতে,	
taunship,	তৌনশীপ,	টাউনশিপ,	
armshtronj,	আর্মস্ট্রজ,	আর্মস্ট্রং,	
badargaji,	বদরগাজী,	বদরগাজী,	
rabo,	রাবো,	রব,	
bisshas,	বিশবাস,	বিশ্বাস,	
jumlalancer,	জুমলাযান্সের,	জুমলাল্যান্সার,	
olympik,	অলিমপিক,	অলিম্পিক,	
windos,	উইন্ডসহ,	উইন্ডোস,	
arg,	আরগি,	আর্গ,	
rakkhanbhag,	রক্ষণভাগ,	রক্ষণভাগ,	
romnar,	রোমনার,	রমনার,	
oncholke,	অঞ্চলকে,	অঞ্চলকে,	
siropa,	সিরোপা,	শিরোপা,	
rakim,	রাকিম,	রাকিম,	
aajeej,	আজেজ,	আজিজ,	
graambasheeo,	গ্রামবশীও,	গ্রামবাসীও,	
langhaner,	লঙ্ঘানের,	লংঘনের,	
si,	সিও,	এসআই,	
thechar,	থেচার,	থ্যাচার,	
unchuporjayer,	উঁচুপরজায়ের,	উঁচুপর্যায়ের,	
toptoshele,	তপ্তশেলে,	তপ্তশেলে,	
juboksoho,	যুবকসহ,	যুবকসহ,	
koreempoor,	করিমপুর,	করিমপুর,	
rushad,	রুশাদ,	রুশদ,	
chrystal,	ক্রিস্টাল,	ক্রাইস্টাল,	
install,	ইনস্টাল,	ইন্সটল,	
chalochchitrei,	চালচ্ছিত্রেই,	চলচ্চিত্রেই,	
khudrokar,	ক্ষুদ্রকার,	ক্ষুদ্রকার,	
bohudin,	বহুদিন,	বহুদিন,	
sangkalanti,	সংকলন্তি,	সংকলনটি,	
torabgonj,	তরাবগঞ্জ,	তোরাবগঞ্জ,	
asif,	আসিফ,	আসিফ,	
narsaari,	নরসারী,	নার্সারি,	
felto,	ফেল্টো,	ফেলত,	
poscime,	পশ্চিমে,	পশ্চিমে,	
ovidhaner,	অভিধানের,	অভিধানের,	
sanaktokaron,	সানক্তকারণ,	সনাক্তকরণ,	
biswashi,	বিশ্বশী,	বিশ্বাসী,	
satarkokari,	সতর্ককারী,	সতর্ককারী,	
naneer,	নানীর,	নানীর,	
baibosthar,	বৈবস্থার,	ব্যবস্থার,	
thaii,	থাই,	থাই,	
dekhso,	দেখসো,	দেখসো,	
cholochchitro,	চলচ্চিত্র,	চলচ্চিত্র,	
jewellery,	জিওলারলি,	জুয়েলারির,	
jaandrel,	যান্দ্রেল,	জাঁদরেল,	
ramonar,	রামোনার,	রমনার,	
treebhuj,	ত্রিভূজ,	ত্রিভূজ,	
shef,	শেফ,	শেফ,	
vaider,	ভাইদের,	ভাইদের,	
khonjena,	খোঁজেনা,	খোঁজেনা,	
bosturoi,	বস্তুরই,	বস্তুরই,	
jeebonnogor,	জীবন্নগর,	জীবননগর,	
nehle,	নেহলে,	নেহলে,	
alaol,	অ্যালাওল,	আলাওল,	
shishupalgarh,	শিশুপল্লগ,	শিশুপালগড়ে,	
croak,	ক্রোক,	ক্রোক,	
dep,	ডেপ,	ডেপ,	
koruna,	করুনা,	করুণা,	
erythrian,	এরিথ্রিয়ান,	এরিথ্রিয়ান,	
poschime,	পশ্চিমে,	পশ্চিমে,	
bisheshya,	বিশেষ্য,	বিশেষ্য,	
nodimatrik,	নদিমাত্রিক,	নদীমাতৃক,	
parswer,	পারস্বের,	পার্শ্বের,	
dadar,	দাদার,	দাদার,	
militarite,	মিলিটারিতে,	মিলিটারিতে,	
dijijer,	দিজিজের,	ডিজিজের,	
safin,	সাফিন,	সাফিন,	
ikbaaler,	ইকবালের,	ইকবালের,	
swostir,	স্বস্তির,	স্বস্তির,	
gajano,	গাজনো,	গজানো,	
pinogbagke,	পিনোগবাগকে,	পিনগবাগকে,	
asociatis,	অসোিজেযাটিস,	এসোসিয়েটস,	
dhani,	ধানী,	ধানি,	
diznee,	দিজনি,	ডিজনী,	
deep,	ডীপ,	দীপ,	
gujab,	গুজাব,	গুজব,	
parshwer,	পার্শ্বের,	পার্শ্বের,	
transformaarer,	ট্রান্সফররারের,	ট্রান্সফরমারের,	
aviyojan,	অভিযোজন,	অভিযোজন,	
jacksoner,	জ্যাকসনের,	জ্যাকসনের,	
ul,	উল্,	উল,	
neerbachoker,	নির্বাচকের,	নির্বাচকের,	
stanahenja,	স্তনােঞ্জে,	স্টোনহেঞ্জ,	
crucer,	ক্রুসের,	ক্রুশের,	
porirshoder,	পরিষ্দদের,	পরির্ষদের,	
boikalyo,	বৈকল্য,	বৈকল্য,	
balakarak,	বালাকারক,	বলকারক,	
prakare,	প্রকরে,	প্রকারে,	
tookror,	টুকর,	টুকরোর,	
bharotiyotar,	ভারতিয়তার,	ভারতীয়তার,	
taposgoner,	তাপসগণের,	তাপসগণের,	
siddhantei,	সিদ্ধান্তেই,	সিদ্ধান্তেই,	
amiretus,	অ্যামেরিটাস,	এমিরেটাস,	
tongaa,	টোঙ্গা,	টোঙ্গা,	
antarctica,	অ্যান্টার্কটিকা,	অ্যান্টার্কটিকা,	
showtey,	শতুয়ে,	শোতে,	
slatgulor,	স্ল্যাটগুলোর,	স্ল্যাটগুলোর,	
jens,	জেন্স,	জিন্স,	
brittakare,	বৃত্তকরে,	বৃত্তাকারে,	
xpose,	ক্সপ্যস,	এক্সপোজ,	
dalee,	ডালি,	ডালে,	
mmadhukkori,	মম্ধুককরী,	মাধুকরী,	
purple,	পার্পল,	পার্পেল,	
jarmaniteo,	জরমানিতেও,	জার্মানিতেও,	
obharbhiu,	ওভারভুউ,	ওভারভিউ,	
krisenter,	ক্রিসেন্টের,	ক্রিসেন্টের,	
dianes,	ডায়েনস,	ডিএনএস,	
pothnirdeshona,	পথনির্দেশনা,	পথনির্দেশনা,	
samaptir,	সমাপ্তির,	সমাপ্তির,	
pooshti,	পুষ্টি,	পুষ্টি,	
plusey,	প্লাসে,	প্লাসে,	
torutoler,	তরুতলের,	তরুতলের,	
akhandata,	অখণ্ডতা,	অখণ্ডতা,	
jamkaalo,	জামকালো,	জমকালো,	
cheenja,	চেঞ্জা,	চেঞ্জ,	
mulyayonsapekkhe,	মূল্যায়সানেষ্ট্ক,	মূল্যায়নসাপেক্ষে,	
antercticker,	অ্যান্টার্টিকের,	অ্যান্টার্কটিকের,	
karlei,	কারলেই,	করলেই,	
abhiyojan,	অভিযযজন,	অভিযোজন,	
ghoomachhe,	ঘুমাচে,	ঘুমাচ্ছে,	
recondishon,	রেকন্ডিশন,	রিকন্ডিশন,	
adhyattikota,	আধ্যাত্মিকতা,	আধ্যাত্মিকতা,	
gej,	গেজ,	গেজ,	
shuchonakal,	শুচনাকাল,	সূচনাকাল,	
superheiroo,	সুপারহেরেও,	সুপারহিরো,	
shiropar,	শিরোপার,	শিরোপার,	
tigmanshu,	তিজমানশু,	তিগ্মাংশু,	
balabhadra,	বলভাদ্র,	বলভদ্র,	
tophaat,	টোফাত,	তফাৎ,	
ghotol,	ঘটল,	ঘটল,	
feroza,	ফেরোজা,	ফিরোজা,	
purushika,	পুরুষিকা,	পুরুষিকা,	
bashoborty,	বাশবর্তী,	বশবর্তী,	
shangsthaner,	শাংস্থানের,	সংস্থানের,	
israelbahini,	ইসরাাবেবাহিনী,	ইস্রায়েলবাহিনী,	
angsogrohone,	অংসগ্রহণে,	অংশগ্রহনের,	
ghumachchila,	ঘুমাচ্ছিলা,	ঘুমাচ্ছিল,	
naraphoka,	নারফোকা,	নরফোক,	
rijoor,	রিজুর,	রিজুর,	
milekhanek,	মিলেখানেক,	মাইলখানেক,	
standards,	স্ট্যান্ডার্ডসহ,	স্টান্ডার্ডস,	
brixfield,	ব্রিক্সিল্ড,	ব্রিক্সফিল্ড,	
saom,	সাওম,	সাওম,	
kaalki,	কালকি,	কালকি,	
rakshanbhag,	রক্ষণভাগ,	রক্ষণভাগ,	
jwar,	জ্বার,	জ্বর,	
naabyota,	নাব্যতা,	নাব্যতা,	
aairish,	আইরিশ,	আইরিস,	
bufer,	বুফার,	বাফার,	
platform,	প্ল্যাটফর্ম,	প্লাটফর্ম,	
tistar,	তিস্তার,	তিস্তার,	
shnaipara,	শ্নাইপার,	স্নাইপার,	
mukharji,	মুখার্জী,	মুখার্জী,	
modelgulo,	মডেলগুলো,	মডেলগুলো,	
laiseensee,	লেসিস্সি,	লাইসেন্স,	
prothar,	প্রথার,	প্রথার,	
pratisthanik,	প্রতিস্থানিক,	প্রাতিষ্ঠানিক,	
maunchostho,	মঞ্চস্থ,	মঞ্চস্থ,	
nirbahey,	নির্বাহে,	নির্বাহে,	
caramiks,	ক্যারামিক্স,	সিরামিকস,	
khoor,	খুর,	ক্ষুর,	
langhoner,	লঙ্ঘনের,	লংঘনের,	
patengar,	পাটেঙ্গার,	পতেঙ্গার,	
vagni,	ভাগনি,	ভগ্নী,	
tintikey,	তিনটিকে,	তিনটিকে,	
addabaj,	আদ্দাবাজ,	আড্ডাবাজ,	
bhittimul,	ভিত্তিমূল,	ভিত্তিমূল,	
bhabarlaler,	ভবরলালের,	ভবরলালের,	
shahidputra,	শহিদপুত্র,	শহীদপুত্র,	
bulano,	বুলানো,	বুলান,	
elbamtite,	এলবামটিতে,	এলবামটিতে,	
tukroti,	তুকরোটি,	টুকরোটি,	
nothivuktir,	নথিভুক্তির,	নথিভুক্তির,	
protul,	প্রতুল,	প্রতুল,	
swadesh,	স্বদেশ,	স্বদেশ,	
bhujangta,	ভুজংটা,	ভুজঙ্গটা,	
tonoo,	টনু,	তনু,	
modele,	মডেলে,	মডেলে,	
dobhara,	দোভারা,	ডোভার,	
mithener,	মিথেনের,	মিথেনের,	
masto,	মাস্টো,	মাস্ত,	
chorban,	চোরবান,	চর্বন,	
gingbhalobasen,	জিনবালবাসেন,	গিংভালোবাসেন,	
jor,	জর,	জ্বর,	
horash,	হোরাশ,	হোরাস,	
adwanced,	অ্যাডবান্সড,	অ্যাডভান্সড,	
ernad,	এরনাড,	এরনাড,	
temanti,	তেমন্টি,	তেমনটি,	
osthisondhi,	অস্থিসন্ধি,	অস্থিসন্ধি,	
chirkoot,	চিরকুট,	চিরকুট,	
lakkhero,	লক্ষেরও,	লক্ষেরও,	
sahooseekotar,	সহুশকতার,	সাহসিকতার,	
overholing,	ওভারহোলিং,	ওভারহোলিং,	
ramantika,	রমণ্টিকা,	রোমান্টিক,	
lutherana,	লুথেরানা,	লুথেরান,	
akhhunno,	আখুন্ন,	অক্ষুণ্ণ,	
muchlima,	মুছলিমা,	মুছলিমা,	
somoibo,	সমৈবো,	সমৈব,	
ramolino,	রমোলিনো,	রামোলিনো,	
shucharita,	শুচরিতা,	সুচরিতা,	
phormat,	ফরমাত,	ফরম্যাট,	
arshie,	আরশি,	আরসিএ,	
ghuznavi,	ঘুজনাভি,	গজনভি,	
fishing,	ফিশিং,	ফিসিং,	
bujhtepari,	বুঝতেপারি,	বুঝতেপারি,	
audioguloke,	অডিওগুলোকে,	অডিওগুলোকে,	
weelcomee,	উইলকমি,	ওয়েলকাম,	
joisttho,	যৈষ্ঠ,	জ্যৈষ্ঠ,	
nyeta,	ন্যাটা,	ম্যাট,	
oojbekistan,	ঔজবেকিস্তান,	উজবেকিস্তান,	
chhanada,	ছানাদা,	ছানাদা,	
pratijogider,	প্রতিযোগীদের,	প্রতিযোগীদের,	
karim,	কারিম,	করিম,	
chiroharit,	চিরোহারিত,	চিরহরিৎ,	
gavaskar,	গাভাস্কার,	গাভাস্কার,	
kidambi,	কিদম্বি,	কিদম্বি,	
kormobuddhite,	কর্মবুদ্ধিতে,	কর্মবুদ্ধিতে,	
licencedhari,	লাইসেন্সধারী,	লাইসেন্সধারী,	
america,	আমেরিকা,	আমেরিকা,	
syfy,	সাইফি,	সাইফাই,	
shakankti,	শকানকটি,	শকাঙ্কটি,	
shourshe,	শরুষে,	সোর্স,	
shangkalonti,	শংকলন্টি,	সংকলনটি,	
ved,	ভেড,	বেদ,	
stagecraft,	স্টেগটাক্র্যাফ্ট,	স্টেজক্রাফট,	
pyaleshtainer,	প্যালেশটেইনের,	প্যালেস্টাইনের,	
shoori,	শূরী,	সুরি,	
baieq,	বেইক,	বাইক,	
rayyaleti,	রায়য়েলেতি,	রয়্যালটি,	
prodiiper,	প্রদিইপের,	প্রদীপের,	
tachnach,	তাচনাচ,	তছনছ,	
mookhomaundoler,	মুখমাউন্ডলের,	মুখমণ্ডলের,	
naajii,	নাজি,	নাত্সি,	
manir,	মানির,	মনির,	
polashir,	পলাশির,	পলাশীর,	
lyaanding,	ল্যান্ডিং,	ল্যান্ডিং,	
sikkhagata,	শিক্ষাগত,	শিক্ষাগত,	
sharoker,	শারোকের,	স্মারকের,	
agamane,	আগামানে,	আগমনে,	
byabaharkariderke,	ব্যবহারকারীদেরকে,	ব্যবহারকারীদেরকে,	
dhos,	ধয়স,	ধস,	
janar,	জানার,	জানার,	
bibhinno,	বিভিন্ন,	বিভন্ন,	
carloos,	কার্লোস,	কার্লোস,	
tunaita,	তুনাইটা,	টুনাইট,	
jalarong,	জালারং,	জলরঙ,	
navaratri,	নবরাত্রী,	নবরাত্রি,	
bahubar,	বাহুবার,	বহুবার,	
tapdei,	তাপদেই,	তাপড়েই,	
konroop,	কনরুপ,	কোনরূপ,	
prakalpatike,	প্রকললপতিকে,	প্রকল্পটিকে,	
biplabee,	বিপ্লবী,	বিপ্লবী,	
gara,	গারা,	গোর,	
dephinishion,	ডিফিশিনন,	ডেফিনেশন,	
choudhurike,	চৌধুরীকে,	চৌধুরীকে,	
paadee,	পদী,	পাড়ে,	
alpo,	অল্প,	অল্প,	
heepatitis,	হেপাটিটিস,	হেপাটাইটিস,	
ritesh,	রিটেশ,	রিতেশ,	
drissogoolote,	দৃশ্যগুলোতে,	দৃশ্যগুলোতে,	
khude,	খুদে,	ক্ষুদে,	
ardasho,	আরদাশো,	আর্দশ,	
hisabagyan,	হিসাবাগ্ঞান,	হিসাবজ্ঞান,	
chanoo,	চানু,	চানু,	
kirti,	কিরটি,	কীর্তি,	
naper,	নাপের,	ন্যাপের,	
byabaharkaree,	ব্যবহারকারী,	ব্যবহারকারী,	
taitela,	তাইতেলা,	টাইটেল,	
fevarite,	ফেভারিতে,	ফেভারিট,	
madhuri,	মধুরি,	মাধুরী,	
naagaalyand,	নাগাল্যান্ড,	নাগাল্যান্ড,	
rastagulikeo,	রাস্তাগুলিকেও,	রাস্তাগুলিকেও,	
bajpa,	বাজপা,	বাজপা,	
chinto,	চিন্তো,	চিনতো,	
grambaseer,	গ্রামবাসীর,	গ্রামবাসীর,	
godabari,	গোদাবারী,	গোদাবরী,	
monjooshree,	মনজুশ্রী,	মঞ্জুশ্রী,	
jyaqa,	জ্যাক,	জ্যাক,	
terlarang,	তেরারাং,	তেরলারং,	
senabahinikey,	সেনাবাহিনীকে,	সেনাবাহিনীকে,	
shudhir,	শুধির,	শুধীর,	
robot,	রোবট,	রোবোট,	
choopi,	চুপি,	চুপি,	
bage,	বাগে,	বাগে,	
susamo,	সুসমো,	সুসম,	
bahati,	বাহাটি,	বাহাতি,	
vesselli,	শেসেলি,	ভেসেলি,	
prokolpogulor,	প্রকল্পগুলোর,	প্রকল্পগুলোর,	
assexe,	এসেেক্সে,	অ্যাসেক্সে,	
pachak,	পাচক,	পাচক,	
shipley,	শিপলি,	শিপলে,	
nodimaatrik,	নদিমাত্রিক,	নদীমাতৃক,	
sahojlovyotar,	সহজলজ্বলতার,	সহজলভ্যতার,	
goshthiti,	গোষ্ঠিটি,	গোষ্ঠীটি,	
siqhar,	সিখার,	শিকার,	
akhandota,	অখন্ডতা,	অখণ্ডতা,	
aalkaatra,	আলকাত্র,	আলকাতরা,	
basakey,	বাসাকে,	বাসাকে,	
horas,	হোরাস,	হোরাস,	
korley,	কর্লে,	করলে,	
meloonborroner,	মেলুনবর্ণণের,	মেলবোর্নের,	
nederlande,	নেডারল্যান্ডে,	নেদারল্যান্ডে,	
tolemyr,	টলেমির,	টলেমির,	
kleentoner,	ক্লিনটনের,	ক্লিনটনের,	
ganochin,	গণচিন,	গণচীন,	
poderthobid,	পদের্থবিদ,	পদার্থবিদ,	
mandondo,	মান্দন্ড,	মানদণ্ড,	
prakalpoguli,	প্রকালপোগুলি,	প্রকল্পগুলি,	
sangitanusthane,	সঙ্গীতানস্থানে,	সঙ্গীতানুষ্ঠানে,	
probhura,	প্রভুরা,	প্রভুরা,	
graambashee,	গ্রামবাশী,	গ্রামবাসী,	
turkeyder,	তুর্কেদের,	তুর্কিদের,	
rohasyer,	রোহস্যের,	রহস্যের,	
govindarajan,	গোবিন্দরাজন,	গোবিন্দরাজন,	
juktorastrer,	যুক্তরাস্ত্রের,	যুক্তরাষ্ট্রের,	
rajbandir,	রাজবন্দির,	রাজবন্দীর,	
segulo,	সেগুলো,	সেগুলো,	
ishtone,	ইস্টোন,	স্টোন,	
cheerokoomari,	চিরকুমারি,	চিরকুমারী,	
kaansaat,	কানসাট,	কানসাট,	
mahasava,	মহাসাভা,	মহাসভা,	
aamor,	আমর,	আমর,	
mahbunur,	মহাবুনুর,	মাহবুনুর,	
aagera,	আগেরা,	আগোরা,	
swarther,	স্বার্থের,	স্বার্থের,	
pnouchute,	পৌঁচুতে,	পৌঁছুতে,	
mosjidtir,	মসজিদটির,	মসজিদটির,	
nikote,	নিকোতে,	নিকটে,	
korijachilen,	করিজাছিলেন,	করিযাছিলেন,	
prasadhoni,	প্রসাধনী,	প্রসাধনী,	
karmokarke,	কর্মকারকে,	কর্মকারকে,	
dantahin,	দন্তাহীন,	দন্তহীন,	
hosto,	হস্ত,	হস্ত,	
turbine,	টারবিন,	টারবাইন,	
hood,	হুড,	হুড,	
omarader,	ওমারাদের,	ওমারাদের,	
elaakati,	এলাকাটি,	এলাকাটি,	
hindutirtha,	হিন্দুতির্থ,	হিন্দুতীর্থ,	
sahittopritite,	সাহিত্যপৃতিতে,	সাহিত্যপ্রীতিতে,	
mane,	মানে,	মানে,	
shikhra,	শিখরা,	শিখরা,	
pingna,	পিংংা,	পিংনা,	
catholicder,	ক্যাথলিকদের,	ক্যাথলিকদের,	
tokee,	টকক,	তকি,	
dibet,	দিবেত,	ডিবেট,	
bonorajite,	বনরাজিতে,	বনরাজিতে,	
aakaabaar,	আকাবার,	আকাবার,	
jyesttha,	জ্যেস্ঠা,	জ্যেষ্ঠা,	
boshoborti,	বশবর্তী,	বশবর্তী,	
shahjapur,	শাহজাপুর,	শাহজাপুর,	
bhorkendra,	ভর্কেন্দ্র,	ভরকেন্দ্র,	
kakhnoba,	কখ্নবা,	কখনওবা,	
golimodhye,	গোলিমঝ্যে,	গলিমধ্যে,	
uddhrito,	উদ্ধৃত,	উদ্ধৃত,	
inziniyarsa,	ইনজিনায়ার্সা,	ইঞ্জিনিয়ার্স,	
somraatder,	সম্রাতদের,	সম্রাটদের,	
chirkut,	চিরকুট,	চিরকুট,	
rakhtokkharoner,	রাখতাক্রণণের,	রক্তক্ষরণের,	
kormoke,	কর্মকে,	কর্মকে,	
miitar,	মিইতার,	মিত্র,	
doorotaumo,	দূরতাউমো,	দূরতম,	
gaje,	গাজে,	গেজ,	
marmader,	মারমাদের,	মারমাদের,	
baibasthaar,	বৈবশ্থার,	ব্যবস্থার,	
durgotsabe,	দুর্গোৎসবে,	দুর্গোৎসবে,	
jitpur,	জিতপুরের,	জিতপুরের,	
ancholsaha,	অঞ্চলসহ,	অঞ্চলসহ,	
chemjong,	চেমজং,	চেমজং,	
amor,	আমোর,	আমর,	
khuizza,	খুইজ্জা,	খুইজ্জা,	
bouddher,	বৌদ্ধের,	বৌদ্ধের,	
ghatiti,	ঘাটিটি,	ঘাঁটিটি,	
deepan,	দীপান,	দীপন,	
dipti,	দীপ্তি,	ডেপুটি,	
antarbhutto,	অন্তর্ভূত্ত,	অন্তর্ভুক্ত,	
ancholtike,	অ্যাংকোলটিকে,	অঞ্চলটিকে,	
jiland,	জিল্যান্ড,	জিল্যান্ড,	
shurugulo,	শুরুগুলো,	শুরুগুলো,	
pariyech,	পারিয়েছ,	পরিয়েছ,	
uter,	উউটের,	উটের,	
tolemy,	টলেমি,	টলেমির,	
satarkabhabe,	সতর্কভাবে,	সতর্কভাবে,	
nirikhe,	নিরিখে,	নিরিখ,	
shakar,	শাকার,	সকার,	
deil,	ডেইল,	ডেইল,	
hepatetisa,	হেপাটেটিসা,	হেপাটাইটিস,	
dhyana,	ধ্যানা,	ধ্যান,	
summer,	সুম্র,	সামার,	
teksuser,	টেকসিউসের,	টেক্সাসের,	
shiulijhra,	শিউলিঘরা,	শিউলিঝরা,	
bhromonkaale,	ভ্রমণকালে,	ভ্রমণকালে,	
ghumachche,	ঘুমাচ্ছে,	ঘুমাচ্ছে,	
smarak,	স্মারক,	স্মারক,	
fitarsaho,	ফিতারসহ,	ফিতরসহ,	
baugey,	বাউগে,	বাগে,	
moreecha,	মরিছা,	মরিচা,	
postac,	পোস্টাক,	পোস্টকে,	
canservatian,	ক্যানাারভেটিন,	কনসারভেশন,	
sampadoner,	সম্পাদনের,	সম্পাদনের,	
bo,	ইয়ো,	বু,	
protectionism,	প্রোটকন্সিসম,	প্রোটেকশনিজম,	
talaal,	তালাল,	তালাল,	
probhur,	প্রভুর,	প্রভুর,	
cuti,	কুটি,	কিউটি,	
jegulur,	যেগুলুর,	যেগুলুর,	
sobrakamer,	সব্রাকমের,	সবরকমের,	
noitik,	নৈতিক,	নৈতিক,	
vogno,	ভগ্ন,	ভগ্ন,	
srichoitonnodeb,	শ্রীচৈতন্যদেব,	শ্রীচৈতন্যদেব,	
noteti,	নোটেটি,	নোটটি,	
liseensee,	লাসিস্সি,	লাইসেন্স,	
shandra,	শান্দ্রা,	শান্দ্রার,	
kortam,	করতাম,	করতাম,	
sumi,	সুমি,	সুমি,	
cheentaikaree,	চেন্তাইকরি,	ছিনতাইকারী,	
scholarsip,	স্কলারশিপ,	স্কলারশিপ,	
dera,	দের,	ডেরা,	
azijer,	আজিজের,	আজিজের,	
wodka,	ওয়াককা,	ভদকা,	
engrejra,	এংরেজরা,	ইংরেজরা,	
torikher,	তরিখের,	তরিখের,	
pakistanira,	পাকিস্তানিরা,	পাকিস্তানীরা,	
hingsar,	হিংসার,	হিংসার,	
kommandar,	কম্মান্ডার,	কমাণ্ডার,	
path,	প্যাথ,	পাথ,	
engrejer,	এংরেজের,	ইংরেজের,	
turbiner,	টারবিনের,	টারবাইনের,	
erajyobasi,	এরাজ্জবাসী,	এরাজ্যবাসী,	
atibiplabi,	অতিবিপ্লবি,	অতিবিপ্লবি,	
taunasipa,	তৌনসিপা,	টাউনশিপ,	
liceensee,	লাইসিস্সি,	লাইসেন্স,	
simaa,	সীমা,	সীমা,	
armeenian,	আর্মিনিয়ান,	আর্মেনিয়ান,	
madhobi,	মাধবী,	মাধবী,	
uporzon,	উপরজন,	উপার্জন,	
medilek,	মেডিলেক,	মেডিলেক,	
sobche,	সবচে,	সবচে,	
ekhate,	এখাতে,	একহাতে,	
kusumeshu,	কুসুমেশু,	কুসুমেষু,	
conservetion,	কনজারভেশন,	কনসারভেশন,	
rupert,	রুপার্ট,	রুপার্ট,	
ajuhath,	অজুহাথ,	অজুহাত,	
koota,	কোটা,	কোটা,	
ekspression,	এক্সপ্রেশন,	এক্সপ্রেশন,	
rilayensa,	রিলায়েনস,	রিলায়েন্স,	
chuti,	চুটি,	ছুটি,	
juktarashtrasaha,	যুক্তারস্ত্রসহ,	যুক্তরাষ্ট্রসহ,	
gandagol,	গান্ডাগোল,	গন্ডগোল,	
bhabaponno,	ভাবান্য,	ভাবাপন্ন,	
conflict,	কনফ্লিক্ট,	কনফ্লিক্ট,	
as,	ওসে,	অস,	
palbongser,	পালবংসের,	পালবংশের,	
jani,	জানি,	জনি,	
anyarup,	অন্যরূপ,	অন্যরূপ,	
bidyadanke,	বিদ্যাদানকে,	বিদ্যাদানকে,	
neutrinoo,	নিউট্রিনো,	নিউট্রিনো,	
pyatarne,	প্যাটরেন,	প্যাটার্নে,	
bihar,	বিহার,	বিহার,	
sorting,	সর্টিং,	সর্টিং,	
kada,	কাদা,	কোডা,	
enginiiring,	ইঞ্জিনিয়ারিং,	ইঞ্জিনিয়ারিং,	
munim,	মুনিম,	মুনিম,	
eupheike,	ইউফেকে,	ইউফেইকে,	
agomoney,	আগোমেন,	আগমনে,	
golghare,	গোলঘরে,	গোলঘরে,	
aswasteekor,	অস্বস্তিকির,	অস্বস্তিকর,	
hizrite,	হিজরিতে,	হিজরীতে,	
nirmankarmisaha,	নির্মণমর্মীসহ,	নির্মাণকর্মীসহ,	
nariderke,	নারীদেরকে,	নারিদেরকে,	
arthonitir,	অর্থনীতির,	অর্থনীতির,	
messengerer,	মেসেনগ্রের,	মেসেঞ্জারের,	
corymb,	কররিম্ব,	করিম,	
ishton,	ইস্টন,	স্টোন,	
irish,	ইরিশ,	আইরিস,	
bhandti,	ভান্ডটি,	ভাণ্ডটি,	
antarvuktimulak,	অন্তর্ভুতিকুলক,	অন্তর্ভুক্তিমূলক,	
sures,	সুরেস,	সুরেশ,	
ankanshilpe,	অঙ্কনশিল্পে,	অঙ্কনশিল্পে,	
machgulo,	মাছগুলো,	মাছগুলো,	
nagorikderkey,	নাগরিকদেরকে,	নাগরিকদেরকে,	
chat,	চাত,	চ্যাট,	
bohorompurer,	বহরকপুরের,	বহরমপুরের,	
chokhwala,	চোখবালা,	চোখওয়ালা,	
chilahatee,	চিলাহাটি,	চিলাহাটি,	
prity,	প্রিটি,	প্রিটি,	
mankisundar,	মনকিসুন্দর,	মানকিসুন্দর,	
fuss,	ফুসেএস,	ফাস,	
tetela,	তেটেলা,	টাইটেল,	
jothon,	যথন,	যথন,	
suparahiro,	সুপারাহিরো,	সুপারহিরো,	
taler,	তালের,	তালের,	
uddhrita,	উদ্ধৃত,	উদ্ধৃত,	
bipajjanak,	বিপাজ্জনক,	বিপজ্জনক,	
gaujano,	গৌজনও,	গজানো,	
otyacharer,	অত্যাচারের,	অত্যাচারের,	
hol,	হোল,	হোল,	
ogovir,	অগভির,	অগভীর,	
osomorthito,	অসমর্থিত,	অসমর্থিত,	
ganoporibahoner,	গণপরিবাহনের,	গণপরিবহনের,	
ponchaasjon,	পঞ্চাসন,	পঞ্চাশজন,	
upobasher,	উপবাশের,	উপবাসের,	
chhutee,	ছুটি,	ছুটি,	
laicenshe,	লাইসেন্সে,	লাইসেন্স,	
onurbar,	অনুর্বার,	অনুর্বর,	
supreetira,	সুপ্রিতিরা,	সুপ্রীতিরা,	
deefinition,	ডিফিশিশন,	ডেফিনেশন,	
dupleks,	ডুপলেক্স,	ডুপ্লে,	
kiibord,	কীইবরড,	কীবোর্ড,	
bhimsen,	ভীমসেন,	ভীমসেন,	
esoosiyetasa,	এসিউজেয়াসা,	এসোসিয়েটস,	
bayshorkarikarone,	বাযশশররকৃষরণে,	বেসরকারিকরণ,	
cheef,	চিফ,	শেফ,	
matorom,	মাতরম,	মাতরম,	
gonohotyakey,	গণসত্যাকে,	গণহত্যাকে,	
ahmed,	আহমেদ,	আহামদ,	
sportstar,	স্পোর্টস্টার,	স্পোর্টসস্টার,	
rubala,	রুবালা,	রুবল,	
jeshtha,	যেশ্ঠা,	জ্যেষ্ঠা,	
beshyasdone,	বেশ্যাসদনে,	বেশ্যাসদনে,	
sheshdinti,	শেষদিনটি,	শেষদিনটি,	
gagee,	গগি,	গেজ,	
saifai,	সাইফাই,	সাইফাই,	
hazat,	হাজাত,	হজত,	
qor,	কার,	কর,	
lendol,	লেনডডল,	লেন্ডল,	
dhauto,	ধৌতো,	ধৌত,	
eshiyetika,	এসিয়েটিকা,	এশিয়াটিক,	
review,	রিভিউ,	রিভিউও,	
eesosiyeetasa,	ইসস্যিয়েতা,	এসোসিয়েটস,	
onupater,	অনুপাতের,	অনুপাতের,	
chalachchitrei,	চলচ্চিত্রেই,	চলচ্চিত্রেই,	
aanaan,	আনান,	আনান,	
photanor,	ফটোনোর,	ফোটানোর,	
nobotomo,	নবতম,	নবতম,	
prokolpoti,	প্রকল্পটি,	প্রকল্পটি,	
shkalarashhipa,	স্কলারশিপা,	স্কলারশিপ,	
parinati,	পরিণাটি,	পরিণতি,	
kourabe,	কৌরাবে,	কৌরবে,	
guha,	গুহা,	গোহ,	
lettere,	লেটারে,	লেটারে,	
nothivookta,	নথিভুক্ত,	নথিভুক্ত,	
vishnuu,	বিশ্নুউ,	বিষ্ণু,	
majdur,	মাজদুর,	মজদুর,	
bhangle,	ভাঙ্গলে,	ভাঙলে,	
sbajan,	স্বাজান,	স্বজন,	
setikey,	সেতিকে,	সেটিকে,	
pyore,	প্যারে,	পিওর,	
prashikkhane,	প্রাশিক্ষণে,	প্রশিক্ষণে,	
maryir,	মারিয়ির,	ম্যারির,	
soinyora,	সৈন্যরা,	সৈন্যরা,	
uddhritto,	উদ্ধৃত্ব,	উদ্ধৃত,	
nagorikkey,	নাগরিককে,	নাগরিককে,	
jonmobhumitir,	জন্মভূমিটির,	জন্মভূমিটির,	
harbare,	হরবারে,	হারবারে,	
phising,	ফিসিং,	ফিসিং,	
deputy,	ডিপিটি,	ডেপুটি,	
nischitvabe,	নিশ্চিতভাবে,	নিশ্চিতভাবে,	
gaandaas,	গান্দাস,	জ্ঞানদাস,	
adhikartai,	অধিকর্তাই,	অধিকর্তাই,	
porbotmala,	পর্বতমালা,	পর্বতমালা,	
subader,	সুবাদের,	সুবাদে,	
caroline,	ক্যারোলিন,	ক্যরোলিন,	
aamontrito,	আমন্ত্রিত,	আমন্ত্রিত,	
shektore,	শেকতরে,	সেক্টরে,	
bondi,	বন্দি,	বন্দী,	
probolshoktio,	প্রবলভক্তিও,	প্রবলশক্তিও,	
bhabatarini,	ভবতারিনি,	ভবতারিণী,	
aashanka,	আশাঙ্কা,	আশংকা,	
somratra,	সম্রাত্র,	সম্রাটরা,	
aziza,	আজিজা,	আজিজা,	
vimsen,	ভিমসেন,	ভীমসেন,	
diibug,	দীববুগ,	ডিবাগ,	
upbasher,	উপবাশের,	উপবাসের,	
konistho,	কনিষ্ঠ,	কনিষ্ঠ,	
andra,	আন্দ্রার,	আন্ড্রা,	
stander,	স্ট্যান্ডের,	স্ট্যাণ্ডের,	
olympicer,	অলিম্পিসের,	অলিম্পিকের,	
pathanirdeshona,	পাঠানিরদেশন,	পথনির্দেশনা,	
nirbaho,	নির্বাহ,	নির্বাহ,	
jounotar,	যৌনতার,	যৌনতার,	
bbosben,	ব্বসেবেন,	বসবেন,	
manjushree,	মঞ্জুশ্রী,	মঞ্জুশ্রী,	
marodeho,	মারদেহ,	মরদেহ,	
mexicoteo,	মেক্সিকোটো,	মেক্সিকোতেও,	
hypar,	হিপার,	হাইপার,	
bojhaao,	বোঝাও,	বোঝাও,	
damakalkarmirao,	দমকলকর্মীরাও,	দমকলকর্মীরাও,	
utotoro,	উততর,	উততর,	
azimpur,	আজিমপুরের,	আজিমপুর,	
umb,	উম্ব,	ইউএমবি,	
shikshagato,	শিক্ষাগত,	শিক্ষাগত,	
agaldar,	আগালদার,	আগলদার,	
rekhapat,	রেখাপাট,	রেখাপাত,	
societyke,	স্িটিকে,	সোসাইটিকে,	
chhootochhuti,	ছুটোচুটি,	ছুটোছুটি,	
rajtontre,	রাজতন্ত্রে,	রাজতন্ত্রে,	
noditei,	নদীতেই,	নদীতেই,	
ongkush,	অংকুষ,	অংকুশ,	
nuhas,	নুহাস,	নুহাশ,	
elakasoho,	এলাকাসহ,	এলাকাসহ,	
bbiswashi,	বিবিস্বাসী,	বিশ্বাসই,	
jini,	জিনি,	যিনি,	
ajuhat,	অজুহাত,	অজুহাত,	
kaia,	কাইয়া,	কায়া,	
ishter,	ইস্টের,	ইস্টের,	
vagini,	ভাগিনি,	ভগিনী,	
chakti,	চাকটি,	চাকতি,	
pretty,	প্রিটি,	প্রিটি,	
byomkesh,	ব্যম্কেশ,	ব্যোমকেশ,	
sucre,	সাকার,	সাকার,	
taunsheep,	তৌনশীপ,	টাউনশিপ,	
seoul,	সিওল,	সোল,	
sonaktokaran,	সোনাক্তকরণ,	সনাক্তকরণ,	
masjidtir,	মসসিদটির,	মসজিদটির,	
cholochchitrer,	চলচ্চিত্রের,	চলচ্চিত্রের,	
laagche,	লাগছে,	লাগছে,	
hozot,	হোজোট,	হজত,	
makong,	মাকং,	মেকং,	
gronthoti,	গ্রন্থটি,	গ্রন্থটি,	
chalochchitreei,	চলচ্চিত্রীয়,	চলচ্চিত্রেই,	
oboshore,	অবশরে,	অবসরে,	
qyapasula,	ক্যাপাসুলা,	ক্যাপসুল,	
kutubuddinke,	কুটুবুদ্দিনকে,	কুতুবুদ্দিনকে,	
kuresher,	কুরেশের,	কুরেশের,	
jatinke,	জাতিনকে,	যতীনকে,	
dip,	ডিপ,	দীপ,	
pujito,	পুজিত,	পুজিত,	
pillai,	পিল্লাই,	পিল্লাই,	
title,	টিটল,	টাইটেল,	
byaktikegreptar,	ব্যক্তিয়েক্ত্র,	ব্যক্তিকেগ্রেপ্তার,	
ashociatesh,	অসোসাইটেশ,	এসোসিয়েটস,	
armori,	আরমোরি,	আরমোরি,	
poroborti,	পরবর্তী,	পরর্বতী,	
kalirkhal,	কালিরখাল,	কালিরখাল,	
chaaktir,	চাকটির,	চাকতির,	
manushgulor,	মানুষগুলোর,	মানুষগুলোর,	
angshogrohon,	অংশগ্রহণ,	অংশগ্রহন,	
charger,	চার্জের,	চার্জার,	
bbiseshyer,	বিবিসেষ্যের,	বিশেষ্যের,	
muhurtati,	মুহুর্তটি,	মুহুর্তটি,	
neker,	নেকের,	নেকের,	
laaisheesh,	লাইশিস,	লাইসেন্স,	
rajyabhogi,	রাজ্যভভগী,	রাজ্যভোগী,	
aairees,	আইযারিস,	আইরিস,	
stana,	স্তানা,	স্টোন,	
bhupal,	ভূপাল,	ভূপাল,	
sthitiko,	স্থিতিকও,	স্থিতিকো,	
conflikt,	কনফ্লিক্ট,	কনফ্লিক্ট,	
bishnoo,	বিষ্ণু,	বিষ্ণু,	
turkii,	তুর্কি,	তুর্কি,	
darjiling,	ডার্িলিং,	দার্জিলিং,	
ekoghore,	একঘরে,	একঘরে,	
kirke,	কীরকে,	কিরকে,	
rejidens,	রেজিডেনস,	রেসিডেন্স,	
armeeniyana,	আর্মিনিয়ান,	আর্মেনিয়ান,	
jolbe,	জলবে,	জ্বলবে,	
atighataner,	অতিঘাটনের,	অতিঘটনের,	
mononiitoder,	মনোনিতদের,	মনোনীতদের,	
jipiusamriddha,	জিপিমুসমৃদ্ধ,	জিপিউসমৃদ্ধ,	
teliha,	তেলিহা,	তেলিহা,	
bairey,	বাইরে,	বাইরে,	
sohinsotar,	সহিনসতার,	সহিংসতার,	
rinobodh,	ঋণবোধ,	ঋণবোধ,	
nirbahe,	নির্বাহে,	নির্বাহে,	
jerusalema,	জেরুসালেমা,	জেরুসালেম,	
chikittsar,	চিকিৎসাতার,	চিকিত্সার,	
fongli,	ফংলি,	ফংলি,	
ghoor,	ঘুর,	ঘুর,	
drissoteer,	দৃশ্যতির,	দৃশ্যটির,	
hafej,	হাফেজ,	হাফেয,	
nirgamon,	নির্গামন,	নির্গমন,	
podarthobidder,	পদার্থবিদদের,	পদার্থবিদদের,	
milton,	মিলটন,	মিলটন,	
jeelyaand,	জিল্যান্ড,	জিল্যান্ড,	
maailkhanek,	মাইলখানেক,	মাইলখানেক,	
moshahidur,	মোশাহীদুর,	মোশাহিদুর,	
difinishion,	ডিফিশিশন,	ডেফিনেশন,	
gobeshana,	গোবেশন,	গবেষনা,	
chalachchitro,	চলচ্চিত্র,	চলচ্চিত্র,	
elakaasoho,	এলাকাসহ,	এলাকাসহ,	
uporoshtho,	উপরস্থ,	উপরস্থ,	
brojomohun,	ব্রমমহন,	ব্রোজোমোহন,	
kalakushalir,	কললকুশালীর,	কলাকুশলীর,	
jetam,	জেতাম,	যেতাম,	
akram,	আক্রাম,	আকরাম,	
dhonni,	ধন্নি,	ধন্যি,	
mukhya,	মুখ্যা,	মুখ্য,	
nirabota,	নিরাতা,	নিরবতা,	
kale,	কালে,	কালে,	
ispredseet,	ইসপ্রাপিটিট,	স্প্রেডশীট,	
bisshasi,	বিশবাসী,	বিশ্বাসী,	
myari,	মায়ারী,	ম্যারি,	
times,	টিইমস,	টাইমস্,	
kareer,	করির,	কারীর,	
alexanderke,	অ্যালেক্সান্ডরকে,	আলেকজান্ডারকে,	
distance,	ডিসট্যান্স,	ডিসট্যান্স,	
noiteekotar,	নৈতিকতার,	নৈতিকতার,	
dubureer,	ডুবুরীর,	ডুবুরির,	
rahi,	রহি,	রাহী,	
charpanch,	চারপাঞ্চ,	চারপাঁচ,	
ohalyar,	ওহাল্যার,	অহল্যার,	
idyi,	ইইডিইই,	আইডিই,	
perri,	পেররি,	পেরি,	
dokan,	দোকান,	দোকান,	
bikromei,	বিক্রমেই,	বিক্রমেই,	
shahurgulor,	শহুরগুলোর,	শহুরগুলোর,	
milea,	মিলেয়া,	মাইলে,	
talgachh,	তালগাছ,	তালগাছ,	
teoner,	টিওনের,	টিওনার,	
sobaiderke,	সবাইদেরকে,	সবাইদেরকে,	
shamijir,	শমমিজির,	স্বামীজীর,	
modelkey,	মডেল্কে,	মডেলকে,	
site,	সিতে,	সিটে,	
faase,	ফাসে,	ফাঁসে,	
mukhomondoler,	মুখমন্ডলের,	মুখমণ্ডলের,	
elakatite,	এলাকাটিতে,	এলাকাটিকে,	
bhumija,	ভূমিজা,	ভূমিজ,	
gonesher,	গনেশের,	গণেশের,	
metropolitan,	মেট্রোপলিটান,	মেট্রোপলিটন,	
hansasya,	হাঁসস্য,	হংসস্য,	
dheke,	ধেকে,	ঢেকে,	
kormoi,	কর্মই,	কর্মই,	
harishankar,	হরিশঙ্কর,	হরিশংকর,	
kadam,	কাদাম,	কদম,	
dhamshrenite,	ধম্শরেণিতে,	ধামশ্রেণীতে,	
ameettrakkhor,	আমিত্রাক্ষ্র,	অমিত্রাক্ষর,	
geja,	গেজা,	গেজ,	
hilser,	হিলসের,	হিলসের,	
khorsed,	খোরসেড,	খোরশেদ,	
hosne,	হোসন,	হোসনে,	
bhittitei,	ভিত্তিতেই,	ভিত্তিতেই,	
uposhthit,	উপশ্থিত,	উপস্থিত,	
murader,	মুরাদের,	মুরাদের,	
nagorikra,	নাগরিকরা,	নাগরিকরা,	
tiuning,	টিউনিং,	টিউনিং,	
bitlaser,	বিটলাসের,	বিটলসের,	
drissogulote,	দৃশ্যগুলোতে,	দৃশ্যগুলোতে,	
fiksing,	ফিকসিং,	ফিক্সিং,	
nirvachaker,	নির্ভাচকের,	নির্বাচকের,	
nepchooner,	নেপচুনের,	নেপচুনের,	
sepha,	সেফা,	শেফ,	
infarmatian,	ইনফার্টাইয়ান,	ইনফরমেশন,	
jolrong,	জলরং,	জলরঙ,	
weenis,	বিনিস,	ভেনিস,	
gafeeloti,	গাফেলটি,	গাফিলতি,	
byabosthar,	ব্যবস্থার,	ব্যবস্থার,	
ekjoge,	একজোগে,	একযোগে,	
goonoman,	গুণমান,	গুণমান,	
manohputa,	মনোসপুতা,	মনঃপুত,	
nartana,	নরতানা,	নর্টন,	
byaboharkari,	ব্যবহারকারী,	ব্যবহারকারী,	
oncholsomuho,	অঞ্চলসমূহ,	অঞ্চলসমূহ,	
shikshakbrinda,	শিক্ষাবৃৃদ্ধা,	শিক্ষকবৃন্দ,	
karecho,	করেছো,	করেছ,	
angibhutovabe,	অঙ্গীভতভুভাবে,	অঙ্গীভূতভাবে,	
niketon,	নিকেটন,	নিকেতন,	
seeramiks,	সেরামিক্স,	সিরামিকস,	
rohosyo,	রোস্য,	রহস্য,	
thailand,	থাইলান্ড,	থাইল্যান্ড,	
bikretara,	বিক্রেতরা,	বিক্রেতারা,	
teestar,	তেস্টার,	তিস্তার,	
hijritey,	হিজরিতে,	হিজরীতে,	
japanostho,	জাপানস্থ,	জাপানস্থ,	
shringa,	শ্রিগা,	শৃঙ্গ,	
licensin,	লাইসেনসিন,	লাইসেন্সিং,	
alexandar,	অ্যালেক্ন্দার,	আলেকজান্ডার,	
somonwitobhabey,	সমন্তিভভাবে,	সমন্বিতভাবে,	
bosano,	বসানো,	বসানো,	
dorgaaho,	ডর্গাহো,	দরগাহ,	
bondhuvabaponyo,	বন্ধুবাবান্য,	বন্ধুভাবাপন্ন,	
bidghootey,	বিদঘুতে,	বিদঘুটে,	
sarbhaarti,	সার্ভর্তী,	সার্ভারটি,	
jubokti,	যুবকটি,	যুবকটি,	
borendroke,	বরেন্দ্রকে,	বরেন্দ্রকে,	
bhramapraban,	ভ্রমপ্রবণ,	ভ্রমপ্রবণ,	
sikkhakromer,	শিক্ষাক্রমের,	শিক্ষাক্রমের,	
oncholshomuher,	অঞ্চলসমূহের,	অঞ্চলসমূহের,	
aieesha,	আইশা,	আইএএস,	
sumitrar,	সুমিত্রার,	সুমিত্রার,	
chouhate,	চৌহাতে,	চৌহাটে,	
melbourner,	মেলবার্নের,	মেলবোর্নের,	
melborrone,	মেলবোর্নো,	মেলবোর্নে,	
nick,	নিক,	নিক্,	
shten,	স্টেন,	স্টেন,	
mitrata,	মিত্রাটা,	মিত্রতা,	
taatey,	টাযাটে,	তাতে,	
utpatti,	উৎপত্তি,	উতপত্তি,	
riazuddin,	রিয়াজুদ্দিন,	রিয়াজউদ্দীন,	
chhaikalo,	ছাইকালো,	ছাইকালো,	
plack,	প্ল্যাক,	প্ল্যাক,	
chheher,	ছেহের,	ছেহের,	
fand,	ফ্যান্ড,	ফান্ড,	
saranor,	সারানোর,	সরানোর,	
grootha,	গ্রোথা,	গ্রোথ,	
chilahaati,	চিলাহাটি,	চিলাহাটি,	
ponera,	পনেরা,	পনের,	
brekethru,	ব্রেকেঠুরু,	ব্রেকথ্রু,	
waal,	ওয়াল,	উল,	
pranidero,	প্রাণীদেরও,	প্রানীদেরও,	
inapharameshana,	ইনাফররমেশন,	ইনফরমেশন,	
backflipe,	ব্যাকফ্লিপে,	ব্যাকফ্লিপে,	
michir,	মিচির,	মিচির,	
jahara,	জাহারা,	যাহরা,	
kingsh,	কিংশ,	কিংস,	
middleton,	মিডললন,	মিডলটন,	
ruble,	রাবল,	রুবল,	
maudelder,	মোডেল্ডার,	মডেলদের,	
swadhinotatukui,	স্বাধীনতাটুকুই,	স্বাধীনতাটুকুই,	
gandharir,	গানধধারীর,	গান্ধারীর,	
trabuco,	ট্রাবুকো,	ট্র্যাবুকো,	
aakik,	আকিক,	আকিক,	
madrasi,	মাদরাসী,	মাদ্রাজি,	
ganesh,	গনেশ,	গণেশ,	
udbhaboney,	উদ্ভাবনে,	উদ্ভাবনে,	
nottee,	নটটি,	নোটটি,	
bonobhumi,	বনভূমি,	বনভূমি,	
argho,	অর্ঘ,	অর্ঘ্য,	
maudelgulo,	মডালগুলো,	মডেলগুলো,	
jatotaa,	জটতা,	যতোটা,	
janmat,	জন্মত,	জন্মাত,	
palbongsher,	পালবংশের,	পালবংশের,	
sathik,	সাথিক,	সঠিক,	
volapuk,	ভোলাপুক,	ভোলাপুক,	
dakshinangsho,	দক্ষিণাস্,	দক্ষিণাংশ,	
manab,	মানব,	মানব,	
punorabortonte,	পুনরাবর্তন্তে,	পুনরাবর্তন্তে,	
tyap,	ত্যাম,	ট্যাপ,	
soori,	সুরী,	সুরি,	
edaningkale,	এডানিংকালে,	ইদানীংকালে,	
freelancerra,	ফ্রিল্যান্সরা,	ফ্রিল্যান্সাররা,	
daayitto,	দায়িত্ব,	দায়িত্ব,	
soteciety,	সোটেসিটি,	সোসাইটিতে,	
shilpojaat,	শিল্পজাত,	শিল্পজাত,	
annimated,	অ্যানিমেমেড,	এনিমেটেড,	
srk,	শির্এক,	শাহরুখ,	
zoubankal,	যৌবনকাল,	যৌবনকাল,	
chintakarma,	চিন্তাকর্ম,	চিন্তাকর্ম,	
ekatitto,	একাতিত্ব,	একাতিত্ব,	
shamshernagar,	শামশরেনগরের,	শমশেরনগর,	
anchalgulir,	অঞ্চলগুলির,	অঞ্চলগুলির,	
jhumjhumita,	ঝুমঝুমিতা,	ঝুমঝুমিটা,	
desiseyer,	ডিসিসিয়ের,	ডিজিজের,	
mulor,	মুলোর,	মুলোর,	
tooku,	টুকু,	টুকু,	
cantan,	ক্যানান,	ক্যান্টন,	
cholechi,	চলেছি,	চলেছি,	
heelser,	হিলসের,	হিলসের,	
yak,	যাক,	ইয়াক,	
vorkendra,	ভর্কেন্দ্র,	ভরকেন্দ্র,	
sthapanagulor,	স্থাপানগুলোর,	স্থাপনাগুলোর,	
metropalitana,	মেট্রোপলিডোন,	মেট্রোপলিটন,	
jamseder,	জামসেদের,	জামসেদের,	
grambaasheeo,	গ্রামবাশীও,	গ্রামবাসীও,	
aarik,	আরিক,	আরিক,	
murad,	মুরাদ,	মুরাদ,	
gondogol,	গণ্ডগোল,	গন্ডগোল,	
markeetim,	মার্কটিং,	মার্কেটিং,	
bonvumitey,	বনভুমিটে,	বনভূমিতে,	
hitlere,	হিটলারে,	হিটলারে,	
ujobekeestaner,	উজোবেকস্তানের,	উজবেকিস্তানের,	
sumoo,	সুমু,	সুমো,	
hydrological,	হাইড্রোলজিক্যাল,	হাইড্রোলজিক্যাল,	
babare,	বাবারে,	বাবারে,	
chikkingsasoho,	চিক্ষিজসসাসহ,	চিকিংসাসহ,	
rudroke,	রুদ্রকে,	রুদ্রকে,	
byabaharkareer,	ব্যবহারকারীর,	ব্যবহারকারীর,	
atmabishvashi,	আত্মবিশাবশী,	আত্মবিশ্বাসী,	
alkatra,	আলকাত্র,	আলকাতরা,	
scholars,	স্কলারস,	স্কলার্স,	
lagto,	লাগতো,	লাগতো,	
uthhaane,	উঠানে,	উঠানে,	
alimpiqa,	অলিম্পিক,	অলিম্পিক,	
atmiyasulabh,	আত্মীয়মাভাভ,	আত্মীয়সুলভ,	
chaanoo,	চানুও,	চানু,	
konruup,	কোররুপ,	কোনরূপ,	
baipass,	বাইপাস,	বাইপাস,	
braqe,	ব্র্যাক,	ব্রেক,	
temonbhabe,	তেমনভাবে,	তেমনভাবে,	
quary,	কোয়ারি,	কোয়েরি,	
ponthaar,	পন্থার,	পন্থার,	
anisa,	আনিসা,	আনিস,	
saseza,	সাসেজা,	সসেজ,	
sangosrobomukto,	সংস্রবমুক্ত,	সংস্রবমুক্ত,	
reshmirekha,	রেশমিরেখা,	রেশমীরেখা,	
carlosh,	কার্লোশ,	কার্লোস,	
bisnoo,	বিসনু,	বিষ্ণু,	
brookoleen,	ব্রুকলিন,	ব্রুকলিন,	
nischitobhave,	নিশ্চিতভাবে,	নিশ্চিতভাবে,	
dabarer,	দাবারের,	দাবারের,	
shikhaboudi,	শিখাবৌদি,	শিখাবৌদি,	
shangsthatikey,	শাংস্থাটিকে,	সংস্থাটিকে,	
puroheetder,	পুরহীতদের,	পুরোহিতদের,	
premo,	প্রেমো,	প্রিমো,	
dreeshtiheen,	দৃষ্টিহীন,	দৃষ্টিহীন,	
fansi,	ফাঁসি,	ফাঁসী,	
oichchheek,	ঐচ্ছিক,	ঐচ্ছিক,	
meridiane,	মেরিডিয়ান,	মেরিডিয়ানে,	
onker,	অঙ্কের,	ওঙ্কার,	
drishi,	দৃশি,	দৃশ্যই,	
euqalyptus,	ইউকল্্পাসিস,	ইউক্যালিপ্টাস,	
awatar,	আওয়াতার,	অবতার,	
madhnagar,	মধনগর,	মাধনগরের,	
sangbadmadhyomgulote,	সংবাদমাধ্যমগুলোতে,	সংবাদমাধ্যমগুলোতে,	
fastara,	ফাস্তারা,	ফস্টার,	
pachattar,	পাচত্রার,	পাচাত্তার,	
sikha,	সিখা,	শিখ,	
shilver,	শিলভার,	সিলভার,	
dakten,	ডাক্েন,	ডাকতেন,	
kuthibarike,	কুঠিবারিকে,	কুঠিবাড়ীকে,	
sethai,	সেথাই,	সেথাই,	
shunani,	শুনানি,	শুনানী,	
konisttha,	কোনিষ্টা,	কনিষ্ঠ,	
jaruri,	জারুরি,	জরূরী,	
templet,	টেম্পলেট,	টেম্পলেট,	
comoros,	কমোোরোস,	কোমোরোস,	
alankorana,	অলঙ্করণা,	অলঙ্করণ,	
qaferder,	কাফারদের,	কাফেরদের,	
bisheshshyer,	বিশেষ্ষ্যের,	বিশেষ্যের,	
kaathhaamaandu,	কাঠানাম্ডু,	কাঠমান্ডু,	
protijogi,	প্রতিযোগী,	প্রতিযোগী,	
rananganey,	রণঙ্গনে,	রণাঙ্গনে,	
wishnu,	উশুন্নু,	বিষ্ণু,	
nanir,	নানির,	নানীর,	
esasiyetasa,	এসসিয়েতসা,	এসোসিয়েটস,	
taalaal,	তালাল,	তালাল,	
upobaashee,	উপবাশী,	উপবাসী,	
neshnosh,	নেশনশো,	নেশনস,	
kayed,	কায়েদ,	কায়েদ,	
kanasarabhesana,	কনসরাভেশন,	কনসারভেশন,	
nirmolota,	নির্মলতা,	নির্মলতা,	
abhidhaner,	অভিধানের,	অভিধানের,	
ganjana,	গঞ্জনা,	গঞ্জনা,	
bim,	বিম,	বিম,	
kamti,	কামটি,	কমতি,	
graminphonor,	গ্রামিনফোনোর,	গ্রামীণফোনর,	
abodamaner,	অবদামনের,	অবদমনের,	
meloonborrone,	মেলনউবর্ণণে,	মেলবোর্নে,	
land,	ল্যান্ড,	ল্যান্ড,	
nothivukto,	নথিভুক্ত,	নথিভুক্ত,	
prosadhani,	প্রসাধানি,	প্রসাধনী,	
emargency,	এ্ারাজেন্সি,	এমার্জেন্সি,	
durgatsob,	দুর্গাৎসব,	দুর্গোৎসব,	
spashtotai,	স্পষ্টতাই,	স্পষ্টতই,	
maadla,	মাদলা,	মাদলা,	
query,	কুয়েরি,	কোয়েরি,	
batikromi,	বাতিকরমমি,	ব্যতিক্রমী,	
deefinishion,	ডিফিশিশন,	ডেফিনেশন,	
manush,	মানুষ,	মানুষ,	
dibate,	দিবাতে,	ডিবেট,	
jacksonke,	জ্যাকসনকে,	জ্যাকসনকে,	
parishram,	পরিশ্রম,	পরিশ্রম,	
iraner,	ইরানের,	ইরানের,	
teemothi,	তিমোি,	টিমোথি,	
nothiboddho,	নথিবদ্ধ,	নথিবদ্ধ,	
haris,	হারিস,	হ্যারিস,	
taronee,	তরনী,	তরণী,	
ragee,	রাজি,	রাগী,	
bishashke,	বিশাকে,	বিশ্বাসকে,	
parkasa,	পারকাসা,	পার্কস,	
palkee,	পালকি,	পাল্কি,	
thyachar,	ণ্যাচার,	থ্যাচার,	
kholdhular,	খোলধুলার,	খোলধূলার,	
lagche,	লাগছে,	লাগছে,	
edipass,	এডিপাস,	ইডিপাস,	
dorun,	দরুন,	দরুণ,	
nischoy,	নিশ্যয়,	নিশ্চয়,	
crime,	ক্রাইম,	ক্রাইম,	
folleni,	ফোলেনি,	ফলেনি,	
amarjito,	অমর্জিত,	অমার্জিত,	
kinsha,	কিনশা,	কিংস,	
biswashi,	বিশ্বশী,	বিশ্বাসই,	
ovinetar,	অভিনেতার,	অভিনেতার,	
karmojog,	কর্মযোগ,	কর্মযোগ,	
bhenasha,	ভেনশা,	ভেনাস,	
abadamoner,	আবাদামনের,	অবদমনের,	
doorger,	দুর্গের,	দুর্গের,	
bikargrosto,	বিকারগ্রস্ত,	বিকারগ্রস্ত,	
ashor,	আশর,	আসর,	
hitaishi,	হিতাইশি,	হিতৈষী,	
taims,	টাইমস,	টাইমস্,	
rata,	রতা,	রত,	
lesense,	লেসেন্সে,	লাইসেন্স,	
sweety,	স্বিটি,	সুইটি,	
vaabnake,	ভাঁবাকে,	ভাবনাকে,	
shajano,	শাজানো,	সাজানো,	
bhutbhut,	ভূতভূত,	ভুটভুট,	
rahee,	রহী,	রাহী,	
samajikatar,	সমাজিকতার,	সামাজিকতার,	
shit,	শিত,	শীত,	
narsinghomgulor,	নরসিংহগীমগলোর,	নার্সিংহোমগুলোর,	
panchadadu,	পঞ্চদদাদু,	পঞ্চাদাদু,	
drishyogulotey,	দৃশ্যগুলতে,	দৃশ্যগুলোতে,	
fatakasto,	ফতাকাস্ত,	ফাটাকেষ্ট,	
niknayman,	নিক্ণামান,	নিকনেইমান,	
konagoolo,	কোনাগুলো,	কণাগুলো,	
akatwa,	আকা্ব,	একাত্ব,	
kkhur,	খুর,	ক্ষুর,	
oitijhya,	ঐতিহ্যা,	ঐতিহ্য,	
boikolyo,	বৈকল্য,	বৈকল্য,	
taufiq,	তাফিক,	তৌফিক,	
kalnir,	কলনির,	কালনীর,	
ahalyar,	অহল্যার,	অহল্যার,	
evaner,	এভানের,	ইভানের,	
agora,	আগোরা,	আগোরা,	
mukhobondho,	মুখবন্ধ,	মুখবন্ধ,	
ateetkale,	অতিতকলে,	অতীতকালে,	
anchalo,	আঞ্চলো,	অঞ্চলও,	
sthaponagulo,	স্থাপনাগুলো,	স্থাপনাগুলো,	
dada,	দাদা,	দাদা,	
bojhao,	বোঝাও,	বোঝাও,	
hariner,	হরিনের,	হরিণের,	
chowdhurir,	চৌধুরীর,	চৌধুরীর,	
bhromoner,	ভ্রমণের,	ভ্রমণের,	
nathivukta,	নথিভুক্ত,	নথিভুক্ত,	
nodiitei,	নোদিতেই,	নদীতেই,	
pharanyeta,	ফরান্যেত,	ফরম্যাট,	
bishwaashshke,	বিশ্বশ্ষকে,	বিশ্বাসকে,	
masjidsaha,	মসসিদসহ,	মসজিদসহ,	
sharifpur,	শরিফপুর,	শরিফপুর,	
kharar,	খারার,	খরার,	
tateo,	তাতেও,	তাতেও,	
graambaaseer,	গ্রামবাসীর,	গ্রামবাসীর,	
jakso,	জাকসো,	যক্ষ,	
somonnitobhabe,	সমন্মিতভাবে,	সমন্বিতভাবে,	
sachetonvabe,	সচেতনাভাবে,	সচেতনভাবে,	
kampita,	কাম্পিটা,	কম্পিত,	
cbi,	সিবিআই,	সিবিআই,	
manushera,	মানুষেরা,	মানুষেরা,	
soorsa,	সুরসা,	সোর্স,	
dosha,	দোষা,	দোসা,	
ched,	চেদ,	ছেদ,	
torunderke,	তরুণ্দরকে,	তরুণদেরকে,	
mumtajer,	মুমতাজের,	মুমতাজের,	
shfingtar,	স্ফিংটার,	স্ফিংটার,	
eura,	ইউরা,	ইউরো,	
prangulo,	প্রাঙগুলো,	প্রানগুলো,	
birishiritey,	বিরিশিরিতে,	বিরিশিরিতে,	
myathiou,	ম্থিজুও,	ম্যাথিউ,	
kade,	কাদে,	কোড,	
kaalengaa,	কালেঙ্গা,	কালেঙ্গা,	
sombhobonaao,	সম্ভবনাও,	সম্ভবনাও,	
sheekar,	শেকার,	শিকার,	
juktorashtreo,	যুক্তরাশ্ত্রেও,	যুক্তরাষ্ট্রেও,	
rachanakal,	রচনাকাল,	রচনাকাল,	
rajashri,	রাজশ্রী,	রাজশ্রী,	
tiger,	টিগের,	টাইগার,	
mailkhanek,	মইলাখানেক,	মাইলখানেক,	
soolke,	সুলকে,	শুল্কে,	
jomoker,	জমকের,	জমকের,	
utshahomulok,	উৎসহ্মূলক,	উৎসাহমূলক,	
scuvi,	স্কাভি,	স্কুভি,	
daaktikite,	ডাকটিকিতে,	ডাকটিকিটে,	
mukhyo,	মুখ্য,	মুখ্য,	
muktijuddhojato,	মুক্তিযুদ্ধাজত,	মুক্তিযুদ্ধজাত,	
chandil,	চণ্ডিল,	চান্ডিল,	
aakkaash,	আককাশ,	আককাস,	
laaishenshh,	লাইশেষ,	লাইসেন্স,	
dishani,	দিশানি,	দিশানি,	
gatibege,	গতিবেগে,	গতিবেগে,	
zerusalem,	জেরুসালেম,	জেরুজালেম,	
yucalyptus,	যুক্লালিপ্ডাস,	ইউক্যালিপ্টাস,	
bonke,	বোনকে,	বনকে,	
mataram,	মাতারাম,	মাতরম,	
lettar,	লেট্টার,	লেটার,	
semai,	সেমাই,	সেমাই,	
chalochchitreer,	চলচ্চিত্রীর,	চলচ্চিত্রের,	
mozdur,	মজদুর,	মজদুর,	
satarkatar,	সতর্কতার,	সতর্কতার,	
bethikata,	বেথিকাটা,	বেঠিকতা,	
vitti,	ভিত্তি,	ভিত্তিই,	
karadando,	কারাদান্ডো,	কারাদণ্ড,	
kormokarer,	কর্মকারের,	কর্মকারের,	
narishwar,	নারিশ্বর,	নারীশ্বরের,	
horidbar,	হরিদবার,	হরিদ্বার,	
tarunra,	তরুণরা,	তরুণরা,	
obhaarbhiu,	অভার্যু,	ওভারভিউ,	
lyaandeeng,	ল্যান্ডিং,	ল্যান্ডিং,	
freekeh,	ফ্রীকেহ,	ফ্রিকেহ,	
bboponer,	ব্পপনের,	বপনের,	
priseflex,	প্রিজেল্ক্সেক,	প্রাইজফ্লেক্স,	
nosihote,	নসিহতে,	নসিহতে,	
orthisoho,	অর্থিসহ,	অর্থিসহ,	
dola,	দোলা,	দলা,	
grushko,	গ্রুষ্কো,	গ্রুশকো,	
duio,	দুইয়ো,	দুইও,	
debate,	দেবাতে,	ডিবেট,	
sqalastiqa,	স্কলসস্তিক,	স্কলাস্টিক,	
podotyagsongkranto,	পদত্যাগসংক্রান্ত,	পদত্যাগসংক্রান্ত,	
chitronattakar,	চিত্রনাট্তাকার,	চিত্রনাট্যকার,	
turky,	টার্কি,	তুর্কি,	
ummool,	উম্মুল,	উম্মুল,	
natshi,	নাটশি,	নাত্সি,	
jonomukhi,	জনমুখী,	জনমুখী,	
change,	চাঙ্গে,	চেঞ্জ,	
gratha,	গ্রাথা,	গ্রোথ,	
ispredsiit,	ইসপ্রেপিসিট,	স্প্রেডশীট,	
kaash,	কাশ,	কাস,	
bbiswash,	বিবিস্বাস,	বিশ্বাস,	
debeting,	ডেবেটিং,	ডিবেটিং,	
schilling,	স্কিলিং,	শিলিং,	
baibosthaar,	বৈবস্থার,	ব্যবস্থার,	
vaphara,	ভাফারা,	বাফার,	
pyetarna,	পিটাারনা,	প্যাটার্ন,	
shrabostee,	শ্রাবস্তি,	শ্রাবস্তী,	
chirontan,	চিরন্তন,	চিরন্তন,	
andamana,	আন্দামানা,	আন্দামান,	
holding,	হোল্ডিং,	হোল্ডিং,	
tochhnochh,	তচ্ছোচ,	তছনছ,	
chirantan,	চিরন্তন,	চিরন্তন,	
armstronz,	আর্মস্ট্রোজ,	আর্মস্ট্রং,	
osommotite,	অসম্মতিতে,	অসম্মতি,	
shubhag,	শুভাগ,	শুভাগ,	
nagorikra,	নাগরিকরা,	নাগরিকেরা,	
institutione,	ইনস্টিটিশনে,	ইনস্টিটিউশনে,	
ratishilatai,	রতিশীলতাই,	রতিশীলতায়,	
heart,	হার্ট,	হার্ট,	
amiya,	আমিয়া,	অমিয়,	
suchanakal,	সুচনাকল,	সূচনাকাল,	
associatis,	অ্যাসোসাইয়াটিস,	এসোসিয়েটস,	
procharjontrogulo,	প্রচারয়ন্ত্রগুলো,	প্রচারযন্ত্রগুলো,	
heze,	হেজে,	হেজ,	
jhalkanite,	ঝালকানিতে,	ঝলকানীতে,	
mah,	মহা,	মাহে,	
sushposhtolikhito,	সুষ্পষ্টলিখিত,	সুষ্পষ্টলিখিত,	
protijogiitamulok,	প্রতিযোগিতামূলক,	প্রতিযোগীতামূলক,	
maritimer,	মারিটিমের,	মেরিটাইমের,	
meshenjar,	মেশেনজার,	মেসেঞ্জার,	
palta,	পাল্লাতা,	পালটা,	
collaborators,	কলাবর্ট্রাস,	কলাবরেটরস,	
jeshh,	যেশ,	জেস,	
shommotir,	শম্মটির,	সম্মতির,	
vittiteo,	ভিত্তিতেও,	ভিত্তিতেও,	
vabook,	ভাবুক,	ভাবুক,	
jonesh,	জনেশ,	জোন্স,	
mmehonoti,	ম্মেহনোটি,	মেহনতি,	
foxcon,	ফক্সকন,	ফক্সকন,	
kushakhali,	কুশাখালি,	কুশাখালি,	
baarbadoj,	বারবাদজ,	বার্বাডোজ,	
plainey,	প্লেইন,	প্লেনে,	
ashamorthito,	আশামর্থিত,	অসমর্থিত,	
purborekorde,	পূর্বরেকর্ডে,	পূর্বরেকর্ডে,	
sahinsatar,	সাহিন্সতার,	সহিংসতার,	
codee,	কডি,	কোডে,	
taufik,	তৌফিক,	তৌফিক,	
nutoner,	নুটনের,	নূতনের,	
chhooteer,	ছুটির,	ছুটির,	
atarkitey,	অ্যারোক্কিইট,	অতর্কিতে,	
noitikota,	নৈতিকতা,	নৈতিকতা,	
gandhike,	গাঁধধিকে,	গান্ধীকে,	
dakter,	ডাক্তের,	ডাকতের,	
byaboharkarie,	ব্যবহারকারী,	ব্যবহারকারীই,	
kanthar,	কন্ঠার,	কাঁথার,	
kayech,	কায়েছ,	কায়েছ,	
chhuteete,	ছুটেতে,	ছুটিতে,	
shresthoshcho,	শ্রেষ্ঠশ্চ,	শ্রেষ্ঠশ্চ,	
argead,	আরজিওড,	আর্জিদ,	
sompadonkaree,	সম্পাদকর্রী,	সম্পাদনকারী,	
sedikei,	সেদিকেই,	সেদিকেই,	
vabuk,	ভাবুক,	ভাবুক,	
tep,	টেপ,	ট্যাপ,	
seshardhe,	শেশার্ধে,	শেষার্ধে,	
joubanbatee,	যৌবনবাতী,	যৌবনবতী,	
prosadhoni,	প্রসাধনী,	প্রসাধনী,	
akkelpure,	আক্কেলপুরে,	আক্কেলপুরে,	
sangbadmadhyamgulote,	সংবাদমাধ্যমগুলোতে,	সংবাদমাধ্যমগুলোতে,	
gyada,	জ্ঞাদা,	গ্যাদা,	
bonsho,	বনশো,	বংশ,	
paikgachha,	পাইকগাছা,	পাইকগাছা,	
mohajote,	মহাযোতে,	মহাজোট,	
lopjonito,	লোফজনিত,	লোপজনিত,	
rajshri,	রাজশরী,	রাজশ্রী,	
rajan,	রজন,	রাজন,	
protizogiita,	প্রতিযোগীতা,	প্রতিযোগীতা,	
brindaboney,	বৃন্দাবনে,	বৃন্দাবনে,	
modhyekar,	মধ্যেকর,	মধ্যেকার,	
rayyalati,	রায়য়ললাটি,	রয়্যালটি,	
dhanche,	ধাঁচে,	ধাঁচে,	
simantarkkhibahinir,	সীমান্তরাচ্বিকারীনীর,	সীমান্তরক্ষীবাহিনীর,	
kramp,	ক্রাম্প,	ক্র্যাম্প,	
jyesthaa,	জ্যেষ্ঠা,	জ্যেষ্ঠা,	
sarsa,	সারসা,	সোর্স,	
uthe,	উঠে,	উঠে,	
simons,	সিমোনস,	সিমন্স,	
dhormokorme,	ধর্মকর্মে,	ধর্মকর্মে,	
bokahoke,	বোকাহকে,	বকাহকে,	
gejeted,	গেজেটেড,	গেজেটেড,	
protistha,	প্রতিষ্ঠা,	প্রতিষ্টা,	
saabyastha,	সাবস্থা,	সাব্যস্থ,	
chintamani,	চিন্তামনি,	চিন্তামনি,	
sudrissho,	সুদৃশ্য,	সুদৃশ্য,	
krimlin,	ক্রিলিিন,	ক্রিমলিন,	
mette,	মেটে,	ম্যাট,	
pretti,	প্রেত্তি,	প্রিটি,	
bapio,	বাপিও,	বাপিও,	
bornolikhon,	বর্ণলিখন,	বর্ণলিখন,	
oswasteekor,	অস্বস্তিকর,	অস্বস্তিকর,	
registrikrito,	রেজিস্ট্রীকৃত,	রেজিস্ট্রীকৃত,	
aprasangikbhabei,	অপ্রসংঙ্কেভাবেই,	অপ্রাসঙ্গিকভাবেই,	
abdoone,	আবদুনে,	আবদুন,	
chhuteer,	ছুটির,	ছুটির,	
neshadrabyer,	নেশাদ্রব্যের,	নেশাদ্রব্যের,	
airish,	আইরিশ,	আইরিস,	
safiha,	সাফিহা,	সাফিহা,	
meghachchanno,	মেঘাচ্ছন্ন,	মেঘাচ্ছন্ন,	
domone,	ডোমোন,	দমনে,	
aatto,	আ্যাট,	আত্ম,	
edaning,	এডানিং,	ইদানিং,	
chadake,	চড়াকে,	চড়াকে,	
brindabane,	বৃন্দাবনে,	বৃন্দাবনে,	
madrasake,	মাদ্রাসাকে,	মাদ্রাসাকে,	
drissotir,	দৃশ্যটির,	দৃশ্যটির,	
aamoode,	আমোগে,	আমুদে,	
roy,	রয়ে,	রায়,	
fake,	ফকে,	ফাকে,	
touraat,	তৌরাত,	তওরাত,	
ganakantha,	গণকণ্ঠ,	গণকণ্ঠ,	
bhushito,	ভূষিত,	ভূষিত,	
headquartus,	হেডকুয়ারাটাস,	হেডকোয়ার্টাস,	
barbadoj,	বারবাদজ,	বার্বাডোজ,	
ingreziteo,	ইংরেজিতেও,	ইংরেজিতেও,	
kekru,	কেকরু,	কেকরু,	
zeland,	জেলাযান্ড,	জিল্যান্ড,	
phareeksa,	ফারিকসা,	ফরেক্স,	
bhenom,	ভেনোম,	ভেনম,	
uddhritir,	উদ্ধৃতির,	উদ্ধৃতির,	
adhunikkaley,	আধুনিককলেয়ে,	আধুনিককালে,	
kadakhonchar,	কাদাখোচ্চার,	কাদাখোঁচার,	
abheedhaaneeck,	অভিধানিক,	অভিধানিক,	
dobhaar,	দোভার,	ডোভার,	
jund,	জান্ড,	জুন্দ,	
bishnu,	বিশ্নু,	বিষ্ণু,	
liaodong,	লিয়াদোং,	লিয়াওদং,	
suparharo,	সুপারহারো,	সুপারহিরো,	
sharif,	শারিফ,	শরিফ,	
krom,	ক্রোম,	ক্রম,	
gabinius,	গাবিনিয়াস,	গাবিনিআস,	
atwobishvashi,	অত্ববিশাশী,	আত্মবিশ্বাসী,	
naubom,	নাবুম,	নবম,	
shudhui,	শুধুই,	শুধুই,	
bahjya,	বাহ্য,	বাহ্য,	
trenda,	ট্রেন্ড,	ট্রেন্ড,	
dokkhinangsho,	দক্ষিণাংশ,	দক্ষিণাংশ,	
maradeha,	মারাদেহা,	মরদেহ,	
makame,	মাকামে,	মাকামে,	
patigoniter,	পাতিগণীতের,	পাটিগণিতের,	
oncoleo,	অঙ্কলেও,	অঞ্চলেও,	
kurdira,	কুর্দীরা,	কুর্দিরা,	
graambaasheeo,	গ্রামবশীও,	গ্রামবাসীও,	
gotihin,	গতিহীন,	গতিহীন,	
daacktickete,	ড্যাকটিকেট,	ডাকটিকিটে,	
baptics,	ব্যাপ্টিক্স,	ব্যাপটিকস,	
hondooras,	হন্দুরাস,	হন্ডুরাস,	
danata,	দানাটা,	ডোনাট,	
pacbar,	পাসবার,	পাঁচবার,	
nischitobhabe,	নিশ্চিতভাবে,	নিশ্চিতভাবে,	
mitrota,	মিত্রোটা,	মিত্রতা,	
sexperter,	সেক্সপার্টের,	সেক্সপার্টের,	
bornanukrome,	বর্ণানুক্রমে,	বর্নানুক্রমে,	
bhowanipur,	ভোওনুপীর,	ভবানীপুর,	
roopdan,	রূপডান,	রুপদান,	
daakteekite,	ডাকটিকিতে,	ডাকটিকিটে,	
bisheshshyo,	বিশেষ্ষে,	বিশেষ্য,	
sontoshpur,	সন্তস্পুর,	সন্তোষপুর,	
blacq,	বিএলএকিক,	ব্ল্যাক,	
karima,	কারিমা,	করিম,	
atak,	আটাক,	আটক,	
deputi,	ডিপিটি,	ডেপুটি,	
juakhelar,	জুয়াখেলার,	জুয়াখেলার,	
sharthe,	শার্থে,	স্বার্থে,	
manoharpur,	মনোহরপুর,	মনোহরপুর,	
encidablu,	এনসিডেব্লু,	এনসিডাব্লু,	
phartha,	ফার্থা,	ফার্থ,	
directarate,	ডিরেক্টরেট,	ডিরেক্টরেট,	
gasthi,	গাস্থি,	গোষ্ঠী,	
daakten,	ডাকটেন,	ডাকতেন,	
protishta,	প্রতিষ্টা,	প্রতিষ্টা,	
ssahocorze,	সংসরকজে,	সাহচর্যে,	
dormetori,	ডরমেটরি,	ডরমিটরি,	
padee,	পদী,	পাড়ে,	
grontho,	গ্রন্থ,	গ্রন্থ,	
neshnos,	নেশনোস,	নেশনস,	
jakatke,	জাকাতকে,	যাকাতকে,	
shtona,	শ্তনা,	স্টোন,	
drishyogulote,	দৃশ্যগুলোতে,	দৃশ্যগুলোতে,	
iksaprishana,	এক্সপৃষ্ণ,	এক্সপ্রেশন,	
innahu,	ইন্নাহু,	ইন্নাহু,	
tarkareer,	তররকারীর,	তরকারীর,	
aasar,	আসার,	আসর,	
groth,	গ্রোথ,	গ্রোথ,	
chorchita,	চর্চিতা,	চর্চিত,	
kumbhalnar,	কুম্ভলনার,	কুম্ভালনার,	
chalochchitro,	চলচ্চিত্র,	চলচ্চিত্র,	
dharabahiktite,	ধারাবাহিক্তিতে,	ধারাবাহিকটিতে,	
siramikasa,	সিরামিকাসা,	সিরামিকস,	
licenshe,	লাইসেন্স,	লাইসেন্স,	
doula,	দৌলা,	দৌলা,	
youth,	ইয়া,	ইয়ুথ,	
oisamoyer,	ঐসময়ের,	ঐসময়ের,	
transform,	ট্রান্সফর্ম,	ট্রান্সফর্ম,	
laaishheshh,	লাইশেশ,	লাইসেন্স,	
ukeliptash,	উকেলিপ্পাশ,	ইউক্যালিপ্টাস,	
eporzonto,	এপরজন্ত,	এপর্যন্ত,	
chhooteete,	ছুটেতে,	ছুটিতে,	
chittronatyokar,	চিত্রনাট্তাকার,	চিত্রনাট্যকার,	
teoyana,	তেওয়ানা,	তাইওয়ান,	
nachiketa,	নচিকেতা,	নচিকেতা,	
enjineers,	ইনজিজারিস,	ইঞ্জিনিয়ার্স,	
maail,	মাইল,	মাইল,	
baet,	বাইত,	বাইট,	
logic,	লজিক,	লজিক,	
tatey,	ট্যাটে,	তাতে,	
mukhomandaler,	মুখমান্ডলের,	মুখমণ্ডলের,	
bharatey,	ভারাতে,	ভারতে,	
dharabahikbhabe,	ধারাবাহিকভাবে,	ধারাবাহিকভাবে,	
mugdal,	মুগদাল,	মুগডাল,	
sahapathike,	সহপাঠীকে,	সহপাঠীকে,	
nishad,	নিশাদ,	নিষাদ,	
dabliudabliui,	ডাব্লিউড্যালিউ,	ডাব্লিউডাব্লিউই,	
toranganj,	তরঙ্গাঞ্জ,	তোরাবগঞ্জ,	
heena,	হীনা,	হেনা,	
shoodhooi,	শুধৌই,	শুধুই,	
esprito,	এসপ্রিতো,	এস্পিরিটো,	
hames,	হেমস,	হোমস,	
haridware,	হরিদ্বারে,	হরিদ্বারে,	
prarthitao,	প্রার্থিতাও,	প্রার্থীতাও,	
khoakshir,	খোয়ক্ষির,	খোয়াক্ষীর,	
whole,	ফোলে,	হোল,	
elaakaa,	এলাকা,	এলাকা,	
yatharthabhabe,	থাথার্াভাবে,	যথার্থভাবে,	
chhadura,	ছাদুরা,	ছাদুরা,	
glanio,	গ্লানিও,	গ্লানিও,	
hastantar,	হস্তান্তর,	হস্তান্তর,	
samratder,	সম্রাতদের,	সম্রাটদের,	
bone,	বনে,	বনে,	
kkomandar,	কোমন্দর,	কমাণ্ডার,	
daktickete,	ডাক্টিকেটে,	ডাকটিকিটে,	
vobanipur,	ভবনীপুর,	ভবানীপুর,	
chalake,	চালাকে,	চালকে,	
houzgulite,	হৌযজগুলিতে,	হাউজগুলিতে,	
chhedon,	ছেদন,	ছেদন,	
katui,	কাটুই,	কাতুই,	
shukraanoo,	শুক্রানু,	শুক্রানু,	
neermol,	নির্মল,	নির্মল,	
venkates,	ভেঙ্কেট,	ভেঙ্কটেশ,	
behrampurer,	বেহরামপুরের,	বহরমপুরের,	
kraanti,	ক্রানটি,	ক্রান্তি,	
meshintao,	মেশিনটাও,	মেশিনটাও,	
aakabar,	আটাবার,	আকাবার,	
sukumaree,	সুকুমররী,	সুকুমারী,	
byatari,	ব্যাটারি,	ব্যাটারী,	
armshtrong,	আর্মস্ট্রং,	আর্মস্ট্রং,	
gotirodh,	গতিরোধ,	গতিরোধ,	
chaalkee,	চালকি,	চালকে,	
sheetke,	শীটকে,	শীতকে,	
ivil,	ইইিল,	ইভিল,	
dagmukta,	ডাগমুক্ত,	দাগমুক্ত,	
bhaisaho,	ভৈইসহ,	ভাইসহ,	
neck,	নেক,	নেক,	
rohinibabu,	রোহিনিবাবু,	রোহিনীবাবু,	
duuma,	ডুমা,	দুমা,	
hughes,	হাগেস,	হিউজেস,	
uporitaley,	উপরিতলে,	উপরিতলে,	
pustir,	পুস্তির,	পুষ্টির,	
toxoid,	টক্সোড,	টক্সয়েড,	
kooshumba,	কুশুম্বা,	কুশুম্বা,	
nirbaaho,	নির্বাহ,	নির্বাহ,	
bojhey,	বোঝে,	বোঝে,	
furio,	ফুরিও,	ফুরিও,	
abhidhaanick,	অভিধানিক,	অভিধানিক,	
jeebnagore,	জীবনাগরে,	জীবননগর,	
pravritir,	প্রবৃতির,	প্রভৃতির,	
iqbalke,	ইকবালকে,	ইকবালকে,	
sikarer,	শিকারের,	শিকারের,	
fising,	ফিসিং,	ফিসিং,	
sahozlabhbhotar,	সহলজভভভতার,	সহজলভ্যতার,	
shamshere,	শামশেরে,	শমসের,	
nimitte,	নিমিত্তে,	নিমিত্তে,	
shringgo,	শৃঙ্গ,	শৃঙ্গ,	
muradpur,	মুরাদপুরের,	মুরাদপুর,	
kode,	কোড়ে,	কোড,	
shrabasti,	শ্রাবস্তি,	শ্রাবস্তী,	
gabhaskaar,	গাভাসকার,	গাভাস্কার,	
konoroop,	কোররূপ,	কোনরূপ,	
unitgulo,	ইউনিটগুলো,	ইউনিটগুলো,	
manob,	মানব,	মানব,	
akmato,	আকমাতো,	একমত,	
peshto,	পেশ্টো,	পেষ্ট,	
siqh,	সিখ,	শিখ,	
paripakey,	পরিপাকে,	পরিপাকে,	
shiter,	শিতের,	শীতের,	
minister,	মিনিস্টের,	মিনিস্টার,	
kailashrao,	কৈলাশরাও,	কৈলাশরাও,	
kaale,	কালে,	কালে,	
ghumachhe,	ঘুমাচে,	ঘুমাচ্ছে,	
nibondhocheler,	নিবন্ধচেলের,	নিবন্ধছেলের,	
gronthowo,	গ্রন্থওও,	গ্রন্থও,	
halding,	হ্যাডিং,	হোল্ডিং,	
kottar,	কোত্তার,	কট্টর,	
mastarsa,	মাস্তারসা,	মাস্টার্স,	
rashider,	রাশিদের,	রশিদের,	
chapchap,	চাপচাপ,	চাপচাপ,	
abosan,	অবসান,	অবসান,	
noiteek,	নৈতিক,	নৈতিক,	
manobikotao,	মানবিকতাও,	মানবিকতাও,	
generalissimo,	জেনারেলিসসিও,	জেনারেলিসিমো,	
kogake,	কোগাকে,	কোগাকে,	
bunot,	বুনোট,	বুনট,	
bhalobaas,	ভালোবাস,	ভালোবাসা,	
anusthane,	অনুষ্ঠানে,	অনুষ্ঠানে,	
lirikti,	লিরিকটি,	লিরিকটি,	
zohns,	জোস্স,	জন্স,	
ganosochetonota,	গণসকেনতা,	গণসচেতনতা,	
daaradaa,	দারাদা,	দারদা,	
bossonte,	বস্নতে,	বসন্তে,	
footbalarra,	ফুটবালারা,	ফুটবলাররা,	
mekong,	মেকং,	মেকং,	
dumaa,	ডুমা,	দুমা,	
janoganonar,	জগগনননার,	জনগণনার,	
abhidhaaneeck,	অভিধানিক,	অভিধানিক,	
yuro,	যুর,	ইউরো,	
katateo,	কাটাতেও,	কাটাতেও,	
nirmalata,	নির্মলতা,	নির্মলতা,	
pabo,	পাবো,	পাব,	
basab,	বাসাব,	বাসাব,	
alumni,	আলুমনি,	অ্যালমনি,	
militarir,	মিলিতারির,	মিলিটারির,	
banshite,	বাঁশীতে,	বাঁশিতে,	
chakurijibirao,	চাকুরিজীবীরাও,	চাকুরীজীবীরাও,	
ekroop,	একরূপ,	একরূপ,	
qara,	কারা,	কর,	
elakayi,	এলাকায়ি,	এলাকাই,	
shcholastic,	শ্ছোলাস্টিক,	স্কলাস্টিক,	
satarka,	সতর্কা,	সতর্ক,	
bostubad,	বস্তুবাদ,	বস্তুবাদ,	
graambasi,	গ্রামবাসী,	গ্রামবাসী,	
utsahamulak,	উৎসহমূলক,	উৎসাহমূলক,	
shatokeo,	শতকেও,	শতকেও,	
chupani,	চুপানি,	চুপানি,	
devolapar,	দেবলাপার,	ডেভলপার,	
horippur,	হরিপপুর,	হরিপুর,	
kalki,	কালকি,	কালকি,	
phox,	ফক্স,	ফক্স,	
kanader,	কানাদের,	কণাদের,	
tawnship,	তানশিপ,	টাউনশিপ,	
roktokhoron,	রক্তখরণ,	রক্তক্ষরণের,	
jotota,	যতা,	যতোটা,	
shhow,	সোউ,	শো,	
istoone,	ইস্তুনে,	স্টোন,	
queri,	কোয়েরি,	কোয়েরি,	
besur,	বেসুর,	বেসুর,	
pouchute,	পৌছুতে,	পৌঁছুতে,	
aaps,	এপিএসএস,	এএপিএস,	
mausumer,	মসুমের,	মৌসুমের,	
siitei,	সিতেই,	শীতেই,	
saoum,	সাওয়াম,	সাওম,	
bhugol,	ভুগোল,	ভূগোল,	
qaro,	কারো,	কারো,	
nirbaahe,	নির্বাহে,	নির্বাহে,	
futote,	ফুটোতে,	ফুটোতে,	
oxforde,	অক্সফডোর,	অক্সফোর্ডে,	
ajibooner,	অজিবুনের,	আজীবনের,	
chomski,	চমসকি,	চমস্কি,	
udvabani,	উদ্ভাবানী,	উদ্ভাবনী,	
bandhubhaabaapanna,	বন্ধুভাবানন্ন,	বন্ধুভাবাপন্ন,	
amorendro,	অমরেন্দ্র,	অমরেন্দ্র,	
gaj,	গজ,	গেজ,	
shatan,	শততান,	শয়তান,	
choshon,	চোষন,	চোষণ,	
khalid,	খালিদ,	খালিদ,	
bedey,	বেদে,	বেদে,	
udbodhani,	উদ্বোধনী,	উদ্বোধনী,	
abikaul,	অবিকাউল,	অবিকল,	
vaisoho,	ভাইসহ,	ভাইসহ,	
himchi,	হিমচি,	হিমচি,	
oblivion,	অব্লিভিওন,	অবলিভিয়ন,	
bardhitansh,	বর্ধিতনশশ,	বর্ধিতাংশ,	
asovya,	আসোভা,	অসভ্য,	
vobani,	ভোবানি,	ভবানী,	
cloring,	ক্লোরিং,	ক্লোরিং,	
commissionvogider,	কমিসনভিজদির,	কমিশনভোগীদের,	
itostatah,	ইৎস্তানা,	ইতস্ততঃ,	
udvaboney,	উদ্ভাবনে,	উদ্ভাবনে,	
phood,	ফুদ,	ফুড,	
akhando,	অখান্ড,	অখন্ড,	
sahocorje,	সহকর্জে,	সাহচর্যে,	
choritrotakeo,	চরিত্রতাকেও,	চরিত্রটাকেও,	
eucalyptus,	ইউক্লাভাপ্টাস,	ইউক্যালিপ্টাস,	
kings,	কিংস,	কিংস,	
bhabanir,	ভবনীর,	ভবানীর,	
jaistho,	জৈস্থ,	জ্যৈষ্ঠ,	
khelaphate,	খেলাফাতে,	খেলাফতে,	
venush,	ভেনুশ,	ভেনাস,	
faskari,	ফাসকারী,	ফাঁসকারী,	
rakhete,	রাখেতে,	রাখেতে,	
purbanchaler,	পূর্বাঞ্চলের,	পূর্বাঞ্চলের,	
sommotite,	সম্মতিতে,	সম্মতিতে,	
qraima,	ক্রেমা,	ক্রাইম,	
monir,	মনির,	মনির,	
drishyer,	দৃশ্যের,	দৃশ্যের,	
eeksapreeshana,	এক্সপ্রীশন,	এক্সপ্রেশন,	
baire,	বাইরে,	বাইরে,	
ronodeep,	রণদীপ,	রণদীপ,	
ashankai,	আশানকাই,	আশঙ্কাই,	
nirarthak,	নিরর্থক,	নিরর্থক,	
mohammadi,	মোহাম্মদি,	মুহাম্মদী,	
karmasampadon,	কর্মসম্পাদন,	কর্মসম্পাদন,	
totokhon,	ততোখন,	ততক্ষন,	
abdi,	আবদি,	অব্দি,	
flexta,	ফ্লেক্সটা,	ফ্লেক্সটা,	
phutbolarder,	ফুটবলারদের,	ফুটবলারদের,	
ghamta,	ঘামটা,	ঘোমটা,	
somoodrotote,	সমুদ্রতে,	সমুদ্রতটে,	
chereche,	চেরেছে,	ছেড়েছে,	
karecho,	করেছো,	করেছো,	
aziboner,	অজিবনের,	আজীবনের,	
khiladirao,	খিলাদীরাও,	খিলাড়িরাও,	
saarbhaarti,	সার্ভার্তি,	সার্ভারটি,	
dharabahikvabe,	ধারাবাহিকভাবে,	ধারাবাহিকভাবে,	
sursur,	সুরসুর,	সুরসুর,	
bairer,	বাইরের,	বাইরের,	
patjata,	পাটজাটা,	পাটজাত,	
arekdol,	আরেকদোল,	আরেকদল,	
zozyota,	যোজ্যতা,	যোজ্যতা,	
debholopar,	দেভলোপর,	ডেভলপার,	
sobrakomer,	সব্রাকমের,	সবরকমের,	
badaghat,	বাদাঘাট,	বাদাঘাট,	
chikitsanirbhar,	চিকিৎসানির্ভর,	চিকিৎসানির্ভর,	
kushumba,	কুশুম্বা,	কুশুম্বা,	
everestey,	ইভারসেট্ে,	এভারেস্টে,	
alaul,	আলালুল,	আলাওল,	
chalachchitrotike,	চালচ্ছিত্রটিকে,	চলচ্চিত্রটিকে,	
zibonnogor,	জীবন্নগর,	জীবননগর,	
miley,	মিলে,	মিলে,	
transapharma,	ট্রান্সফার্মা,	ট্রান্সফর্ম,	
khalidkay,	খালিককায়,	খালিদকে,	
neemeetto,	নিউটিত,	নিমিত্ত,	
jeebanjapon,	জীবনবাপন,	জীবনযাপন,	
detik,	দেতিক,	দেতিক,	
shukrabab,	শুক্রববব,	শুক্রবাব,	
chikitsar,	চিকিৎসার,	চিকিত্সার,	
laaisensh,	মাইসেন্স,	লাইসেন্স,	
bokul,	বকুল,	বকুল,	
hijri,	হিজরি,	হিজরী,	
khargosher,	খারগোশের,	খরগোসের,	
somraat,	সমরাত,	সম্রাট,	
sanghar,	সংঘর,	সংহার,	
probeshan,	প্রবেশন,	প্রবেশন,	
enamela,	এনামেলা,	এনামেল,	
nichols,	নিকোলস,	নিকলস,	
rahee,	রহী,	রাহি,	
capsule,	ক্যাপসুলে,	ক্যাপ্সুল,	
barder,	বারদের,	বার্ডের,	
hyaloyin,	হ্যালোয়ন,	হ্যালোইন,	
dhwajbhango,	ধ্বাভভঙ্গ,	ধ্বজভঙ্গ,	
marri,	মারি,	ম্যারি,	
munsi,	মুনসি,	মুন্সী,	
sawam,	সাবাম,	সাওম,	
scholastik,	স্কলাস্তিক,	স্কলাস্টিক,	
rena,	রেনা,	রেনো,	
munshiji,	মুন্সীজি,	মুনশীজি,	
catholicbad,	ক্যাথলিভবাড,	ক্যাথলিকবাদ,	
notikotar,	নতিকতার,	নৈতিকতার,	
jamarate,	জামারাতে,	জামারাতে,	
duburir,	ডুবুরির,	ডুবুরির,	
siddhantoke,	সিদ্ধান্তকে,	সিদ্ধান্তকে,	
sonaicha,	সোনাইচা,	সোনাইচা,	
beem,	বীম,	বিম,	
battery,	ব্যাটারি,	ব্যাটারী,	
dharmadasbabu,	ধর্মদাসবাবু,	ধর্মদাসবাবু,	
providere,	প্রভীদেরে,	প্রভাইডারে,	
poscater,	পোস্কেটের,	পশ্চাতের,	
breakthrough,	ব্রক্তরঘঘ,	ব্রেকথ্রু,	
harees,	হারিস,	হ্যারিস,	
renoo,	রেনু,	রেনো,	
dhanijomite,	ধনিজোমিতে,	ধানিজমিতে,	
ganonanatto,	গণনানত্ব,	গণনাট্য,	
chalaabi,	চালাবি,	চালাবে,	
gandhiio,	গাঁধিয়েও,	গান্ধীও,	
pancbaar,	পাঁচবার,	পাঁচবার,	
aansareer,	আনসারীর,	আনসারীর,	
zaire,	জাইরে,	জাইরে,	
sikkharthirao,	শিক্ষার্থীরাও,	শিক্ষার্থীরাও,	
kaathhmaandute,	কাঠনম্্ডুতে,	কাঠমান্ডুতে,	
ahong,	আহগ,	অহং,	
naabbota,	নাব্বতা,	নাব্যতা,	
grambaaseeder,	গ্রামবাসীদের,	গ্রামবাসীদের,	
bolatkar,	বলাটকর,	বলাৎকার,	
rajotwo,	রাজত্ব,	রাজত্ব,	
bipradas,	বিপ্রদাস,	বিপ্রদাস,	
orthoneeti,	অর্থনীতি,	অর্থনীতির,	
elaakaate,	এলাকাতে,	এলাকাতে,	
paramartha,	পরমার্থ,	পরমার্থ,	
mail,	মাইল,	মাইল,	
ateetkaale,	অতিতকালে,	অতীতকালে,	
bane,	বানে,	বনে,	
utsahi,	উৎসাহী,	উৎসাহী,	
parkin,	পারকিন,	পার্কিং,	
jones,	জোনেস,	জোন্স,	
krusher,	ক্রুসের,	ক্রুশের,	
shringge,	শ্রিগে,	শৃঙ্গে,	
dhandu,	ধন্দু,	ধন্দু,	
shomostigoto,	সমস্তিগত,	সমষ্টিগত,	
akten,	আকতেন,	অকটেন,	
eevil,	ইবিল,	ইভিল,	
jerusaleme,	জেরুসালেমে,	জেরুসালেমে,	
steen,	স্টিন,	স্টেন,	
ceramiksh,	সেরামিক্স,	সিরামিকস,	
sabrakamer,	সব্রকামের,	সবরকমের,	
marpit,	মারপিট,	মারপিট,	
setike,	সেতিকে,	সেটিকে,	
bhenicer,	ভেনিসের,	ভেনিসের,	
anichchi,	আনিচ্ছি,	আনিচ্ছি,	
bonbhumi,	বনভূমি,	বনভূমি,	
mandope,	ম্যান্ডোপ,	মন্ডপে,	
ap,	এপি,	আপ,	
laishenshim,	লাইশেন্মিং,	লাইসেন্সিং,	
lavta,	লাভটা,	লাভটা,	
gabhaaskar,	গাভাস্কার,	গাভাস্কার,	
shariba,	শারিবা,	শরিবা,	
supparak,	সুপারাক,	সুপ্পারক,	
korimpur,	করিমপুরের,	করিমপুর,	
plato,	প্লাটো,	প্লেটো,	
akeeb,	আকিব,	আকিব,	
apolokbhabe,	অপলোকভাবে,	অপলকভাবে,	
shlok,	শ্লক,	শ্লোক,	
saras,	সারাস,	সরস,	
swartho,	স্বার্থ,	স্বার্থ,	
nisader,	নিসাদের,	নিষাদের,	
europia,	ইউরোপিয়া,	ইউরোপিয়া,	
danaqana,	ডানাকানা,	ডানকান,	
modhumotii,	মধুমতিই,	মধুমতী,	
porinoti,	পরিণটি,	পরিণতি,	
vugoley,	ভুগোলি,	ভূগোলে,	
girilal,	গিরিলাল,	গিরিলাল,	
deenes,	ডিইনস,	দীনেশ,	
aaireshe,	আইরেরেশ,	আইরেসে,	
shardotsobei,	শার্দোবসদেই,	শারদোৎসবেই,	
jathartho,	যথার্থ,	যথার্থ,	
venisey,	ভেনিসে,	ভেনিসে,	
fasir,	ফাসির,	ফাসীর,	
poorohitra,	পুরোহিত্র,	পুরোহিতরা,	
ispreedshiit,	ইসপ্রিপশিট,	স্প্রেডশীট,	
deebug,	দীবুগ,	ডিবাগ,	
dhangsachchi,	ধ্বংসচ্চি,	ধ্বংসাচ্ছি,	
temonvabe,	তেমনভাবে,	তেমনভাবে,	
uthaney,	উঠানে,	উঠানে,	
kinsa,	কিনসা,	কিংস,	
aaeerese,	আওরেসে,	আইরেসে,	
bijepi,	বিজেপি,	বিজেপি,	
bishhnu,	বিশ্নু,	বিষ্ণু,	
giitikobitar,	গীতিকিবিতার,	গীতিকবিতার,	
aalkatraa,	আলকাত্রা,	আলকাতরা,	
taroni,	তারোনি,	তরণী,	
muhaiminer,	মেহাইমুনিনের,	মুহাইমিনের,	
townshhip,	টৌঁশিপ,	টাউনশিপ,	
mumtaz,	মুমতাজ,	মুমতাজ,	
horipur,	হরিপুর,	হরিপুর,	
ghomtaa,	ঘোমটা,	ঘোমটা,	
station,	স্টেশন,	ষ্টেশন,	
sohojlovyotar,	সহজলজ্যোতার,	সহজলভ্যতার,	
diniphition,	ডিনিফিশন,	ডেফিনেশন,	
plate,	প্লেট,	প্লেটে,	
yuroo,	যুরুও,	ইউরো,	
asovarno,	অসোভার্ন,	অসবর্ণ,	
suiti,	সুয়টি,	সুইটি,	
postay,	পোস্টা,	পোস্টে,	
everage,	এভারেজ,	এভারেজ,	
kobulennechha,	কবুলেনেেছা,	কবুলেন্নেছা,	
salphat,	সালফাট,	সালফেট,	
direqtareta,	ডিরেক্টরেট,	ডিরেক্টরেট,	
mitro,	মিত্রো,	মিত্র,	
dokanei,	দোকানেই,	দোকানেই,	
soommo,	সুম্মো,	সুমো,	
songasthatike,	সংস্থাটিকে,	সংস্থাটিকে,	
sachetanvabe,	সচেতনভাবে,	সচেতনভাবে,	
aashtikotaa,	আষ্টিকতা,	আস্তিকতা,	
codeti,	কোডেটি,	কোডটি,	
teenej,	তেইেজ,	টিনেজ,	
pronoti,	প্রণতি,	প্রণতি,	
veenis,	ভিনিস,	ভেনিস,	
juddhahato,	যুদ্ধাহাত,	যুদ্ধাহত,	
bhyaatikaner,	ভ্যাটিকানের,	ভ্যাটিকানের,	
kathmandu,	কাঠমণ্ডু,	কাঠমান্ডু,	
bondishalatei,	বন্দিশালাতেই,	বন্দিশালাতেই,	
pader,	পাদ়র,	প্যাডের,	
oncholeo,	অঞ্চলেও,	অঞ্চলেও,	
dhormoprobortokder,	ধর্মপ্রবর্বকদের,	ধর্মপ্রবর্তকদের,	
ganochien,	গনচিয়েন,	গণচীন,	
tuni,	তুনী,	টুনি,	
show,	শোউ,	শো,	
jemy,	জেমি,	জেমি,	
cheerontan,	চিরোন্ান,	চিরন্তন,	
pinglateo,	পিংলাতেও,	পিংলাতেও,	
rakkhandurga,	রক্ষণদূর্গ,	রক্ষণদুর্গ,	
atorkitey,	অতরকিটি,	অতর্কিতে,	
bharpur,	ভারপুর,	ভরপুর,	
acrolect,	অ্যাক্রোলেক্ট,	অ্যাক্রোলেক্ট,	
fostar,	ফস্টার,	ফস্টার,	
parabortee,	পারাবর্তী,	পরর্বতী,	
asamonjasyopurno,	অসামঞ্জসস্থূর্ণ,	অসামঞ্জস্যপূর্ণ,	
nopdnodir,	নপদনদির,	নদনদীর,	
biplobi,	বিপ্লবি,	বিপ্লবী,	
dushtogone,	দুষ্টগণে,	দুষ্টগণে,	
superheroo,	সুপারহেরো,	সুপারহিরো,	
stoonahenja,	স্তূণােঞ্জে,	স্টোনহেঞ্জ,	
wrighter,	হৃটার,	রাইটের,	
sollallhu,	সোল্লাল্লু,	সল্লাল্লাহু,	
morathee,	মোরাথি,	মরাঠি,	
subade,	সুবাদে,	সুবাদে,	
parther,	পার্থের,	পার্থের,	
deool,	ডেওলুল,	দেউল,	
vault,	ভাযালল্ট,	ভল্ট,	
akkaas,	আক্কাস,	আককাস,	
dojo,	দজ,	ডোজো,	
gaaddafee,	গড়ড়াফি,	গাদ্দাফী,	
graambasider,	গ্রামবাসীদের,	গ্রামবাসীদের,	
toufik,	তৌফিক,	তৌফিক,	
hugeke,	হুগেকে,	হিউজকে,	
dhache,	ধাছে,	ধাঁচে,	
bishaashke,	বিশাসকে,	বিশ্বাসকে,	
jhijhi,	ঝিঝি,	ঝিঝি,	
jerushalema,	জেরুশালেমা,	জেরুসালেম,	
tokeo,	টকেও,	টোকেও,	
hossne,	হোসনন,	হোসনে,	
kompeeto,	কম্পিতো,	কম্পিত,	
akpashe,	আকপাশে,	একপাশে,	
thanvi,	থানভি,	থানভী,	
shanno,	শান্ন,	সান্নো,	
heavy,	হিভি,	হেভি,	
samajeek,	সমাজিক,	সামাজিক,	
bsnleu,	বিএসএনলুউ,	বিএসএনএলইইউ,	
dinara,	দিনারা,	ডিনার,	
krechi,	ক্রেছি,	করেছি,	
abanishankar,	অবনিশঙ্কর,	অবনিশংকর,	
mokhmoley,	মখ্যলে,	মখমলে,	
daakticketer,	ড্যাকটিকেটের,	ডাকটিকিটের,	
daap,	ডাপ,	ড্যাপ,	
pleta,	প্লেটা,	প্লেটো,	
deobonde,	দেওবন্ডে,	দেওবন্দে,	
gaichhe,	গাইছে,	গাইছে,	
chowdhuryke,	চৌধুরীকে,	চৌধুরীকে,	
hadisti,	হাদিস্তি,	হাদিসটি,	
moresbai,	মোরেসবাই,	মোরেসবাই,	
nirikho,	নিরিখো,	নিরিখ,	
ansareer,	আনসারীর,	আনসারীর,	
uporitale,	উপরিতালে,	উপরিতলে,	
jontrangshogulor,	যন্ত্রাংশগুলোর,	যন্ত্রাংশগুলোর,	
swajan,	স্বজন,	স্বজন,	
vedanta,	ভেদান্তা,	বেদান্ত,	
antarctika,	অন্তর্কটিকা,	অ্যান্টার্কটিকা,	
soource,	সুর্স,	সোর্স,	
balatkar,	বালাতকার,	বলাৎকার,	
sangbadmadhyame,	সংবাদমধ্যমে,	সংবাদমাধ্যমে,	
orrgho,	অর্ঘ,	অর্ঘ্য,	
nomo,	নমো,	নমো,	
shansthaner,	শান্থানের,	সংস্থানের,	
thaanobhi,	থানোভি,	থানভী,	
hetimganje,	হেতিমগঞ্জে,	হেতিমগঞ্জে,	
gujob,	গুজোব,	গুজব,	
bhenus,	ভেনুস,	ভেনাস,	
hugheke,	হুঘেকে,	হিউজকে,	
makhno,	মখ্নো,	মাখনো,	
eexpreession,	এক্সপ্রিশন,	এক্সপ্রেশন,	
raiialati,	রায়ালতী,	রয়্যালটি,	
baaiq,	বাইক,	বাইক,	
kormokarke,	কর্মকারকে,	কর্মকারকে,	
wagadada,	ওয়াদাদা,	বাগদাদ,	
bosontoke,	বসন্তকে,	বসন্তকে,	
sadbi,	সাদবি,	সাধ্বী,	
dikpal,	ডিকপাল,	দিকপাল,	
directorate,	ডিরেক্টরেট,	ডিরেক্টরেট,	
maudelti,	মোডেলটি,	মডেলটি,	
brail,	ব্রাইল,	ব্রেইল,	
jolrang,	জোলরাং,	জলরঙ,	
elakatike,	এলাকাটিকে,	এলাকাটিকে,	
idipasha,	ইদিপাশা,	ইডিপাস,	
cs,	সিএসএ,	সিএস,	
edic,	এডিক,	এডিক,	
kanshat,	কাশশট,	কানসাট,	
seebiai,	সিবিয়াই,	সিবিআই,	
protijogii,	প্রতিযোগী,	প্রতিযোগী,	
ekok,	একো,	একক,	
baganoto,	বাগানত,	বাগানত,	
romantik,	রোমান্তিক,	রোমান্টিক,	
sohokari,	সোকারি,	সহকারী,	
bishwaashshoi,	বিশ্বশ্ষই,	বিশ্বাসই,	
dembakreeti,	দেম্বকররিটি,	ডিম্বাকৃতি,	
icelands,	ইমেস্যান্ডস,	আইসল্যান্ডসহ,	
thabai,	থাবাই,	থাবাই,	
bachai,	বাচাই,	বাছাই,	
provritike,	প্রভৃতিকে,	প্রভৃতিকে,	
bastubad,	বাস্তুবাদ,	বস্তুবাদ,	
umedpoor,	উমেমপুর,	উমেদপুর,	
arifin,	আরিফিন,	আরিফিন,	
saainyo,	সাইন্য,	সৈন্য,	
bhramarotsab,	ভ্রমারতসবব,	ভ্রমরোৎসব,	
casper,	ক্যাসপের,	ক্যাসপার,	
ponchaashjon,	পঞ্চাশজন,	পঞ্চাশজন,	
bonvumi,	বনভুমি,	বনভূমি,	
suhasini,	সুহাসিনী,	সুহাসিনী,	
chandrimaa,	চন্দ্রিমা,	চন্দ্রিমা,	
bhardwaj,	ভার্দজজ,	ভরদ্বাজ,	
durgatsober,	দুর্গাৎসবের,	দুর্গোৎসবে,	
notey,	নোটে,	নোটে,	
orthobochorke,	অর্থবছরকে,	অর্থবছরকে,	
shuperheiro,	শুপারহেরোরো,	সুপারহিরো,	
pothon,	পথন,	পঠন,	
mentither,	মেনটিথের,	মেনটিথের,	
chaudhuriyo,	চৌধুরীয়,	চৌধুরীও,	
boudher,	বৌধের,	বৌদ্ধের,	
dhyanastha,	ধ্যানস্থ,	ধ্যানস্থ,	
hitokor,	হিতোকোর,	হিতকর,	
macbeth,	ম্যাকবেথ,	ম্যাকবেথ,	
pyor,	প্যার,	পিওর,	
niutrino,	নিউট্রিনো,	নিউট্রিনো,	
dormitory,	ডরমিটরি,	ডরমিটরি,	
daltagi,	ডালতাগি,	দলত্যাগী,	
durtomo,	দূর্মমো,	দূরতম,	
municipal,	মুনিসিপাল,	মিউনিসিপ্যাল,	
elakatay,	এলাকাটায়,	এলাকাতে,	
parqa,	পারকা,	পার্ক,	
cooda,	কোডা,	কোডা,	
ramachandranke,	রামচন্দ্রনকে,	রামাচন্দ্রনকে,	
ispredsheet,	ইসপ্রাপ্িপ,	স্প্রেডশীট,	
qlauda,	ক্লাদা,	ক্লাউড,	
aporishodhito,	অপরিশোধিত,	অপরিশোধিত,	
ramantic,	রামান্টিক,	রোমান্টিক,	
parka,	পারকা,	পার্ক,	
dwijenbabuder,	দ্বিজেনবাবাদুর,	দ্বিজেনবাবুদের,	
pratijogira,	প্রতিযোগীরা,	প্রতিযোগীরা,	
brekthrough,	ব্রেক্ররুঘ,	ব্রেকথ্রু,	
vabaponno,	ভাপাবন্য,	ভাবাপন্ন,	
fokskon,	ফক্সকন,	ফক্সকন,	
landin,	ল্যান্ডিন,	ল্যান্ডিং,	
osthishondhi,	অস্থিসন্ধি,	অস্থিসন্ধি,	
shasheja,	শেশেজা,	সসেজ,	
windo,	উইন্ডও,	উইন্ডো,	
dorgah,	ডোরগাহ,	দরগাহ,	
bm,	বিএমএ,	বিএম,	
