braqe,	ব্রেক,	ব্রেক,	
bibhinno,	বিভিন্ন,	বিভন্ন,	
sikkhokder,	শিক্ষকদের,	শিক্ষকদের,	
sorting,	সর্টিং,	সর্টিং,	
monur,	মনুর,	মনুর,	
ucchosito,	উচ্চসিত,	উচ্ছসিত,	
taholo,	তাহলো,	তাহলো,	
orbi,	ওরবি,	ওরবি,	
moonshi,	মুশি,	মুন্সি,	
boikolyo,	বৈলক্য,	বৈকল্য,	
abhijitda,	অভিজিতদা,	অভিজিতদা,	
hol,	হল,	হোল,	
ashociatesh,	অ্যাসিয়েটস,	এসোসিয়েটস,	
suraropito,	সুরারণপিত,	সুরারোপিত,	
abdoone,	আব্দুনে,	আবদুন,	
senabahinikey,	সেনাবাহিণীকে,	সেনাবাহিনীকে,	
munsi,	মুনসি,	মুন্সী,	
paira,	পায়রা,	পাইরা,	
bhabanir,	ভাবানীর,	ভবানীর,	
pratisthasaho,	প্রতিষ্ঠাসহ,	প্রতিষ্ঠাসহ,	
lobbytey,	লবিটি,	লবিতে,	
nothibhukteer,	নথিভুক্তির,	নথিভুক্তির,	
byaboharkarike,	ব্যবহারকারীকে,	ব্যবহারকারীকে,	
fevarite,	ফেভারাইট,	ফেভারিট,	
siddharther,	সিদ্ধার্থের,	সিদ্ধার্থের,	
matis,	মাতিস,	ম্যাটিস,	
soundorjotakei,	সৌন্দর্যতাকেই,	সৌন্দর্যটাকেই,	
bolechile,	বলেছিলে,	বলেছিলে,	
gaj,	গাজ,	গেজ,	
bidyadanke,	বিদ্যাদনকে,	বিদ্যাদানকে,	
janamukhi,	জনমুখী,	জনমুখী,	
durlabhatwang,	দুর্লাভাত্ং,	দুর্লভত্বং,	
everage,	এভারেজ,	এভারেজ,	
asommoti,	অসম্মতি,	অসম্মতি,	
conflict,	কনফ্লিক্ট,	কনফ্লিক্ট,	
kourabe,	কৌরাবে,	কৌরবে,	
kalirkhal,	কালিরখাল,	কালিরখাল,	
uzobekeestaan,	উজোবিকেশ্ান,	উজবেকিস্তান,	
bishwaashshoi,	বিশ্বাশ্যই,	বিশ্বাসই,	
poderthobid,	পদের্থবিদ,	পদার্থবিদ,	
byaboharkareer,	ব্যবহারকারীর,	ব্যবহারকারীর,	
bo,	বো,	বু,	
ukeliptas,	উকেলিপ্যাটস,	ইউক্যালিপ্টাস,	
susamo,	সুসামো,	সুসম,	
gavaskar,	গাভাস্কার,	গাভাস্কার,	
khuizza,	খুইজ্জা,	খুইজ্জা,	
benojir,	বেনোজির,	বেনজীর,	
borkhastokritora,	বরখাস্তকৃতরা,	বরখাস্তকৃতরা,	
shansthaner,	শানস্থানের,	সংস্থানের,	
atarkitey,	আতার্কিতে,	অতর্কিতে,	
antorvukta,	অন্তর্ভক্ত,	অন্তর্ভুক্ত,	
dokanei,	দোকানেই,	দোকানেই,	
parishram,	পরিশ্রম,	পরিশ্রম,	
afzol,	আফজল,	আফজল,	
turkamena,	তুর্কামেনা,	তুর্কমেন,	
probhuder,	প্রভূদের,	প্রভুদের,	
adhunikkaley,	আধুনিকলালে,	আধুনিককালে,	
ekla,	একলা,	একলা,	
sharifpur,	শরিফপুর,	শরিফপুর,	
purohitder,	পুরোহিতদের,	পুরোহিতদের,	
shangkulaan,	সাংকুলান,	সংকুলান,	
elahabade,	এলাহাবাদে,	এলাহাবাদে,	
siit,	সিইটি,	শীত,	
daaun,	দাউন,	ডাউন,	
weenis,	ভেনিস,	ভেনিস,	
ganoporibahoner,	গণপরিবাহনের,	গণপরিবহনের,	
nabotom,	নববতম,	নবতম,	
debdebyr,	ডেবডেবর,	দেবদেবীর,	
murad,	মুরাদ,	মুরাদ,	
thyachar,	থ্যাচর,	থ্যাচার,	
sikkhakbrinda,	শিক্ষাকবৃন্দ,	শিক্ষকবৃন্দ,	
jhamala,	ঝামালা,	ঝামালা,	
bhadaka,	ভাড়াকা,	ভদকা,	
desiseyer,	ডিসিসেয়ের,	ডিজিজের,	
uqeliptas,	উকেলিপ্পাস,	ইউক্যালিপ্টাস,	
bairey,	বাইরে,	বাইরে,	
komanera,	কোমানেরা,	কমানেরা,	
jesh,	জেশ,	জেস,	
nirikho,	নিরিখো,	নিরিখ,	
mahakabi,	মহাকাবি,	মহাকবি,	
seniar,	সেনিয়ার,	সিনিয়র,	
poribahokotto,	পরিবাহকত্ব,	পরিবাহকত্ব,	
dharmantor,	ধর্মন্তর,	ধর্মান্তর,	
nothibhukta,	নথিভুক্ত,	নথিভুক্ত,	
dwipke,	দ্বীপকে,	দ্বীপকে,	
manoharpur,	মনোহরপুর,	মনোহরপুর,	
panchashjon,	পাঁচাশ্জন,	পঞ্চাশজন,	
asociatis,	অ্যাসোসিটিস,	এসোসিয়েটস,	
footbalarer,	ফুটবলারের,	ফুটবলারের,	
chalochchitreei,	চালচচিত্রী,	চলচ্চিত্রেই,	
modelgulo,	মডেলগুলো,	মডেলগুলো,	
ispreedshiit,	ইসপ্রিড্শিটি,	স্প্রেডশীট,	
sahojatprobritti,	সহযাগবৃত্রটিত্তি,	সহজাতপ্রবৃত্তি,	
baet,	বিইটি,	বাইট,	
kaia,	কাইয়া,	কায়া,	
chai,	চাই,	ছাই,	
daybhager,	দাইভাগের,	দায়ভাগের,	
srabosty,	স্রাবস্টি,	শ্রাবস্তী,	
taatey,	তাতে,	তাতে,	
poscime,	পশ্চিম,	পশ্চিমে,	
samratra,	সম্রত্র,	সম্রাটরা,	
dweepgoolotey,	দ্বিপগুলোতে,	দ্বীপগুলোতে,	
hunine,	হুনিন,	হুনাইন,	
muchi,	মুছি,	মুচি,	
procharjontrogulo,	প্রচারণয্ত্রগুলো,	প্রচারযন্ত্রগুলো,	
ingrezeeteo,	ইংরেজিতেও,	ইংরেজিতেও,	
beam,	বিম,	বিম,	
dajhyo,	দাঝ্য,	দাহ্য,	
bhenise,	ভেনিসে,	ভেনিসে,	
angshogrohon,	আংশগ্রহণ,	অংশগ্রহন,	
chheher,	ছেহের,	ছেহের,	
sethai,	সেথাই,	সেথাই,	
venisey,	ভেনিসে,	ভেনিসে,	
protinito,	প্রতিনিত,	প্রতিনিত,	
jacksonke,	জ্যাকসনকে,	জ্যাকসনকে,	
asabhya,	অসভ্য,	অসভ্য,	
jamanataswarup,	জমমনাতস্বরূপ,	জামানতস্বরূপ,	
adarsho,	আদার্ষ,	আর্দশ,	
tomader,	তোমাদের,	তোমাদের,	
aakkas,	আক্কাস,	আককাস,	
porizoner,	পরিজনের,	পরিজনের,	
konorup,	কোনোূপ,	কোনরূপ,	
serveray,	সার্ভেরা,	সার্ভারে,	
jonoshongjog,	জনসংযোগ,	জনসংযোগ,	
biphal,	বিফল,	বিফল,	
teamothy,	টিমোথি,	টিমোথি,	
nilfamarir,	নীলফামারীর,	নীলফামারীর,	
protisthan,	প্রতিষ্ঠান,	প্রতিষ্টান,	
dhormoprobortokder,	ধর্মপ্রবর্তকদের,	ধর্মপ্রবর্তকদের,	
oswasteekor,	অস্বস্থেকর,	অস্বস্তিকর,	
arthanitike,	অর্থনীতিকে,	অর্থনীতিকে,	
kailashrao,	কৈলাশ্রও,	কৈলাশরাও,	
ghoorchen,	ঘরছেন,	ঘুরেছেন,	
chhayi,	ছাই়ি,	ছাই,	
gandagol,	গান্ডাগলো,	গন্ডগোল,	
streegon,	স্ত্রীগণ,	স্ত্রীগণ,	
byomkes,	ব্যকমেস,	ব্যোমকেশ,	
mile,	মিলে,	মিলে,	
jor,	জর,	জ্বর,	
asovyo,	অসো্য,	অসভ্য,	
rohinibabu,	রোহিনীবাবু,	রোহিনীবাবু,	
alpakichudin,	অল্পচিদুনিন,	অল্পকিছুদিন,	
dreeshtiheen,	দ্রিশ্হিতীন,	দৃষ্টিহীন,	
veniser,	ভেনিসের,	ভেনিসের,	
jotinkey,	জটিনকে,	যতীনকে,	
overholing,	ওভারহলিং,	ওভারহোলিং,	
ivil,	ইইভিল,	ইভিল,	
spenser,	স্পেন্সের,	স্পেন্সার,	
chikitshar,	চিকিতসার,	চিকিত্সার,	
baieq,	ব্যইয়েক,	বাইক,	
chaka,	চাকা,	চাকা,	
kortona,	কর্তনা,	করতনা,	
soori,	সুরি,	সুরি,	
ikbaaler,	ইকবালের,	ইকবালের,	
nibobondhonkrito,	নিববন্ধন্ত্রিক,	নিববন্ধনকৃত,	
bhoutikeshu,	ভৌতিকেশু,	ভৌতিকেষু,	
trenda,	ট্রেন্ডা,	ট্রেন্ড,	
lyandim,	ল্যান্ডিম,	ল্যান্ডিং,	
rodney,	রডনি,	রেডনি,	
foxcon,	ফক্সকন,	ফক্সকন,	
asamonjasyopurno,	অসামনস্যসূপূর্ণ,	অসামঞ্জস্যপূর্ণ,	
dhanche,	ধাঁচে,	ধাঁচে,	
pakistanira,	পাকিস্তানিরা,	পাকিস্তানীরা,	
eenameela,	এনামিলা,	এনামেল,	
segulo,	সেগুলো,	সেগুলো,	
habathu,	হাবুথু,	হাবাথু,	
rastagulikeo,	রাস্তাগুলিকেও,	রাস্তাগুলিকেও,	
wilderske,	উইল্ডার্সকে,	উইল্ডার্সকে,	
muktijuddhojato,	মুক্তিযুদ্ধজহত,	মুক্তিযুদ্ধজাত,	
suiti,	সুইটি,	সুইটি,	
jonoikaa,	জনাকা,	জনৈকা,	
meghachchanno,	মেঘচাঞ্চন,	মেঘাচ্ছন্ন,	
nirvaha,	নির্ভা,	নির্বাহ,	
fatakesto,	ফাতাসেত্টো,	ফাটাকেষ্ট,	
puding,	পুডিং,	পুডিং,	
anchalgoolir,	আঞ্চলগুলির,	অঞ্চলগুলির,	
eesa,	এসএ,	আইএএস,	
bahjya,	বাহজ্জা,	বাহ্য,	
angsogrohone,	অংসগ্রহণে,	অংশগ্রহনের,	
pharanyeta,	ফরণ্যেত,	ফরম্যাট,	
calabe,	ক্যালাবে,	চালাবে,	
domone,	ডমনে,	দমনে,	
bidhirnityang,	বিধির্তিন্তাং,	বিধির্নিত্যং,	
noiteek,	নৈতিক,	নৈতিক,	
digri,	দিগ্রি,	ডিগ্রি,	
golimodhye,	গলিমধ্যে,	গলিমধ্যে,	
chadake,	চাড়কে,	চড়াকে,	
koruna,	কোরুনা,	করুণা,	
vange,	ভাঙ্গে,	ভাঙ্গে,	
assaciates,	অ্যাসিয়াসিস,	এসোসিয়েটস,	
mekon,	মেকন,	মেকং,	
eesosiyeetasa,	এসসিয়েতসস,	এসোসিয়েটস,	
sontoshpur,	সন্তোশপুর,	সন্তোষপুর,	
chirkoot,	চিরকুট,	চিরকুট,	
jerusaleme,	জেরুসালামে,	জেরুসালেমে,	
bodhir,	বোধির,	বধির,	
dhaanche,	ঢাঁচে,	ধাঁচে,	
gronthowo,	গ্রন্থও,	গ্রন্থও,	
katateo,	কাতাতেও,	কাটাতেও,	
kagbeni,	কাগবেনি,	কাগবেনি,	
lagchhe,	লাগছে,	লাগছে,	
bojiye,	বোিয়ে,	বজিয়ে,	
bandhan,	বানধন,	বাঁধন,	
morodeho,	মরদেহ,	মরদেহ,	
laatimer,	লাটিমের,	লাটিমের,	
plator,	প্ল্যাটর,	প্লেটোর,	
ul,	ইউএলএল,	উল,	
poroborti,	পরবর্তী,	পরর্বতী,	
sathik,	সাথিক,	সঠিক,	
atorkitey,	আতরকিতে,	অতর্কিতে,	
klaud,	ক্লাউড,	ক্লাউড,	
swarther,	স্বার্থের,	স্বার্থের,	
satarka,	সাতারকা,	সতর্ক,	
nutaner,	নুতানের,	নূতনের,	
korush,	করুশ,	ক্রুশ,	
headquartus,	হেডকুড়ারাটস,	হেডকোয়ার্টাস,	
nyata,	ন্যাটা,	ম্যাট,	
vobobibhuti,	ভববিভিভুটি,	ভববিভূতি,	
senabahineekey,	সেনাবাহিনীকে,	সেনাবাহিনীকে,	
parq,	পার্ক,	পার্ক,	
planeti,	প্লানেটি,	প্লেনটি,	
songasthatike,	সংস্থাসথিকে,	সংস্থাটিকে,	
uporoshtho,	উপরস্থ,	উপরস্থ,	
footbalarra,	ফুটবলাররা,	ফুটবলাররা,	
rajtantro,	রাজতন্ত্র,	রাজতন্ত্র,	
jamjamat,	জমমজাত,	জমজমাট,	
chamski,	চামসককি,	চমস্কি,	
nabbata,	নব্বাটা,	নাব্যতা,	
helloin,	হেল্লোন,	হ্যালোইন,	
booponer,	বপনের,	বপনের,	
mukhomandaley,	মুখোমন্ডলে,	মুখমণ্ডলে,	
mailkhanek,	মাইলখানেক,	মাইলখানেক,	
utpotti,	উতপত্তি,	উতপত্তি,	
jansa,	জানসা,	জন্স,	
starker,	স্টার্কের,	স্টার্কের,	
dhyanastha,	ধ্যানস্থ,	ধ্যানস্থ,	
ishtone,	ইস্তনে,	স্টোন,	
eukalyptus,	ইউকালপ্টাপস,	ইউক্যালিপ্টাস,	
elbamtite,	এলবমমটিতে,	এলবামটিতে,	
helly,	হেলি,	হিলি,	
hafej,	হাফেজ,	হাফেয,	
shaddhi,	শাদ্ধি,	সাধ্বী,	
qrisenta,	ক্রিসেন্টা,	ক্রিসেন্ট,	
echhti,	এছটি,	এছটি,	
prakar,	প্রকার,	প্রকার,	
tigmanshu,	টিগমাংশু,	তিগ্মাংশু,	
bbosben,	ব্বসবেন,	বসবেন,	
ruptan,	রূপতান,	রূপটান,	
louhojato,	লৌহজাত,	লৌহজাত,	
aansaareer,	আনসারির,	আনসারীর,	
turkii,	তুর্কি,	তুর্কি,	
munjur,	মুঞ্জুর,	মুনজুর,	
amudey,	আমুদে,	আমুদে,	
rajyotiro,	রাজ্যটিরও,	রাজ্যটিরও,	
caramiks,	ক্যারামিকস,	সিরামিকস,	
parisankhanvid,	পরিসংখ্যানভিদ,	পরিসংখ্যানবিদ,	
kraim,	ক্রাইম,	ক্রাইম,	
satjaner,	সাতজনের,	সাতজনের,	
janosamaj,	জনসামাজ,	জনসমাজ,	
bhittitei,	ভিত্তিতেই,	ভিত্তিতেই,	
faskari,	ফাস্কারি,	ফাঁসকারী,	
quata,	কোয়াটা,	কোটা,	
niemond,	নিমমন্ড,	নিমন্ড,	
sompadon,	সম্পাদন,	সম্পাদন,	
redcrosser,	রেডক্রসের,	রেডক্রসের,	
bikretara,	বিক্রেতারা,	বিক্রেতারা,	
poddhotitei,	পদ্ধতিতেই,	পদ্ধতিতেই,	
tahorir,	তাহরীর,	তাহরীর,	
pinogbagke,	পিনোগবাগকে,	পিনগবাগকে,	
literacy,	লিটারেকি,	লিটারেসি,	
aholya,	আহল্যা,	অহল্যা,	
phutonta,	ফুটনটা,	ফুটন্ত,	
supreetira,	সুপ্রিতররা,	সুপ্রীতিরা,	
eshiyetika,	এশিয়েতিকা,	এশিয়াটিক,	
chalaabi,	চালাবি,	চালাবে,	
dharmadasbabu,	ধর্মদাসবাবু,	ধর্মদাসবাবু,	
nomo,	নোমো,	নমো,	
aakik,	আকিক,	আকিক,	
boudhher,	বৌধের,	বৌদ্ধের,	
dinar,	দিনার,	ডিনার,	
sthitiko,	স্থিতিক,	স্থিতিকো,	
keyboarder,	কীয়বর্দের,	কীবোর্ডের,	
ramnathbabur,	রামনাথবাবুর,	রামনাথবাবুর,	
minilosar,	মিনিলোসার,	মিনিলোসার,	
nutunotto,	নুতুনত্ব,	নতুনত্ব,	
sadeena,	সাদিনা,	সাডেন,	
bhyatikaner,	ভ্যাতিকানের,	ভ্যাটিকানের,	
chowdhuryke,	চৌধুরিকে,	চৌধুরীকে,	
idyi,	ইইডিআই,	আইডিই,	
elakatite,	এলাকাটিতে,	এলাকাটিকে,	
vugoley,	ভাগলে,	ভূগোলে,	
gonona,	গননা,	গননা,	
salchak,	সালচাক,	সালচাক,	
hena,	হেনা,	হেনা,	
doneta,	দোনেটা,	ডোনাট,	
kyatgarite,	ক্যাটগারিতে,	ক্যাটগারিতে,	
dholeshwari,	ধলেশ্বরী,	ধলেশ্বরী,	
degreeo,	দিগ্রিও,	ডিগ্রিও,	
mumtaj,	মুমতাজ,	মুমতাজ,	
kiibord,	কাইবোর্ড,	কীবোর্ড,	
mitrota,	মিত্রতা,	মিত্রতা,	
madhumati,	মধুমতি,	মধুমতী,	
aagera,	আগেরা,	আগোরা,	
khoor,	খুর,	ক্ষুর,	
bhagnekeo,	ভাগনেকেও,	ভাগ্নেকেও,	
subader,	সুবাদের,	সুবাদে,	
jonmobhumitir,	জন্মভুমিতির,	জন্মভূমিটির,	
chhon,	ছন,	ছোঁ,	
ashiatic,	আশযাশিটিক,	এশিয়াটিক,	
mukharji,	মুখর্জি,	মুখার্জী,	
charger,	চার্জের,	চার্জার,	
mandarbani,	মনন্দরবনি,	মন্দারবাণী,	
lambaate,	লাম্বাতে,	লম্বাটে,	
aaps,	এপিএস,	এএপিএস,	
saraiki,	সারাইকি,	সরাইকি,	
sohinsotar,	সোহিন্ততার,	সহিংসতার,	
elakasoho,	এলাকাসহ,	এলাকাসহ,	
becha,	বেচা,	বেচা,	
khalid,	খালিদ,	খালিদ,	
onchalti,	অঞ্চলটি,	অঞ্চলটি,	
ratishilatai,	রতিশীলতাই,	রতিশীলতায়,	
ancholgoolir,	আঁচলোগলির,	অঞ্চলগুলির,	
maailkhanek,	মাইলখানেক,	মাইলখানেক,	
hondooras,	হন্ডোরাস,	হন্ডুরাস,	
gannaprakasham,	গণ্যাপ্রকাশম,	গন্নাপ্রকাশম,	
bandhubhaabaapanna,	বন্ধুভবপন্ন,	বন্ধুভাবাপন্ন,	
teemothy,	তিমোঠি,	টিমোথি,	
gej,	জেজ,	গেজ,	
tigre,	তিগ্রে,	টাইগার,	
melbourner,	মেলবোর্নের,	মেলবোর্নের,	
siddhante,	সিদ্ধন্তে,	সিদ্ধান্তে,	
shandra,	শান্দ্রা,	শান্দ্রার,	
audioguloke,	অডিওগুলোকে,	অডিওগুলোকে,	
kuttake,	কুট্তাকে,	কুত্তাকে,	
dhangsachchi,	ধ্বংসাচ্চি,	ধ্বংসাচ্ছি,	
rasunkunchi,	রাুনকুঞ্চি,	রসুনকুঁচি,	
besirbhaagi,	বেসিরভিগা,	বেশিরভাগই,	
ponjikar,	পন্জিকার,	পঞ্জিকার,	
satarkokari,	সতর্ককারী,	সতর্ককারী,	
miraclee,	মিরাকলি,	মিরাকেল,	
phonekari,	ফোনাকারি,	ফোনকারী,	
sanaktokaron,	সানাক্তকরণ,	সনাক্তকরণ,	
gobeshana,	গোবেশন,	গবেষনা,	
commissionvogider,	কমিসন্ভোগীদের,	কমিশনভোগীদের,	
station,	স্টেশন,	ষ্টেশন,	
shiter,	শিতের,	শীতের,	
mononiitoder,	মনোনিতদের,	মনোনীতদের,	
kampita,	কাম্পিতা,	কম্পিত,	
bisheshshyo,	বিশেষ্য,	বিশেষ্য,	
dai,	ডাই,	দিই,	
shringge,	শ্রিংগে,	শৃঙ্গে,	
nirgomon,	নির্গমন,	নির্গমন,	
drissoke,	দৃষ্যকে,	দৃশ্যকে,	
batsmanei,	ব্যাটসম্যাই,	ব্যাটসম্যানই,	
forma,	ফরমা,	ফর্মা,	
grambaseer,	গ্রাম্বাসীর,	গ্রামবাসীর,	
graminphonor,	গ্রামিনপফরণের,	গ্রামীণফোনর,	
vagni,	ভাগনি,	ভগ্নী,	
postay,	পোস্টে,	পোস্টে,	
bharpur,	ভারপুর,	ভরপুর,	
samajikotar,	সামাজিকতার,	সামাজিকতার,	
shikkharrthirao,	শিক্ষার্থীরারাও,	শিক্ষার্থীরাও,	
gorjon,	গর্জন,	গর্জন,	
comoros,	কমোরোস,	কোমোরোস,	
kode,	কোডে,	কোড,	
muhuriganj,	মুহুরীগঞ্জ,	মুহুরীগঞ্জ,	
bangalore,	বাঙ্গালোর,	ব্যাঙ্গালুরে,	
suhayeler,	সুহায়েলের,	সুহায়েলের,	
janar,	জানার,	জানার,	
dito,	দিতো,	দিতো,	
dombhoke,	দম্ভকে,	দম্ভকে,	
prokolpoti,	প্রকলপপতি,	প্রকল্পটি,	
addhattikotar,	আদ্ধাত্যকতার,	আধ্যাত্মিকতার,	
saramukhe,	সারুমুখে,	সারামুখে,	
whole,	ভোলে,	হোল,	
kusumeshu,	কুসুমেষু,	কুসুমেষু,	
phood,	ফুড,	ফুড,	
pratijogider,	প্রতিযোগীদের,	প্রতিযোগীদের,	
bisheshyo,	বিশেষ্য,	বিশেষ্য,	
bayii,	বাইই,	বাঈ,	
orhan,	ওরহান,	ওরহান,	
duhsthanostho,	দুঃস্থানস্থ,	দুঃস্থানস্থ,	
nick,	নিক,	নিক্,	
toufiq,	টৌফিক,	তৌফিক,	
playtey,	প্লেইট,	প্লেটে,	
dharmiyabhabei,	ধর্মিয়হভাবেই,	ধর্মীয়ভাবেই,	
agamane,	আগামানে,	আগমনে,	
saalsa,	সালসা,	সালসা,	
sheshardhe,	শেষার্ধে,	শেষার্ধে,	
antarctica,	আন্টার্কটিিকা,	অ্যান্টার্কটিকা,	
sarboporee,	সর্বপরী,	সর্বোপরী,	
mawdeel,	মাউলিল,	মডেল,	
pujito,	পুজিত,	পুজিত,	
kheylechen,	খেয়েছেছেন,	খেলেছেন,	
ekok,	একক,	একক,	
byabostho,	ব্যবস্থ,	ব্যাবস্থা,	
ahalyar,	আহাল্যার,	অহল্যার,	
bodna,	বোদনা,	বদনা,	
oitijhya,	ঐতিহ্যা,	ঐতিহ্য,	
procharona,	প্রচারণা,	প্রচারণা,	
monroe,	মনরোয়,	মনেরোর,	
qonfliqt,	কনফ্লিক্ট,	কনফ্লিক্ট,	
hooldim,	হোল্ডিম,	হোল্ডিং,	
protijogi,	প্রতিযোগী,	প্রতিযোগী,	
vins,	ভিন্স,	ভিন্স,	
ishter,	ইস্টার,	ইস্টের,	
tiunara,	তিউনারা,	টিউনার,	
chanoo,	চানু,	চানু,	
dubureer,	দুবুরির,	ডুবুরির,	
bhuushito,	ভূষিিত,	ভূষিত,	
tinage,	তিনাগে,	টিনেজ,	
avisongson,	অভিসংসন,	অভিশংসন,	
jounotar,	যৌনতার,	যৌনতার,	
dormroome,	ডর্মরূমে,	ডর্মরুমে,	
jotota,	যতটা,	যতোটা,	
opohoron,	অপহরণ,	অপহরন,	
nowel,	নোয়েল,	নভেল,	
nirbahey,	নির্বাহে,	নির্বাহে,	
chaalkee,	চালকি,	চালকে,	
chenza,	চেঞ্জা,	চেঞ্জ,	
jocqey,	জককে,	জকি,	
khitkar,	খিতকার,	ক্ষিতকর,	
jiland,	জিলান্দ,	জিল্যান্ড,	
bokahoke,	বোাাহকে,	বকাহকে,	
cholchhee,	চলচেই,	চলছে,	
goora,	গুরা,	গোর,	
kinsha,	কিনশা,	কিংস,	
anchalo,	অঞ্চালো,	অঞ্চলও,	
landey,	ল্যান্ডে,	ল্যান্ডে,	
khudhartara,	ক্ষুধার্তরা,	ক্ষুধার্তরা,	
kharavel,	খারাভেল,	খারবেল,	
blyaka,	ব্ল্যাক,	ব্ল্যাক,	
bagdad,	বাগদাদ,	বাগদাদে,	
aro,	আরোর,	আরও,	
thyachara,	থ্যাচার,	থ্যাচার,	
emarjenshi,	এমার্েেষি,	এমার্জেন্সি,	
shasankorta,	শাসংকর্তা,	শাসনকর্তা,	
dong,	ডং,	ডং,	
abhidhaanic,	অভিধানিক,	অভিধানিক,	
torabgonj,	তরাবগঞ্জ,	তোরাবগঞ্জ,	
adhyatmikata,	অধ্যাম্মিকতা,	আধ্যাত্মিকতা,	
phutbolarder,	ফুটবলার্ডের,	ফুটবলারদের,	
shommotir,	শম্মটির,	সম্মতির,	
ayumi,	আয়ুমি,	আয়ুমি,	
drissoteer,	দৃশ্যতির,	দৃশ্যটির,	
akpashe,	আকপাশে,	একপাশে,	
bonorajite,	বনরাজিতে,	বনরাজিতে,	
vogno,	ভগনন,	ভগ্ন,	
brahmanera,	ব্রাহ্মণেরা,	ব্রাহ্মণেরা,	
kamti,	কামটি,	কমতি,	
prothakey,	প্রথাকে,	প্রথাকে,	
cheento,	চীন্ত,	চিনতো,	
ernad,	এরনাদ,	এরনাড,	
hindutirtha,	হিন্দুতীর্থা,	হিন্দুতীর্থ,	
fuss,	ফুস,	ফাস,	
ved,	ভেড,	বেদ,	
niknayman,	নিকনায়মন,	নিকনেইমান,	
anchalgulir,	অঞ্চলগুলির,	অঞ্চলগুলির,	
landing,	ল্যান্ডিং,	ল্যান্ডিং,	
provur,	প্রভুর,	প্রভুর,	
laishensh,	লইশেন্স,	লাইসেন্স,	
kumbhalnar,	কুম্ভলননার,	কুম্ভালনার,	
heena,	হীনা,	হেনা,	
pratisthanikvabe,	প্রতিস্থানিকভাবে,	প্রাতিষ্ঠানিকভাবে,	
murader,	মুরাদের,	মুরাদের,	
hevy,	হেভি,	হেভি,	
mozdur,	মজদুর,	মজদুর,	
tapdei,	তাপদেই,	তাপড়েই,	
sobche,	সবছে,	সবচে,	
ghotleo,	ঘোটলেও,	ঘটলেও,	
eduardo,	এডুয়ার্ডো,	এডুয়ার্দো,	
japanostho,	জাপানস্থ,	জাপানস্থ,	
veemsen,	ভীমসেন,	ভীমসেন,	
teoyana,	তেওয়ানা,	তাইওয়ান,	
sadbi,	সাদবি,	সাধ্বী,	
eporjonto,	এপর্যন্ত,	এপর্যন্ত,	
cxt,	সিএসটিটি,	সিএক্সটি,	
said,	সাইদ,	সাইদ,	
sumitrar,	সুমিত্রার,	সুমিত্রার,	
kk,	কেকি,	কেকে,	
sanghatakder,	সংঘটককদের,	সংঘটকদের,	
ikboler,	ইকবলের,	ইকবলের,	
steen,	স্টীন,	স্টেন,	
qarqa,	কার্ক,	কার্ক,	
chhutochhuti,	ছুটোচুটি,	ছুটোছুটি,	
kandy,	কা্দি,	ক্যান্ডি,	
drissogulo,	দৃষ্সগুলো,	দৃশ্যগুলো,	
chhutee,	ছুটি,	ছুটি,	
drissogulote,	দৃষ্সগুলোতে,	দৃশ্যগুলোতে,	
beem,	বিম,	বিম,	
jipiusamriddha,	জিপুইসমৃদ্ধ,	জিপিউসমৃদ্ধ,	
shikshakrom,	শিক্ষাক্রম,	শিক্ষাক্রম,	
raghubar,	রঘুবার,	রঘুবীর,	
vault,	ভাল্ট,	ভল্ট,	
mumtazer,	মুমতাজের,	মুমতাজের,	
bondishalatei,	বন্দিশালাতেই,	বন্দিশালাতেই,	
ghurechen,	ঘুরেছেন,	ঘুরেছেন,	
tecnokret,	টেকনক্রেট,	টেকনোক্র্যাট,	
madelim,	মাদেলিম,	মডেলিং,	
suparichito,	সুপারিচিত,	সুপরিচিত,	
choson,	চসন,	চোষণ,	
kul,	কুল,	কুল,	
purborekorde,	পূর্বরেকর্ডে,	পূর্বরেকর্ডে,	
longhan,	লংহান,	লংঘন,	
notti,	নতটি,	নোটটি,	
bhumija,	ভূমিজা,	ভূমিজ,	
bhenasha,	ভেনশা,	ভেনাস,	
besirvagei,	বেসির্ভাগেই,	বেশিরভাগেই,	
thailandshoho,	থাইলন্ডসহ,	থাইল্যান্ডসহ,	
hastamathun,	হা্তামাঠুন,	হস্তমথুন,	
dibate,	দিবাতে,	ডিবেট,	
adhikartai,	অধিকর্তাই,	অধিকর্তাই,	
baire,	বাইরে,	বাইরে,	
monzeele,	মনজিলে,	মঞ্জিলে,	
homsher,	হোমশের,	হোমসের,	
chhatrodiger,	ছাত্রদীগের,	ছাত্রদিগের,	
prakalpatike,	প্রাকলপািতে,	প্রকল্পটিকে,	
jhijhi,	ঝিঝি,	ঝিঝি,	
europia,	ইউরোপিয়া,	ইউরোপিয়া,	
shootar,	শুতার,	শ্যুটার,	
manush,	মানুশ,	মানুষ,	
segular,	সেগুলার,	সেগুলোর,	
evaner,	ইভানের,	ইভানের,	
mesenjarer,	মেসেনজারের,	মেসেঞ্জারের,	
iraner,	ইরানের,	ইরানের,	
ajeeboner,	অজিবনের,	আজীবনের,	
balokarak,	বালোকারক,	বলকারক,	
shiqara,	শিকারা,	শিকার,	
corsin,	কর্সিন,	করসিন,	
erajyobasi,	এরজ্যবাসী,	এরাজ্যবাসী,	
mujuru,	মুজুরু,	মুজুরু,	
keyu,	কেই,	কেউ,	
sarboshokteeman,	সার্বশত্তমমন,	সর্বশক্তিমান,	
aieesha,	আইশা,	আইএএস,	
cheekitsar,	চিকিৎসার,	চিকিত্সার,	
arg,	আর্গ,	আর্গ,	
seo,	সিও,	সেও,	
taffsherer,	তাফশেরের,	তাফসীরের,	
shilpojaat,	শিল্পজাত,	শিল্পজাত,	
bornolikhon,	বর্ণলিখন,	বর্ণলিখন,	
veenis,	ভেনিস,	ভেনিস,	
siropa,	সিরোপা,	শিরোপা,	
deool,	দেওলল,	দেউল,	
armori,	আরমরি,	আরমোরি,	
shudhui,	শুধুই,	শুধুই,	
rahee,	রহহি,	রাহী,	
badaghat,	বাদাঘাট,	বাদাঘাট,	
with,	উইথ,	ভিত,	
narsinghomgulor,	নারসিংহহগুলোর,	নার্সিংহোমগুলোর,	
madhobeer,	মধবীর,	মাধবীর,	
ansareer,	আনসারির,	আনসারীর,	
lutheerana,	লুঠিরননা,	লুথেরান,	
granthatyke,	গ্রান্থটিকে,	গ্রন্থটিকে,	
chalachchitrei,	চলচ্ছিত্রেই,	চলচ্চিত্রেই,	
site,	সিতে,	সিটে,	
sangbadmadhyomgulote,	সংবাদমাধ্যমগুলোতে,	সংবাদমাধ্যমগুলোতে,	
siramikasa,	সিরামীকাসা,	সিরামিকস,	
nutoner,	নুটোনের,	নূতনের,	
purple,	পারপল,	পার্পেল,	
harbur,	হারবুর,	হারবার,	
skolastik,	স্কোলাস্তিক,	স্কলাস্টিক,	
ganjana,	গঞ্জনা,	গঞ্জনা,	
chowdhurir,	চৌধুরির,	চৌধুরীর,	
antarbhutto,	অন্তর্ভূত্ত,	অন্তর্ভুক্ত,	
annanere,	আন্নানেরে,	অন্যানেরে,	
torkareer,	তর্কারীর,	তরকারীর,	
noitikota,	নৈতিকতা,	নৈতিকতা,	
chhintayikari,	ছিন্তাই়িকারী,	ছিনতাইকারী,	
bboponer,	ব্বপনের,	বপনের,	
moushumei,	মৌশুমেই,	মৌসুমেই,	
thechar,	ঠেচার,	থ্যাচার,	
cheerontan,	চীরনততন,	চিরন্তন,	
prokalpagulo,	প্রকালপাগুলো,	প্রকল্পগুলো,	
lajik,	লাজিক,	লজিক,	
bolvodro,	বলভদ্র,	বলভদ্র,	
laat,	ল্যাট,	লাট,	
abheedhaaneeck,	অভিধানেক,	অভিধানিক,	
nathibhuktir,	নথিভুক্তির,	নথিভুক্তির,	
rashedul,	রাশেদুল,	রাশিদুল,	
siqhar,	সিখার,	শিকার,	
songkoloney,	সংকলনে,	সংকলনে,	
aarik,	আরিক,	আরিক,	
adorsho,	আদর্শ,	আর্দশ,	
horidwar,	হরিদ্বার,	হরিদ্বার,	
dakshinangsho,	দক্ষিণাংশ,	দক্ষিণাংশ,	
pronoti,	প্রণতি,	প্রণতি,	
venice,	ভেনিস,	ভেনিস,	
bhabatarini,	ভাবতরীণী,	ভবতারিণী,	
venuser,	ভেনুসের,	ভেনাসের,	
akmato,	আকমাতো,	একমত,	
toufik,	তৌফিক,	তৌফিক,	
lubitz,	লুবিতজজ,	লুবিৎজ,	
sqalarashipa,	স্কলরশিপ,	স্কলারশিপ,	
aachhis,	অ্যাচিস,	আছিস,	
jewellery,	জিয়েল্বিরি,	জুয়েলারির,	
jommu,	জম্মু,	জম্মু,	
kholdhular,	খোলধুলার,	খোলধূলার,	
platform,	প্ল্যাটফর্ম,	প্লাটফর্ম,	
ganochien,	গণছিয়ন,	গণচীন,	
shatan,	শাতান,	শয়তান,	
aarke,	আরকে,	আরকে,	
shrimoti,	শ্রীমতি,	শ্রীমতি,	
somoodrotote,	সমদ্রততে,	সমুদ্রতটে,	
parswer,	পারস্বের,	পার্শ্বের,	
shikkhartheerao,	শিক্ষার্থেরাও,	শিক্ষার্থীরাও,	
mashtarsha,	মা্তরর্ষা,	মাস্টার্স,	
khappar,	খপপপর,	খপ্পর,	
lahano,	লাহানো,	লাহানো,	
elakatike,	এলাকাটিকে,	এলাকাটিকে,	
mag,	ম্যাগ,	এমএজি,	
feemalee,	ফেমলি,	ফিমেল,	
pujit,	পুজিত,	পুজিত,	
bhogiroth,	ভোগীরথ,	ভগীরথ,	
dhanak,	ধনক,	ধানক,	
aairish,	আইরিশ,	আইরিস,	
nopdnodir,	নপডোনির,	নদনদীর,	
kaferder,	কাফেরদের,	কাফেরদের,	
doorotaumo,	দৌরতৌমৌ,	দূরতম,	
jitpur,	জিৎপুর,	জিতপুরের,	
cheess,	চেস,	চেস,	
chhooti,	ছুটি,	ছুটি,	
zommu,	জম্মু,	জম্মু,	
elaaka,	এলাকা,	এলাকা,	
kalkarkhana,	কালকরখানা,	কলকারখানা,	
bollov,	বলোভ,	বল্লভ,	
qarpeta,	কার্পেট,	কার্পেট,	
chintakarma,	চিন্তকর্মা,	চিন্তাকর্ম,	
patrol,	পাত্রলল,	পেট্রোল,	
oboshore,	অবশরে,	অবসরে,	
vvimsenn,	ভিভিমেন্স,	ভীমসেন,	
thaanobhi,	থানভি,	থানভী,	
seeramiks,	সিরামিক্স,	সিরামিকস,	
byaboharkari,	ব্যবহারকারী,	ব্যবহারকারী,	
kantojir,	কান্তজির,	কান্তজির,	
oswastikor,	অস্বাস্িকর,	অস্বস্তিকর,	
romantik,	রোমান্তিক,	রোমান্টিক,	
karmokarke,	কার্মকারকে,	কর্মকারকে,	
sinaake,	সিনাকে,	সিনাকে,	
boner,	বনের,	বনের,	
schilling,	স্কিলিং,	শিলিং,	
beshakbar,	বেশাকবার,	বেশকবার,	
flexta,	ফ্লেক্সটা,	ফ্লেক্সটা,	
jothon,	যথন,	যথন,	
parinati,	পরিণাটি,	পরিণতি,	
armeeniyana,	আর্মিনীয়ন,	আর্মেনিয়ান,	
bibader,	বিবাদের,	বিবাদের,	
venkates,	ভেঙ্কাটেস,	ভেঙ্কটেশ,	
nariider,	নারীদের,	নারীদের,	
taderek,	তাদেরেক,	তাদেরেক,	
ajijer,	অজিজের,	আজিজের,	
pulivendla,	পুলিভেন্ডলা,	পুলিভেন্ডলা,	
sangbadmadhyame,	সংবাদমধ্যমে,	সংবাদমাধ্যমে,	
gorrer,	গোরের,	গোরের,	
cs,	সিএস,	সিএস,	
cinematographar,	সিনেমাগোরফতর,	সিনেমাটোগ্রাফার,	
byaboharkariyi,	ব্যবহারকারী,	ব্যবহারকারীই,	
sangsakti,	সংংক্তি,	সংসক্তি,	
niropekkho,	নিরপেক্ষ,	নিরপেক্ষ,	
sahojlovyotar,	সাহজ্লবহযতার,	সহজলভ্যতার,	
manohputa,	মানোপুতা,	মনঃপুত,	
seramiks,	সেরামিক্স,	সিরামিকস,	
deebug,	দীবুগ,	ডিবাগ,	
dalnata,	দলনাটা,	ডালনাটা,	
shakankti,	শাকাংকটি,	শকাঙ্কটি,	
dip,	ডিপি,	দীপ,	
rajnaiteek,	রাজনীতকে,	রাজনৈতীক,	
vangley,	ভ্যাঙ্লি,	ভাঙলে,	
niketon,	নিকেতন,	নিকেতন,	
gosthike,	গোষ্ঠিকে,	গোষ্ঠীকে,	
ghumunoi,	ঘুমুনই,	ঘুমুনোই,	
asantosh,	আসন্তোষ,	অসন্তোষ,	
shrabastee,	শ্রাবস্তি,	শ্রাবস্তী,	
baganoto,	বাগানত,	বাগানত,	
rekhapat,	রেখাপাত,	রেখাপাত,	
chal,	চাল,	চাল,	
footballerra,	ফুটবাললারা,	ফুটবলাররা,	
hyaloyin,	হ্যালিনি,	হ্যালোইন,	
kirke,	কিরকে,	কিরকে,	
infarmatian,	ইনফার্মিটেন,	ইনফরমেশন,	
kosambir,	কোসাম্বীর,	কোসাম্বীর,	
nirgoon,	নিরগণ,	নির্গুণ,	
nagarikera,	নাগারিকেরা,	নাগরিকেরা,	
bade,	বাদে,	বাদে,	
apad,	আ্যাডাদ,	আপদ,	
shem,	সিম,	সেম,	
karmosansthan,	কর্মসংস্থান,	কর্মসংস্থান,	
hastantar,	হস্তান্তর,	হস্তান্তর,	
dankaan,	ডানকান,	ডানকান,	
bitertrate,	বাটারট্রেট,	বাইটারট্রেট,	
parshwer,	পার্শ্বের,	পার্শ্বের,	
shangsthaner,	সাংস্থানের,	সংস্থানের,	
omeettrakkhor,	অমেত্রাক্ষর,	অমিত্রাক্ষর,	
rajbondir,	রাজবন্দির,	রাজবন্দীর,	
agomone,	আগোমোন,	আগমনে,	
grontho,	গ্রন্থ,	গ্রন্থ,	
phuda,	ফুডা,	ফুড,	
bujhtepari,	বুঝতেপারি,	বুঝতেপারি,	
airish,	আইরিশ,	আইরিস,	
gajetted,	গেজেট্টেড,	গেজেটেড,	
shhikara,	শিকারা,	শিকার,	
chasee,	চাসে,	চেস,	
gananatyo,	গণনা্য,	গণনাট্য,	
parjotaker,	পার্যতাকের,	পর্যটকের,	
samanwitovabe,	সামান্নিতভাবে,	সমন্বিতভাবে,	
uponeesoder,	উপনিসদের,	উপনিষদের,	
hizrite,	হিজরিতে,	হিজরীতে,	
batikromi,	বাতিক্রমি,	ব্যতিক্রমী,	
kei,	কেই,	কেই,	
deares,	ডেয়ারিস,	ডিআরএস,	
kindom,	কিন্ডম,	কিংডম,	
ghoomato,	ঘুমাতো,	ঘুমাতো,	
lettere,	লেটারে,	লেটারে,	
prosadhaner,	প্রসাধনের,	প্রসাধনের,	
kanshater,	কানশাটের,	কানসাটের,	
mozlis,	মজিলস,	মজলিশ,	
onshogrohoner,	অনশগ্রহণের,	অংশগ্রহনের,	
balithubar,	বালীথুবাবার,	বালিথুবার,	
hojurer,	হজুরের,	হজুরের,	
bhutbhut,	ভূতভূত,	ভুটভুট,	
somonnitobhabe,	সমন্নিতভাবে,	সমন্বিতভাবে,	
directorete,	ডিরেক্টরেট,	ডিরেক্টরেট,	
uddhritto,	উদ্ধৃত্ব,	উদ্ধৃত,	
prrajanankaal,	প্রজনানকাল,	প্রজননকাল,	
byapoktor,	ব্যাপক্তর,	ব্যাপকতর,	
eshtonia,	এস্তোনিয়া,	এস্তোনিয়া,	
azimpur,	আজিমপুর,	আজিমপুর,	
khali,	খালি,	খালি,	
sausage,	সাউজাগে,	সসেজ,	
krishibigyani,	কৃষিবিজ্ঞানি,	কৃষিবিজ্ঞানী,	
baibosthar,	বাইবস্থার,	ব্যবস্থার,	
chalochchitreer,	চালচচিত্রীর,	চলচ্চিত্রের,	
muchlima,	মুছলিমা,	মুছলিমা,	
ghoomachhilo,	ঘুমাচছিল,	ঘুমাচ্ছিল,	
spredashiita,	স্প্রেশাটিটা,	স্প্রেডশীট,	
zoubankal,	যৌবনকাল,	যৌবনকাল,	
dobhaar,	দোভার,	ডোভার,	
ukeliptash,	উকেলিপ্তাশ,	ইউক্যালিপ্টাস,	
primoo,	প্রিমু,	প্রিমো,	
kushumba,	কুশুমববা,	কুশুম্বা,	
shasonkarta,	শাসনকর্তা,	শাসনকর্তা,	
masto,	মাস্তো,	মাস্ত,	
karecho,	কারেছো,	করেছ,	
bodhukeo,	বোধুকেও,	বধুকেও,	
kormopontha,	কর্মপন্থা,	কর্মপন্থা,	
olpo,	ওল্পো,	অল্প,	
hypar,	হাপার,	হাইপার,	
marketing,	মার্কেটিং,	মার্কেটিং,	
danaqana,	দানাকানা,	ডানকান,	
modelkey,	মডেলকে,	মডেলকে,	
charban,	চারবান,	চর্বন,	
khoakshir,	খোকশাকির,	খোয়াক্ষীর,	
ralf,	রাল্ফ,	রালফ,	
poschime,	পশ্চিমে,	পশ্চিমে,	
sangosrobomukto,	সংস্বর্মমুক্ত,	সংস্রবমুক্ত,	
ekbai,	একবাই,	একবাই,	
boudher,	বৌধের,	বৌদ্ধের,	
ancholsaha,	অ্যাঞ্চলসহ,	অঞ্চলসহ,	
ooipokar,	ঔৈপকার,	উইপোকার,	
shit,	শিট,	শীত,	
nanir,	নানির,	নানীর,	
paste,	পাস্তে,	পেষ্ট,	
bakhyateet,	বাখ্যাতিত,	ব্যাখ্যাতীত,	
nothivukto,	নথিভুক্ত,	নথিভুক্ত,	
thakeni,	থাকেনি,	থাকেনি,	
srk,	এসআরক,	শাহরুখ,	
brookoleen,	ব্রুকলীন,	ব্রুকলিন,	
mosharroph,	মশারররফ্প,	মশাররফ,	
arasie,	আরাসি,	আরসিএ,	
turista,	তুরিস্টা,	টুরিস্ট,	
dharavahiker,	ধারাবাহিকের,	ধারাবাহিকের,	
alaul,	আলাউল,	আলাওল,	
shuchonakal,	শুচনাকাল,	সূচনাকাল,	
irish,	ইরিশ,	আইরিস,	
babare,	বাবারে,	বাবারে,	
sarbhaarti,	সর্ভর্তি,	সার্ভারটি,	
reejideencee,	রিজিনিন্স,	রেসিডেন্স,	
spashtotai,	স্পষ্টতাই,	স্পষ্টতই,	
prashikkhane,	প্রশিক্ষণে,	প্রশিক্ষণে,	
pare,	প্যারে,	পাড়ে,	
bijepi,	বিজেপি,	বিজেপি,	
elakayi,	এলাকায়ি,	এলাকাই,	
utotoro,	উততর,	উততর,	
kanthar,	কান্থার,	কাঁথার,	
bangladesh,	বাংলাদেশ,	বঙ্গালাদেস,	
nottee,	নটটী,	নোটটি,	
bosano,	বোসানো,	বসানো,	
choudry,	চাড্রি,	চৌধুরী,	
kalenga,	কালেঙ্গা,	কালেঙ্গা,	
kuthibarike,	কুথিবারিকে,	কুঠিবাড়ীকে,	
durgatsob,	দুর্গটাস,	দুর্গোৎসব,	
lendal,	লেন্ডাল,	লেন্ডল,	
masjidsaho,	মাজিদসহ,	মসজিদসহ,	
mokhmoley,	মোখমলে,	মখমলে,	
salmanul,	সালমানুল,	সালমানুল,	
nibondhocheler,	নিবন্ধছেলের,	নিবন্ধছেলের,	
buth,	বাথ,	বুথ,	
qlauda,	কালাউডা,	ক্লাউড,	
veenish,	ভিনিশ,	ভেনিস,	
toler,	তোলর,	তালের,	
horippur,	হরিপপুর,	হরিপুর,	
kathghera,	কাঠঘেরা,	কাঠঘেরা,	
abadamoner,	অবদামনের,	অবদমনের,	
sumi,	সুমি,	সুমি,	
harza,	হারজা,	হার্জ,	
bhenkates,	ভেঙ্কাতেস,	ভেঙ্কটেশ,	
uporitale,	উপরিতালে,	উপরিতলে,	
bihar,	বিহার,	বিহার,	
iub,	আইউইবি,	আইইউবি,	
ghumacchilo,	ঘুমাচ্ছিল,	ঘুমাচ্ছিল,	
nisader,	নিষাদের,	নিষাদের,	
karuna,	করুনা,	করুণা,	
dakter,	ডাক্টার,	ডাকতের,	
carlos,	কারলোস,	কার্লোস,	
stana,	স্তানা,	স্টোন,	
chhutir,	ছুটির,	ছুটির,	
zesa,	জেসা,	জেস,	
flirt,	ফ্লার্ট,	ফ্লার্ট,	
chandanara,	চান্দানারা,	চন্দনারা,	
raagee,	রেজ,	রাগী,	
bitlaser,	বিটলাসের,	বিটলসের,	
chinto,	চিন্তো,	চিনতো,	
keuoi,	কেওই,	কেউই,	
bbiswashi,	বিব্বাসী,	বিশ্বাসই,	
tikta,	টিকটা,	তিক্ত,	
atmiyasulabh,	আত্মীয়সমূল্য,	আত্মীয়সুলভ,	
mangoleek,	মানলোীক,	মাঙ্গলিক,	
sarjur,	সার্জুর,	সরযূর,	
sylvi,	সিলভি,	সিলভি,	
gujab,	গুজাব,	গুজব,	
obosorer,	অবসরের,	অবসরের,	
dighol,	দিঘো,	দীঘল,	
catholicder,	ক্যাথলিকডের,	ক্যাথলিকদের,	
roopdan,	রূপান,	রুপদান,	
saabyastha,	সাব্যস্থ,	সাব্যস্থ,	
lat,	ল্যাট,	লাট,	
shekender,	শেকেন্দের,	সেকেন্ডের,	
ekghare,	একঘরে,	একঘরে,	
khanonkaj,	খাননকাজ,	খননকাজ,	
alexandar,	আলেক্সান্ডার,	আলেকজান্ডার,	
naitikatavodh,	নৈতিককাতো,	নৈতিকতাবোধ,	
vishnuu,	ভিষ্ণুও,	বিষ্ণু,	
ruble,	রাবল,	রুবল,	
anchalei,	অঞ্চালেই,	অঞ্চলেই,	
societyke,	সোিসটিকে,	সোসাইটিকে,	
onurbar,	অনুরবার,	অনুর্বর,	
bamon,	বামন,	বামন,	
korimpur,	করিমমুর,	করিমপুর,	
paroner,	পারণের,	পারণের,	
tarkale,	তারকালে,	তারকালে,	
jati,	জাতি,	যাতি,	
manab,	মানব,	মানব,	
utsahamulak,	উৎসাহামূলক,	উৎসাহমূলক,	
bonvumitey,	বনভুমিতে,	বনভূমিতে,	
eucalyptus,	ইউক্লাপেপটাস,	ইউক্যালিপ্টাস,	
sumita,	সুমিতা,	সুমিতা,	
heavy,	হেযা,	হেভি,	
meshintao,	মেশিনটাও,	মেশিনটাও,	
pillai,	পিল্লাই,	পিল্লাই,	
jhanjra,	ঝাঁজরা,	ঝাঁজরা,	
shiropar,	শিরোপার,	শিরোপার,	
sazanor,	সাজানোর,	সাজানোর,	
pingna,	পিংননা,	পিংনা,	
nirgamon,	নির্গামন,	নির্গমন,	
bohudeen,	বহুদীন,	বহুদিন,	
upacharjo,	উপাচার্য্য,	উপাচার্য,	
scuvi,	স্কিবি,	স্কুভি,	
teliha,	তেলিহা,	তেলিহা,	
edaningkale,	এডানিংকালে,	ইদানীংকালে,	
panchashjan,	পঞ্চশজ্ঞান,	পঞ্চাশজন,	
nek,	নেক,	নেক,	
chahidapotrer,	চাহিদাপত্রের,	চাহিদাপত্রের,	
oxite,	অক্সিতে,	অক্সাইট,	
baarnish,	বার্নিশ,	বার্নিশ,	
bulichev,	বুলিচেভ,	বুলিচেভ,	
firozaa,	ফিরোজা,	ফিরোজা,	
amittrakkhor,	অমিত্রাক্ষর,	অমিত্রাক্ষর,	
ponera,	পনেরা,	পনের,	
phaltu,	ফাল্তু,	ফালতু,	
kooshumba,	কোশুমবা,	কুশুম্বা,	
ispredseet,	ইসপ্রেডসটিট,	স্প্রেডশীট,	
prokar,	প্রকার,	প্রকার,	
arekdol,	আরেকডল,	আরেকদল,	
oblivion,	অব্লিভিন,	অবলিভিয়ন,	
drishyogulotey,	দৃশ্যগুলোতে,	দৃশ্যগুলোতে,	
firalem,	ফিরালেম,	ফিরালেম,	
pleena,	প্লিন,	প্লেন,	
rezidence,	রেজিডেন্সে,	রেসিডেন্স,	
rakhtokkharone,	রাতকষ্কারণে,	রক্তক্ষরণে,	
esoosiyetasa,	এসুইয়েতসসা,	এসোসিয়েটস,	
holding,	হোল্ডিং,	হোল্ডিং,	
kaatbey,	কাটবে,	কাটবে,	
naneer,	নানির,	নানীর,	
bodhirota,	বোধিরতা,	বধিরতা,	
bopoon,	বোনু,	বপন,	
nibirbhabe,	নিবিরভাবে,	নিবিরভাবে,	
soheensotar,	সোহেনসতার,	সহিংসতার,	
bhramarotsab,	ভ্রামোরস্ব,	ভ্রমরোৎসব,	
saom,	সাওয়াম,	সাওম,	
grambaasheeo,	গ্রাম্বাশীও,	গ্রামবাসীও,	
bupher,	বুফার,	বাফার,	
bouddho,	বৌদ্ধ,	বৌদ্ধ,	
ebhara,	এবারা,	এভার,	
chalochchitrogulor,	চালচ্চিত্রগুলোর,	চলচ্চিত্রগুলোর,	
apolokbhabe,	অপলোকভাবে,	অপলকভাবে,	
gloria,	গ্লোরিয়া,	গ্লোরিয়া,	
jamjomat,	জামজাতা,	জমজমাট,	
sonaktokaran,	সনাক্তকরণ,	সনাক্তকরণ,	
bipradas,	বিপ্রদাস,	বিপ্রদাস,	
ched,	চেড,	ছেদ,	
somosto,	সমস্ত,	সমস্ত,	
dhanyi,	ধনই,	ধন্যি,	
nanabornobishishto,	নানারণবির্ষিষ্ট,	নানাবর্ণবিশিষ্ট,	
baaik,	বাইক,	বাইক,	
nikate,	নিকাতে,	নিকটে,	
musolmanera,	মাসলম্নারা,	মুসলমানেরা,	
byabaharkareederke,	ব্যবহারকারীদেরকে,	ব্যবহারকারীদেরকে,	
jontropatigulite,	যন্ত্রপাগুতিগতে,	যন্ত্রপাতিগুলিতে,	
engrezder,	এংরজেদদের,	ইংরেজদের,	
oncholshomuher,	অঙ্চলসমূহের,	অঞ্চলসমূহের,	
chitronattakar,	চিত্রনাটকাার,	চিত্রনাট্যকার,	
tokee,	তোক,	তকি,	
vugorvey,	ভাগর্ভে,	ভূগর্ভে,	
ovinetar,	অভিনেতার,	অভিনেতার,	
priseflex,	প্রিসেফ্েেস্স,	প্রাইজফ্লেক্স,	
bunot,	বুনত,	বুনট,	
laga,	লাগা,	লগ,	
monjurul,	মঞ্জুরুল,	মনজুরুল,	
deh,	দেহ,	দেহ্,	
neerbachoker,	নির্বাচকের,	নির্বাচকের,	
bojhey,	বঝে,	বোঝে,	
bonke,	বং্ে,	বনকে,	
rajbandi,	রাজবন্দী,	রাজবন্দী,	
kalki,	কালকি,	কালকি,	
bojhe,	বোঝে,	বোঝে,	
hames,	হেমস,	হোমস,	
madhuri,	মধুরি,	মাধুরী,	
emarjensi,	এমারজেন্সি,	এমার্জেন্সি,	
saamaanya,	সামান্য,	সামান্য,	
morathee,	মরাথে,	মরাঠি,	
kade,	কাদে,	কোড,	
shniper,	স্পিনের,	স্নাইপার,	
supparak,	সুপপারক,	সুপ্পারক,	
crucer,	ক্রুসের,	ক্রুশের,	
jounatar,	যৌনাতার,	যৌনতার,	
rilayensa,	রিলায়েনসসা,	রিলায়েন্স,	
lambi,	লাম্বি,	লম্বি,	
dokaangoolote,	ডোকানগুলোতে,	দোকানগুলোতে,	
plate,	প্ল্যাতে,	প্লেটে,	
chilahaati,	চিলাহাটি,	চিলাহাটি,	
jakso,	জাক্সো,	যক্ষ,	
kuldip,	কুল্ডীপ,	কুলদীপ,	
dijmarescu,	দিজমাকররসু,	দিজমার্সাকু,	
vesselli,	ভেসেল্লি,	ভেসেলি,	
bhramapraban,	ভ্রমপ্রবাণ,	ভ্রমপ্রবণ,	
dadapur,	দাদাপুর,	দাদাপুর,	
poripaker,	পরিপাকের,	পরিপাকের,	
taufik,	তৌফিক,	তৌফিক,	
turisht,	টুরিস্ট,	টুরিস্ট,	
marri,	মার্রি,	ম্যারি,	
pyatarne,	প্যাটার্ন,	প্যাটার্নে,	
ekshoti,	একশটি,	একশোটি,	
nirbachokder,	নির্বাচকদের,	নির্বাচকদের,	
saoum,	সাওয়াম,	সাওম,	
bhujangta,	ভূজংটা,	ভুজঙ্গটা,	
uporitoler,	উপরিতলের,	উপরিতলের,	
rena,	রেনা,	রেনো,	
paripakey,	পরিপাকে,	পরিপাকে,	
lampot,	লামপপ,	লম্পট,	
ostad,	ওস্তাড,	ওস্তাদ,	
arthurer,	অর্থুরের,	আর্থারের,	
ekatitto,	একাতিত্ব,	একাতিত্ব,	
dharabahikotitey,	ধারাবাহিকতিতে,	ধারাবাহিকটিতে,	
dhaleshwari,	ধলেশ্বরী,	ধলেশ্বরী,	
chaudhuriyo,	চৌধুরীয়,	চৌধুরীও,	
fising,	ফিসিং,	ফিসিং,	
deefinition,	ডিফিশিশন,	ডেফিনেশন,	
krisenter,	ক্রিসেন্টের,	ক্রিসেন্টের,	
jeebnagore,	জীবনাগরে,	জীবননগর,	
poriskoron,	পরিস্করণ,	পরিষ্করণ,	
chaalaabi,	চালাবি,	চালাবে,	
tanu,	তানু,	তনু,	
mataram,	মাতারাম,	মাতরম,	
brindaboney,	বৃন্দাবনে,	বৃন্দাবনে,	
ahmed,	আহমেদ,	আহামদ,	
hoonayin,	হুনাইন,	হুনাইন,	
sonaicha,	সোনাইছা,	সোনাইচা,	
srisri,	স্রীসরি,	শ্রীশ্রী,	
horipur,	হরিপুর,	হরিপুর,	
soinyora,	সৈন্যরা,	সৈন্যরা,	
riphleksa,	রিফলেকসা,	রিফ্লেক্স,	
chaudhurio,	চৌধুরিও,	চৌধুরীও,	
makhno,	মাখনো,	মাখনো,	
kani,	কানি,	কানি,	
neemeetto,	নিমেত্তো,	নিমিত্ত,	
sookumari,	শুকুমারী,	সুকুমারী,	
kamla,	কামলা,	কামলা,	
aatto,	আট্টো,	আত্ম,	
somsher,	সোমশের,	সমশের,	
aporishodhito,	অপরিষোধিত,	অপরিশোধিত,	
ghotolen,	ঘটলেন,	ঘটলেন,	
onupater,	অনুপাতের,	অনুপাতের,	
ashirbadatri,	আশির্রাব্তদির,	আশীর্বাদাত্রী,	
nikela,	নিকেলা,	নিকেল,	
shudhir,	শুধির,	শুধীর,	
patigoniter,	পাতিগণিতের,	পাটিগণিতের,	
tateo,	তাতেও,	তাতেও,	
sahapathike,	সহপাঠিকে,	সহপাঠীকে,	
poste,	পোস্তে,	পোস্টে,	
bhabanipur,	ভবণীনপুর,	ভবানীপুর,	
horas,	হোরাস,	হোরাস,	
chyeta,	চ্যেট,	চ্যাট,	
rananganey,	রণনঙ্গে,	রণাঙ্গনে,	
parkasa,	পারকাসা,	পার্কস,	
bhaangchur,	ভাংচুর,	ভাংচুর,	
torabganj,	তোরাবগঞ্জ,	তোরাবগঞ্জ,	
pouchute,	পৌছুতে,	পৌঁছুতে,	
kobutorer,	কবুতরের,	কবুতরের,	
anagarikra,	আনাগারিকরা,	অনাগরিকরা,	
bisshaskey,	বিশ্বাসকে,	বিশ্বাসকে,	
udor,	উদর,	উদর,	
orthanitike,	অর্থানিতিকে,	অর্থনীতিকে,	
badhamuktovabe,	বাধামুক্তভাবে,	বাধামুক্তভাবে,	
bbosonto,	ব্বসন্ত,	বসন্ত,	
bhaandar,	ভান্ডার,	ভাণ্ডার,	
kod,	কোড,	কোড,	
arke,	আরকে,	আরকে,	
jakatke,	জাকাতকে,	যাকাতকে,	
aakaabaar,	আকাবার,	আকাবার,	
nepchooner,	নেপচুনের,	নেপচুনের,	
female,	ফেমালে,	ফিমেল,	
dhamshrenite,	ধামশ্রেণীতে,	ধামশ্রেণীতে,	
daktickete,	ডাক্টিকেতে,	ডাকটিকিটে,	
tawnship,	তাবশিপ,	টাউনশিপ,	
towraat,	টাররট,	তওরাত,	
bairer,	বাইরের,	বাইরের,	
deenesh,	দিনেশ,	দীনেশ,	
shibraj,	শিবরাজ,	শিবরাজ,	
suraaropeeto,	সুরাপরিত,	সুরারোপিত,	
ramantika,	রামন্তিকা,	রোমান্টিক,	
musalmanderke,	মুসলমান্ডদেরকে,	মুসলমানদেরকে,	
hozot,	হজত,	হজত,	
shringgo,	শ্রিংগো,	শৃঙ্গ,	
phising,	ফিসিং,	ফিসিং,	
dubaate,	দুবাতে,	ডুবাতে,	
ekirokom,	একিরকম,	একইরকম,	
protizogii,	প্রতিযোগী,	প্রতিযোগী,	
proteemar,	প্রতিমার,	প্রতিমার,	
oikhan,	ঐখান,	ঐখান,	
kinto,	কিন্তো,	কিনত,	
swadesh,	স্বদেশ,	স্বদেশ,	
myat,	ম্যাত,	ম্যাট,	
kaferderke,	কাফেরদেরকে,	কাফেরদেরকে,	
carlosh,	কারলোশ,	কার্লোস,	
shucharita,	শুচারিতা,	সুচরিতা,	
obharbhiu,	অভারভিউ,	ওভারভিউ,	
chhooteete,	ছুটিতে,	ছুটিতে,	
graambasi,	গ্রামবাসি,	গ্রামবাসী,	
dhos,	ধোস,	ধস,	
barack,	ব্রাকাক,	বারাক,	
shotodha,	ষতধা,	শতধা,	
prity,	প্রিটি,	প্রিটি,	
dhormokorme,	ধর্মকর্মে,	ধর্মকর্মে,	
chalachchitrer,	চলচ্ছিত্রের,	চলচ্চিত্রের,	
debeting,	ডেবেটিং,	ডিবেটিং,	
install,	ইন্সটাল,	ইন্সটল,	
kuhelika,	কুহেলিকা,	কুহেলিকা,	
jhumjhumita,	ঝুমঝুমিতা,	ঝুমঝুমিটা,	
artilary,	আর্টিলারি,	আর্টিলারি,	
shomser,	শোমসের,	সমশের,	
bisheshshyer,	বিশেষ্যের,	বিশেষ্যের,	
atmabishvashi,	আত্মাীবাশী,	আত্মবিশ্বাসী,	
hool,	হুল,	হুল,	
amontronkarider,	অমন্ত্রনারীকদের,	আমন্ত্রণকারীদের,	
unchiyechilo,	উঁচিয়েছিলো,	উঁচিয়েছিল,	
difinisian,	ডিফিশিনিয়ান,	ডেফিনেশন,	
bhageri,	ভাগেরি,	ভাগেরই,	
kadapaker,	কাড়াপাকের,	কড়াপাকের,	
lavta,	লাভটা,	লাভটা,	
scholastik,	স্কোলাস্তিক,	স্কলাস্টিক,	
gyada,	জ্যাদা,	গ্যাদা,	
ongshogrohoner,	অংশগ্রহণের,	অংশগ্রহনের,	
prithibir,	পৃথিবীর,	পৃথবীর,	
phokser,	ফক্সের,	ফক্সের,	
saurce,	সার্স,	সোর্স,	
nanilalke,	নানীলালকে,	ননীলালকে,	
temone,	তেমোে,	তেমনই,	
stoonahenja,	স্তনহানেজ্জা,	স্টোনহেঞ্জ,	
chandrima,	চানদ্রিমা,	চন্দ্রিমা,	
musalmani,	মুসলমানি,	মুসলমানই,	
bhangchur,	ভাংচুর,	ভাংচুর,	
jaanar,	জানার,	জানার,	
yaq,	যাক,	ইয়াক,	
obosan,	অবসান,	অবসান,	
azijer,	আজিজের,	আজিজের,	
prarthonakokkher,	প্রার্ননাক্ষেকের,	প্রার্থনাকক্ষের,	
karadando,	কারাদান্ডো,	কারাদণ্ড,	
karmake,	কারমেকে,	কর্মকে,	
pooshteer,	পুষ্টীর,	পুষ্টির,	
phormat,	ফরমাত,	ফরম্যাট,	
moshzidtike,	মসজিদটিকে,	মসজিদটিকে,	
edmiral,	এডমিরাল,	এডমিরাল,	
damakalkarmirao,	দমকলককর্মীরাও,	দমকলকর্মীরাও,	
shunani,	শুনানি,	শুনানী,	
alankorana,	আলানকরণ,	অলঙ্করণ,	
duple,	ডাপলে,	ডুপ্লে,	
armstronz,	আর্মস্ট্রাজজ,	আর্মস্ট্রং,	
khaaneker,	খানেকের,	খানেকের,	
bulano,	বুলানো,	বুলান,	
bohoodin,	বহদিন,	বহুদিন,	
shasheja,	শাশেজা,	সসেজ,	
byaptikaler,	ব্যাপ্তিকালের,	ব্যাপ্তিকালের,	
catholicbad,	ক্যাথলিকবাড,	ক্যাথলিকবাদ,	
temanti,	তেমানটি,	তেমনটি,	
laps,	ল্যাপস,	ল্যাপস,	
rushod,	রুশদ,	রুশদ,	
anyarup,	অন্যরূপ,	অন্যরূপ,	
mimgulor,	মিমগুলোর,	মিমগুলোর,	
nathivookteer,	নাথিভুক্তির,	নথিভুক্তির,	
sosoa,	সোসো,	শশা,	
abeganuvutir,	অবেগানুভুতির,	আবেগানুভূতির,	
dolphiny,	ডলফিনি,	ডলফিনি,	
artherer,	আর্থারের,	আর্থারের,	
jaandrel,	জ্যাণ্ড্রেল,	জাঁদরেল,	
zubokra,	যুবোকরা,	যুবকরা,	
reflex,	রিফ্লেক্স,	রিফ্লেক্স,	
greenald,	গ্রিনাল্ড,	গ্রিনল্ড,	
nartana,	নারতানা,	নর্টন,	
sikara,	সিকারা,	শিকার,	
adhyattikota,	অধ্যাত্মকতা,	আধ্যাত্মিকতা,	
deilee,	দেইলি,	ডেইলি,	
elakai,	এলাকাই,	এলাকাই,	
relance,	রিল্যান্সে,	রিলায়েন্স,	
balaruma,	বালারুমা,	বলরুম,	
aaireshe,	আইরেশে,	আইরেসে,	
mausumeo,	মুসুমেও,	মৌসুমেও,	
gujob,	গুজব,	গুজব,	
gingbhalobasen,	গিনভালবাসোনে,	গিংভালোবাসেন,	
omarader,	ওমারাদের,	ওমারাদের,	
sukumaree,	সুকুমারী,	সুকুমারী,	
bhotomulyoke,	ভোটমূল্যকে,	ভোটমূল্যকে,	
koomarir,	কমমারীর,	কুমারীর,	
capsul,	ক্যাপসুল,	ক্যাপসুল,	
sompadonkaree,	সম্পাদনকারী,	সম্পাদনকারী,	
chopal,	চোপাল,	চপল,	
maritimer,	মারিটিমের,	মেরিটাইমের,	
shef,	শেফ,	শেফ,	
gronthao,	গ্রন্থাও,	গ্রন্থও,	
eexpreession,	ইক্কপ্রিশন,	এক্সপ্রেশন,	
sawam,	সোয়াম,	সাওম,	
bisheshya,	বিশেষ্য,	বিশেষ্য,	
residence,	রেসিডেন্সে,	রেসিডেন্স,	
ansarir,	আনসারির,	আনসারীর,	
mukhomandal,	মুখোমন্ডল,	মুখমণ্ডল,	
riazuddin,	রিয়াউদদিন,	রিয়াজউদ্দীন,	
annorup,	অন্যরূপ,	অন্যরূপ,	
rajendracholer,	রজেন্দ্রাললের,	রাজেন্দ্রচোলের,	
monzushree,	মনজুশ্রী,	মঞ্জুশ্রী,	
kingsh,	কিংস,	কিংস,	
haripur,	হরিপুর,	হরিপুর,	
bossonte,	বসন্তে,	বসন্তে,	
gandhariir,	গান্ধারীর,	গান্ধারীর,	
grooth,	গ্রুথ,	গ্রোথ,	
oncholshomuh,	অঙ্ছলসূূহ,	অঞ্চলসমূহ,	
panda,	পান্ডা,	পান্ডে,	
torunosomriddho,	তরুণসমৃদ্ধ,	তরুণসমৃদ্ধ,	
turkyder,	টার্কিদের,	তুর্কিদের,	
holdim,	হোল্ডিম,	হোল্ডিং,	
zaire,	জাইরে,	জাইরে,	
konruup,	কননরূপ,	কোনরূপ,	
bangobandhu,	বঙ্গবন্ধু,	বঙ্গবন্ধু,	
ranangane,	রণাঙ্গনে,	রণাঙ্গনে,	
sahittekder,	সাহিত্যেেদের,	সাহিত্যেকদের,	
cholochchitrake,	চলচ্চিত্রাকে,	চলচ্চিত্রকে,	
groundta,	গ্রাউন্ডটা,	গ্রাউন্ডটা,	
teenisa,	তীনিসা,	টেনিস,	
bojhao,	বোঝাও,	বোঝাও,	
shcholastic,	স্চোলাস্টিক,	স্কলাস্টিক,	
nirapattamulok,	নিরাপত্তামূলক,	নিরাপত্তামূলক,	
orthisoho,	অর্থিসহ,	অর্থিসহ,	
siddhanto,	সিদ্ধান্ত,	সিদ্ধান্তও,	
prothar,	প্রথার,	প্রথার,	
laaisens,	লাইসেন্স,	লাইসেন্স,	
byatikrami,	ব্যতিক্রমী,	ব্যতিক্রমী,	
heze,	হেজে,	হেজ,	
bibechyo,	বিবেচ্য,	বিবেচ্য,	
harees,	হাযারিস,	হ্যারিস,	
munim,	মুনিম,	মুনিম,	
darji,	দার্জি,	দরজি,	
bhogno,	ভগ্ন,	ভগ্ন,	
armashtram,	আর্মাষ্ট্রম,	আর্মস্ট্রং,	
suri,	সুরি,	সুরি,	
cheerokoomari,	চেরকোমারি,	চিরকুমারী,	
boshoborty,	বোরোবটি,	বশবর্তী,	
rachonakal,	রচনাকাল,	রচনাকাল,	
drabyatah,	দ্রাব্যাহ,	দ্রব্যতঃ,	
odeb,	ওডেব,	ওদেব,	
batistambhatike,	বাতিস্তামভভিতে,	বাতিস্তম্ভটিকে,	
hosney,	হোনয়ে,	হোসনে,	
shite,	শিতে,	শীতে,	
jahangirbad,	জাহাঙ্গীরবাদ,	জাহাঙ্গীরবাদ,	
jomoker,	জমকের,	জমকের,	
sangram,	সংগ্রাম,	সঙ্গ্রাম,	
courtcaser,	কার্টক্সের,	কোর্টকেসের,	
bishnoo,	বিষ্ণ,	বিষ্ণু,	
cinemapremider,	সিনেমাপ্রেমিদের,	সিনেমাপ্রেমীদের,	
chereche,	চেরেছে,	ছেড়েছে,	
armshtrong,	আর্মশ্্র্ং,	আর্মস্ট্রং,	
rayyaleti,	রায়ায়ালটি,	রয়্যালটি,	
hosne,	হো্নে,	হোসনে,	
cholochchitrai,	চলচ্চিত্রায়,	চলচ্চিত্রই,	
tookror,	টুকর,	টুকরোর,	
siddhantei,	সিদ্ধন্তেই,	সিদ্ধান্তেই,	
milekhaanek,	মিলেখানেক,	মাইলখানেক,	
neshnos,	নেশনস,	নেশনস,	
bhushito,	ভূষিত,	ভূষিত,	
cholochchitrer,	চলচ্চিত্রের,	চলচ্চিত্রের,	
uindos,	উইনডোস,	উইন্ডোস,	
cuti,	কিউটি,	কিউটি,	
chhuti,	ছুটি,	ছুটি,	
awrbit,	আরবিট,	অরবিট,	
booroon,	বুরুন,	বোরন,	
parther,	পার্থার,	পার্থের,	
somoibo,	সমযৈব,	সমৈব,	
deenes,	ডিনেস,	দীনেশ,	
shilver,	শিলভের,	সিলভার,	
bibecchyo,	বিবেক্ছ্য,	বিবেচ্য,	
niutrino,	নিউট্রিনো,	নিউট্রিনো,	
roktokhoron,	রক্তকরণ,	রক্তক্ষরণের,	
aswasteekor,	অস্বস্থেকর,	অস্বস্তিকর,	
freelancerra,	ফ্রীল্যান্ডারেরা,	ফ্রিল্যান্সাররা,	
hock,	হক,	হুক,	
dekhso,	দেখসো,	দেখসো,	
boiporiityen,	বৈপরিিত্যেন,	বৈপরীত্যেন,	
uparjoner,	উপার্যনের,	উপার্জনের,	
anandamahale,	আনন্দমহলে,	আনন্দমহলে,	
bouddher,	বৌদ্ধের,	বৌদ্ধের,	
moshahidur,	মোশাহিদুর,	মোশাহিদুর,	
azin,	আজিন,	আজিন,	
pacbar,	প্যাকবার,	পাঁচবার,	
lutherana,	লুঠেরানা,	লুথেরান,	
songasthaner,	সংস্থান্নের,	সংস্থানের,	
dakkhinkare,	দক্ষিণকারে,	দক্ষিণকরে,	
browser,	ব্রাভার,	ব্রাউজার,	
themekey,	থেমেকে,	থিমকে,	
snehban,	স্নেহবান,	স্নেহবান,	
ghoshito,	ঘোষিত,	ঘোষিত,	
brake,	ব্রেকে,	ব্রেক,	
gronther,	গ্রন্থের,	গ্রন্থের,	
shuri,	শুরি,	সুরি,	
corymb,	কররমমব,	করিম,	
mukhobondho,	মুখবন্ধ,	মুখবন্ধ,	
samle,	সামলে,	সামলে,	
alkatra,	আলকাত্রা,	আলকাতরা,	
gandhiio,	গাঁধধিও,	গান্ধীও,	
perri,	পেরি,	পেরি,	
bhabarlaler,	ভববরালের,	ভবরলালের,	
swastir,	স্বস্তির,	স্বস্তির,	
manushgulor,	মানুষগুলোর,	মানুষগুলোর,	
emiratas,	এমিরাতাস,	এমিরেটাস,	
chopol,	চপল,	চপল,	
samajik,	সামাজিক,	সামাজিক,	
shomostigoto,	শমস্তিগত,	সমষ্টিগত,	
noiteekotar,	নৈতেছকতার,	নৈতিকতার,	
graambaaseeo,	গ্রামবাসওয়ো,	গ্রামবাসীও,	
karore,	কাররে,	কারোর,	
torkarir,	তরকারির,	তরকারীর,	
saifai,	সাইফাই,	সাইফাই,	
bishnu,	বিষ্ণু,	বিষ্ণু,	
porishongkhanbid,	পরিষংখানাবিদ,	পরিসংখ্যানবিদ,	
eokee,	ইজকি,	এওকি,	
goolen,	গোলেন,	গুলেন,	
chaaktir,	চাকটির,	চাকতির,	
arshie,	আর্শি,	আরসিএ,	
nabatarange,	নবতর্গে,	নবতরঙ্গে,	
ancholsomuho,	আঞ্চলসমূহ,	অঞ্চলসমূহ,	
phiksa,	ফিকসা,	ফিক্স,	
jolaatonko,	জলাাতনক,	জলাতঙ্ক,	
choopi,	চুপি,	চুপি,	
protibedokrao,	প্রতিবেদকরাও,	প্রতিবেদকরাও,	
bhimsen,	ভীমসেন,	ভীমসেন,	
jalarong,	জালারং,	জলরঙ,	
balakarak,	বালাকারক,	বলকারক,	
deepan,	দীপান,	দীপন,	
masjidsaha,	মাজদিসহ,	মসজিদসহ,	
prajanankal,	প্রজননকাল,	প্রজননকাল,	
blasterke,	ব্লাস্টারকে,	ব্লাস্টারকে,	
cloring,	ক্লরিং,	ক্লোরিং,	
fanding,	ফ্যান্ডিং,	ফান্ডিং,	
volivoler,	ভলিভলের,	ভলিভলের,	
zoojyota,	যুজ্যতা,	যোজ্যতা,	
jini,	জিনী,	যিনি,	
mathews,	ম্যাথেভস,	ম্যাথিউস,	
temonvabe,	টেমনভাবে,	তেমনভাবে,	
kayed,	কায়েদ,	কায়েদ,	
mekong,	মেকং,	মেকং,	
nyeta,	নিতা,	ম্যাট,	
jund,	জান্ড,	জুন্দ,	
samashtike,	সমাশটিকে,	সমষ্টিকে,	
chhedon,	ছেদন,	ছেদন,	
kaamij,	কামিজ,	কামিজ,	
laaz,	লাজ,	লাজ,	
directarate,	ডিরেক্টরেট,	ডিরেক্টরেট,	
daqop,	ডাকপ,	দাকোপ,	
assexe,	অ্যাসেক্সে,	অ্যাসেক্সে,	
nirobota,	নিরোবতা,	নিরবতা,	
jones,	জোনেস,	জোন্স,	
dharavahik,	ধারাবাহিক,	ধারাবাহিক,	
tophaat,	টোফাত,	তফাৎ,	
tottorat,	তত্ত্বার,	তওরাত,	
malinga,	মালিঙ্গা,	মালিংগা,	
byomkesh,	ব্যকেেশ,	ব্যোমকেশ,	
mozdoor,	মজদুর,	মজদুর,	
vromonkaley,	ভ্রোমনকালে,	ভ্রমণকালে,	
kramp,	ক্রাম্প,	ক্র্যাম্প,	
jalbe,	জালবে,	জ্বলবে,	
sahooseekotar,	সাহসেকতার,	সাহসিকতার,	
asif,	আসিফ,	আসিফ,	
atibiplabi,	অতিবিপ্লবল,	অতিবিপ্লবি,	
sangbadmadhyome,	সংবাদমাধ্যমে,	সংবাদমাধ্যমে,	
kotibondhe,	কতিবন্ধে,	কটিবন্ধে,	
narbur,	নারবুর,	নরবুর,	
maudelgulo,	মোডেলগুলো,	মডেলগুলো,	
ekbakke,	একবাককে,	একবাক্যে,	
indro,	ইন্দ্রো,	ইন্দ্র,	
faaj,	ফাজ,	ফাজ,	
kaalki,	কালকি,	কালকি,	
windo,	উইন্ডো,	উইন্ডো,	
oitijhyotike,	ঐতিহ্যটিকে,	ঐতিহ্যটিকে,	
bastubad,	বাস্তুবাদ,	বস্তুবাদ,	
kantajir,	কান্তজির,	কান্তজির,	
rudrasagar,	রুদ্রসাগর,	রুদ্রসাগরের,	
sten,	স্টেন,	স্টেন,	
meloonborroner,	মেলোবর্ণরের,	মেলবোর্নের,	
dwijenbabuder,	দ্বিজেনবাবুদের,	দ্বিজেনবাবুদের,	
hugheke,	হুগেকে,	হিউজকে,	
daaktikite,	দাকটিকিতে,	ডাকটিকিটে,	
tukrote,	তুকরোতে,	টুকরোতে,	
bikargrosto,	বিকার্গরস্ত,	বিকারগ্রস্ত,	
duburir,	দুবুরির,	ডুবুরির,	
durgatsabe,	দুর্গাতসবে,	দুর্গোৎসবে,	
bite,	বিতে,	বাইট,	
pabo,	পাবো,	পাব,	
bedanta,	বেদান্ত,	বেদান্ত,	
aborto,	আবর্তো,	আবর্ত,	
basaake,	বাসাকে,	বাসাকে,	
karpeter,	কার্পেটের,	কার্পেটের,	
nathivukteer,	নাথিভুক্তের,	নথিভুক্তির,	
nirabota,	নিরাবতা,	নিরবতা,	
parisankhanbid,	পরিসংখ্যানবিদ,	পরিসংখ্যানবিদ,	
satyaky,	সতত্যাক,	সাত্যকি,	
shlok,	শ্লক,	শ্লোক,	
danata,	দানাটা,	ডোনাট,	
milton,	মিলটন,	মিলটন,	
shourshe,	শূর্ষে,	সোর্স,	
porirshoder,	পরির্ষদের,	পরির্ষদের,	
madrasi,	মাদরাাি,	মাদ্রাজি,	
itostatah,	ইতস্তাহা,	ইতস্ততঃ,	
saazano,	সাজানো,	সাজানো,	
shringa,	শ্রিংগা,	শৃঙ্গ,	
bokul,	বকুল,	বকুল,	
nirmolota,	নির্মলতা,	নির্মলতা,	
diznee,	দিজনি,	ডিজনী,	
vaticaner,	ভ্যাটিকেনের,	ভ্যাটিকানের,	
joubanbatee,	যৌবনবাতী,	যৌবনবতী,	
pratista,	প্রতিষ্টা,	প্রতিষ্টা,	
rakim,	রাকিম,	রাকিম,	
mookhomaundoler,	মুখমাউন্ডলের,	মুখমণ্ডলের,	
volapuk,	ভোলাপুক,	ভোলাপুক,	
kaley,	কালে,	কালে,	
narishwar,	নারীশ্বর,	নারীশ্বরের,	
gardeen,	গার্ডিন,	গার্ডেন,	
heteler,	হেটেলের,	হেটেলের,	
dai,	ডাই,	ডে,	
akkharkey,	আক্ষরকে,	অক্ষরকে,	
chupani,	চুপানী,	চুপানি,	
oporishodhito,	অপরিষোধিত,	অপরিশোধিত,	
choritrotakeo,	চরিত্রতাকেও,	চরিত্রটাকেও,	
daakteekite,	দাকটিকীতে,	ডাকটিকিটে,	
erokomer,	এরোকমের,	এরকমের,	
dishani,	দিশানি,	দিশানি,	
dabliudabliui,	ডাব্ডিউললিউবলি,	ডাব্লিউডাব্লিউই,	
vimsen,	ভিমসেন,	ভীমসেন,	
granada,	গ্রানাদা,	গ্র্যানাডা,	
besooro,	বেসরো,	বেসুর,	
madeling,	মাযেডিং,	মডেলিং,	
sooya,	সূয়া,	সোয়া,	
moddhyoshtho,	মধ্যোষ্ঠ,	মধ্যস্থ,	
dabarer,	দাবারের,	দাবারের,	
bolatkar,	বলাতকার,	বলাৎকার,	
antorbhuktimulak,	আন্তর্ভূতিমূলক,	অন্তর্ভুক্তিমূলক,	
nathivookto,	নাথীভুক্ত,	নথিভুক্ত,	
bhaisaho,	ভাইসহ,	ভাইসহ,	
taronee,	তারণী,	তরণী,	
gaddaafee,	গড়দাফি,	গাদ্দাফী,	
tooku,	টুকু,	টুকু,	
bosontoke,	বসনততকে,	বসন্তকে,	
biswashi,	বিশ্বাসি,	বিশ্বাসী,	
sotorkobhabey,	সতর্কভাবে,	সতর্কভাবে,	
shainyader,	শৈন্যদের,	সৈন্যদের,	
america,	আমেরিকা,	আমেরিকা,	
smarok,	স্মররক,	স্মারক,	
fol,	ফোল,	ফল,	
yathaarthabhaabe,	যথারথাভাবে,	যথার্থভাবে,	
mukhabandha,	মুখবন্ধ,	মুখবন্ধ,	
conflikt,	কনফ্লিক্ট,	কনফ্লিক্ট,	
muhaiminer,	মুহাইমিনের,	মুহাইমিনের,	
zeebonto,	জীবন্ত,	জীবন্ত,	
kadakhonchar,	কাদাখোঁচার,	কাদাখোঁচার,	
poddhotiteyi,	পদ্ধতিতেই,	পদ্ধতিতেই,	
baibosthaar,	বাইবস্থার,	ব্যবস্থার,	
faltu,	ফাল্তু,	ফালতু,	
manir,	মানির,	মনির,	
dhandu,	ধন্দু,	ধন্দু,	
sallallahu,	সাল্লাল্লাহু,	সল্লাল্লাহু,	
machsoho,	মাছসহ,	মাছসহ,	
darjiling,	ডার্জিলিং,	দার্জিলিং,	
ahong,	আহং,	অহং,	
ajuhat,	অজুহাত,	অজুহাত,	
shrichaitanyadev,	শ্রীচৈতন্যভাবে,	শ্রীচৈতন্যদেব,	
madhuree,	মধুরী,	মাধুরী,	
shikara,	শিকারা,	শিকার,	
patishapta,	পাতিশপ্ত,	পাটিসাপটা,	
dala,	ডাল,	দলা,	
haris,	হারিস,	হ্যারিস,	
vaphara,	ভাফারা,	বাফার,	
pragreesa,	প্রাগ্রেস,	প্রগ্রেস,	
himsrot,	হিমস্রো,	হিমস্রোত,	
spredshiit,	স্প্রেডশিইট,	স্প্রেডশীট,	
shommotite,	শম্মতিতে,	সম্মতিতে,	
nodimaatrik,	নদীমাত্রিক,	নদীমাতৃক,	
popke,	পপপে,	পোপকে,	
antarvuktimulak,	অন্তর্বভিতুমূলক,	অন্তর্ভুক্তিমূলক,	
marry,	ম্যারি,	ম্যারি,	
aaeerese,	আইরেসে,	আইরেসে,	
bhittow,	ভিত্ত,	ভিত্তিও,	
sainyader,	সৈন্যদের,	সৈন্যদের,	
rakkhandurga,	রক্ষণদুর্গ,	রক্ষণদুর্গ,	
jerusalemer,	জেরুসালেমের,	জেরুজালেমের,	
bonvumi,	বনভুমী,	বনভূমি,	
baptics,	ব্যাপটিক্স,	ব্যাপটিকস,	
kanar,	কানার,	কণার,	
manushsoho,	মানুষহ,	মানুষসহ,	
sithilotar,	সিথীলতার,	শিথিলতার,	
ganoparibahaner,	গণপরিবাহনের,	গণপরিবহনের,	
sangkalanti,	সংকলণটটি,	সংকলনটি,	
kabutorer,	কাবুতরের,	কবুতরের,	
peeri,	পীরি,	পেরি,	
ramonar,	রামনার,	রমনার,	
sofie,	সোফি,	সোফি,	
talgach,	তালগাছ,	তালগাছ,	
lokhindorer,	লোখিন্দরের,	লখিন্দরের,	
nutan,	নুতান,	নূতন,	
donat,	দোনাত,	ডোনাট,	
ghumachchila,	ঘুমাচ্ছিলা,	ঘুমাচ্ছিল,	
senior,	সেনিওর,	সিনিয়র,	
muradke,	মুরাদকে,	মুরাদকে,	
beekaargrasta,	বিকাগ্রাস্তস,	বিকারগ্রস্ত,	
daaradaa,	দারাদা,	দারদা,	
noditir,	নদীটির,	নদীটির,	
pratisthanik,	প্রতিষ্ঠানিক,	প্রাতিষ্ঠানিক,	
porinoti,	পরিণতি,	পরিণতি,	
siraju,	সিরাজু,	সিরাজু,	
chongar,	চঙ্গার,	চোঙ্গার,	
oxfordey,	অক্সফোর্ডে,	অক্সফোর্ডে,	
quota,	কুয়াটা,	কোটা,	
chakradhare,	চক্রধরে,	চক্রধরে,	
elgoridom,	এলগোরিডম,	এলগরিদম,	
suparichiti,	সুপারিচিতি,	সুপরিচিতি,	
thare,	থারে,	থরে,	
fongli,	ফংলি,	ফংলি,	
santoshpore,	সন্তোষপরে,	সন্তোষপুর,	
tatey,	তাতে,	তাতে,	
remission,	রিমিশন,	রিমিশন,	
notey,	নতেই,	নোটে,	
skolarsip,	স্কলারসিপ,	স্কলারশিপ,	
sampadoner,	সম্পাদনের,	সম্পাদনের,	
deaubande,	ডিউবান্ডে,	দেওবন্দে,	
saqara,	সাকারা,	সাকার,	
bishasey,	বিষসে,	বিশ্বাসে,	
matthews,	ম্যাথেভিস,	ম্যাথিউস,	
kichutei,	কিছুতেই,	কিছুতেই,	
durgatsober,	দুর্গাৎসবের,	দুর্গোৎসবে,	
uporzon,	উপরজন,	উপার্জন,	
mugdha,	মুগধা,	মুগ্ধ,	
macbeth,	ম্যাকেে,	ম্যাকবেথ,	
judge,	জুডগে,	জাজ,	
elaakati,	এলাকাটি,	এলাকাটি,	
pratijogitamulak,	প্রতিযোগিতামূলক,	প্রতিযোগীতামূলক,	
houzgulite,	হাউজগুলিতে,	হাউজগুলিতে,	
fanse,	ফেন্সে,	ফাঁসে,	
roy,	রয়,	রায়,	
grahoksebai,	গ্রাহকসেবাই,	গ্রাহকসেবায়,	
laicenshe,	লাইসেন্সে,	লাইসেন্স,	
shudden,	শুদ্দেন,	সাডেন,	
sommotite,	সম্মতিতে,	সম্মতিতে,	
jeher,	জেহের,	জেহের,	
habsi,	হাববি,	হাবশী,	
shahjapur,	শাহজাপুর,	শাহজাপুর,	
utpatti,	উৎপট্টি,	উতপত্তি,	
camerapersoner,	ক্যামেরাপারসেনের,	ক্যামেরাপার্সনের,	
nariderke,	নারীদেরকে,	নারীদেরকে,	
dipankar,	দিপনকার,	দিপঙ্কর,	
licencer,	লাইসেন্সের,	লাইসেন্সের,	
edseler,	এডসেলের,	এডসেলের,	
kheshar,	খেশার,	খেশার,	
shikhbe,	শিখবে,	শিখবে,	
sumoo,	সুমো,	সুমো,	
gopalrao,	গোপালরাও,	গোপালরাও,	
panchbar,	পাঁচবার,	পাঁচবার,	
kada,	কাদা,	কোডা,	
hajirhat,	হাজিরহাট,	হাজিরহাট,	
carlo,	কারলো,	কার্লো,	
ekspression,	এক্সপ্রেশন,	এক্সপ্রেশন,	
unchuporjayer,	উঁচুপূর্যায়ের,	উঁচুপর্যায়ের,	
doobate,	দৌবাতে,	ডুবাতে,	
labonaktatar,	লাণণাক্তার,	লবণাক্ততার,	
chetanagoto,	চেতানগত,	চেতনাগত,	
registrikrito,	রেজিস্ট্রিকৃত,	রেজিস্ট্রীকৃত,	
temonbhabe,	তেমনভাবে,	তেমনভাবে,	
bbiseshyer,	বিবেষি্যের,	বিশেষ্যের,	
hadisti,	হাদিসটি,	হাদিসটি,	
antorvuktimulak,	আন্তর্বমিক্তুলা,	অন্তর্ভুক্তিমূলক,	
ekjoge,	একযোগে,	একযোগে,	
favorite,	ফেভরিতে,	ফেভারিট,	
rakkhanbhag,	রক্ষণভাগ,	রক্ষণভাগ,	
jemy,	জেমি,	জেমি,	
zibonnogor,	জীবনগ্র,	জীবননগর,	
phakay,	ফাকা,	ফাকে,	
baasaate,	বাসাতে,	বাসাতে,	
ispredsheet,	ইসপ্রেডশিত,	স্প্রেডশীট,	
breq,	ব্রেক,	ব্রেক,	
dojo,	ডোজো,	ডোজো,	
ekoirokom,	একআরকম,	একইরকম,	
tricksguli,	ট্রিক্সগুলি,	ট্রিকসগুলি,	
satarkabhabe,	সতররকভাবে,	সতর্কভাবে,	
hitokor,	হিতকর,	হিতকর,	
pyaleshtainer,	প্লেযাশেশনেরের,	প্যালেস্টাইনের,	
kompeeto,	কম্পিত,	কম্পিত,	
gabinius,	গ্যাবিনিয়াস,	গাবিনিআস,	
daayitto,	দায়িত্ত,	দায়িত্ব,	
sikkhagata,	শিক্ষাগত,	শিক্ষাগত,	
proteemake,	প্রতিমাকে,	প্রতিমাকে,	
internship,	ইন্টারশনপিপ,	ইন্টার্নশিপ,	
shalook,	শালুক,	শালুক,	
shitei,	শিতেই,	শীতেই,	
byathapather,	ব্যথাপথের,	ব্যথাপথের,	
ganohotyake,	গণহত্যাকে,	গণহত্যাকে,	
duryogamoyee,	দুর্যোগায়ী,	দুর্যোগময়ী,	
kuronir,	কুরোনির,	কুরনীর,	
juakhelar,	জুয়াখেলার,	জুয়াখেলার,	
soceitytey,	সোেসিট্টে,	সোসাইটিতে,	
kinenni,	কিনেননি,	কিনেননি,	
avidur,	অভিদুর,	আভিদুর,	
chalake,	চালাকে,	চালকে,	
baikalyo,	বৈকল্য,	বৈকল্য,	
zonsa,	জনসা,	জোন্স,	
autopromotioner,	অটোপ্রোমোশনের,	অটোপ্রমোশনের,	
shatodha,	শতধো,	শতধা,	
balatarin,	বালাতারিন,	বালাতারিয়ান,	
neerbahe,	নেরবাহে,	নির্বাহে,	
neutrinoo,	নেউত্রিনো,	নিউট্রিনো,	
tetela,	টেতেলা,	টাইটেল,	
protijogiider,	প্রতিযোগীদের,	প্রতিযোগীদের,	
aholyar,	আহল্যার,	অহল্যার,	
byaboharkarie,	ব্যবহারকরীীেই,	ব্যবহারকারীই,	
kanasarabhesana,	কানাসারেভাষণা,	কনসারভেশন,	
supplenza,	সাপ্পলেনজা,	সাপলেঞ্জা,	
oncholeo,	অঞ্চলেও,	অঞ্চলেও,	
katui,	কাটুই,	কাতুই,	
bufer,	বাফার,	বাফার,	
uparjon,	উপার্যন,	উপার্জন,	
raunanganey,	রৌনাঙ্গনে,	রণাঙ্গনে,	
geejeeteeda,	গীজিটেদা,	গেজেটেড,	
jetam,	জেতাম,	যেতাম,	
hariken,	হারিকেন,	হ্যারিকেন,	
dufresne,	ডাফ্রেন,	ডুফরেস্ন,	
spredashita,	স্প্রেশাটিতা,	স্প্রেডশীট,	
nodimatrik,	নদীমাত্রিক,	নদীমাতৃক,	
augustine,	অগান্টিনে,	অগাস্টিন,	
sanaktakaran,	সনককতকরণ,	সনাক্তকরণ,	
thaii,	থাইই,	থাই,	
chiraharit,	চিরাহারিত,	চিরহরিৎ,	
zerusaleme,	জেরুসালেমে,	জেরুসালেমে,	
mandanda,	মন্দননডা,	মানদণ্ড,	
tirmijii,	তির্মিজি,	তিরমিজি,	
potka,	পটকা,	পটকা,	
phutanta,	ফুটানটা,	ফুটন্ত,	
sossar,	সসসার,	সকার,	
marmaraa,	মারমারা,	মারমারা,	
deil,	দেইল,	ডেইল,	
pyore,	পিয়োরে,	পিওর,	
siqh,	সিক,	শিখ,	
firoze,	ফিরোজে,	ফিরোজ,	
mumtajer,	মুমতাজের,	মুমতাজের,	
manibhaijaner,	মানিভাইজনের,	মণিভাইজানের,	
orrgho,	অর্ঘ,	অর্ঘ্য,	
brixfield,	ব্রিক্সিফল্ড,	ব্রিক্সফিল্ড,	
beshirbhaagei,	বেশিরভাগেই,	বেশিরভাগেই,	
sollallhu,	সল্লাল্লুহ,	সল্লাল্লাহু,	
attacharito,	আট্চাচারিত,	অত্যাচারিত,	
jahara,	জাহারা,	যাহরা,	
sanstha,	সানস্থা,	সংস্থা,	
narsaari,	নারসারি,	নার্সারি,	
ajuhath,	অজুহাত,	অজুহাত,	
maudelti,	মোডেলটি,	মডেলটি,	
chokrantosoho,	চক্রান্তসহ,	চক্রান্তসহ,	
pretti,	প্রেত্তি,	প্রিটি,	
mast,	মাস্ট,	মাস্ত,	
digrir,	দিগ্রির,	ডিগ্রির,	
debete,	দেবেতে,	ডিবেট,	
sqirt,	স্কির্ট,	স্কার্ট,	
orunima,	অরুণীমা,	অরুণিমা,	
pleto,	প্লেটো,	প্লেটো,	
sobchey,	সব্চে,	সবচে,	
sadeep,	সাদীপ,	সদীপ,	
bolbo,	বলবো,	বলবো,	
heerani,	হিরানী,	হিরানি,	
mandape,	মণ্ডপে,	মন্ডপে,	
hupile,	হুপিলে,	হুপিলে,	
purushika,	পুরুষিকা,	পুরুষিকা,	
eigulor,	এইগুলোর,	এইগুলোর,	
bohudin,	বহুদিন,	বহুদিন,	
chalachchitroi,	চলাচিত্রই,	চলচ্চিত্রই,	
megacaldera,	মেগাকালদেররে,	মেগাক্যাল্ডেরা,	
minister,	মিনিস্টের,	মিনিস্টার,	
gaphiloti,	গাফিলোটি,	গাফিলতি,	
omanisa,	ওমানিস,	অমানিশা,	
foxer,	ফক্সার,	ফক্সের,	
deputy,	ডেপুটি,	ডেপুটি,	
palkee,	পালকে,	পাল্কি,	
gaandaas,	গাযান্াাস,	জ্ঞানদাস,	
gonjona,	গঞ্জনা,	গঞ্জনা,	
distibutor,	ডিস্টিবুটোর,	ডিস্টিবিউটারের,	
ovarview,	ওভারভভিয়া,	ওভারভিউ,	
tikto,	তিক্ত,	তিক্ত,	
emargency,	এমরজেন্সি,	এমার্জেন্সি,	
karu,	কারু,	কারু,	
agomoney,	আ্যাগমনে,	আগমনে,	
eupheike,	ইউফেইকে,	ইউফেইকে,	
chhooteer,	ছুটির,	ছুটির,	
chapchap,	চাপচাপ,	চাপচাপ,	
dhwajbhango,	ধ্বজভাঙ্গ,	ধ্বজভঙ্গ,	
jeebonnogor,	জীবনগোগর,	জীবননগর,	
karam,	কারাম,	কেরাম,	
qarlosa,	কারলোসা,	কার্লোস,	
ispredsiit,	ইসপ্রেডস্টিট,	স্প্রেডশীট,	
poorohitra,	পুরহিত্রা,	পুরোহিতরা,	
miitar,	মিতার,	মিত্র,	
conservetion,	কনসার্ভেশন,	কনসারভেশন,	
sahittopritite,	সাহিত্যপিরিতে,	সাহিত্যপ্রীতিতে,	
licensin,	লাইসেনিস,	লাইসেন্সিং,	
bhiktara,	ভিক্তারা,	ভিক্টর,	
chalai,	চালাই,	চালাবে,	
hisaber,	হিসাবের,	হিসাবের,	
uponishad,	উপনীসাদ,	উপনিষদ,	
peeth,	পে,	পীঠ,	
teman,	তেমান,	তেমন,	
shamshere,	শামশেরে,	শমসের,	
falak,	ফালাক,	ফলক,	
iuro,	ইউরো,	ইউরো,	
pachchi,	পাচ্ছি,	পাচ্ছি,	
hoondayi,	হোনদায়ি,	হুন্দাই,	
cocaine,	কোকেইন,	কোকেইন,	
modhyekar,	মধ্যেকর,	মধ্যেকার,	
prottokkhovabe,	প্রত্যক্ষভাবে,	প্রত্যক্ষভাবে,	
anubhutimalar,	অনুভূতিমালার,	অনুভূতিমালার,	
sedikei,	সেদিকেই,	সেদিকেই,	
fansi,	ফানসি,	ফাঁসী,	
lendol,	লেন্ডল,	লেন্ডল,	
ashamorthito,	আশামর্থিত,	অসমর্থিত,	
chomski,	চোমসকি,	চমস্কি,	
poriharsoho,	পরিহারসহ,	পরিহারসহ,	
jomjamat,	জমমাজাত,	জমজমাট,	
hajeerhatt,	হাজেরহাট্ট,	হাজিরহাট,	
qonflict,	কনফ্লিক্ট,	কনফ্লিক্ট,	
ragei,	রাগেই,	রাগেই,	
bikargrasta,	বিকারগ্রস্ত,	বিকারগ্রস্ত,	
uponeeshod,	উপনেশদ,	উপনিষদ,	
bizito,	বিজিত,	বিজিত,	
audiotike,	অডিওটিকে,	অডিওটিকে,	
change,	চাঙ্গে,	চেঞ্জ,	
kyatagorir,	ক্যাতাগরির,	ক্যাটাগরির,	
liceensee,	লাইসেন্সি,	লাইসেন্স,	
chalchhe,	চাল্চে,	চলছে,	
rinobodh,	ঋণবোধ,	ঋণবোধ,	
qyantana,	ক্যান্না,	ক্যান্টন,	
swatantrata,	স্বাতন্ত্র্যতা,	স্বতন্ত্রতা,	
cholochchitratike,	চলচ্চিত্রািকিতে,	চলচ্চিত্রটিকে,	
fimela,	ফিমেলা,	ফিমেল,	
directorate,	ডিরেক্টরেট,	ডিরেক্টরেট,	
udyem,	উড়েম,	উদ্যেম,	
bikretaara,	বিক্রেতারা,	বিক্রেতারা,	
ajeem,	আজিম,	আজিম,	
rilayensha,	রিলায়েন্স,	রিলায়েন্স,	
anisa,	অনিসা,	আনিস,	
hilser,	হিলসের,	হিলসের,	
licenshe,	লাইসেন্স,	লাইসেন্স,	
gaziipur,	গাজিপপুর,	গাজীপুর,	
diibug,	দিবিগু,	ডিবাগ,	
simaa,	সিমা,	সীমা,	
nederlande,	নেদারল্যান্ডে,	নেদারল্যান্ডে,	
ronangane,	রোনাঙ্গণে,	রণাঙ্গনে,	
prokolpotike,	প্রকল্পতিকে,	প্রকল্পটিকে,	
dephinishion,	ডেফিনিশন,	ডেফিনেশন,	
bulan,	বুলান,	বুলান,	
shikhra,	শিখরা,	শিখরা,	
barnis,	বার্নিস,	বার্নিশ,	
fokskon,	ফক্সকন,	ফক্সকন,	
aarmstrong,	আর্মস্ট্রং,	আর্মস্ট্রং,	
dajjha,	দজঝ্,	দাহ্য,	
lyataa,	ল্তা,	ল্যাটা,	
postac,	পোস্টাক,	পোস্টকে,	
bandi,	বা্দি,	বন্দী,	
laaisheesh,	লইশেশ,	লাইসেন্স,	
prosadhoni,	প্রসাধনী,	প্রসাধনী,	
somratra,	সম্রাত্রা,	সম্রাটরা,	
kleentoner,	ক্লিনতের,	ক্লিনটনের,	
pleeta,	প্লিত,	প্লেট,	
neerbahi,	নেরবাহি,	নির্বাহি,	
chalachchitro,	চলচ্চিত্র,	চলচ্চিত্র,	
vabuk,	ভাবুক,	ভাবুক,	
taateo,	তাতেও,	তাতেও,	
kidambi,	কিদাম্বী,	কিদম্বি,	
bejiye,	বেজিয়ে,	বেজিয়ে,	
langhangulir,	লঙ্ঘানগুলির,	লঙ্ঘনগুলির,	
shasonamoleri,	শাসনামলেরই,	শাসনামলেরই,	
dorun,	দোরুন,	দরুণ,	
krisenta,	ক্রিসেনটা,	ক্রিসেন্ট,	
goonoman,	গুনমান,	গুণমান,	
jarmaniteo,	জার্মানিতেও,	জার্মানিতেও,	
residensa,	রেসিডেনসস,	রেসিডেন্স,	
glanio,	গ্লানিও,	গ্লানিও,	
giitikobitar,	গীতিকতিবাতার,	গীতিকবিতার,	
daaoon,	দাওন,	ডাউন,	
machhti,	মাছটি,	মাছটি,	
kurdider,	কুরদিদের,	কুর্দিদের,	
ganonanatto,	গণনানত্ব,	গণনাট্য,	
lagto,	লাগত,	লাগতো,	
kushakhali,	কুশাখালী,	কুশাখালি,	
rinattak,	রীনত্বক,	ঋনাত্মক,	
labonaaktotaar,	লাবণাকাত্তার,	লবণাক্ততার,	
sorano,	সোরানো,	সরানো,	
mitrata,	মিত্রাটা,	মিত্রতা,	
baipass,	বাইপাস,	বাইপাস,	
shektor,	শেকতর,	সেক্টর,	
madhukori,	মধুকরি,	মাধুকরী,	
charukala,	চররুকালা,	চারুকলা,	
geja,	জেজ,	গেজ,	
upobasee,	উপবাসী,	উপবাসী,	
akheli,	আখেলি,	আখেলী,	
vagini,	ভাগিনি,	ভগিনী,	
esprito,	এসপ্রিত,	এস্পিরিটো,	
sohojlovyotar,	সহজল্ভোত্তার,	সহজলভ্যতার,	
ganaporibahaner,	গণপরিবাহনের,	গণপরিবহনের,	
ashok,	আশোক,	আশোক,	
emerjency,	এমারজেন্সি,	এমার্জেন্সি,	
gaddaphii,	গাড়াাফিই,	গাদ্দাফী,	
oncolsoho,	অন্লসহ,	অঞ্চলসহ,	
anyorup,	অন্যরূপ,	অন্যরূপ,	
sahocorje,	সহকর্যে,	সাহচর্যে,	
foreks,	ফোরক্স,	ফরেক্স,	
olympic,	অলম্পিক,	অলিম্পিক,	
kaathhaamaandu,	কথমাান্দু,	কাঠমান্ডু,	
alaoler,	অ্যালাওলের,	আলাওলের,	
mmehonoti,	ম্মেহনটি,	মেহনতি,	
siitei,	সিতেই,	শীতেই,	
boiragirhat,	বৈরাগিরহাট,	বৈরাগিরহাট,	
sayanaida,	সায়ানাদা,	সায়ানাইড,	
konnoder,	কন্যদের,	কন্যদের,	
khagen,	খাগেন,	খগেন,	
bipajjanak,	বিপজ্জনাক,	বিপজ্জনক,	
argho,	আর্ঘ,	অর্ঘ্য,	
prokolpogulor,	প্রকল্পগুলোর,	প্রকল্পগুলোর,	
melborrone,	মেলবর্োনে,	মেলবোর্নে,	
generalissimo,	জেনারেলাসসিমো,	জেনারেলিসিমো,	
iling,	ইলিং,	ইলিং,	
abdan,	আবদান,	আব্দান,	
deobonde,	দেওবন্দে,	দেওবন্দে,	
notikotar,	নতীকতার,	নৈতিকতার,	
goteehin,	গোটিহীন,	গতিহীন,	
kottar,	কোত্তার,	কট্টর,	
graambaasheeo,	গ্রামবাশীও,	গ্রামবাসীও,	
gyandas,	জ্ঞানদাস,	জ্ঞানদাস,	
bagdadii,	বাগদাদী,	বাগদাদী,	
spancer,	স্প্যান্সের,	স্পেন্সার,	
oichchheek,	ঐচ্ছেক,	ঐচ্ছিক,	
dipke,	ডিপকে,	দ্বীপকে,	
mulyayonsapekkhe,	মূল্যায়ননসেক্ষে,	মূল্যায়নসাপেক্ষে,	
parqa,	পারকা,	পার্ক,	
sanghitar,	সংঘিতার,	সংহিতার,	
torunra,	তরুরা,	তরুণরা,	
toroonraa,	তরুণা,	তরুণরা,	
hank,	হ্যাঙ্ক,	হাঙ্ক,	
postar,	পোস্টার,	পোস্টের,	
steena,	স্টিন,	স্টেন,	
hingsar,	হিংসার,	হিংসার,	
rudroke,	রুদ্রকে,	রুদ্রকে,	
parqim,	পারকিম,	পার্কিং,	
nobotom,	নবতম,	নবতম,	
confliqt,	কনফ্লিক্ট,	কনফ্লিক্ট,	
ceramicsh,	সেরামিক্চ,	সিরামিকস,	
mohammadi,	মোহাম্মাদি,	মুহাম্মদী,	
choddo,	চদ্দ,	চোদ্দো,	
badargaji,	বদরজাজী,	বদরগাজী,	
musabbirul,	মুসাববিরুল,	মুসাব্বিরুল,	
mohit,	মহিত,	মুহিত,	
planey,	প্ল্যা,	প্লেনে,	
jaunotar,	যৌনতার,	যৌনতার,	
bhejaano,	ভেজানো,	ভেজানো,	
daltagi,	দলততাগী,	দলত্যাগী,	
drissogoolote,	দৃশ্যগুলোতে,	দৃশ্যগুলোতে,	
ahalya,	আহাল্যা,	অহল্যা,	
gabhaskaar,	গাবাস্কার,	গাভাস্কার,	
anektai,	অনেকটাই,	অনেকটাই,	
ekghore,	একঘরে,	একঘরে,	
kutubuddinke,	কুটুবুদ্দিনকে,	কুতুবুদ্দিনকে,	
sexperter,	সেক্সপার্টের,	সেক্সপার্টের,	
brekethru,	ব্রেকটেরুু,	ব্রেকথ্রু,	
nothivookta,	নথিভুক্তা,	নথিভুক্ত,	
qirq,	কিরক,	কার্ক,	
baait,	বাইত,	বাইট,	
shikkhadikkhay,	শিক্ষাদিক্ষায়,	শিক্ষাদিক্ষায়,	
prakalpoguli,	প্রকল্পগুলি,	প্রকল্পগুলি,	
mach,	মাচ,	মাছ,	
buddhitii,	বুদ্ধিতি,	বুদ্ধিটিই,	
deelibhara,	ডীলীভারা,	ডেলিভার,	
sumeeta,	সুমেতা,	সুমিতা,	
udbhabaney,	উদ্ভাবনে,	উদ্ভাবনে,	
moshjidke,	মসজিদকে,	মসজিদকে,	
doorger,	ডোরগের,	দুর্গের,	
chinito,	চিনিত,	চিনতো,	
oyebjin,	ওয়েবিজন,	ওয়েবজিন,	
mishal,	মিশাল,	মিশাল,	
dipti,	দিপ্তি,	ডেপুটি,	
neshadrabyer,	নেশাদ্বার্যের,	নেশাদ্রব্যের,	
daap,	ড্যাপ,	ড্যাপ,	
codeti,	কোেটি,	কোডটি,	
taufiq,	তৌফিক,	তৌফিক,	
motabolombira,	মতাবলম্বীরা,	মতাবলম্বীরা,	
poorohitder,	পুরহিতদের,	পুরোহিতদের,	
khabarsoho,	খাবারসহ,	খাবারসহ,	
shommoteer,	শম্মতীর,	সম্মতির,	
niphelheim,	নিফেলহাফাই,	নিফেলহেইম,	
taroni,	তারণী,	তরণী,	
nirgaman,	নির্গামন,	নির্গমন,	
attorkite,	আত্রোকটিতে,	অতর্কিতে,	
gratha,	গ্রাথা,	গ্রোথ,	
teenej,	তেনিজ,	টিনেজ,	
remakri,	রেমাকরি,	রেমাক্রী,	
shasyadi,	শস্যাদি,	শস্যাদি,	
kharar,	খারার,	খরার,	
zubokder,	যুবকদের,	যুবকদের,	
dhache,	ঢাচে,	ধাঁচে,	
asiatic,	এ্যাসিয়াটিক,	এশিয়াটিক,	
giitikobita,	গীতিকবিতা,	গীতিকবিতা,	
gobeshakgon,	গোবেশকগণ,	গবেষকগণ,	
summer,	সাম্মার,	সামার,	
padee,	পড়ে,	পাড়ে,	
atwabishvashi,	অত্বৈবিশাবী,	আত্মবিশ্বাসী,	
patengar,	পাতেনগার,	পতেঙ্গার,	
bhenus,	ভেনুস,	ভেনাস,	
poripakey,	পরিপাকে,	পরিপাকে,	
alpo,	আলপো,	অল্প,	
binee,	বিনে,	বেনি,	
okkhorke,	অক্ষকরে,	অক্ষরকে,	
agomonke,	আগমনকে,	আগমনকে,	
baaiq,	বাইক,	বাইক,	
ovidhaner,	অভিধানের,	অভিধানের,	
korimer,	করিমের,	করিমের,	
elaakaati,	এলাকাটি,	এলাকাটি,	
rudiger,	রুদিগের,	রুদিগের,	
upobashii,	উপবাশী,	উপবাসী,	
ghotleyo,	ঘোটলিও,	ঘটলেও,	
iqbalke,	ইকবালকে,	ইকবালকে,	
mitro,	মিত্রো,	মিত্র,	
byan,	ব্যান,	ব্যাং,	
asaciates,	অ্যাসিয়াসেস,	এসোসিয়েটস,	
dhani,	ধানি,	ধানি,	
laagche,	লাগছে,	লাগছে,	
mercial,	মার্সিয়াল,	মার্শিয়াল,	
tuleche,	তুলেছে,	তুলেছে,	
siddhantoo,	সিদ্ধান্ত,	সিদ্ধান্তও,	
atighataner,	অতিঘাতনের,	অতিঘটনের,	
trabuco,	ট্রাবাকো,	ট্র্যাবুকো,	
planea,	প্লেন,	প্লেনে,	
rahimed,	রহিমেদ,	রহিমেদ,	
churger,	চুর্গের,	চার্জের,	
bajhyo,	বাঝ্য,	বাহ্য,	
bhowanipur,	ভোনানিপুর,	ভবানীপুর,	
upobaashee,	উপবাশী,	উপবাসী,	
prachirer,	প্রাচিরের,	প্রাচিরের,	
samanyai,	সামন্যই,	সামান্যই,	
terlarang,	তেরলার্ং,	তেরলারং,	
utkhaat,	উৎখাত,	উত্খাত,	
anichchi,	অনিচ্ছি,	আনিচ্ছি,	
faase,	ফাসে,	ফাঁসে,	
basturoi,	বস্তুরই,	বস্তুরই,	
israelbahini,	ইসরাল়েববাহিনী,	ইস্রায়েলবাহিনী,	
baugey,	বাউগে,	বাগে,	
sachetanvabe,	সচেতনভাবে,	সচেতনভাবে,	
pharn,	ফার্ন,	ফার্ন,	
guzon,	গুজন,	গুজব,	
pooshti,	পুষ্টি,	পুষ্টি,	
ponchasjon,	পঞ্চাজন,	পঞ্চাশজন,	
nirvachokder,	নির্ভচক্দদের,	নির্বাচকদের,	
mooney,	মুনে,	মুনে,	
souripurang,	সৌরিপুরং,	সৌরিপুরং,	
drissotir,	দৃশ্যটির,	দৃশ্যটির,	
elaakaate,	এলাকাতে,	এলাকাতে,	
abodamaner,	অবদামানের,	অবদমনের,	
brindabane,	বৃন্দাবানে,	বৃন্দাবনে,	
tukrowti,	টুকরোটি,	টুকরোটি,	
ajij,	অজিজ,	আজিজ,	
chapal,	চাপাল,	চপল,	
capsule,	ক্যাপসুলে,	ক্যাপ্সুল,	
bone,	বনে,	বনে,	
shhow,	শোউ,	শো,	
hattey,	হ্যাটে,	হাঁটতে,	
shchalastic,	স্ইালাস্টিক,	স্কলাস্টিক,	
karima,	কারিমা,	করিম,	
pratool,	প্রাটোল,	প্রতুল,	
trutimatra,	ট্রুটিমাত্রা,	ত্রুটিমাত্র,	
mmadhuri,	ম্মাধুরি,	মাধুরী,	
akten,	আকতেন,	অকটেন,	
direqtareta,	ডিরেক্টরেট,	ডিরেক্টরেট,	
roopdaan,	রূপান,	রুপদান,	
durgotsabe,	দুর্গোৎসবে,	দুর্গোৎসবে,	
jinsa,	জিনসা,	জিন্স,	
ateetkaale,	আতিতকালে,	অতীতকালে,	
saseza,	সাসেজা,	সসেজ,	
gandharir,	গান্ধারীর,	গান্ধারীর,	
aprasangikbhabei,	অপ্রসংযাকভাবাবে,	অপ্রাসঙ্গিকভাবেই,	
nischitobhave,	নিশ্চিতভাবে,	নিশ্চিতভাবে,	
bage,	বাগে,	বাগে,	
gasthi,	গা্্থি,	গোষ্ঠী,	
megh,	মেঘ,	মেঘ,	
baibasthaar,	বৈবাস্থার,	ব্যবস্থার,	
navaratri,	নবরত্রী,	নবরাত্রি,	
nothivuktir,	নথুভুক্তির,	নথিভুক্তির,	
bheenisa,	ভীনিসা,	ভেনিস,	
graambaaseer,	গ্রামবেসার,	গ্রামবাসীর,	
militarir,	মিলিটারির,	মিলিটারির,	
choudhursoho,	চৌধুরসহ,	চৌধুরসহ,	
zarniz,	জার্নিজ,	জারনিজ,	
ramantic,	র্যামান্টিক,	রোমান্টিক,	
halding,	হাযাডলিং,	হোল্ডিং,	
logotype,	লোগোটিপে,	লোগোটাইপ,	
ongkush,	অংকুশ,	অংকুশ,	
rashider,	রাশিদের,	রশিদের,	
sardar,	সরদার,	সরদার,	
khuliechilam,	খুলিয়েছিলাম,	খুলিয়েছিলাম,	
blacker,	ব্ল্কার,	ব্ল্যাকের,	
eevil,	ইইভিল,	ইভিল,	
charpanch,	চারপঞ্চ,	চারপাঁচ,	
carbus,	কারবাস,	কারবাস,	
shangsthatikey,	সাংস্থাথটিকে,	সংস্থাটিকে,	
providere,	প্রভিদেরে,	প্রভাইডারে,	
sarajibonbyapi,	সারাজৈবন্যাাপী,	সারাজীবনব্যাপী,	
ganochin,	গণছিন,	গণচীন,	
dikpal,	ডিকপাল,	দিকপাল,	
difinishian,	ডিফিশিশন,	ডেফিনেশন,	
muktilav,	মুক্তিলাভ,	মুক্তিলাভ,	
ghenshei,	ঘেনশেই,	ঘেঁষেই,	
nagorikderkey,	নাগরিকদেরকে,	নাগরিকদেরকে,	
torikher,	তরিখের,	তরিখের,	
zeeland,	জিল্যান্ড,	জিল্যান্ড,	
totokson,	টোটকসন,	ততক্ষন,	
ddebet,	দেবিত,	ডিবেট,	
banshite,	বাঁশিতে,	বাঁশিতে,	
grotha,	গ্রথা,	গ্রোথ,	
aasar,	আসার,	আসর,	
fud,	ফুদ,	ফুড,	
title,	টিটলে,	টাইটেল,	
bikromei,	বিক্রমেই,	বিক্রমেই,	
jacksoner,	জ্যাকসনের,	জ্যাকসনের,	
bhromonkaale,	ভ্রমণকালে,	ভ্রমণকালে,	
mmadhukkori,	ম্মাধুককরি,	মাধুকরী,	
dolu,	দোলু,	ডলু,	
dokkhinangsho,	দক্ষিণাংশ,	দক্ষিণাংশ,	
saras,	সারাস,	সরস,	
jeten,	জেতেন,	জেতেন,	
shahoshikatar,	শাহশিকতার,	সাহসিকতার,	
ameettrakkhor,	অমেত্রকক্ষর,	অমিত্রাক্ষর,	
bishhnu,	বিষ্ণু,	বিষ্ণু,	
soorsa,	সূরসা,	সোর্স,	
duiekdiner,	দুই়েকদিনের,	দুইএকদিনের,	
hertj,	হার্টজ,	হার্জ,	
deep,	দিপ,	দীপ,	
foks,	ফকক,	ফক্স,	
manatmulak,	মানামূলক,	মানতমূলক,	
cheekitshar,	চিকিৎসার,	চিকিত্সার,	
masjidti,	মাসজিদটি,	মসজিদটি,	
shpredshiit,	স্প্রেডশিটি,	স্প্রেডশীট,	
bujhechhila,	বুঝেছিলি,	বুঝেছিল,	
akreetokarjo,	আক্রীতকার্য,	অকৃতকার্য,	
moushum,	মৌশুম,	মৌসুম,	
shroddhabihin,	শ্রদ্ধাবিহীন,	শ্রদ্ধাবিহীন,	
lagche,	লাগ্ে,	লাগছে,	
mousumeo,	মুসুমেও,	মৌসুমেও,	
abti,	আবটি,	আবতি,	
janoganonar,	জনগোননার,	জনগণনার,	
shringey,	শ্রিংয়ে,	শৃঙ্গে,	
bhandti,	ভান্ডটি,	ভাণ্ডটি,	
hitaishi,	হিতাইশি,	হিতৈষী,	
zozyota,	যজ্যতা,	যোজ্যতা,	
dianes,	ডায়েনেস,	ডিএনএস,	
bamni,	বামনি,	বামনী,	
raia,	রায়াই,	রায়,	
mosjidtir,	মসজিদটির,	মসজিদটির,	
udvaboney,	উদ্ভাবনে,	উদ্ভাবনে,	
kyathlik,	ক্ষাথলিক,	ক্যাথলিক,	
amanisha,	আমানিশা,	অমানিশা,	
puroheetder,	পুরোহীতদের,	পুরোহিতদের,	
maryir,	মারইর,	ম্যারির,	
shkalarashhipa,	স্কলরাশিপ,	স্কলারশিপ,	
noteti,	নতেটি,	নোটটি,	
progresh,	প্রোগ্রেস,	প্রগ্রেস,	
toptoshele,	তপ্তশেলে,	তপ্তশেলে,	
dwibidho,	দ্বিবিধ,	দ্বিবিধ,	
shikshagata,	শিক্ষগত,	শিক্ষাগত,	
elakaai,	এলাকাই,	এলাকাই,	
byabosthar,	ব্যবস্থার,	ব্যবস্থার,	
jackey,	জ্যাকে,	জকি,	
pranibigyani,	প্রাণীবিজ্ঞানী,	প্রাণীবিজ্ঞানী,	
birmuktijoddhagan,	বিরমুক্তিদ্ধান,	বীরমুক্তিযোদ্ধাগণ,	
uthe,	উঠে,	উঠে,	
hakone,	হাকোনে,	হাকোনে,	
aflatoxin,	আফ্াালক্সিন,	আ্যফ্ল্যাটক্সিন,	
songkulan,	সংকুলন,	সংকুলান,	
elakaatite,	এলাকাটিতে,	এলাকাটিকে,	
baipash,	বাইপাশ,	বাইপাস,	
jonesh,	জোনেশ,	জোন্স,	
kortam,	কর্তাম,	করতাম,	
indrakanan,	ইন্দ্রকানা,	ইন্দ্রকানন,	
vedanta,	বেদন্ত,	বেদান্ত,	
bhikkharthe,	ভিক্ষার্থে,	ভিক্ষার্থে,	
maaktoome,	মাক্তমে,	মাকতুম,	
khiladirao,	খিলাদীরাও,	খিলাড়িরাও,	
blogarra,	ব্লোগাররা,	ব্লগাররা,	
harasta,	হারাস্তা,	হারাস্তা,	
sharthe,	শার্থে,	স্বার্থে,	
homshke,	হোমশকে,	হোমসকে,	
addabaj,	আদ্দাবাজ,	আড্ডাবাজ,	
kirti,	কিরটি,	কীর্তি,	
dharabahikvabe,	ধারাবাহিকভাবে,	ধারাবাহিকভাবে,	
mahbunur,	মাহবুনুর,	মাহবুনুর,	
popaike,	পপাাইকে,	পপাইকে,	
canservatian,	কনসেরভেনিতান,	কনসারভেশন,	
asamanyo,	অসামণ্য,	অসামান্য,	
kachhakaachhi,	কচকাছালি,	কাছাকাছি,	
bibadey,	বিবাদে,	বিবাদে,	
abheedhanic,	অভিধেনিক,	অভিধানিক,	
dorgah,	দোরগাহ,	দরগাহ,	
mane,	মানে,	মানে,	
uddhrito,	উদ্ধৃত,	উদ্ধৃত,	
firoza,	ফিরোজা,	ফিরোজা,	
bii,	বিআই,	বি,	
chakundite,	চাকুন্ডিতে,	চাকুন্দিতে,	
logic,	লুগিক,	লজিক,	
kalakushalir,	কালাকুশীলীর,	কলাকুশলীর,	
kayech,	কায়েচ,	কায়েছ,	
nirmol,	নির্মল,	নির্মল,	
plack,	প্ল্যাক,	প্ল্যাক,	
addata,	আডডডাটা,	আড্ডাটা,	
collaborators,	কলাবর্বরেস,	কলাবরেটরস,	
ghumachche,	ঘুমাচ্ছে,	ঘুমাচ্ছে,	
abanishankar,	অবনিশঙ্কর,	অবনিশংকর,	
byke,	বিইকে,	বাইক,	
sepha,	সেফা,	শেফ,	
chikitsanirbhar,	চিকিৎসানির্ভর,	চিকিৎসানির্ভর,	
shten,	স্টেন,	স্টেন,	
mosjidsoho,	মসজিদসহ,	মসজিদসহ,	
amor,	আমোর,	আমর,	
protul,	প্রতুল,	প্রতুল,	
shamshernagar,	শাশমেরনগর,	শমশেরনগর,	
wodka,	ওডডকা,	ভদকা,	
oitijje,	ঐতিহ্যে,	ঐতিহ্যে,	
bisnuke,	বিষ্নুকে,	বিষ্ণুকে,	
motke,	মতকে,	মতকে,	
pravura,	প্রবুরা,	প্রভুরা,	
taunsheep,	তৌউনশিপ,	টাউনশিপ,	
khargosher,	খারগোশের,	খরগোসের,	
bondhukey,	বন্ধুকে,	বন্ধুকে,	
obdee,	অব্দ,	অব্দি,	
parijaner,	পারিজানের,	পরিজনের,	
nirmolotaa,	নির্মলতা,	নির্মলতা,	
dhyana,	ধ্যানা,	ধ্যান,	
foloshrutite,	ফলশ্রুটিতে,	ফলশ্রুতিতে,	
setikey,	সেটিকে,	সেটিকে,	
soomitrar,	সুমিত্রার,	সুমিত্রার,	
anhu,	আনহু,	আনহু,	
shahanara,	শাহানারা,	শাহানারা,	
madhabike,	মাধাবিকে,	মাধবীকে,	
cn,	সিএননি,	সিএন,	
srichoitonnodeb,	শ্রীচৈতন্দ্বে,	শ্রীচৈতন্যদেব,	
suparahiro,	সুপারাহীরও,	সুপারহিরো,	
pravritir,	প্রারবিতির,	প্রভৃতির,	
hoteltite,	হোটেলটিতে,	হোটেলটিতে,	
maudelder,	মাউডেল্ডের,	মডেলদের,	
votarer,	ভোটারের,	ভোটারের,	
ceramicer,	সেরামিইজের,	সিরামিকের,	
kathmandute,	কাঠমণ্ডুতে,	কাঠমান্ডুতে,	
moomtaj,	মুমতাজ,	মুমতাজ,	
duio,	দুই,	দুইও,	
harysoner,	হারাসনের,	হ্যারিসনের,	
coons,	কনস,	কুনস,	
keu,	কেউ,	কেউ,	
satan,	সাতান,	শয়তান,	
shikshagato,	শিক্ষাগত,	শিক্ষাগত,	
borendroke,	বরেন্দ্রকে,	বরেন্দ্রকে,	
sulfatee,	সুলফেটি,	সালফেট,	
manober,	মানবের,	মানবের,	
soleel,	সোলিল,	সলিল,	
asamorik,	আসামরিক,	অসামরিক,	
dhhaabi,	ঢাবি,	ঢাবি,	
bisshasi,	বিশ্ষাসি,	বিশ্বাসী,	
biplabee,	বিপ্লাবে,	বিপ্লবী,	
palashir,	পালশশির,	পলাশীর,	
jorury,	জরুরি,	জরূরী,	
tanshree,	তনঁশ্রী,	তানশ্রী,	
tiger,	টিজের,	টাইগার,	
lopjonito,	লোপজনিত,	লোপজনিত,	
khanabale,	খানাবেল,	খানাবলে,	
tonoo,	টনো,	তনু,	
kathla,	কাঠলা,	কাঠলা,	
deraa,	দীরা,	ডেরা,	
probhritike,	প্রভৃতিকে,	প্রভৃতিকে,	
jani,	জানি,	জনি,	
soketgulor,	সকেতগুলোর,	সকেটগুলোর,	
musallati,	মুসল্লাটি,	মুসল্লাটি,	
jokkher,	যক্ষের,	যক্ষের,	
paramartha,	পরমর্থ,	পরমার্থ,	
victor,	ভিক্টর,	ভিক্টর,	
bishesyo,	বিশেষ্য,	বিশেষ্য,	
gandhike,	গান্ধিকে,	গান্ধীকে,	
shabkam,	শবকম,	শবকাম,	
hights,	হাইটস,	হাইটস,	
naajii,	নাজি,	নাত্সি,	
dibug,	দিবুগ,	ডিবাগ,	
neelkamal,	নীলকামল,	নীলকমল,	
juktorastrer,	যুক্তরস্ত্রের,	যুক্তরাষ্ট্রের,	
ganokantha,	গণকান্থা,	গণকণ্ঠ,	
laaishenshh,	লাইশেন্স,	লাইসেন্স,	
govindarajan,	গোবিন্দরাজন,	গোবিন্দরাজন,	
mah,	মাহ,	মাহে,	
satarkabhabey,	সতররকভাবে,	সতর্কভাবে,	
dovaar,	দোভার,	ডোভার,	
simantarkkhibahinir,	সীমান্ত্রকরবিষারীর,	সীমান্তরক্ষীবাহিনীর,	
iksaprishana,	এক্সপ্রিশণ,	এক্সপ্রেশন,	
sakshatkarer,	সাক্কতকরের,	সাক্ষাৎকারের,	
inafarameshana,	ইনাফারেশন,	ইনফরমেশন,	
vool,	ভুল,	উল,	
phund,	ফান্ড,	ফান্ড,	
kormobuddhite,	কর্মবুদ্ধিতে,	কর্মবুদ্ধিতে,	
daakten,	ডাকেন,	ডাকতেন,	
teemothi,	তীমোঠি,	টিমোথি,	
pichte,	পিছতে,	পিছতে,	
balabhadra,	বালাভদ্রা,	বলভদ্র,	
peerry,	পাররি,	পেরি,	
seqtara,	সেকটারা,	সেক্টর,	
karmakarke,	কারমাকরকে,	কর্মকারকে,	
dhhaloor,	ঢালুর,	ঢালুর,	
pradoshik,	প্রাদশিক,	প্রাদশিক,	
promodwara,	প্রমোদ্বারা,	প্রমদ্বারা,	
antennal,	আন্তেননাল,	অ্যান্টেনাল,	
chorchita,	চরচিটা,	চর্চিত,	
asaktibandhan,	অসককতিবন্ধন,	আসক্তিবন্ধন,	
elakaasoho,	এলাকাসহ,	এলাকাসহ,	
dinifitian,	ডিইনফিটিন,	ডেফিনেশন,	
satarkatar,	সতরকাতার,	সতর্কতার,	
survative,	সার্ভেটিভ,	সারভেটিভ,	
taler,	তালের,	তালের,	
huqa,	হুকা,	হুক,	
perry,	পেরি,	পেরি,	
sorsa,	সররা,	সোর্স,	
matrirup,	মাতৃরূপ,	মাতৃরূপ,	
mausumer,	মোউসুমের,	মৌসুমের,	
nirbaaho,	নির্বাহ,	নির্বাহ,	
kinsa,	কিনসা,	কিংস,	
shekarmani,	শেকারমানি,	শেকরমানি,	
langhoner,	লাংঘনের,	লংঘনের,	
afrazuler,	আফরাজুলের,	আফরাজুলের,	
jaaygata,	জায়গটা,	জায়গাটা,	
reliance,	রিলিয়ান্স,	রিলায়েন্স,	
nirdesika,	নির্দেসিকা,	নির্দেশিকা,	
projanankal,	প্রজাননকাল,	প্রজননকাল,	
freekeh,	ফ্রিকহে,	ফ্রিকেহ,	
neshnosh,	নেশনস,	নেশনস,	
saqara,	সাকারা,	সকার,	
beila,	বেইলা,	বেইলা,	
daraider,	দাাইদের,	দরাইদের,	
cooda,	কোডা,	কোডা,	
swostir,	স্বস্তির,	স্বস্তির,	
nibeditar,	নিবেদীতার,	নিবেদিতার,	
proshtotto,	প্রস্তত্ব,	প্রস্ত্তত,	
furio,	ফুরিও,	ফুরিও,	
protistha,	প্রতিষ্ঠা,	প্রতিষ্টা,	
maradeha,	মারাদেহা,	মরদেহ,	
uddhrita,	উদ্ধৃত,	উদ্ধৃত,	
shrabostee,	শ্রাবস্তি,	শ্রাবস্তী,	
koyeeri,	কয়েরি,	কোয়েরি,	
chrystal,	ক্রিসটাল,	ক্রাইস্টাল,	
prakalpagulor,	প্রকালপাগুলোর,	প্রকল্পগুলোর,	
dobhara,	দোভারা,	ডোভার,	
militaryr,	মিলিটারির,	মিলিটারির,	
salapheeta,	সালাফেটা,	সালফেট,	
jyaqa,	জ্যাক,	জ্যাক,	
angkita,	অংকিটা,	অঙ্কিতা,	
dembakreeti,	দেম্বককরীতি,	ডিম্বাকৃতি,	
ekbakye,	একবাযকে,	একবাক্যে,	
rabo,	রাবো,	রব,	
nischitobhabe,	নিশ্চিতভাবে,	নিশ্চিতভাবে,	
registaner,	রেজিস্টেনের,	রেগিস্তানের,	
icelands,	আইসিল্্যান্ডস,	আইসল্যান্ডসহ,	
tata,	টা,	তাতা,	
saranor,	সারানোর,	সরানোর,	
madraser,	মাদ্রাসের,	মাদ্রাজের,	
ishahak,	ইসাহাক,	ইসাহাক,	
monzooshree,	মনজনশ্রী,	মঞ্জুশ্রী,	
karadandey,	কারাদান্ডে,	কারাদণ্ডে,	
machgulo,	মাছগুলো,	মাছগুলো,	
mirina,	মিরিনা,	মিরিনা,	
poriikkhateo,	পরিক্ষাতেও,	পরীক্ষাতেও,	
ashonkai,	আশনকাই,	আশঙ্কাই,	
nariderke,	নারীদেরকে,	নারিদেরকে,	
yak,	যাক,	ইয়াক,	
bandhano,	বাঁধানো,	বাঁধানো,	
zerusalem,	জেরুসালেম,	জেরুসালেম,	
ganosochetonota,	গণসচেতনতা,	গণসচেতনতা,	
byepass,	বিয়াপস,	বাইপাস,	
oitijjha,	ঐতিহ্ঝা,	ঐতিহ্য,	
antarctika,	আন্তার্কটিকা,	অ্যান্টার্কটিকা,	
biplabeer,	বিপ্লেবির,	বিপ্লবীর,	
times,	টিইমস,	টাইমস্,	
osommotite,	অসম্মতিতে,	অসম্মতি,	
dharabahiktite,	ধারাবাহিক্তে,	ধারাবাহিকটিতে,	
sikarder,	সিকারদের,	শিকারদের,	
gurmukh,	গুরমুখ,	গুরমুখ,	
teestar,	টেস্টর,	তিস্তার,	
nirvachaker,	নির্ভাচকের,	নির্বাচকের,	
definition,	ডিফিনাশন,	ডেফিনেশন,	
senabahinio,	সেনাবাহিনিও,	সেনাবাহিনীও,	
baarnis,	বারনিস,	বার্নিশ,	
aranyani,	অরণ্ননী,	অরণ্যানী,	
jonomukhi,	জনমুখী,	জনমুখী,	
aasirbaad,	আশিরবাদ,	আশির্বাদ,	
fasir,	ফাসির,	ফাসীর,	
bedey,	বেদে,	বেদে,	
byaboharkarir,	ব্যবহারকারীর,	ব্যবহারকারীর,	
salmaner,	সালমানের,	সালমানের,	
toki,	তোকি,	তকি,	
jansha,	জননা,	জন্স,	
aakaabar,	আকাবার,	আকাবার,	
koordider,	কর্ডিদের,	কুর্দিদের,	
nothibhukto,	নথিভুক্ত,	নথিভুক্ত,	
dheke,	ধেকে,	ঢেকে,	
bosantake,	বসননাতকে,	বসন্তকে,	
taigara,	তাইগারা,	টাইগার,	
breqathru,	ব্রেকথরু,	ব্রেকথ্রু,	
bisshonath,	বিশ্নাথা,	বিশ্বনাথ,	
daktikit,	ডাক্তিটি,	ডাকটিকিট,	
onkush,	অং্ুুশ,	অংকুশ,	
shattoki,	শাত্কোকি,	সাত্যকি,	
sthapona,	স্থাপনা,	স্থাপনা,	
akhandota,	অখণ্ডতা,	অখণ্ডতা,	
ekroop,	একরোপ,	একরূপ,	
bardhitansh,	বার্ধিতানশ,	বর্ধিতাংশ,	
poketchorder,	পকেটকর্ধের,	পকেটচরদের,	
dakticket,	ডাকটিকেত,	ডাকটিকিট,	
fake,	ফেকে,	ফাকে,	
zerusalemer,	জেরুসালেমের,	জেরুজালেমের,	
somraat,	সমররাট,	সম্রাট,	
heelser,	হেলসার,	হিলসের,	
dhila,	ধীলা,	ঢিলা,	
marpit,	মারপিট,	মারপিট,	
azaan,	আজাান,	আজান,	
sealvi,	সিলভি,	সিলভি,	
pathkrom,	পাঠকর্ম,	পাঠক্রম,	
chotogolper,	চতগল্পের,	ছোটগল্পের,	
heawy,	হেভি,	হেভি,	
pracharanamulak,	প্রচরণামূলক,	প্রচারণামূলক,	
phartha,	ফারথা,	ফার্থ,	
liedtke,	লিয়েটকে,	লইডটক,	
bhoolapuka,	ভোলাপুকা,	ভোলাপুক,	
satarkakari,	সতর্ককারী,	সতর্ককারী,	
mitrer,	মিত্রের,	মিত্রের,	
gonohotyakey,	গণহত্যাকে,	গণহত্যাকে,	
aalaa,	আলা,	আলা,	
vobanipur,	ভোবানীপুর,	ভবানীপুর,	
mukhyo,	মুখ্য,	মুখ্য,	
beauby,	বিউবি,	বিউবি,	
leaders,	লিডার্স,	লিডার্স,	
fooloo,	ফুলো,	পোলো,	
carloos,	কারললুস,	কার্লোস,	
chire,	চিরে,	চিরে,	
rajtantra,	রাজতান্ত্র,	রাজতন্ত্র,	
toxoid,	টক্সোইড,	টক্সয়েড,	
bajite,	বাজিতে,	বাজিতে,	
qulim,	কুলিম,	কুলিং,	
pariyech,	পারিয়েে,	পরিয়েছ,	
peshto,	পেষ্টো,	পেষ্ট,	
naabbota,	নাব্যতা,	নাব্যতা,	
daakticketer,	ডাকটিকেটের,	ডাকটিকিটের,	
templet,	টেম্পলেট,	টেম্পলেট,	
remacry,	রিম্যাক্রি,	রেমাক্রী,	
transapharma,	ট্রান্সফোর্ম,	ট্রান্সফর্ম,	
dep,	ডেপ,	ডেপ,	
standards,	স্ট্যান্ডর্ডস,	স্টান্ডার্ডস,	
doltyagi,	দল্তিযাগী,	দলত্যাগী,	
laaisensh,	লাইসেন,	লাইসেন্স,	
bonshi,	বোশি,	বংশী,	
asthishondhi,	অস্থিশন্ধি,	অস্থিসন্ধি,	
shoodhooi,	সুধই,	শুধুই,	
sahinsatar,	সাহিন্াতার,	সহিংসতার,	
ramachandranke,	রামাচন্দ্রনকে,	রামাচন্দ্রনকে,	
shatokeo,	শাতকেও,	শতকেও,	
kajangale,	কজনগলে,	কজঙ্গলে,	
ujobekeestan,	উজোবেকস্তান,	উজবেকিস্তান,	
rayyalati,	রায়ায়াতি,	রয়্যালটি,	
pack,	প্যাক,	প্ল্যাক,	
paadee,	পাদে,	পাড়ে,	
valobase,	ভালোবাসে,	ভালোবাসে,	
chalachchitra,	চলচ্চিত্র,	চলচ্চিত্র,	
hugeke,	হুগেকে,	হিউজকে,	
agaldar,	আগালদার,	আগলদার,	
jumlalancer,	জুমলানাস্সের,	জুমলাল্যান্সার,	
shhepha,	শেফা,	শেফ,	
enjineers,	এঞ্জিনির্স,	ইঞ্জিনিয়ার্স,	
dakten,	ডাকতেন,	ডাকতেন,	
bondi,	বন্দী,	বন্দী,	
vejjanno,	ভেজ্জান্য,	ভেজানো,	
hitlere,	হিটলারে,	হিটলারে,	
pachattar,	পাচা্টার,	পাচাত্তার,	
encidablu,	এনসিডাবলু,	এনসিডাব্লু,	
bhabaponno,	ভবাপণ্ন,	ভাবাপন্ন,	
harbare,	হারবরে,	হারবারে,	
scholars,	স্কলারস,	স্কলার্স,	
vittio,	ভিত্তিও,	ভিত্তিও,	
oisamoyer,	ঐশময়ের,	ঐসময়ের,	
sharansthal,	শারান্থল,	শরণস্থল,	
chhootochhuti,	ছুটছুটি,	ছুটোছুটি,	
paner,	প্যানের,	পানের,	
bongsho,	বংশো,	বংশ,	
difinishion,	ডিফিশিশন,	ডেফিনেশন,	
gudamjat,	গুদাজমত,	গুদামজাত,	
humner,	হামনার,	হামনার,	
boshoborti,	বশবর্তী,	বশবর্তী,	
sthapanar,	স্থাপনার,	স্থাপনার,	
ponero,	পনেরও,	পনের,	
chikitsar,	চিকিৎসার,	চিকিত্সার,	
crime,	ক্রাইম,	ক্রাইম,	
dristiheen,	দৃষ্টিহীন,	দৃষ্টিহীন,	
nothiboddho,	নথিবদ্ধ,	নথিবদ্ধ,	
mumtaz,	মুমতাজ,	মুমতাজ,	
maila,	মাইলা,	মাইল,	
safiin,	সাফিন,	সাফিন,	
khaschandpur,	খাশচন্দপুরের,	খাসচাঁদপুর,	
ruby,	রুবি,	রুবী,	
uddhritir,	উদ্ধ্রিতির,	উদ্ধৃতির,	
dekaner,	দেকানের,	দেকানের,	
gafeeloti,	গাফিলোটি,	গাফিলতি,	
khudrokar,	ক্ষুদ্রকার,	ক্ষুদ্রকার,	
nodiitei,	নদীতেই,	নদীতেই,	
achintopurer,	অচিন্তপুরের,	অচিন্তপুরের,	
peterke,	পেটারকে,	পিটারকে,	
sangaskritipreme,	সংস্কৃত্পীর্পেমে,	সংস্কৃতিপ্রেমে,	
porbotmala,	পর্বতম্লা,	পর্বতমালা,	
bonsho,	বংশো,	বংশ,	
jatinkey,	জাতিনকে,	যতীনকে,	
prodiiper,	প্রদিয়পের,	প্রদীপের,	
difinision,	ডিফিশনন,	ডেফিনেশন,	
ramzaner,	রামজানের,	রমযানের,	
metropolitan,	মেট্রোপ্লাটাটন,	মেট্রোপলিটন,	
highcomissione,	হাকমমিকেশনে,	হাইকমিশনে,	
huka,	হুকা,	হুক,	
probhura,	প্রভুরা,	প্রভুরা,	
premo,	প্রেমো,	প্রিমো,	
romnar,	রোমনার,	রমনার,	
antarctica,	আন্টার্কটিিকা,	অ্যান্টার্কটিকার,	
injiniyarim,	ইঞ্জিনিপারিম,	ইঞ্জিনিয়ারিং,	
jibnagore,	জীবনাগরে,	জীবননগর,	
semai,	সেমাই,	সেমাই,	
madhobi,	মাধবী,	মাধবী,	
youth,	যোউথ,	ইয়ুথ,	
tecno,	টেকনো,	টেকনো,	
dayitta,	দায়িত,	দায়িত্ব,	
osthishondhi,	অস্থিশন্ধি,	অস্থিসন্ধি,	
dokaangulotey,	ডোকানগুলোতে,	দোকানগুলোতে,	
swasthohinotay,	স্বাস্থানহীনতায়,	স্বাস্থ্যহীনতায়,	
choshon,	চোষন,	চোষণ,	
pancbaar,	প্যানব্যার,	পাঁচবার,	
dii,	দিআই,	দিই,	
shukrabab,	শুকররবাব,	শুক্রবাব,	
garora,	গারোরা,	গারোরা,	
suraaropito,	সুরারীপত,	সুরারোপিত,	
oncoleo,	অনকলেও,	অঞ্চলেও,	
shanno,	শান্নো,	সান্নো,	
meshmeshya,	মেশমেশ্যা,	মেশহমেশহিইয়া,	
bojhaao,	বোঝাও,	বোঝাও,	
sweety,	স্বতি,	সুইটি,	
fulkapi,	ফুলকাপি,	ফুলকপি,	
saarbharti,	সারভারটি,	সার্ভারটি,	
medilek,	মেডিলেক,	মেডিলেক,	
chhutochhooti,	ছুটোচটি,	ছুটোছুটি,	
jegulur,	জেগুলুর,	যেগুলুর,	
utshahomulok,	উত্সাহামূলক,	উৎসাহমূলক,	
fatkabazare,	ফাটকাবাজারে,	ফাটকাবাজারে,	
maktum,	মাকতুম,	মাকতুম,	
goshthiti,	গোষ্ঠিটি,	গোষ্ঠীটি,	
prakare,	প্রকরে,	প্রকারে,	
pranidero,	প্রাণীদেরও,	প্রানীদেরও,	
vandar,	ভান্ডার,	ভাণ্ডার,	
byatari,	ব্যতারি,	ব্যাটারী,	
matt,	মাট,	ম্যাট,	
obdi,	ওবদি,	অব্দি,	
aatmobishwasi,	আত্মবিশ্বাসী,	আত্মবিশ্বাসী,	
falasrutite,	ফলাসরুতিতে,	ফলশ্রুতিতে,	
sabrakamer,	সাবরাকেমের,	সবরকমের,	
stagecraft,	স্টেগ্যাফ্র্যাফট,	স্টেজক্রাফট,	
kkhur,	কুখুর,	ক্ষুর,	
parikhar,	পারিখর,	পরিখার,	
shnaipara,	শ্নাইপর,	স্নাইপার,	
dosha,	দোশা,	দোসা,	
adwanced,	অ্যাডব্যান্ডে,	অ্যাডভান্সড,	
soundarja,	সৌন্দর্য্য,	সৌর্ন্দয্য,	
zakharovar,	যাখারোভার,	জাখারোভার,	
bike,	বিকে,	বাইক,	
madhoori,	মধধুরি,	মাধুরী,	
grootha,	গ্রুথা,	গ্রোথ,	
johny,	জনহি,	জনি,	
sangharshik,	সংঘর্ষিক,	সাংঘর্ষিক,	
irana,	ইরানা,	ইরান,	
dalip,	দালিপ,	দালিপ,	
jhimochchilo,	ঝিমোচছিলো,	ঝিমোচ্ছিলো,	
bonobhumi,	বনভূমি,	বনভূমি,	
nadnadeer,	নাদনাদির,	নদনদীর,	
laishenshim,	লইশেনশিম,	লাইসেন্সিং,	
horeepur,	হরিপুর,	হরিপুর,	
dharabahikbhabe,	ধারাবাহিকভাবে,	ধারাবাহিকভাবে,	
shrabasti,	শ্রাবস্তি,	শ্রাবস্তী,	
lishenshe,	লিশেনশে,	লাইসেন্স,	
jyesthaa,	জ্যেষ্ঠা,	জ্যেষ্ঠা,	
shukraanoo,	শুক্রাণো,	শুক্রানু,	
ooipoka,	ঔৈপকা,	উইপোকা,	
nirbaho,	নির্বাহ,	নির্বাহ,	
jerushalema,	জেরুশালেমা,	জেরুসালেম,	
myari,	ম্যারি,	ম্যারি,	
rajbandir,	রাজবন্দির,	রাজবন্দীর,	
yuroo,	যুরো,	ইউরো,	
average,	এভারেজ,	এভারেজ,	
abhidhaaneeck,	অভিধানেক,	অভিধানিক,	
daebug,	দাবুগ,	ডিবাগ,	
dinara,	দিনারা,	ডিনার,	
hossne,	হোসনে,	হোসনে,	
protiakromonei,	প্রতিয়াক্রমণেই,	প্রতিআক্রমণেই,	
modele,	মডেলে,	মডেলে,	
suhasini,	সুহাসিনি,	সুহাসিনী,	
jotsna,	জোসন্া,	জ্যোৎস্না,	
hijrite,	হিজরিতে,	হিজরীতে,	
samaptir,	সমাপ্তির,	সমাপ্তির,	
samoshtigato,	সমষ্টিগত,	সমষ্টিগত,	
madrasa,	মাদররা,	মাদ্রাসা,	
pleta,	প্লেট,	প্লেটো,	
flux,	ফ্লাক্স,	ফ্লাস্ক,	
monchostho,	মঞ্চস্থ,	মঞ্চস্থ,	
prasadhani,	প্রসাধনী,	প্রসাধনী,	
path,	প্যাথ,	পাথ,	
sheepha,	সিফা,	শেফ,	
ddheela,	ঢীল,	ঢিলা,	
rakhtokkharoner,	রাতকষ্কারণের,	রক্তক্ষরণের,	
byabaharkarike,	ব্যবহারকারীকে,	ব্যবহারকারীকে,	
sheshdinti,	শেষদিনটি,	শেষদিনটি,	
andon,	আন্ডন,	আন্দোন,	
plate,	প্ল্যাতে,	প্লেট,	
bhittimul,	ভিত্তিমুল,	ভিত্তিমূল,	
chalochchitrei,	চালচ্চিত্রেই,	চলচ্চিত্রেই,	
video,	ভিদেও,	ভিডিয়োও,	
sommoteer,	সম্মতীর,	সম্মতির,	
chhaikalo,	ছাইকালো,	ছাইকালো,	
shift,	শিফ্ট,	শিফট,	
shithilata,	শীথিলতা,	শিথিলতা,	
foolkopi,	ফুলকপি,	ফুলকপি,	
sachetonvabe,	সচেতভাবে,	সচেতনভাবে,	
folleni,	ফলেনি,	ফলেনি,	
provritike,	প্রভৃতিকে,	প্রভৃতিকে,	
bodhirta,	বোধর্তা,	বধিরতা,	
jaistho,	জৈস্থ,	জ্যৈষ্ঠ,	
pyor,	পায়ার,	পিওর,	
manjushree,	মঞ্জুশ্রী,	মঞ্জুশ্রী,	
nagorikra,	নাগোিকরা,	নাগরিকরা,	
brekthrough,	ব্রেক্থরোঘ,	ব্রেকথ্রু,	
transform,	ট্রান্সফোর্ম,	ট্রান্সফর্ম,	
qanasarabheshana,	কানাসারভাশন,	কনসারভেশন,	
gotihin,	গোিহীন,	গতিহীন,	
farna,	ফার্ণা,	ফার্ন,	
sahozlabhbhatar,	সহজল্লভভাতার,	সহজলভ্যতার,	
humira,	হুমিরা,	হুমিরা,	
gejetade,	গেজেতাদে,	গেজেটেড,	
safiha,	সাফিহা,	সাফিহা,	
superheiroo,	সুপারহাইরো,	সুপারহিরো,	
grauth,	গ্রুথ,	গ্রোথ,	
bbiswasho,	বিব্বাস্য,	বিশ্বাসও,	
obhaarbhiu,	অভারভিউ,	ওভারভিউ,	
amburi,	অম্বুরি,	আম্বুরি,	
welcome,	ওয়েলকমে,	ওয়েলকাম,	
yucalyptus,	জুযাকলাইপ্তাস,	ইউক্যালিপ্টাস,	
natshi,	নাটশি,	নাত্সি,	
peengna,	পেংনা,	পিংনা,	
bijito,	বিজিত,	বিজিত,	
meshenjar,	মেশেঞ্জার,	মেসেঞ্জার,	
jeelyaand,	জিল্যান্ড,	জিল্যান্ড,	
siima,	সিমা,	সীমা,	
digreeke,	দিগ্রীকে,	ডিগ্রিকে,	
husni,	হাসনি,	হুসনি,	
jonosomaj,	জনসমাজ,	জনসমাজ,	
porobortii,	পরবর্তীই,	পরর্বতী,	
chandrimaa,	চান্দ্রিমা,	চন্দ্রিমা,	
deputee,	দেপুটি,	ডেপুটি,	
laiseensee,	লাইসেনিস,	লাইসেন্স,	
bapio,	বাপিও,	বাপিও,	
sommotitey,	সম্মতিতে,	সম্মতিতে,	
deejeejer,	দীজিজের,	ডিজিজের,	
gandhikey,	গান্ধিকে,	গান্ধীকে,	
abarte,	আবর্তে,	আবর্তে,	
habol,	হাবল,	হাবোল,	
aakkaash,	আক্কাশ,	আককাস,	
kekru,	কেক্রু,	কেকরু,	
ssahocorze,	স্যাহকোর্জে,	সাহচর্যে,	
nodnodeer,	নদননীর,	নদনদীর,	
guha,	গুহা,	গোহ,	
basab,	বাসাব,	বাসাব,	
rokibul,	রকিবুল,	রকিবুল,	
nirbahi,	নির্বাহি,	নির্বাহি,	
norpholk,	নরফলক,	নরফোক,	
nisshongotake,	নিঃশঙ্গতাকে,	নিঃসঙ্গতাকে,	
hijritey,	হিজরিতে,	হিজরীতে,	
huk,	হুক,	হুক,	
prothati,	প্রথাটি,	প্রথাটি,	
torutoler,	তরুটললের,	তরুতলের,	
markeetim,	মার্কিটিম,	মার্কেটিং,	
shingping,	শিংপিং,	শিংপিং,	
probolshoktio,	প্রবলশক্তিও,	প্রবলশক্তিও,	
hoil,	হোল,	হইল,	
prachando,	প্রাান্ডো,	প্রচণ্ড,	
proboleme,	প্রবলেেমে,	প্রবলেমে,	
feroza,	ফেরোজা,	ফিরোজা,	
deeares,	ডিয়ারেস,	ডিআরএস,	
rokkhonabekkhoner,	রক্ষণাবেক্ষণের,	রক্ষণাবেক্ষণের,	
devolapar,	দেভলাপার,	ডেভলপার,	
dijijer,	দিজিজের,	ডিজিজের,	
pitiler,	পিটিলের,	পিটিলের,	
turbine,	টুরবিনে,	টারবাইন,	
akhhunno,	আখুন্ন,	অক্ষুণ্ণ,	
kolkarkhana,	কোলকারখানা,	কলকারখানা,	
manob,	মানব,	মানব,	
mastarsa,	মাস্তারসা,	মাস্টার্স,	
sthaponagulo,	স্থাপনাগুলো,	স্থাপনাগুলো,	
wishnu,	উইনু,	বিষ্ণু,	
engrejer,	এংরেজের,	ইংরেজের,	
brittakare,	বৃত্তকরে,	বৃত্তাকারে,	
steeit,	স্টিনট,	স্টেইট,	
pathanirdeshona,	পাঠানির্দেশনা,	পথনির্দেশনা,	
kloud,	ক্লুড,	ক্লাউড,	
miley,	মিলে,	মিলে,	
durgotshob,	দুর্গতৎব,	দুর্গোৎসব,	
tukroke,	টুকরোকে,	টুকরোকে,	
arthonitite,	অর্থনীতিতে,	অর্থনীতিতে,	
neermol,	নির্মল,	নির্মল,	
purohitra,	পুরোহিত্রা,	পুরোহিতরা,	
ghomta,	ঘোমটা,	ঘোমটা,	
alonkaran,	আলোকরণ,	অলঙ্করণ,	
ceramiker,	সেরামিকের,	সিরামিকের,	
tongaa,	টোঙ্গা,	টোঙ্গা,	
saria,	সারিয়া,	সরিয়া,	
kormokarer,	কর্মকারের,	কর্মকারের,	
sucre,	সাক্রে,	সাকার,	
nehle,	নেহলে,	নেহলে,	
soolke,	সুলকে,	শুল্কে,	
basermick,	বেসারমিক,	বেসারমিক,	
muradkey,	মুরাদকে,	মুরাদকে,	
auttacharer,	অট্টাচারের,	অত্যাচারের,	
janmat,	জননমত,	জন্মাত,	
tenishe,	তেনিশে,	টেনিসে,	
ashanka,	আশানকা,	আশংকা,	
ingreziteo,	ইংরেজিতেও,	ইংরেজিতেও,	
bornanukrome,	বর্ণানকুরমে,	বর্নানুক্রমে,	
dhalur,	ধালুর,	ঢালুর,	
sanaktokaran,	সানক্তকরণ,	সনাক্তকরণ,	
gejeted,	গেজেটেড,	গেজেটেড,	
motkey,	মৎকে,	মতকে,	
bonnopran,	বন্যপ্রাণ,	বন্যপ্রাণ,	
janghu,	জাহু,	জঙ্ঘু,	
showtey,	শোটে,	শোতে,	
shoori,	শূরী,	সুরি,	
avetar,	আভেতার,	অবতার,	
shangkalonti,	সংকলণ্ডটি,	সংকলনটি,	
qaro,	কারো,	কারো,	
deefinision,	ডিফিশিশন,	ডেফিনেশন,	
ipl,	আইপিএল,	আইপিএল,	
neck,	নেক,	নেক,	
gostigulo,	গোস্টিগুলো,	গোষ্ঠীগুলো,	
treebhuj,	ত্রিভূজ,	ত্রিভূজ,	
otyacharito,	অত্যাচারিত,	অত্যাচারিত,	
daaktikit,	দাকটিকিট,	ডাকটিকিট,	
bisshasyi,	বিশ্বাসী,	বিশ্বাসই,	
sushposhtolikhito,	সুষ্পশ্টলিখিত,	সুষ্পষ্টলিখিত,	
euqalyptus,	ইউক্লাপ্তাপ,	ইউক্যালিপ্টাস,	
mekapgulo,	মেকাপগুলো,	মেকআপগুলো,	
lirikti,	লিরিকটি,	লিরিকটি,	
chalochchitraeeo,	চালচ্চিত্রাও,	চলচ্চিত্রেও,	
anusthane,	অনুষ্ঠানে,	অনুষ্ঠানে,	
khorsed,	খোরসেড,	খোরশেদ,	
aajeej,	আজী,	আজিজ,	
lettar,	লেট্টার,	লেটার,	
alsaar,	আলসার,	আলসার,	
milea,	মিলিয়া,	মাইলে,	
jamarate,	জামারাতে,	জামারাতে,	
naazi,	নাজি,	নাত্সি,	
yatharthabhabe,	যথারথাভাবে,	যথার্থভাবে,	
suisharke,	সুইশারকে,	সুইশারকে,	
welaqama,	ওয়ালাকামা,	ওয়েলকাম,	
akai,	আকাই,	একাই,	
noitik,	নৈটিক,	নৈতিক,	
cena,	সেনা,	সিনা,	
mohajote,	মহাযোতে,	মহাজোট,	
shoriph,	শরিফ,	শরিফ,	
samley,	সামলে,	সামলে,	
gotirodh,	গতিরোধ,	গতিরোধ,	
godamjato,	গোদামজোত,	গুদামজাত,	
raiialati,	রায়য়ালটি,	রয়্যালটি,	
plaiin,	প্লেইন,	প্লেন,	
gobeshonar,	গবেষণার,	গবেষনার,	
kaansaat,	কান্সাট,	কানসাট,	
shchalastik,	স্ইলাস্িটিক,	স্কলাস্টিক,	
rojapalaner,	রোজাপালনের,	রোজাপালনের,	
banglota,	বাংলোটা,	বাংলোটা,	
nazranar,	নাজরানার,	নাজরানার,	
nuhas,	নুহাস,	নুহাশ,	
ghoomachhe,	ঘুমাচেছে,	ঘুমাচ্ছে,	
horiddar,	হরিদ্দার,	হরিদ্বার,	
sangasthagulo,	সংস্থাগুলো,	সংস্থাগুলো,	
shahidputra,	শহিদপুত্র,	শহীদপুত্র,	
hurricane,	হ্রারিকেন,	হ্যারিকেন,	
osoborno,	অসবর্ণ,	অসবর্ণ,	
naagaalyand,	নাগাল্যান্ড,	নাগাল্যান্ড,	
pratishthanik,	প্রতিষ্ঠানিক,	প্রাতিষ্ঠানিক,	
tolemy,	টোলমি,	টলেমির,	
recondishon,	রেকন্ডিশন,	রিকন্ডিশন,	
rakkhanvag,	রক্ষণভাগ,	রক্ষণভাগ,	
ramchander,	রামচন্দের,	রামচন্দরের,	
gajiipur,	গাজিপপুর,	গাজীপুর,	
bojata,	বোজাতা,	বোজাটা,	
jatotaa,	যততাা,	যতোটা,	
harbore,	হারবোরে,	হারবারে,	
paab,	প্বাব,	পাব,	
edmeeral,	এডমিরাল,	এডমিরাল,	
ap,	এপিএপ,	আপ,	
parabortee,	পারাবর্তী,	পরর্বতী,	
dharmee,	ধর্মী,	ধর্মী,	
elaakaa,	এলাকা,	এলাকা,	
mathieu,	মাথিউ,	ম্যাথিউ,	
kartona,	কারটোনা,	করতনা,	
tigmanshu,	টিগমাংশু,	তিগমংশু,	
vortuki,	ভো্টুকি,	ভর্তুকি,	
bostubad,	বস্তুবাদ,	বস্তুবাদ,	
rohasyer,	রোহা্যের,	রহস্যের,	
anutpadanshil,	অনুতপানশাীল,	অনুৎপাদনশীল,	
salsa,	সালসা,	সালসা,	
aanaan,	আনান,	আনান,	
oncholsomuho,	অঞ্চলসমূহ,	অঞ্চলসমূহ,	
kanasharabheshhana,	কানারাভেশন,	কনসারভেশন,	
purbanchaler,	পুরবঞ্চললের,	পূর্বাঞ্চলের,	
manushe,	মানুশে,	মানুষে,	
boikalyo,	বৈকাল্য,	বৈকল্য,	
shilpajata,	শিল্পজাতা,	শিল্পজাত,	
beshyasdone,	বেশ্যাস্দনে,	বেশ্যাসদনে,	
vezano,	ভেজানো,	ভেজানো,	
samaveshke,	সমাভেশকে,	সমাবেশকে,	
amorendro,	অমোরেন্দ্র,	অমরেন্দ্র,	
koreempoor,	করিমপর,	করিমপুর,	
mankisundar,	মানকিসুন্দর,	মানকিসুন্দর,	
taranee,	তারানি,	তরণী,	
fastag,	ফাস্তাগ,	ফ্যাসট্যাগ,	
vogiroth,	ভোগীরতথ,	ভগীরথ,	
casper,	ক্যাসপার,	ক্যাসপার,	
soteciety,	সোটিসেটি,	সোসাইটিতে,	
krechi,	ক্রেচি,	করেছি,	
andamana,	আন্দামানা,	আন্দামান,	
maailey,	মাইলে,	মাইলে,	
chargar,	চার্গার,	চার্জার,	
somraatder,	সমরাটদের,	সম্রাটদের,	
laaishheshh,	লইশেশ,	লাইসেন্স,	
probondhobhittik,	প্রবন্ধভিত্তিক,	প্রবন্ধভিত্তিক,	
indrani,	ইন্দ্রানী,	ইন্দ্রাণী,	
protishta,	প্রতিষ্টা,	প্রতিষ্টা,	
birishiritey,	বিরিশিরিতে,	বিরিশিরিতে,	
muradpur,	মুরাদপুর,	মুরাদপুর,	
sadadyarao,	সদদ্যরাও,	সদদ্যরাও,	
gabhaaskar,	গাভাসকার,	গাভাস্কার,	
joumana,	জমানা,	জুমানা,	
brojomohun,	ব্রোজমুহন,	ব্রোজোমোহন,	
ponchashjon,	পঞ্চাশন,	পঞ্চাশজন,	
ronodeep,	রণদীপ,	রণদীপ,	
sutir,	সুটির,	সুতির,	
songbadmadhyame,	সংবাদমাধ্যমে,	সংবাদমাধ্যমে,	
bhittiti,	ভিত্তিটি,	ভিত্তিটি,	
aqram,	আক্রম,	আকরাম,	
hamburgey,	হাম্বুয়ার্গে,	হামবুর্গে,	
minishtarer,	মিনিষ্টারের,	মিনিস্টারের,	
protectionism,	প্রোটেকশনিিয়াম,	প্রোটেকশনিজম,	
songkolonti,	সংকলন্তি,	সংকলনটি,	
khalidkay,	খলিদকয়ে,	খালিদকে,	
angibhutovabe,	অঙ্গিভুভাাবে,	অঙ্গীভূতভাবে,	
krom,	ক্রম,	ক্রম,	
selim,	সেলিম,	সেলিম,	
sahajlabhbhotar,	সহলযলভভভার,	সহজলভ্যতার,	
mukhoshdharir,	মুখোশধারীর,	মুখোশধারীর,	
neker,	নেকের,	নেকের,	
daacktickete,	ডাক্টিকেতে,	ডাকটিকিটে,	
kobulennechha,	কবুলেনেেছে,	কবুলেন্নেছা,	
sector,	সেক্টর,	সেক্টর,	
aembed,	এ্যাম্বেড,	এম্বেড,	
harja,	হারজা,	হার্জ,	
dhanijomite,	ধানিজমিতে,	ধানিজমিতে,	
tookrokey,	তুক্রকে,	টুকরোকে,	
shumo,	শুমো,	সুমো,	
bhalobaas,	ভালোবাস,	ভালোবাসা,	
bohorompurer,	বহরপ্রমুরের,	বহরমপুরের,	
yuro,	যুরো,	ইউরো,	
gagee,	গগগী,	গেজ,	
gunje,	গুঁজে,	গুঁজে,	
eshtoniya,	এস্তনিয়া,	এস্তোনিয়া,	
asovya,	অসো্যা,	অসভ্য,	
makong,	মাকোং,	মেকং,	
degree,	ডিগ্রি,	ডিগ্রি,	
aashtikotaa,	আষ্টিকতা,	আস্তিকতা,	
sondhisthaponer,	সন্ধিস্বাপনের,	সন্ধিস্থাপনের,	
bondira,	বন্দিরা,	বন্দীরা,	
abhiyojan,	অভিযোজনা,	অভিযোজন,	
ishton,	ইস্তন,	স্টোন,	
backflipe,	ব্যাকফ্লিপে,	ব্যাকফ্লিপে,	
sures,	সুরেস,	সুরেশ,	
adhunikkale,	আধুনিকালে,	আধুনিককালে,	
bonbhumi,	বনভূমি,	বনভূমি,	
pacchi,	পাচ্চি,	পাচ্ছি,	
dologuloo,	দলগুলো,	দলগুলোও,	
ganesh,	গনেশ,	গণেশ,	
plato,	প্ল্যাটো,	প্লেটো,	
kokeyin,	কোকেন,	কোকেইন,	
ummool,	উম্মুল,	উম্মুল,	
juddhahato,	যুদ্ধহত,	যুদ্ধাহত,	
sobrakamer,	সব্রাকমের,	সবরকমের,	
rockibul,	রকিবিল,	রকিবুল,	
cheentaikaree,	চিন্তিইকারী,	ছিনতাইকারী,	
horiddare,	হরিদ্দারে,	হরিদ্বারে,	
stanahenja,	স্তাণাহেন্জা,	স্টোনহেঞ্জ,	
khoka,	খোকা,	খোকা,	
lebina,	লেবিনা,	লেবিনা,	
fibergulote,	ফাইারবাগুলোতে,	ফাইবারগুলোতে,	
kommandar,	কোম্মান্ডার,	কমাণ্ডার,	
adhyatmik,	অধ্যামটিক,	আধ্যাত্মিক,	
dormetori,	ডর্মেতরি,	ডরমিটরি,	
jamkaalo,	জামকালো,	জমকালো,	
ashamarthita,	আশামর্থিত,	অসমর্থিত,	
taitela,	তাইতেলা,	টাইটেল,	
rajyabhogi,	রাজ্যভোগী,	রাজ্যভোগী,	
graambasider,	গ্রামবাসীদের,	গ্রামবাসীদের,	
licensedhari,	লাইসেন্ডাররি,	লাইসেন্সধারী,	
durotamo,	দূরতামো,	দূরতম,	
konar,	কোনার,	কণার,	
jins,	জিন্স,	জিন্স,	
shansthagulo,	শানষ্ঠাগুলো,	সংস্থাগুলো,	
orthobochorke,	অর্থবছরকে,	অর্থবছরকে,	
grambaashio,	গ্রামবাশীও,	গ্রামবাসীও,	
samratder,	সমরাতদের,	সম্রাটদের,	
dibi,	দিবি,	দিবি,	
rajdhani,	রাজধানী,	রাজধানি,	
palestine,	প্যালেস্টাইন,	প্যালেস্টাইনে,	
chilahatee,	চিলাহাটি,	চিলাহাটি,	
windows,	উইন্ডাস,	উইন্ডোস,	
marketin,	মার্কেটিন,	মার্কেটিং,	
jyaqasana,	জ্যাকসসন,	জ্যাকসন,	
nationalser,	নেশনালাসের,	ন্যাশনালসের,	
billaho,	বিল্লাহো,	বিল্লাহ,	
thanvi,	থানভি,	থানভী,	
palta,	পাল্টা,	পালটা,	
byabosthar,	ব্যবস্থার,	ব্যাবস্থার,	
edipass,	এডিপাস,	ইডিপাস,	
sarsa,	সারসা,	সোর্স,	
basakey,	বাসাকে,	বাসাকে,	
graambashee,	গ্রামবাশি,	গ্রামবাসী,	
osamarik,	অসমারিক,	অসামরিক,	
palbongser,	পালবংসের,	পালবংশের,	
nirbaahe,	নির্বাহে,	নির্বাহে,	
rupantarer,	রূপান্তরের,	রুপান্তরের,	
bongshokey,	বংশকে,	বংশকে,	
hood,	হুড,	হুড,	
nirmankaaj,	নির্মাণকাজ,	নির্মাণকাজ,	
naazee,	নাজি,	নাত্সি,	
bahati,	বাহাটি,	বাহাতি,	
itastata,	ইতস্ততা,	ইতস্তত,	
gondhe,	গন্ধে,	গন্ধে,	
ase,	আসে,	আসে,	
jibonnogor,	জীবনগোর,	জীবননগর,	
qaferderkey,	কাফারদেরকে,	কাফেরদেরকে,	
mulor,	মুলোর,	মুলোর,	
ministara,	মিনিস্টারা,	মিনিস্টার,	
lakshmir,	লক্ষ্মীর,	লক্ষ্মীর,	
taxikeo,	ট্যাক্সিকেও,	ট্যাক্সিকেও,	
kormyi,	করম্ই,	কর্মই,	
romarder,	রোমারদের,	রোমারদের,	
torkarite,	টরকারিতে,	তরকারিতে,	
gaujano,	গৌজানো,	গজানো,	
laesens,	লেসেন্স,	লাইসেন্স,	
stander,	স্ট্যান্ডার,	স্ট্যাণ্ডের,	
vaider,	ভাইদের,	ভাইদের,	
societytey,	সসিটিতিে,	সোসাইটিতে,	
chetanagato,	চেতানাগত,	চেতনাগত,	
hansasya,	হাঁসস্য,	হংসস্য,	
meridiane,	মেরিডিয়ানে,	মেরিডিয়ানে,	
sheekar,	শিকার,	শিকার,	
dibet,	দিবেত,	ডিবেট,	
oxforde,	অক্সফোর্ডে,	অক্সফোর্ডে,	
edic,	এডিস,	এডিক,	
armshtronj,	আর্মশ্র্্জ,	আর্মস্ট্রং,	
uthhaane,	উঠানে,	উঠানে,	
latsaheb,	লতৎসহেব,	লাটসাহেব,	
kormoi,	কর্মই,	কর্মই,	
akkheperi,	অক্ষেপেরই,	আক্ষেপেরই,	
kaathhmaandute,	কাঠমান্ডুতে,	কাঠমান্ডুতে,	
farhetin,	ফারহেটিন,	ফারহেতিন,	
phiksim,	ফিকসিম,	ফিক্সিং,	
dipgulote,	ডিপগুলোতে,	দ্বীপগুলোতে,	
smarak,	স্মরক,	স্মারক,	
shishupalgarh,	শিশুপগল্হর,	শিশুপালগড়ে,	
peethey,	পেথে,	পীঠে,	
bhabaaponno,	ভবাপণ্ন,	ভাবাপন্ন,	
premoronge,	প্রেমরঙ্গে,	প্রেমরঙে,	
hari,	হারি,	হরি,	
urey,	এরে,	ইউরি,	
sponsorshipe,	স্পনশরশীপে,	স্পন্সরশীপে,	
mahasava,	মহাসব,	মহাসভা,	
baffer,	ব্যাফার,	বাফার,	
nagorikota,	নাগরিকতা,	নাগরিকতা,	
abosare,	অবসারে,	অবসরে,	
torunderke,	তরুন্ডেরকে,	তরুণদেরকে,	
bishshasho,	বিশ্বাশো,	বিশ্বাসও,	
patochitra,	পাতচিত্র,	পটচিত্র,	
sikarer,	সিকারের,	শিকারের,	
kaloniir,	কালনীর,	কালনীর,	
umedpoor,	উমেডপুরও,	উমেদপুর,	
jeshh,	জেশ,	জেস,	
gatibege,	গাটিবেজে,	গতিবেগে,	
roopmatro,	রূপমাত্র,	রূপমাত্র,	
chatrorai,	চাত্ররাই,	ছাত্ররাই,	
vetrillocuism,	ভেট্রিলোকুইসম,	ভেট্রিলোকুইজম,	
ankanshilpe,	আঙ্কনশিল্পে,	অঙ্কনশিল্পে,	
udbhaboney,	উদ্ভাবনে,	উদ্ভাবনে,	
jamseder,	জামসেদের,	জামসেদের,	
shikkhakram,	শিক্ষাক্রম,	শিক্ষাক্রম,	
khelaphate,	খেলাফাতে,	খেলাফতে,	
porjotoker,	পর্যটকের,	পর্যটকের,	
rohosyoti,	রহস্যটি,	রহস্যটি,	
ghaghat,	ঘাঘাত,	ঘাঘট,	
aniyantrita,	অনিয়নপ্রিত্ত,	অনিয়ন্ত্রিত,	
janagononar,	জানাগণনার,	জনগণনার,	
byaktikegreptar,	ব্যক্তিকেষেগ্রেত্র,	ব্যক্তিকেগ্রেপ্তার,	
talaal,	তালাল,	তালাল,	
abhidhaanick,	অভিধানিক,	অভিধানিক,	
jaatti,	যাত্তি,	জাতটি,	
kaash,	কাশ,	কাস,	
taunship,	টাউনশিপ,	টাউনশিপ,	
bachhaikrito,	বাছাইকৃত,	বাছাইকৃত,	
adbhanced,	অ্যাডভাঞ্ডেড,	অ্যাডভান্সড,	
danakana,	দানাকানা,	ডানকান,	
nabayug,	নবায়ুগ,	নবযুগ,	
pettern,	পেটার্ন,	প্যাটার্ন,	
gate,	গেটে,	গ্যেটে,	
prosadhani,	প্রসাধানি,	প্রসাধনী,	
rifleksa,	রিফলেকসা,	রিফ্লেক্স,	
nadike,	নাদীকে,	নদীকে,	
chat,	চাত,	চ্যাট,	
aosafur,	আওসাফুর,	আওশাফুর,	
dara,	ডারা,	দারা,	
oshtader,	অস্তাদের,	ওস্তাদের,	
eporzonto,	এপর্জন্ত,	এপর্যন্ত,	
societykey,	সসিটিকে,	সোসাইটিকে,	
prapokkey,	প্রাপক্্বে,	প্রাপককে,	
rajashri,	রাজশ্রী,	রাজশ্রী,	
mukhomandaler,	মুখোমণ্ডলের,	মুখমণ্ডলের,	
antercticker,	আন্টার্টকটিকের,	অ্যান্টার্কটিকের,	
akatwa,	আকাত্ব,	একাত্ব,	
scholarsip,	স্কলারশিপ,	স্কলারশিপ,	
oncholgulir,	অনচলগুলির,	অঞ্চলগুলির,	
piulir,	পিউলির,	পিউলির,	
shikhaboudi,	শিখাবৌদি,	শিখাবৌদি,	
slatgulor,	স্ল্যাটগুলোর,	স্ল্যাটগুলোর,	
nischoy,	নিশ্চয়,	নিশ্চয়,	
eura,	ইউরা,	ইউরো,	
avinetar,	অভিনেতার,	অভিনেতার,	
somabeshti,	সমাবেষটটি,	সমাবেশটি,	
uter,	উটার,	উটের,	
karaa,	কারা,	কারো,	
lesense,	লেজেন্স,	লাইসেন্স,	
prangulo,	প্রাণগুলো,	প্রানগুলো,	
fastara,	ফাস্তারা,	ফস্টার,	
rakhete,	রাখেতে,	রাখেতে,	
kkomandar,	ক্ষমান্দার,	কমাণ্ডার,	
ray,	রায়ে,	রায়,	
mette,	মেত্তে,	ম্যাট,	
sudrishya,	সুদ্রিশ্য,	সুদৃশ্য,	
scholastic,	স্কোলাস্টিক,	স্কলাস্টিক,	
saainyo,	সাইন্য,	সৈন্য,	
atak,	আটাক,	আটক,	
fostar,	ফোস্তার,	ফস্টার,	
karmazog,	কারমাজো,	কর্মযোগ,	
machkabar,	মাকাবার,	মাচকাবার,	
poschimey,	পশ্চিমে,	পশ্চিমে,	
siddhanter,	সিদ্ধন্তের,	সিদ্ধান্তের,	
dada,	দাদা,	দাদা,	
jatata,	জাতাটা,	যতোটা,	
myathiou,	ম্যাথিও,	ম্যাথিউ,	
sportstar,	স্পোর্স্টার,	স্পোর্টসস্টার,	
seekkharthirao,	শীক্ষার্থীরাও,	শিক্ষার্থীরাও,	
unitgulo,	উনিতগুলো,	ইউনিটগুলো,	
peri,	পেরি,	পেরি,	
pratiyogitar,	প্রতিযোগিতার,	প্রতিযোগীতার,	
konisttha,	কনিস্ঠা,	কনিষ্ঠ,	
sursur,	সুরসুর,	সুরসুর,	
qara,	কারা,	কর,	
lyaataa,	ল্তা,	ল্যাটা,	
weelcomee,	ভলকমি,	ওয়েলকাম,	
jwar,	জ্বার,	জ্বর,	
rahee,	রহহি,	রাহি,	
aziza,	আজিজা,	আজিজা,	
hydrological,	হাইড্রোজিক্যাল,	হাইড্রোলজিক্যাল,	
larson,	লারসন,	লারসন,	
pachak,	পাচাক,	পাচক,	
masjidke,	মাসজীদকে,	মসজিদকে,	
jens,	জেনস,	জিন্স,	
jeebanjapon,	জীবা্জপান,	জীবনযাপন,	
jolrang,	জলরাং,	জলরঙ,	
marodeho,	মারোদেহ,	মরদেহ,	
beetloser,	বিটলসের,	বিটলসের,	
dharavahikbhabe,	ধারাহাভিকভাবে,	ধারাবাহিকভাবে,	
rajnikant,	রাজনীকান্ত,	রাজনীকান্ত,	
breel,	ব্রল,	ব্রিল,	
mulbhitti,	মূলভিত্তি,	মূলভিত্তি,	
holuder,	হলুদের,	হলুদের,	
andra,	আন্ড্রা,	আন্ড্রা,	
mukhomondoler,	মুখমন্ডলের,	মুখমণ্ডলের,	
kaale,	কালে,	কালে,	
monchosthol,	মন্চস্থল,	মঞ্চস্থল,	
mayily,	মায়াইলি,	মাইলি,	
doula,	দোলা,	দৌলা,	
ramolino,	রামোলিনো,	রামোলিনো,	
oedipus,	ওডিপুস,	ইডিপাস,	
bethikata,	বেথিকাটা,	বেঠিকতা,	
khude,	খুড়ে,	ক্ষুদে,	
harishankar,	হরিশংকর,	হরিশংকর,	
ghatleo,	ঘাটলেও,	ঘটলেও,	
qor,	কোর,	কর,	
futonta,	ফুটনটা,	ফুটন্ত,	
delibhara,	ডেলিভারা,	ডেলিভার,	
ghoshanapatratio,	ঘোষণাপত্রটিও,	ঘোষণাপত্রটিও,	
landin,	ল্যান্ডিন,	ল্যান্ডিং,	
bhyaatikaner,	ভ্যাতিকানের,	ভ্যাটিকানের,	
ateetkale,	আতিতকালে,	অতীতকালে,	
sipa,	সিপা,	শিপ,	
plasse,	প্লেস,	প্লাসে,	
firti,	ফিরতি,	ফিরতি,	
mukherjee,	মুখেরজি,	মুখার্জী,	
turky,	টুর্কি,	তুর্কি,	
sangkoolan,	সংকোলন,	সংকুলান,	
ganoporibahon,	গণপরিবাহন,	গণপরিবহন,	
gazeetteed,	গজজিটিটড,	গেজেটেড,	
barder,	বার্ডার,	বার্ডের,	
waal,	ওয়াল,	উল,	
kanshat,	কানশাট,	কানসাট,	
orbit,	অরবিট,	অরবিট,	
cholocchitrer,	চলচিচ্ত্রের,	চলচ্চিত্রের,	
sikkhakromer,	শিক্ষাক্রমের,	শিক্ষাক্রমের,	
tinhazar,	তিনহাজার,	তিনহাজার,	
konistho,	কনিস্থ,	কনিষ্ঠ,	
ogovir,	অগভির,	অগভীর,	
dhojovongo,	ধোজভঙ্গ,	ধ্বজভঙ্গ,	
hooq,	হুক,	হুক,	
atmobonchito,	আত্মবঞ্চিত,	আত্মবঞ্চিত,	
touraat,	টোরাট,	তওরাত,	
reetesh,	রেটেশ,	রিতেশ,	
dipon,	ডিপন,	দীপন,	
shresthoshcho,	শ্রেষ্ঠচ্চ,	শ্রেষ্ঠশ্চ,	
sayatana,	সায়াটনন,	শয়তান,	
bhagno,	ভাগন,	ভগ্ন,	
mukhbondho,	মুখবন্ধ,	মুখবন্ধ,	
idipasha,	ইডিপাশ,	ইডিপাস,	
gyandaas,	জ্ঞানদাস,	জ্ঞানদাস,	
gaje,	গাজে,	গেজ,	
thailand,	থাইলান্ড,	থাইল্যান্ড,	
pisach,	পিসাচ,	পিশাচ,	
mukhya,	মুখ্যা,	মুখ্য,	
soomita,	সুমিতা,	সুমিতা,	
mercedes,	মার্সেডসে,	মার্সেডেস,	
dokaanei,	ডোকানেই,	দোকানেই,	
bifol,	বিফল,	বিফল,	
samyuktha,	সম্যুক্ঠা,	সামিউক্তা,	
atmira,	আত্মীরা,	আত্মীরা,	
expreshshion,	এক্সপ্রেশন,	এক্সপ্রেশন,	
lendl,	লেন্ডল,	লেন্ডল,	
danab,	দানাব,	দানব,	
mohajot,	মহাযত,	মহাজোট,	
chirkut,	চিরকুট,	চিরকুট,	
prasadhoni,	প্রাসাধনী,	প্রসাধনী,	
majdur,	মাজদুর,	মজদুর,	
sharif,	শরিফ,	শরিফ,	
batikromee,	বাতিক্রমী,	ব্যতিক্রমী,	
prijon,	প্রিজন,	প্রিজন,	
babona,	বাবোনা,	বাবনা,	
chhanada,	ছননাদা,	ছানাদা,	
songrahak,	সংগ্রাহক,	সংগ্রাহক,	
xpose,	এক্সপে,	এক্সপোজ,	
ranangone,	রণনঙ্গণে,	রণাঙ্গনে,	
paolasthi,	পাওলাস্থি,	পাওলাসথি,	
ashankai,	আশানকাই,	আশঙ্কাই,	
dooburir,	দুবুরির,	ডুবুরির,	
thandabhabe,	থান্ধাভাবে,	ঠাণ্ডাভাবে,	
amiya,	অমিয়া,	অমিয়,	
akram,	আক্রম,	আকরাম,	
shtona,	সাননা,	স্টোন,	
shubhag,	শুভাগ,	শুভাগ,	
joisttho,	জৈস্থথ,	জ্যৈষ্ঠ,	
khelechen,	খেলেছেন,	খেলেছেন,	
jotharthovabey,	যথার্থভাবে,	যথার্থভাবে,	
lotharan,	লোথারান,	লুথেরান,	
bayshorkarikarone,	বাশ্বরাকারীকণণে,	বেসরকারিকরণ,	
probhur,	প্রভুর,	প্রভুর,	
chalachchitroke,	চালাচ্চ্রিকে,	চলচ্চিত্রকে,	
shilbar,	শিলবার,	সিলভার,	
nagorikke,	নাগরিককে,	নাগরিককে,	
haridware,	হরিদ্বারে,	হরিদ্বারে,	
ghamtaa,	ঘামটা,	ঘোমটা,	
varote,	ভারতে,	ভারতে,	
debholopar,	দেভলপার,	ডেভলপার,	
pyetarna,	পিতার্ণ,	প্যাটার্ন,	
oncoltike,	অনকলটিকে,	অঞ্চলটিকে,	
krema,	ক্রেমা,	ক্রাইম,	
kanasarabheeshana,	কনসারাভিষণা,	কনসারভেশন,	
daqten,	ডাকটেন,	ডাকতেন,	
chorban,	চরবান,	চর্বন,	
gajano,	গাজানো,	গজানো,	
teentir,	টেনটির,	তিনটির,	
saralya,	সরল্যা,	সারল্য,	
johor,	জহর,	জহর,	
madhabi,	মাধবী,	মাধবী,	
pluck,	প্লুক,	প্ল্যাক,	
habshi,	হাবশি,	হাবশী,	
chokhwala,	চোখ্যালা,	চোখওয়ালা,	
magical,	ম্যাগিকাল,	ম্যাজিকাল,	
krus,	ক্রুস,	ক্রুশ,	
oojbekistan,	অজ্েকিস্তান,	উজবেকিস্তান,	
impaction,	ইমপ্যাকশন,	ইমপ্যাকশন,	
chhadura,	ছদুুরা,	ছাদুরা,	
lakkhero,	লক্ষেরও,	লক্ষেরও,	
harris,	হ্যারিস,	হ্যারিস,	
pustir,	পুস্তির,	পুষ্টির,	
marmader,	মারমেদের,	মারমাদের,	
liseensee,	লিসিনসি,	লাইসেন্স,	
teennis,	টেনিস,	টেনিস,	
esasiyetasa,	এসাইসিয়েতসা,	এসোসিয়েটস,	
grambasheeo,	গ্রাম্বাশীও,	গ্রামবাসীও,	
dienes,	ডায়েনেস,	ডিএনএস,	
elakaate,	এলাকাতে,	এলাকাতে,	
osthisondhi,	অস্থিনস্ধি,	অস্থিসন্ধি,	
aviyojan,	অভিযোজন,	অভিযোজন,	
barrageke,	বারাজেকে,	ব্যারেজকে,	
bonnypran,	বন্যপ্রাণ,	বন্যপ্রাণ,	
nirmalata,	নির্মলতা,	নির্মলতা,	
mulyabriddhikale,	মূল্যবৃদ্ধিকালে,	মূল্যবৃদ্ধিকালে,	
shasankarta,	শাসংকর্তা,	শাসনকর্তা,	
ganakantha,	গণকান্থ,	গণকণ্ঠ,	
salafeta,	সালাফেতা,	সালফেট,	
horidbar,	হরিদবার,	হরিদ্বার,	
bee,	বীই,	বি,	
anusvara,	অনুসভারা,	অনুস্বার,	
arthonitir,	অর্থনীতির,	অর্থনীতির,	
beatleser,	বিটলেসের,	বিটলসের,	
sampadon,	সম্পদন,	সম্পাদন,	
muhurtati,	মুহুর্তটি,	মুহুর্তটি,	
forex,	ফোরেক্স,	ফরেক্স,	
shloker,	শ্লোকের,	শ্লোকের,	
milayatane,	মিলায়তনে,	মিলায়তনে,	
shaater,	শাতের,	শ্যুটার,	
plainey,	প্লেইনি,	প্লেনে,	
michhilti,	মিছিলটি,	মিছিলটি,	
ritesh,	রিটশ,	রিতেশ,	
bhenom,	ভেনম,	ভেনম,	
rohosyo,	রহশ্য,	রহস্য,	
protijogitamulok,	প্রতিযোগিতামূলক,	প্রতিযোগীতামূলক,	
somonwitobhabey,	সমন্নিতভাবে,	সমন্বিতভাবে,	
swadhinotatukui,	স্বাধীনতাটুকুই,	স্বাধীনতাটুকুই,	
himchi,	হিমচি,	হিমচি,	
elakatikay,	এলাকাটিকায়,	এলাকাটিকে,	
inziniyarsa,	ইন্জিনিয়ার,	ইঞ্জিনিয়ার্স,	
konflict,	কনফ্লিক্ট,	কনফ্লিক্ট,	
hughes,	হুগেস,	হিউজেস,	
aaziz,	আজিজ,	আজিজ,	
bapokotor,	বাপোকর,	ব্যাপকতর,	
rakshanbhag,	রক্ষণভাগ,	রক্ষণভাগ,	
krimlin,	ক্রিমিন,	ক্রিমলিন,	
ghomtaa,	ঘোমটা,	ঘোমটা,	
prabhritite,	প্রভৃতিতে,	প্রভৃতিতে,	
bhalobasar,	ভালোবাসার,	ভালোবাসার,	
tintir,	তিনটির,	তিনটির,	
byabaharkaree,	ব্যবহারকারী,	ব্যবহারকারী,	
talaa,	তালা,	তালা,	
epiela,	এপিলেয়া,	আইপিএল,	
bajpa,	বাজপা,	বাজপা,	
hepatitis,	হেপাটিটিস,	হেপাটাইটিস,	
protyokkhovabey,	প্রত্যক্ষভাবে,	প্রত্যক্ষভাবে,	
shilpikuler,	শিল্পিকুলের,	শিল্পীকুলের,	
ganaparibahan,	গণপরিবাহন,	গণপরিবহন,	
kiandi,	কিয়ান্দি,	ক্যান্ডি,	
booksar,	বুকসার,	বুক্সার,	
bachai,	বাছাই,	বাছাই,	
bishshaasho,	বিশ্বাশো,	বিশ্বাসও,	
murali,	মুরালি,	মুরলী,	
ebham,	এবাম,	ইভিএম,	
nathivukta,	নথিভুক্ত,	নথিভুক্ত,	
shamuker,	শামুকের,	শামুকের,	
paikgachha,	পাইকগাছা,	পাইকগাছা,	
byabaharkareer,	ব্যবহারকররের,	ব্যবহারকারীর,	
orthoneeti,	অর্থনীতি,	অর্থনীতির,	
chirontan,	চিরন্তন,	চিরন্তন,	
themeke,	থেমেকে,	থিমকে,	
chakti,	চাকটি,	চাকতি,	
yanqee,	যানকী,	ইয়াংকি,	
kakhnoba,	কাখনোবা,	কখনওবা,	
chalochchitraeer,	চালচ্চিত্রারীর,	চলচ্চিত্রের,	
siddhantoke,	সিদ্ধান্তকে,	সিদ্ধান্তকে,	
songbadmadhyomer,	সংবাদমাধ্যমের,	সংবাদমাধ্যমের,	
ostheesandhi,	অস্থিনাস্ধি,	অস্থিসন্ধি,	
bipti,	বিপ্তি,	বিপ্তি,	
renoo,	রেনু,	রেনো,	
swairacharibirodhi,	স্বৈরাচরিবরোধী,	স্বৈরাচারীবিরোধী,	
mythological,	মাথথোজিক্যাল,	মাইথলজিকাল,	
colgirl,	কলজির্ল,	কলগার্ল,	
jolrong,	জলরং,	জলরঙ,	
ayantarqatiqa,	আযনন্তরটিকতা,	অ্যান্টার্কটিকা,	
bisshas,	বিশ্বাস,	বিশ্বাস,	
alpa,	আলপা,	অল্প,	
kayartara,	কায়ারতার,	কোয়ার্টার,	
ekhate,	এখাতে,	একহাতে,	
shajano,	শাজানো,	সাজানো,	
hert,	হার্ট,	হার্ট,	
cholochchitro,	চলচ্চিত্র,	চলচ্চিত্র,	
santaa,	সানতা,	সান্তা,	
aizulke,	আইজুলকে,	আইজুলকে,	
ekoghore,	একঘরে,	একঘরে,	
bedantodhormo,	বেদান্দধর্ম,	বেদান্তধর্ম,	
abhidhaaner,	অভিধানের,	অভিধানের,	
robot,	রোবোট,	রোবোট,	
innahu,	ইননাহু,	ইন্নাহু,	
kogake,	কোগাকে,	কোগাকে,	
diiptii,	দীইপটিই,	ডেপুটি,	
ardasho,	আর্াশো,	আর্দশ,	
taunasipa,	তাউনাসিপা,	টাউনশিপ,	
pushtee,	পুষতত,	পুষ্টি,	
ghotol,	ঘটল,	ঘটল,	
teoner,	টেওনের,	টিওনার,	
vittiteo,	ভিত্তিতেও,	ভিত্তিতেও,	
karim,	কারিম,	করিম,	
abikaul,	অবিকাল,	অবিকল,	
parkin,	পারকিন,	পার্কিং,	
agora,	আগোরা,	আগোরা,	
hoteltee,	হোটেলটি,	হোটেলটি,	
tochhnochh,	তোচনোচ,	তছনছ,	
vabnakey,	ভব্নকে,	ভাবনাকে,	
rubala,	রুবালা,	রুবল,	
fotanor,	ফোটানোর,	ফোটানোর,	
dormitory,	ডর্মিটরি,	ডরমিটরি,	
chirantan,	চিরনন্তন,	চিরন্তন,	
ekekrokom,	একেকরকমক,	একেকরকম,	
hosto,	হোস্তো,	হস্ত,	
deliver,	ডেলিভার,	ডেলিভার,	
taap,	টাপ,	ট্যাপ,	
patjata,	পাতজাতা,	পাটজাত,	
amiretus,	এ্যামিরেটাস,	এমিরেটাস,	
aansareer,	আনসেরির,	আনসারীর,	
hundai,	হুন্ডাই,	হুন্দাই,	
madhoboir,	মধৈবরইর,	মাধবীর,	
podarthobidder,	পদার্থবিদদের,	পদার্থবিদদের,	
proo,	প্রু,	প্রো,	
thabai,	থাবাই,	থাবাই,	
shurugulo,	শুরুগুলো,	শুরুগুলো,	
sobaiderke,	সবাইদেরকে,	সবাইদেরকে,	
abheedhaneek,	অভিধানীক,	অভিধানিক,	
sectore,	সেক্টরে,	সেক্টরে,	
qaferder,	কাফারদের,	কাফেরদের,	
kaaferder,	কাফেরদের,	কাফেরদের,	
shariba,	শারিবা,	শরিবা,	
niketaner,	নিকেতানের,	নিকেতনের,	
shaahaabiike,	শাহাবাবীকে,	সাহাবীকে,	
kale,	কালে,	কালে,	
ala,	আল,	আলা,	
mulvitti,	মূলভিত্তি,	মূলভিত্তি,	
ancholgoolote,	আঁযাচগললুতে,	অঞ্চলগুলোতে,	
diniphition,	ডিনিফিশন,	ডেফিনেশন,	
dorgaaho,	দরগাহো,	দরগাহ,	
girilal,	গিরিলাল,	গিরিলাল,	
asbab,	আসবাব,	আসবাব,	
shektore,	শেকতোরে,	সেক্টরে,	
seshardhe,	শেষার্ধে,	শেষার্ধে,	
taims,	টাইমস,	টাইমস্,	
pinglateo,	পিংলাতেও,	পিংলাতেও,	
karlei,	কারলেই,	করলেই,	
byboshthar,	ব্ববস্থার,	ব্যাবস্থার,	
yaak,	যাক,	ইয়াক,	
shtonehenge,	স্উননেহঙ্গে,	স্টোনহেঞ্জ,	
vorkendra,	ভোরকেন্দ্রে,	ভরকেন্দ্র,	
jaubankal,	যৌবনকাল,	যৌবনকাল,	
tyapa,	ত্যাপ,	ট্যাপ,	
hughkey,	হুগকে,	হিউজকে,	
capshule,	কাপশুলে,	ক্যাপসুল,	
jathartho,	যাথার্থ,	যথার্থ,	
biswashi,	বিশ্বাসি,	বিশ্বাসই,	
krusher,	ক্রুষের,	ক্রুশের,	
kichudinpar,	কিছুদিনপর,	কিছুদিনপর,	
drishi,	দৃশি,	দৃশ্যই,	
mahibur,	মাহিবুর,	মহিবুর,	
jolbe,	জলবে,	জ্বলবে,	
suchanakal,	সুচনাকাল,	সূচনাকাল,	
totokhon,	ততকনন,	ততক্ষন,	
qraima,	ক্রাইমা,	ক্রাইম,	
sarollo,	সারোল্লো,	সারল্য,	
bosturoi,	বস্তুরই,	বস্তুরই,	
wedanta,	উয়ান্ত,	বেদান্ত,	
ghatla,	ঘাটলা,	ঘটল,	
udvabani,	উদ্ববানী,	উদ্ভাবনী,	
debdebie,	দেবদেবী,	দেবদেবী,	
mochlekha,	মোচলেখা,	মোছলেখা,	
si,	সিআই,	এসআই,	
nirbahe,	নির্বাহে,	নির্বাহে,	
manabmaner,	মানবমনের,	মানবমনের,	
deefinishion,	ডিফিশিশন,	ডেফিনেশন,	
magar,	মাগার,	মাগার,	
oncholke,	অঞ্চলকে,	অঞ্চলকে,	
naobihar,	নাওবিহার,	নৌবিহার,	
jaadrel,	জ্যাড্রেল,	জাঁদরেল,	
sinakey,	সিনাকে,	সিনাকে,	
gazetted,	গ্যাজেটেড,	গেজেটেড,	
gaaddafee,	গাদ্ফাফী,	গাদ্দাফী,	
rejidens,	রেজিডেনস,	রেসিডেন্স,	
nagorikkey,	নাগরিককে,	নাগরিককে,	
ragee,	রেজ,	রাগী,	
moreecha,	মরিচা,	মরিচা,	
karmojog,	কার্যগগ,	কর্মযোগ,	
shipley,	শিপলি,	শিপলে,	
sausagee,	সাউজাগ,	সসেজ,	
protishtan,	প্রতিষ্টান,	প্রতিষ্টান,	
jandrel,	জ্যান্ড্রেল,	জাঁদরেল,	
aairees,	আইরেসিস,	আইরিস,	
dewaben,	দেওবানে,	দেওয়াবেন,	
gaichhe,	গাইছে,	গাইছে,	
senabahineeow,	সেনাবাহীনিয়েব,	সেনাবাহিনীও,	
saifullahil,	সাঈুল্লাহিল,	সাইফুল্লাহিল,	
suparharo,	সুপারহারো,	সুপারহিরো,	
upobasher,	উপবাশের,	উপবাসের,	
silabhara,	সিলাভরা,	সিলভার,	
amarika,	আমারিকা,	আমেরিকা,	
fiksing,	ফিকসিং,	ফিক্সিং,	
tistar,	তিস্তার,	তিস্তার,	
chandil,	চান্দিল,	চান্ডিল,	
brittakar,	বৃত্তকার,	বৃত্তাকার,	
khilaphat,	খিলাফাত,	খিলাফত,	
land,	ল্যান্ড,	ল্যান্ড,	
gore,	গোরে,	গোর,	
ovidhanik,	অভিধানিক,	অভিধানিক,	
treend,	ট্রিন্ড,	ট্রেন্ড,	
pothon,	পথন,	পঠন,	
hukar,	হুকার,	হুকার,	
sqalastiqa,	স্কালস্টিকা,	স্কলাস্টিক,	
nachiketa,	নচিকেতা,	নচিকেতা,	
katiusha,	কাতিউশা,	কাতিউশা,	
michir,	মিচির,	মিচির,	
elaakate,	এলাকাতে,	এলাকাতে,	
panthar,	পান্থার,	পন্থার,	
sangkulaan,	সংকুলন,	সংকুলান,	
serup,	সেরূপ,	সেরূপ,	
shakara,	শাকোরা,	সাকার,	
chaudhurider,	চৌধুরীদের,	চৌধুরীদের,	
inphormeshon,	ইনফর্মেশন,	ইনফরমেশন,	
munshiji,	মুনশিজি,	মুনশীজি,	
lekhaksattwar,	লেখকস্তত্বর,	লেখকসত্ত্বার,	
aamor,	আমোর,	আমর,	
tarkareer,	তরকররির,	তরকারীর,	
mookhomandoler,	মুখমণ্ডলের,	মুখমণ্ডলের,	
mirakela,	মিরাকেলা,	মিরাকেল,	
punorabortonte,	পুনরাবর্তনটে,	পুনরাবর্তন্তে,	
cantan,	ক্যানটান,	ক্যান্টন,	
ixprission,	এক্সপ্রিশন,	এক্সপ্রেশন,	
panchadadu,	পঞ্চাদদু,	পঞ্চাদাদু,	
kaalengaa,	কালেঙ্গা,	কালেঙ্গা,	
oindrila,	ঐন্দ্রিলা,	ঐন্দ্রিলা,	
koordira,	কোরদিরা,	কুর্দিরা,	
arifin,	আরিফিন,	আরিফিন,	
bharotiyotar,	ভারতীয়তার,	ভারতীয়তার,	
dhauto,	ধাতত,	ধৌত,	
nilkuthir,	নীলকুঠির,	নীলকুঠির,	
suiza,	সুইজা,	সুইজা,	
swajan,	স্বজা,	স্বজন,	
sanghar,	সংহার,	সংহার,	
chakrapani,	চক্রপানি,	চক্রপানী,	
graambasheeo,	গ্রামবাশীও,	গ্রামবাসীও,	
ponchaashjon,	পঞ্চাশজন,	পঞ্চাশজন,	
as,	এসএ,	অস,	
ashor,	আশর,	আসর,	
ajibooner,	অজিবুনের,	আজীবনের,	
palbongsher,	পালবংশের,	পালবংশের,	
timoothi,	তিমোথু,	টিমোথি,	
taposgoner,	তাপসগণের,	তাপসগণের,	
jhonkar,	ঝোঁকার,	ঝঙ্কার,	
rajpur,	রাজপুর,	রাজপুর,	
turkeyder,	তুর্কেইদের,	তুর্কিদের,	
nimnosakkharkari,	নিম্নসাক্্ারকী,	নিম্নস্বাক্ষরকারী,	
uthaney,	উঠানে,	উঠানে,	
sift,	সিফ্ট,	শিফট,	
naubom,	নিউবম,	নবম,	
sharoker,	শারকের,	স্মারকের,	
adorso,	আদর্স,	আর্দশ,	
dumaa,	দুমা,	দুমা,	
upobaasee,	উপবাসী,	উপবাসী,	
juktarashtrasaha,	যুক্তারস্তারসহ,	যুক্তরাষ্ট্রসহ,	
qredita,	ক্রেডিটা,	ক্রেডিট,	
remacri,	রিম্যাকরি,	রেমাক্রী,	
uindoos,	উইনডাস,	উইন্ডোস,	
bishwaashshke,	বিশ্বাস্কে,	বিশ্বাসকে,	
romjaner,	রোমনের,	রমযানের,	
daltyagi,	দল্ত্াগী,	দলত্যাগী,	
dorneca,	ডর্নেকা,	ডরনেকা,	
ghuznavi,	ঘুজনাী,	গজনভি,	
sombhobonao,	সম্ভবনাও,	সম্ভবনাও,	
philo,	ফিলো,	ফিলো,	
hizriite,	হিজরিতে,	হিজরীতে,	
lyaanding,	ল্যান্ডিং,	ল্যান্ডিং,	
grambaasi,	গ্রামবাসী,	গ্রামবাসী,	
abdi,	আব্দি,	অব্দি,	
akkelpure,	আক্কেলপুরে,	আক্কেলপুরে,	
bossoben,	বোসবেন,	বসবেন,	
dimbacriti,	ডিম্বাক্রিটি,	ডিম্বাকৃতি,	
reshidensha,	রেশিডেনশা,	রেসিডেন্স,	
abhidhanick,	অভিধানিক,	অভিধানিক,	
nogore,	নগরে,	নগরে,	
gara,	গারা,	গোর,	
ohalyar,	ওহাল্যার,	অহল্যার,	
pathanatak,	পাঠননাটক,	পথনাটক,	
spreedashita,	স্প্রীদািিত,	স্প্রেডশীট,	
shardotsobei,	শার্দোতসবেই,	শারদোৎসবেই,	
nabatamo,	নাতামো,	নবতম,	
sookkho,	সূক্ষ,	সুক্ষ্ম,	
dibya,	দিব্য়া,	দিব্যা,	
karir,	কারির,	কারীর,	
nojder,	নজদের,	নজদের,	
chhotogolper,	ছোটগল্পের,	ছোটগল্পের,	
poripake,	পরিপাকে,	পরিপাকে,	
cloudbook,	ক্লাউডবক,	ক্লাউডবুক,	
shector,	শেক্টর,	সেক্টর,	
windos,	উইন্ডজস,	উইন্ডোস,	
quartar,	কোয়ার্তার,	কোয়ার্টার,	
utsahi,	উতসাহি,	উৎসাহী,	
aamoode,	আমোদে,	আমুদে,	
zerusalem,	জেরুসালেম,	জেরুজালেম,	
nirikhe,	নিরিখে,	নিরিখ,	
dakteekiter,	ডাক্তিকীতের,	ডাকটিকিটের,	
sahozlabhbhotar,	সহজল্ভভাতার,	সহজলভ্যতার,	
jhalkanite,	ঝালকনিতে,	ঝলকানীতে,	
sarder,	সার্দের,	সরদার,	
mojlish,	মজলিস,	মজলিশ,	
gasthii,	গাস্থিই,	গোষ্ঠীই,	
sheetke,	সিটকে,	শীতকে,	
mukhmondole,	মুখমন্ডলে,	মুখমণ্ডলে,	
dooburira,	দুবুরিরা,	ডুবুরিরা,	
gaichey,	গাইছে,	গাইছে,	
soource,	সুুর্সে,	সোর্স,	
akeeb,	আকিব,	আকিব,	
manushti,	মনুষ্টি,	মানুষটি,	
pnouchute,	পুঁচুতে,	পৌঁছুতে,	
uporitaley,	উপরিতালে,	উপরিতলে,	
horash,	হোরাশ,	হোরাস,	
onker,	অঙ্কার,	ওঙ্কার,	
bangulzai,	বাঁলুলজাই,	বঙ্গুলিজাই,	
heart,	হার্ট,	হার্ট,	
maley,	ম্যালি,	মালে,	
orthonitir,	অর্থনীতির,	অর্থনীতির,	
madhnagar,	মাধনগর,	মাধনগরের,	
fitarsaho,	ফিতারসহ,	ফিতরসহ,	
srivatsalakshanang,	শ্রীবত্লাংককষাং,	শ্রীবৎসলক্ষণং,	
vodqa,	ভোডকা,	ভদকা,	
juktorashtreo,	যুক্তরাষ্ট্রেও,	যুক্তরাষ্ট্রেও,	
ganosachetanata,	গণসচেতননাতা,	গণসচেতনতা,	
rajan,	রাজান,	রাজন,	
bosante,	বোান্তে,	বসন্তে,	
soinyo,	সৈন্য,	সৈন্য,	
basaalt,	বাসাললট,	ব্যাসল্ট,	
futote,	ফুটোতে,	ফুটোতে,	
accountdharira,	একআউন্্াররারাইরা,	একাউন্টধারীরা,	
subade,	সুবাদে,	সুবাদে,	
stoic,	স্টোক,	স্টোয়িক,	
ghumachhe,	ঘুমাচে,	ঘুমাচ্ছে,	
asovarno,	অসভার্ণ,	অসবর্ণ,	
saver,	সাভার,	সেভার,	
poscater,	পোস্কেটের,	পশ্চাতের,	
kaleo,	কালেও,	কালেও,	
sthapanagulo,	স্থাপানুগো,	স্থাপনাগুলো,	
bhorkendra,	ভোরকেন্দ্রে,	ভরকেন্দ্র,	
teksuser,	টেকসুসের,	টেক্সাসের,	
hosbaleke,	হোসবালেকে,	হোসবালেকে,	
karmoi,	কারমই,	কর্মই,	
prokolpogulikei,	প্রকল্পগুলিকেই,	প্রকল্পগুলিকেই,	
sambhabonao,	সম্ভাবনাও,	সম্ভবনাও,	
crashlands,	ক্র্যালন্্ডস,	ক্র্যাশল্যান্ডস,	
shoreefer,	শরিফের,	শরিফের,	
francine,	ফ্রান্সিন,	ফ্রান্সিন,	
cathalic,	ক্যাথালিক,	ক্যাথলিক,	
homeser,	হোমেসের,	হোমসের,	
godabari,	গোদাবারী,	গোদাবরী,	
ooporoshtho,	ঔপরস্থ,	উপরস্থ,	
sokkhomotabriddhi,	সক্ষমতাবৃদ্ধি,	সক্ষমতাবৃদ্ধি,	
madaspushto,	মাদাসপুষ্ট,	মদদপুষ্ট,	
stona,	স্তোনা,	স্টোন,	
shrabosty,	শ্রাবস্তি,	শ্রাবস্তী,	
nakkal,	নাককাল,	নক্কল,	
gondogol,	গণ্ডগোল,	গন্ডগোল,	
abosan,	অবসান,	অবসান,	
ghatiti,	ঘাটিটি,	ঘাঁটিটি,	
vabaponno,	ভবাপন্ন,	ভাবাপন্ন,	
sikkharrtheerao,	শিক্ষার্থের্ারাও,	শিক্ষার্থীরাও,	
rata,	রাটা,	রত,	
institutione,	ইন্সটিটিউশন,	ইনস্টিটিউশনে,	
osamanno,	অসমান্য,	অসামান্য,	
naper,	নেপার,	ন্যাপের,	
baju,	বাজু,	বাজু,	
vince,	ভিনসে,	ভিন্স,	
aalkaatra,	আলকাতরা,	আলকাতরা,	
ghetu,	ঘেটু,	ঘেটু,	
jeshtha,	জেষ্টা,	জ্যেষ্ঠা,	
carzar,	কার্জার,	চার্জার,	
niropekshtar,	নিরোপেক্ষ্টর,	নিরপেক্ষতার,	
karaponner,	কারাপণ্যের,	কারাপণ্যের,	
ji,	জিআই,	জি,	
dalee,	দালী,	ডালে,	
mahafezkhanar,	মাহফাজখানর,	মহাফেজখানার,	
ingrejra,	ইংরেজরা,	ইংরেজরা,	
cheenja,	চিঞ্জা,	চেঞ্জ,	
sohokari,	সোকারি,	সহকারী,	
elakatir,	এলাকাটির,	এলাকাটির,	
bidghootey,	বিইঘোটে,	বিদঘুটে,	
purbancoler,	পুর্বানকোলের,	পূর্বাঞ্চলের,	
golghare,	গোলঘারে,	গোলঘরে,	
kanuner,	কানুনের,	কানুনের,	
tokeo,	টোকেও,	টোকেও,	
yukeliptash,	যুক্তিলে্তশ,	ইউক্যালিপ্টাস,	
grambaaseeder,	গ্রম্বসাদীদের,	গ্রামবাসীদের,	
nothivukta,	নথুভুক্ত,	নথিভুক্ত,	
goodamjato,	গুদামজোত,	গুদামজাত,	
deputi,	দেপুটি,	ডেপুটি,	
abhirupbabuke,	অভিরূপপাবুকে,	অভিরূপবাবুকে,	
gronthoti,	গ্রন্থটি,	গ্রন্থটি,	
matorom,	মাতরম,	মাতরম,	
kareer,	কারীর,	কারীর,	
graambaashee,	গ্রামবাশী,	গ্রামবাসী,	
mase,	মেস,	মাসে,	
fakhrul,	ফখরুল,	ফাখরুল,	
chakurijibirao,	চাকুরিজীবিরাও,	চাকুরীজীবীরাও,	
brail,	ব্রেইল,	ব্রেইল,	
probeshkari,	প্রবেশকারী,	প্রবেশকারী,	
bishaashke,	বিষাশকে,	বিশ্বাসকে,	
baman,	বামান,	বামন,	
bhardwaj,	ভার্দ্বজ,	ভরদ্বাজ,	
bm,	বিএম,	বিএম,	
meghacchonno,	মেঘাচঞ্ন,	মেঘাচ্ছন্ন,	
tennis,	টেনিস,	টেনিস,	
sthapanagulor,	স্থাপানুগুলোর,	স্থাপনাগুলোর,	
liaodong,	লিয়াডং,	লিয়াওদং,	
cbi,	সিবিবি,	সিবিআই,	
telakucha,	তেলাকুচা,	তেলাকুচা,	
ship,	শিপ,	শিপ,	
seekkhokbrindo,	শীক্ষকবৃন্দ,	শিক্ষকবৃন্দ,	
bharotchilo,	ভারতচিল,	ভারতছিল,	
doorotomo,	দূরতম,	দূরতম,	
firozapure,	ফিরোজাপুরে,	ফিরোজাপুরে,	
upbasher,	উপবাশের,	উপবাসের,	
militarite,	মিলিটারিতে,	মিলিটারিতে,	
pothnirdeshona,	পোথনির্দেশন,	পথনির্দেশনা,	
deciliter,	ডেসাইলিটের,	ডেসিলিটার,	
dhonni,	ধননি,	ধন্যি,	
nirmankarmisaha,	নির্মাণকারীিমসহ,	নির্মাণকর্মীসহ,	
orbeet,	অরবিত,	অরবিট,	
brittakarey,	বৃত্তকরে,	বৃত্তাকারে,	
votar,	ভোটার,	ভোটার,	
refleks,	রিফ্লেকস,	রিফ্লেক্স,	
grambaashi,	গ্রম্বাশী,	গ্রামবাসী,	
mentither,	মেন্টিথের,	মেনটিথের,	
informetion,	ইনফর্মেশন,	ইনফরমেশন,	
drishyogulote,	দৃশ্যগুলোতে,	দৃশ্যগুলোতে,	
joones,	জুনেস,	জোন্স,	
eeksapreeshana,	এক্ষপ্রেশন,	এক্সপ্রেশন,	
aalkatraa,	আলকাতরা,	আলকাতরা,	
eekbalke,	একবালকে,	ইকবালকে,	
aamontrito,	আমন্ত্রিত,	আমন্ত্রিত,	
engreziteo,	এনজ্রেজিতেও,	ইংরেজিতেও,	
pretty,	প্রেট্টি,	প্রিটি,	
bosontokke,	বসন্তকে,	বসন্তকে,	
durarohini,	দুরারহিনী,	দুরারোহিণী,	
akhando,	অখান্ডো,	অখন্ড,	
olympik,	অলিম্পিক,	অলিম্পিক,	
baharamporer,	বাহারামপোর,	বহরমপুরের,	
nagorikra,	নাগোিকরা,	নাগরিকেরা,	
mangolic,	ম্যাংলোলিক,	মাঙ্গলিক,	
sombhobonaao,	সম্ভবনাও,	সম্ভবনাও,	
proshtutkarok,	প্রস্তুতকারক,	প্রস্তুতকারক,	
tachnach,	টাচনাচ,	তছনছ,	
hijri,	হিজরি,	হিজরী,	
bhimsenkei,	ভীমসেনকেই,	ভীমসেনকেই,	
cholchhe,	চলছে,	চলছে,	
chouhate,	চৌহাতে,	চৌহাটে,	
breakthrough,	ব্রেক্্রথং,	ব্রেকথ্রু,	
damodar,	দামোদার,	দামদর,	
heepatitis,	হিপাটিটিস,	হেপাটাইটিস,	
bhabotarini,	ভাবতারিণী,	ভবতারিণী,	
batom,	বাতম,	বাটম,	
niharkantibabu,	নীহারকান্তিবাবু,	নিহারকান্তিবাবু,	
kram,	ক্রাম,	ক্রম,	
modyer,	মডিয়ার,	মদ্যের,	
vaibon,	ভাইবন,	ভাইবোন,	
fand,	ফ্ন্ড,	ফান্ড,	
mandope,	মানদোপে,	মন্ডপে,	
existing,	এক্সসিটিং,	এক্সিসটিং,	
tookrote,	তুক্রতে,	টুকরোতে,	
serology,	সেরোলজি,	সেরোলজি,	
taalaal,	টালাল,	তালাল,	
omkar,	ওমকার,	ওঙ্কার,	
rotheen,	রোথেন,	রথীন,	
rahshahi,	রাহশাহী,	রাহশাহী,	
tintikey,	টিনটিকে,	তিনটিকে,	
neemitte,	নিমিত্তে,	নিমিত্তে,	
sithilota,	সিথিলতা,	শিথিলতা,	
mardud,	মারদুদ,	মরদুদ,	
enginiiring,	ইঞ্জিনিরিং,	ইঞ্জিনিয়ারিং,	
fasi,	ফাসি,	ফাঁসী,	
rajshri,	রাজশ্রী,	রাজশ্রী,	
vaisoho,	ভাইসহ,	ভাইসহ,	
ceramiksh,	সেরামিক্স,	সিরামিকস,	
bim,	বিম,	বিম,	
amar,	আমার,	আমর,	
bhenicer,	ভেনিসের,	ভেনিসের,	
codee,	কোডি,	কোডে,	
jaruri,	জাুরি,	জরূরী,	
sikha,	সিখা,	শিখ,	
vushi,	ভুশি,	ভুষি,	
koro,	কর,	করো,	
protisthar,	প্রতিষ্ঠার,	প্রতিষ্ঠার,	
ultrasonography,	ইল্ট্রাসনগ্রাফি,	আলট্রাসনোগ্রাফিও,	
kodorer,	কদরের,	কদরের,	
chitlar,	চিতলার,	চিতলার,	
greep,	গ্রিপ,	গ্রিপ,	
tyap,	ত্যাপ,	ট্যাপ,	
uttor,	উত্তর,	উওর,	
vittimul,	ভিত্তিমুল,	ভিত্তিমূল,	
graambaaseeder,	গ্রামবাসীদের,	গ্রামবাসীদের,	
neemeette,	নিমেতিতে,	নিমিত্তে,	
mandondo,	মানদন্ডো,	মানদণ্ড,	
vobani,	ভোবানী,	ভবানী,	
langhaner,	লাংহানের,	লংঘনের,	
seoul,	সিওল,	সোল,	
dharavassokar,	ধারাবাস্যকার,	ধারাভাষ্যকার,	
neelfamarir,	নিল্লামারীর,	নীলফামারীর,	
gobeshokgon,	গবেশকগণ,	গবেষকগণ,	
tolemyr,	টোলিমির,	টলেমির,	
bhupal,	ভুপাল,	ভূপাল,	
quary,	কোয়ারি,	কোয়েরি,	
chintamani,	চিন্তামানি,	চিন্তামনি,	
anchalsaho,	অঞ্চলসহ,	অঞ্চলসহ,	
rajotta,	রাোট্বা,	রাজত্ব,	
shapad,	শাপাদ,	শ্বাপদ,	
akkaas,	আক্কাস,	আককাস,	
rachanakal,	রচনাকাল,	রচনাকাল,	
awatar,	অওয়াতার,	অবতার,	
shoreefpur,	শরীপুর,	শরিফপুর,	
rushad,	রুশাদ,	রুশদ,	
varma,	ভারমা,	ভার্মা,	
dola,	দোলা,	দলা,	
obosore,	অবসরে,	অবসরে,	
kisti,	কিস্তি,	কিস্তি,	
vaabnake,	ভাবনাকে,	ভাবনাকে,	
krush,	ক্রুশ,	ক্রুশ,	
bhandar,	ভান্দার,	ভাণ্ডার,	
venus,	ভেনুস,	ভেনাস,	
spreadshiit,	স্প্রেডশাইট,	স্প্রেডশীট,	
uposhthit,	উপশ্থিত,	উপস্থিত,	
proshikkhane,	প্রশিক্ষণে,	প্রশিক্ষণে,	
bane,	বানে,	বনে,	
oitijjo,	ঐতিহ্য,	ঐতিহ্য,	
debdebier,	দেবদেবীর,	দেবদেবীর,	
choudhurike,	চৌধুরীকে,	চৌধুরীকে,	
croak,	ক্রোক,	ক্রোক,	
shishu,	শিশু,	শিশু,	
scorey,	স্কোরে,	স্কোরে,	
lutharen,	লুথারেন,	লুথেরান,	
mesenjjar,	মেসেঞ্জজার,	মেসেঞ্জার,	
guzober,	গুজবের,	গুজবের,	
hisabagyan,	হিসাবজ্ঞান,	হিসাবজ্ঞান,	
queri,	কুয়রর,	কোয়েরি,	
grushko,	গ্রুষ্ক,	গ্রুশকো,	
protijogiitamulok,	প্রতিযোগিতামূলক,	প্রতিযোগীতামূলক,	
mail,	মেল,	মাইল,	
lidars,	লিডারস,	লিডার্স,	
maunchostho,	মন্চস্থ,	মঞ্চস্থ,	
uchchotara,	উচ্চতারা,	উচ্চতর,	
bhebechili,	ভেবেছিলি,	ভেবেছিলি,	
plak,	প্ল্যাক,	প্ল্যাক,	
konoroop,	কোনোরূপ,	কোনরূপ,	
hul,	হুল,	হুল,	
saptahokal,	সপ্তঃহককল,	সপ্তাহকাল,	
rupert,	রিপার্ট,	রুপার্ট,	
kraanti,	ক্রান্তি,	ক্রান্তি,	
byaktigotovabeo,	ব্যক্তিগতভাবেও,	ব্যাক্তিগতভাবেও,	
hetimganje,	হেতিমগঞ্জে,	হেতিমগঞ্জে,	
manbe,	মানবে,	মানবে,	
marathi,	মারাঠি,	মরাঠি,	
milekhanek,	মিলেখানেক,	মাইলখানেক,	
sbajan,	স্বজন,	স্বজন,	
ujobekeestaner,	উজোবেকবিস্তানের,	উজবেকিস্তানের,	
seekkhaou,	শিক্ষাও,	শিক্ষাও,	
shashtra,	শাস্ত্রা,	শাস্ত্র,	
shikh,	শিখ,	শিখ,	
contemporary,	কন্টেম্পারারির,	কন্টেম্পোরারি,	
shikare,	শিকারে,	শিকারে,	
metrikoleshana,	মেত্রিকোলেখান,	মেট্রিকোলেশন,	
pohnpeic,	পোহ্নেক,	ফোনপেইক,	
concerter,	কনসার্টের,	কানসাটের,	
detik,	ডেটিক,	দেতিক,	
ghurte,	ঘুরতে,	ঘুরতে,	
groth,	গ্রোথ,	গ্রোথ,	
spredsheet,	স্প্রেশডিট,	স্প্রেডশীট,	
engrejra,	এংরেজ্রা,	ইংরেজরা,	
shikkharthirao,	শিক্ষার্থীরাও,	শিক্ষার্থীরাও,	
chikittsar,	চিকিৎসার,	চিকিত্সার,	
aabarte,	আবর্তে,	আবর্তে,	
orgho,	অর্ঘ,	অর্ঘ্য,	
soommita,	সুমিতা,	সুমিতা,	
cholochchitraeeo,	চলচ্চিত্রাও,	চলচ্চিত্রেও,	
poste,	পোস্তে,	পোষ্টে,	
alaol,	আললাওল,	আলাওল,	
koyekbare,	কয়েকবারে,	কয়েকবারে,	
alimpiqa,	আলিমপিকা,	অলিম্পিক,	
raagei,	রাগেই,	রাগেই,	
salphat,	সালফাট,	সালফেট,	
prarthitao,	প্রার্থিতাও,	প্রার্থীতাও,	
talgachh,	তালগাছ,	তালগাছ,	
shuperheiro,	শুপারহেইরো,	সুপারহিরো,	
rca,	রাকা,	আরসিএ,	
dakope,	ডাকোপে,	দাকোপ,	
bashoborty,	বাশোবরটি,	বশবর্তী,	
aakabar,	আকাবার,	আকাবার,	
bhogni,	ভগ্নি,	ভগ্নী,	
shekarone,	শেকারোনে,	সেকারণে,	
raiji,	রাইজি,	রাইজি,	
turbiner,	টুরবিনের,	টারবাইনের,	
parking,	পার্কিং,	পার্কিং,	
sangitanusthane,	সং্গীতনসুন্ঠানে,	সঙ্গীতানুষ্ঠানে,	
bosonte,	বসন্তে,	বসন্তে,	
chikkingsasoho,	চিক্সিংসাহসহ,	চিকিংসাসহ,	
chiroharit,	চিরহহারিত,	চিরহরিৎ,	
manushera,	মানুষেরা,	মানুষেরা,	
probeshan,	প্রবেশান,	প্রবেশন,	
philipiner,	ফিলিপিনের,	ফিলিপাইনের,	
kruser,	ক্রুসের,	ক্রুশের,	
spredasita,	স্প্রেডাসিটা,	স্প্রেডশীট,	
uparzoner,	উপার্জনের,	উপার্জনের,	
baarbadoj,	বারবাজ,	বার্বাডোজ,	
rajtontre,	রাজটন্ত্রে,	রাজতন্ত্রে,	
pet,	পেট,	পেত,	
restuarant,	রেস্টুরেন্ট,	রেষ্টুরেন্ট,	
ajibon,	অজিবন,	আজীবন,	
amarjito,	অমার্জিত,	অমার্জিত,	
bishwasho,	বিশ্বশো,	বিশ্বাসও,	
bisnukey,	বিষ্ণুকে,	বিষ্ণুকে,	
tasminer,	তাসমিনের,	তাসমিনের,	
bondiira,	বন্দিরা,	বন্দীরা,	
dadar,	দাদার,	দাদার,	
rajtontro,	রাজটন্ত্র,	রাজতন্ত্র,	
ghoor,	ঘুর,	ঘুর,	
rajnoitik,	রাজনৈতিক,	রাজনৈতীক,	
kadam,	কাদাম,	কদম,	
shorifer,	শরিফের,	শরিফের,	
shiulijhra,	শিউলিল্রর,	শিউলিঝরা,	
disposes,	ডিসপেজোস,	ডিসপোজেস,	
monjooshree,	মঞ্জশ্রী,	মঞ্জুশ্রী,	
simons,	সিমনস,	সিমন্স,	
somraatra,	সম্রাত্রা,	সম্রাটরা,	
alexanderke,	আলেক্সান্ডারকে,	আলেকজান্ডারকে,	
keui,	কেউই,	কেউই,	
loombinee,	লুমবিনি,	লুম্বিনী,	
dapadpi,	দাপাপ্ডি,	দাপাদপি,	
pray,	প্রাই,	প্রায়,	
rahi,	রাহি,	রাহী,	
direectoratee,	ডিরেক্টরেট,	ডিরেক্টরেট,	
plusey,	প্লুসে,	প্লাসে,	
nobotomo,	নবতম,	নবতম,	
aireshe,	আইরেশে,	আইরেসে,	
messengerer,	মেসেনগেরের,	মেসেঞ্জারের,	
nirikh,	নিরিখ,	নিরিখ,	
aditisaha,	আদিতিসহ,	অদিতিসহ,	
modhumotii,	মধুমতিই,	মধুমতী,	
tep,	টিপি,	ট্যাপ,	
saatzoner,	সাতজনের,	সাতজনের,	
pader,	পাদের,	প্যাডের,	
mexicoteo,	মেক্সিকোটেও,	মেক্সিকোতেও,	
aziboner,	আজিবনের,	আজীবনের,	
abheedhanik,	অভিধানিক,	অভিধানিক,	
ciima,	সিইমএ,	সীমা,	
pratijogira,	প্রতিযোগীরা,	প্রতিযোগীরা,	
disni,	ডিসনি,	ডিজনী,	
songasthatir,	সংস্থাসটির,	সংস্থাটির,	
bagicha,	বাগিচা,	বাগিচা,	
prokolpow,	প্রোকোলপো,	প্রকল্পও,	
sambatsarkal,	সম্বাস্তরকল,	সম্বৎসরকাল,	
everestey,	এভারাসটে,	এভারেস্টে,	
kanader,	কানাদের,	কণাদের,	
nachar,	নাচার,	নাচার,	
show,	শো,	শো,	
moresbai,	মোরেসবাই,	মোরেসবাই,	
safin,	সাফিন,	সাফিন,	
middleton,	মিডলটন,	মিডলটন,	
skirt,	স্কার্ট,	স্কার্ট,	
choukato,	চৌকাতো,	চৌকাত,	
sbaajan,	স্বজান,	স্বজন,	
udbhaboni,	উদ্ভাবনী,	উদ্ভাবনী,	
niurolaji,	নিউরোলজি,	নিউরোলজি,	
laiseensim,	লাইসেন্সিম,	লাইসেন্সিং,	
udbodhaney,	উদ্বধানে,	উদ্বোধনে,	
lungiti,	লুংগিটি,	লুঙ্গিটি,	
nichupattir,	নিচুপা্তির,	নিচুপট্টির,	
erythrian,	এরিথিরিয়ান,	এরিথ্রিয়ান,	
elakatay,	এলাকাতা,	এলাকাতে,	
shamijir,	শামিজির,	স্বামীজীর,	
timathi,	তিমাঠি,	টিমোথি,	
nosihote,	নসিহতে,	নসিহতে,	
shulfate,	শুলফাতে,	সালফেট,	
vushito,	ভূষিত,	ভূষিত,	
chemjong,	চেমজং,	চেমজং,	
shahabike,	শাহাবীকে,	সাহাবীকে,	
stonehenje,	স্তনহেহজ্জে,	স্টোনহেঞ্জ,	
duuma,	দুমা,	দুমা,	
cholechi,	চলেছি,	চলেছি,	
superheroo,	সুপারহেরু,	সুপারহিরো,	
akpaase,	আকপাসে,	একপাশে,	
polashir,	পোলাশির,	পলাশীর,	
naabyota,	নাব্যতা,	নাব্যতা,	
nazad,	নাজাদ,	নাজাদ,	
upbrazillian,	আপবারজিলিয়ান,	আপব্রাজিলিয়ান,	
oncholtee,	অনচলটি,	অঞ্চলটি,	
wrighter,	ভ্যাটের,	রাইটের,	
maner,	মানের,	মানে,	
kalnir,	কালনির,	কালনীর,	
battery,	ব্যাটেরি,	ব্যাটারী,	
fishing,	ফিশিং,	ফিসিং,	
biplobi,	বিপ্লবি,	বিপ্লবী,	
magrey,	ম্যাগ্রে,	ম্যাগ্রে,	
scholarship,	স্কলারশিপ,	স্কলারশিপ,	
sahachke,	সহচাকে,	সাহাচকে,	
gabeshonar,	গবেশনার,	গবেষনার,	
cheef,	চীফ,	শেফ,	
graambaashio,	গ্রামবাশিও,	গ্রামবাসীও,	
swartho,	স্বার্থ,	স্বার্থ,	
alumni,	আলুম্নি,	অ্যালমনি,	
chalachchitrotike,	চলচাচ্তির্তিকে,	চলচ্চিত্রটিকে,	
parikha,	পারখখা,	পরিখার,	
protijogii,	প্রতিযোগী,	প্রতিযোগী,	
maail,	মাইল,	মাইল,	
chaiten,	চাইতেন,	চাইতেন,	
shikshakbrindo,	শিক্ষাকবৃন্দ,	শিক্ষকবৃন্দ,	
gemske,	জেমসকে,	জেমসকে,	
evereste,	এভারেস্টে,	এভারেস্টে,	
ponthaar,	পন্থার,	পন্থার,	
samajeek,	সমাজিক,	সামাজিক,	
patininda,	পাতিনিন্দা,	পতিনিন্দ,	
majlishpur,	মজলিশপুর,	মজলিশপুর,	
abheedhaaneek,	অভিধানীক,	অভিধানিক,	
sahab,	সাহাব,	সাহাব,	
sima,	সিমা,	সীমা,	
bahubar,	বহুবার,	বহুবার,	
seguloi,	সেগুলোই,	সেগুলোই,	
ardasha,	আর্াশা,	আর্দশ,	
creshcent,	ক্রেসনেন্ট,	ক্রিসেন্ট,	
rubidiyaam,	রুবিদীয়াম,	রুবিডিয়াম,	
protizogiita,	প্রতিযোগিতা,	প্রতিযোগীতা,	
achintyabhedaved,	অচিন্ত্যবভাদেদ,	অচিন্ত্যভেদাভেদ,	
rajtantrey,	রাজতন্ত্রে,	রাজতন্ত্রে,	
edaning,	এডানিং,	ইদানিং,	
arsie,	আর্সি,	আরসিএ,	
sarbhare,	সারভারে,	সার্ভারে,	
scoore,	স্কুরে,	স্কোর,	
tukroti,	তুকরোটি,	টুকরোটি,	
thailandsaho,	থাইলান্দসহ,	থাইল্যান্ডসহ,	
phox,	ফোক্স,	ফক্স,	
bbiswashke,	বিব্বাযাসকে,	বিশ্বাসকে,	
bhangle,	ভাঙ্গলে,	ভাঙলে,	
prosadhoner,	প্রসাধনের,	প্রসাধনের,	
toching,	তোচিং,	টোচিং,	
sip,	সিপ,	শিপ,	
dei,	দেই,	দিই,	
zohns,	জোনস,	জন্স,	
palteche,	পাল্টেছে,	পাল্টেছে,	
moorali,	মুরালি,	মুরলী,	
biprodas,	বিপ্রদাস,	বিপ্রদাস,	
maarmaader,	মারমাদের,	মারমাদের,	
korimkey,	করিমকে,	করিমকে,	
doloo,	দললো,	ডলু,	
qyapasula,	ক্যাপাসুলা,	ক্যাপসুল,	
gitikobita,	গীকিটবিতা,	গীতিকবিতা,	
shatoke,	শাতকে,	শতকে,	
tunaita,	তুনাইটা,	টুনাইট,	
prasadhoner,	প্রাসাধনের,	প্রসাধনের,	
korley,	করলে,	করলে,	
kormoke,	কর্মকে,	কর্মকে,	
digree,	দিগ্রী,	ডিগ্রি,	
mugdal,	মুগদাল,	মুগডাল,	
phareeksa,	ফরিক্স,	ফরেক্স,	
surke,	সুরকে,	সুরকে,	
canflikt,	কাঁফলিক্ট,	কনফ্লিক্ট,	
artore,	আর্তোর,	আর্টরে,	
chittronatyokar,	চিত্রনাট্যকার,	চিত্রনাট্যকার,	
dhadhiye,	ধাধিয়ে,	ধাধিয়ে,	
bondhuvabaponyo,	বন্ধুবাহনপূ্য,	বন্ধুভাবাপন্ন,	
onchalgulir,	অঞ্চলগুলির,	অঞ্চলগুলির,	
mukhomandoler,	মুখমণ্ডলের,	মুখমণ্ডলের,	
korle,	করলে,	করলে,	
drishyer,	দৃষ্যের,	দৃশ্যের,	
sikkharthirao,	শিক্ষার্থীরাও,	শিক্ষার্থীরাও,	
wictor,	উইক্টর,	ভিক্টর,	
sangbadmadhyamgulote,	সংবাদমাধ্যমগুলোতে,	সংবাদমাধ্যমগুলোতে,	
dera,	ডেরা,	ডেরা,	
inapharameshana,	ইনাফরমেশন,	ইনফরমেশন,	
tahalo,	তাহালো,	তাহলো,	
maladabha,	মালাদাবা,	মলদোভা,	
teta,	টেট,	টেটা,	
nirbachakder,	নির্বাচকদের,	নির্বাচকদের,	
ancholtike,	অ্যাঞ্চলটিকে,	অঞ্চলটিকে,	
borlen,	বরলেন,	বরলেন,	
nichols,	নিচোলস,	নিকলস,	
suporichita,	সুপরীচিত,	সুপরিচিত,	
bhugol,	ভূগল,	ভূগোল,	
sqolastiq,	স্কোলাস্টিক,	স্কলাস্টিক,	
nili,	নীলী,	নিলি,	
kurdira,	কুরদিরা,	কুর্দিরা,	
munot,	মুনোট,	মুনোট,	
dupleks,	ডাপলেক্স,	ডুপ্লে,	
dantahin,	দানতাহীন,	দন্তহীন,	
rajotwo,	রাজত্ব,	রাজত্ব,	
bosoben,	বসবেন,	বসবেন,	
kormokarke,	কর্মকারকে,	কর্মকারকে,	
dhangsantup,	ধ্বংসংস্তুপ,	ধ্বংসন্তুপ,	
jyesttha,	জ্যেষ্ঠা,	জ্যেষ্ঠা,	
firth,	ফির্থ,	ফার্থ,	
sudrissho,	সুদৃশ্,	সুদৃশ্য,	
mukhamandoler,	মুখামন্ডলের,	মুখমণ্ডলের,	
jonee,	জনে,	জনি,	
russad,	রুশাদ,	রুশদ,	
bhromoner,	ভ্রমণের,	ভ্রমণের,	
katbe,	কাতবে,	কাটবে,	
makame,	মাকামে,	মাকামে,	
ajeejer,	আজিজের,	আজিজের,	
okritokarjo,	অক্তিকার্য,	অকৃতকার্য,	
shikshakbrinda,	শিক্ষকবৃন্দ,	শিক্ষকবৃন্দ,	
cholochchitra,	চলচ্চিত্রা,	চলচ্চিত্র,	
atwobishvashi,	অত্ববিশ্বাসা,	আত্মবিশ্বাসী,	
sobrakomer,	সব্রকমের,	সবরকমের,	
konagoolo,	কনাগুলো,	কণাগুলো,	
besur,	বেসুর,	বেসুর,	
chhuteer,	ছুটের,	ছুটির,	
kazianis,	কাজিয়ানিস,	কাজানিস,	
mehsus,	মেহসাস,	মেহসুস,	
champa,	চম্পা,	চাঁপা,	
mojdur,	মজদুর,	মজদুর,	
licencedhari,	লাইসেন্ডারি,	লাইসেন্সধারী,	
lisense,	লিসেন্সে,	লাইসেন্স,	
chaloke,	চালোকে,	চালকে,	
rubidium,	রিবিডিউমিয়াম,	রুবিডিয়াম,	
uddharkarmirai,	উদ্ধারকারীরামারাই,	উদ্ধারকর্মীরাই,	
domonmulok,	দমনমূলক,	দমনমূলক,	
shahurgulor,	শহুরগুলোর,	শহুরগুলোর,	
norfolk,	নোফলক,	নরফোক,	
juboksoho,	যুবকসহ,	যুবকসহ,	
seebiai,	সিবিয়াই,	সিবিআই,	
jothartho,	যথার্থ,	যথার্থ,	
naraphoka,	নারাফোক,	নরফোক,	
bosben,	বসবেন,	বসবেন,	
pakhtunistan,	পাখ্তুনিস্তান,	পাখতুনিস্তান,	
vabook,	ভাবুক,	ভাবুক,	
seconder,	সেকন্ডার,	সেকেন্ডের,	
monohputo,	মনোপপুত,	মনঃপুত,	
distance,	ডিসট্যান্স,	ডিসট্যান্স,	
barbadoj,	বারবাদজ,	বার্বাডোজ,	
shhashtra,	সাষ্ট্রা,	শাস্ত্র,	
setike,	সেটিকে,	সেটিকে,	
transformaarer,	ট্রান্সফর্মারের,	ট্রান্সফরমারের,	
osomorthito,	অসমর্থিত,	অসমর্থিত,	
debate,	দেবাতে,	ডিবেট,	
fatakasto,	ফাতাকাস্ত,	ফাটাকেষ্ট,	
niroja,	নিরোজা,	নিরোজা,	
shakar,	শাকোর,	সকার,	
indra,	ইন্দ্রা,	ইন্দ্র,	
graambasio,	গ্রামবাসিও,	গ্রামবাসীও,	
jerusalema,	জেরুসালেমা,	জেরুসালেম,	
mitroder,	মিত্রোদের,	মিত্রদের,	
ghamta,	ঘামটা,	ঘোমটা,	
photanor,	ফোটানোর,	ফোটানোর,	
jibanto,	জীবন্ত,	জীবন্ত,	
dacope,	ড্যাকপে,	দাকোপ,	
khamotagulor,	ক্ষমতাগুলোর,	ক্ষমতাগুলোর,	
ekatto,	একাত্ব,	একাত্ব,	
pharmesigulote,	ফার্মেসিগুলোতে,	ফার্মেসীগুলোতে,	
bisnoo,	বিসনু,	বিষ্ণু,	
abhidhaner,	অভিধানের,	অভিধানের,	
zeland,	জেলান্দ,	জিল্যান্ড,	
jontrangshogulor,	যন্ত্রাংশগুলোর,	যন্ত্রাংশগুলোর,	
behrampurer,	বেহরামপুরের,	বহরমপুরের,	
annimated,	অ্যানিমেেট,	এনিমেটেড,	
durtomo,	দুর্তমো,	দূরতম,	
olympicer,	অলমিপিসের,	অলিম্পিকের,	
teter,	টেটের,	টেটের,	
korkotkraantee,	কর্কটকা্রান্ত,	কর্কটক্রান্তি,	
noditei,	নদীতেই,	নদীতেই,	
byabaharkariderke,	ব্যবহারকারীদেরকে,	ব্যবহারকারীদেরকে,	
romancha,	রোমাঞ্চা,	রোমাঞ্চ,	
townshhip,	তনবিশিপ,	টাউনশিপ,	
bandra,	বান্দ্রা,	বন্দীরা,	
dokan,	দোকান,	দোকান,	
gamdan,	গামডান,	গামদান,	
reshmirekha,	রেশমিরেখা,	রেশমীরেখা,	
titarer,	তিতারের,	তিতারের,	
durgotsab,	দুর্গোৎসব,	দুর্গোৎসব,	
rohasyati,	রোহাস্যটি,	রহস্যটি,	
lutharan,	লুঠারান,	লুথেরান,	
chhuteete,	ছুটিতে,	ছুটিতে,	
hariner,	হারিনের,	হরিণের,	
farid,	ফারিদ,	ফরিদ,	
venush,	ভেনুশ,	ভেনাস,	
korijachilen,	করিযাছিলেন,	করিযাছিলেন,	
nabyata,	নব্বতা,	নাব্যতা,	
akkhunno,	অক্ষুণ্ন,	অক্ষুণ্ণ,	
caroline,	ক্যারোলিন,	ক্যরোলিন,	
balatkar,	বালাতকার,	বলাৎকার,	
miraqela,	মিরাকেলা,	মিরাকেল,	
yura,	যুরা,	ইউরো,	
dushtogone,	দুষ্টগণে,	দুষ্টগণে,	
madrasake,	মাদ্রাসাকে,	মাদ্রাসাকে,	
kaande,	কান্ডে,	কাণ্ডে,	
jontrototto,	যন্ত্রতত্ত্ব,	যন্ত্রতত্ত্ব,	
blacq,	ব্লক,	ব্ল্যাক,	
soommo,	সুম্মো,	সুমো,	
manobikotao,	মানবিকতাও,	মানবিকতাও,	
meropenemer,	মেরোডেনেমের,	মেরোপেনেমের,	
obhijojan,	অভিযোজন,	অভিযোজন,	
nazad,	নাজাদ,	নজদ,	
kings,	কিংস,	কিংস,	
masjidtir,	মাসজিদটির,	মসজিদটির,	
mithener,	মিথেনের,	মিথেনের,	
phiqsa,	ফিকসা,	ফিক্স,	
valobasen,	ভালোবাসেন,	ভালোবাসেন,	
nishad,	নিষাদ,	নিষাদ,	
saarbhaarti,	সারভারটি,	সার্ভারটি,	
chilona,	চিলোনা,	ছিলনা,	
bhaibon,	ভাইবন,	ভাইবোন,	
chuti,	চুটি,	ছুটি,	
gazipur,	গাজীপুর,	গাজিপুর,	
amanisa,	আমানিসা,	অমানিশা,	
ponchaasjon,	পঞ্চাসন্ন,	পঞ্চাশজন,	
aashanka,	আশানকা,	আশংকা,	
otyacharer,	অত্যাচারের,	অত্যাচারের,	
chalochchitro,	চালচ্চিত্র,	চলচ্চিত্র,	
laishensha,	লাইশেন্স,	লাইসেন্স,	
syfy,	সিএফএই,	সাইফাই,	
parka,	পারকা,	পার্ক,	
hazat,	হাজাত,	হজত,	
pratiyogita,	প্রতিযোগিত,	প্রতিযোগীতা,	
eoki,	ইোকি,	এওকি,	
acrolect,	অ্যাক্রোলেকট,	অ্যাক্রোলেক্ট,	
udbodhani,	উদ্বোানি,	উদ্বোধনী,	
khonjena,	খোঁজেনা,	খোঁজেনা,	
enamela,	এনামেলা,	এনামেল,	
juboke,	যুবকে,	যুবকে,	
mele,	মেলে,	মাইল,	
hafsa,	হাফসা,	হাফসা,	
wagadada,	ওয়াগাদাদা,	বাগদাদ,	
gonesher,	গনেষের,	গণেশের,	
deqe,	দেকে,	ডেকে,	
jaanachhe,	জাচাঁছে,	জানাচ্ছে,	
bharatey,	ভারতে,	ভারতে,	
chaanoo,	চানো,	চানু,	
sthaponagulor,	স্থাপনাগুলোর,	স্থাপনাগুলোর,	
gandhiir,	গান্ধীর,	গান্ধীর,	
hepatetisa,	হেপাতেটিসা,	হেপাটাইটিস,	
bbiswash,	বিব্ব্যাশ,	বিশ্বাস,	
onucheeder,	অনুচীদের,	অনুচ্ছেদের,	
toroonra,	তরুণা,	তরুণরা,	
felto,	ফেল্োো,	ফেলত,	
chet,	চেত,	চ্যাট,	
sthapanatir,	স্থাপনাটির,	স্থাপনাটির,	
nischitvabe,	নিশ্চিতভাবে,	নিশ্চিতভাবে,	
akhandata,	অখন্ডতা,	অখণ্ডতা,	
kash,	কাশ,	কাস,	
shfingtar,	স্ফিংতার,	স্ফিংটার,	
bishashke,	বিষাসকে,	বিশ্বাসকে,	
nikote,	নিকোতে,	নিকটে,	
promothesh,	প্রমথোেষে,	প্রমথেশ,	
ujbekistaner,	উজবেকিস্তানের,	উজবেকিস্তানের,	
jamaanor,	জামানোর,	জমানোর,	
geographics,	গিওগ্রাফিক্স,	জিওগ্রাফিকস,	
toranganj,	তোরাঙ্গজ,	তোরাবগঞ্জ,	
tuni,	তুনি,	টুনি,	
akar,	আকার,	একার,	
arashie,	আরাশি,	আরসিএ,	
chalochchitraeei,	চালচ্চিত্রা়ী,	চলচ্চিত্রেই,	
istoone,	ইস্তুনে,	স্টোন,	
vitti,	ভিত্তি,	ভিত্তিই,	
chhadite,	ছাদিতে,	ছড়িতে,	
associatis,	অ্যাসোসিটিস,	এসোসিয়েটস,	
kaalaam,	কালাম,	কালাম,	
metropalitana,	মেট্রোপালিটানা,	মেট্রোপলিটন,	
ghotaibe,	ঘটাইবে,	ঘটাইবে,	
suchonakal,	সূচনাকাল,	সূচনাকাল,	
transhapharma,	ট্রানফোষ্ম্মা,	ট্রান্সফর্ম,	
prime,	প্রাইম,	প্রাইম,	
kiuti,	কিউটি,	কিউটি,	
black,	ব্ল্যাক,	ব্ল্যাক,	
joubankal,	যৌবকাল,	যৌবনকাল,	
bsnleu,	বিএনস্লিউ,	বিএসএনএলইইউ,	
durbhagya,	দুর্ভাগ্য,	দূর্ভাগ্য,	
jubokti,	যুবক্তি,	যুবকটি,	
karecho,	কারেছো,	করেছো,	
query,	কোয়ারি,	কোয়েরি,	
joki,	জোকি,	জকি,	
podotyagsongkranto,	পদত্যাংস্কারান্ত,	পদত্যাগসংক্রান্ত,	
gandogol,	গাণ্ডগোল,	গন্ডগোল,	
laesensh,	লয়েসন্,	লাইসেন্স,	
sheets,	শীটস,	শীটস,	
lyaandeeng,	ল্যান্ডিং,	ল্যান্ডিং,	
maadla,	মাদলা,	মাদলা,	
argead,	আরজজড,	আর্জিদ,	
surakarder,	সুরাকরদের,	সুরকারদের,	
armeenian,	আর্মিনিয়ান,	আর্মেনিয়ান,	
nirarthak,	নিরার্থক,	নিরর্থক,	
batikromshalee,	বাতিক্মকশালী,	ব্যতিক্রমধর্মী,	
railliner,	রেলিলার,	রেললাইনের,	
tiuning,	টিউনিং,	টিউনিং,	
hillse,	হিলসে,	হিলসে,	
samany,	সামানি,	সামান্য,	
punosthaner,	পুনস্থানের,	পুনঃস্থানের,	
haitasha,	হাইতাশা,	হাইটস,	
tantubayer,	তা্তুবায়ের,	তন্তুবায়ের,	
manjushri,	মঞ্জুশ্রী,	মঞ্জুশ্রী,	
review,	রিভিউউ,	রিভিউও,	
dhaleshorii,	ধলেশরি,	ধলেশ্বরী,	
rijoor,	রিজুর,	রিজুর,	
jatinke,	জাটিনকে,	যতীনকে,	
dhrubaker,	ধ্রুবাকের,	ধ্রুবকের,	
shho,	ঝহ,	শো,	
kuresher,	কুরেশের,	কুরেশের,	
meloonborrone,	মেলোবর্ণরে,	মেলবোর্নে,	
teunar,	তেউনার,	টিউনার,	
tarunra,	তরুণরা,	তরুণরা,	
oiteejye,	ঐতিজ্যে,	ঐতিহ্যে,	
tennys,	টেনিস,	টেনিস,	
nodiiteyi,	নদিয়েতি,	নদীতেই,	
khalidke,	খালিদকে,	খালিদকে,	
kathmandu,	কঠমনন্ডু,	কাঠমান্ডু,	
bowie,	বয়াই,	বওই,	
orthanitir,	অর্থানীতির,	অর্থনীতির,	
umb,	ইউএমবি,	ইউএমবি,	
karmasampadon,	কর্মসম্পদন,	কর্মসম্পাদন,	
alraji,	আলরাজি,	আলরাজী,	
nimitte,	নিমিত্তে,	নিমিত্তে,	
samajikatar,	সমাজিকতার,	সামাজিকতার,	
binakar,	বিনাকার,	বিনাকার,	
panchasjan,	পঞ্চাসজন,	পঞ্চাশজন,	
proshadhoner,	প্রশাননের,	প্রসাধনের,	
koota,	কোট,	কোটা,	
highcommissionay,	হিকমম্সেনয়া,	হাইকমিশনে,	
monir,	মনির,	মনির,	
bouddha,	বৌদ্ধ,	বৌদ্ধ,	
municipal,	মিনিপিপাল,	মিউনিসিপ্যাল,	
dagmukta,	দাগমুক্ত,	দাগমুক্ত,	
mutar,	মুতার,	মুতার,	
konroop,	কননরূপ,	কোনরূপ,	
