pragreesa,	প্রোগ্রীসা,	প্রগ্রেস,	
cholochchitro,	চলচ্চিত্র,	চলচ্চিত্র,	
groth,	গ্রোথ,	গ্রোথ,	
adhyatmikata,	অধ্যাতমিকতা,	আধ্যাত্মিকতা,	
abadamoner,	আবাদামনের,	অবদমনের,	
pooshteer,	পুষ্টীর,	পুষ্টির,	
jatata,	জাতাটা,	যতোটা,	
dii,	দী,	দিই,	
drissoke,	দৃষ্যকে,	দৃশ্যকে,	
devolapar,	দেভলাপার,	ডেভলপার,	
kod,	কোড,	কোড,	
samratra,	সম্রাত্র,	সম্রাটরা,	
upobashii,	উপবাসী,	উপবাসী,	
kharar,	খারার,	খরার,	
seeramiks,	সেরারিমিকস,	সিরামিকস,	
ovidhanik,	অভিধানিক,	অভিধানিক,	
upobasher,	উপবাশের,	উপবাসের,	
sohokari,	সহকারী,	সহকারী,	
beshakbar,	বেশকবার,	বেশকবার,	
capsule,	ক্যাপসুলে,	ক্যাপ্সুল,	
hul,	হুল,	হুল,	
favorite,	ফাভোরিতে,	ফেভারিট,	
bandi,	বান্ডি,	বন্দী,	
baait,	বাইত,	বাইট,	
quota,	কোওটা,	কোটা,	
bikargrasta,	বিকারগ্রস্তা,	বিকারগ্রস্ত,	
jewellery,	জিউয়েলারি,	জুয়েলারির,	
shansthaner,	শান্থসানের,	সংস্থানের,	
pouchute,	পৌছুতে,	পৌঁছুতে,	
goora,	গুরা,	গোর,	
bouddher,	বৌদ্ধের,	বৌদ্ধের,	
nathivukta,	নথিভুক্ত,	নথিভুক্ত,	
teenisa,	তীনিসা,	টেনিস,	
chhadura,	ছাদুরা,	ছাদুরা,	
mataram,	মাতারাম,	মাতরম,	
audiotike,	অডিওটিকে,	অডিওটিকে,	
hilser,	হিলসের,	হিলসের,	
anchalo,	আঞ্চলো,	অঞ্চলও,	
jani,	জানি,	জনি,	
saralya,	সরলা,	সারল্য,	
licensin,	লাইসেন্সিন,	লাইসেন্সিং,	
bibhinno,	বিভিন্ন,	বিভন্ন,	
janmat,	জন্মত,	জন্মাত,	
graambasio,	গ্রামবাসিও,	গ্রামবাসীও,	
moddhyoshtho,	মধ্যস্থ,	মধ্যস্থ,	
domone,	ডমনে,	দমনে,	
bhabarlaler,	ভবরলালের,	ভবরলালের,	
bakhyateet,	বাখ্যাতত,	ব্যাখ্যাতীত,	
comoros,	কমোোরস,	কোমোরোস,	
oojbekistan,	অজবেকিস্তান,	উজবেকিস্তান,	
chikittsar,	চিকিত্সসার,	চিকিত্সার,	
jotinkey,	জটিনকে,	যতীনকে,	
sepha,	সেফা,	শেফ,	
annorup,	আন্নরূপ,	অন্যরূপ,	
sausagee,	সৌগসী,	সসেজ,	
gonjona,	গঞ্জনা,	গঞ্জনা,	
dharmiyabhabei,	ধর্মিয়ভাবেই,	ধর্মীয়ভাবেই,	
fansi,	ফান্সি,	ফাঁসী,	
japanostho,	জাপানস্থ,	জাপানস্থ,	
cholochchitra,	চলচ্চিত্র,	চলচ্চিত্র,	
sosoa,	সোসো,	শশা,	
jacksonke,	জ্যাকসনকে,	জ্যাকসনকে,	
juboksoho,	যুবকসহ,	যুবকসহ,	
dianes,	ডিয়ানেস,	ডিএনএস,	
oitijjha,	ঐতিহ্ঝা,	ঐতিহ্য,	
conflict,	কনফ্লিক্ট,	কনফ্লিক্ট,	
magical,	ম্যাজিকাল,	ম্যাজিকাল,	
jini,	জিনি,	যিনি,	
jonomukhi,	জনমুখী,	জনমুখী,	
debete,	দেবেতে,	ডিবেট,	
daltagi,	দলতাগী,	দলত্যাগী,	
backflipe,	ব্যাকফ্লিপে,	ব্যাকফ্লিপে,	
nirmolota,	নির্মলতা,	নির্মলতা,	
musallati,	মুসল্লতি,	মুসল্লাটি,	
show,	শো,	শো,	
asif,	আসিফ,	আসিফ,	
hadisti,	হাদিস্টি,	হাদিসটি,	
parinati,	পরিণাটি,	পরিণতি,	
cholochchitratike,	চলচ্চিত্রাটিকে,	চলচ্চিত্রটিকে,	
sadeena,	সাদেনা,	সাডেন,	
prijon,	প্রিজন,	প্রিজন,	
korimkey,	করিমকে,	করিমকে,	
cholochchitrai,	চলচ্চিত্রায়,	চলচ্চিত্রই,	
iling,	ইলিং,	ইলিং,	
baikalyo,	বাইকল্য,	বৈকল্য,	
pyaleshtainer,	প্যালেশটেইনের,	প্যালেস্টাইনের,	
chalochchitreei,	চালচ্চিত্রেই,	চলচ্চিত্রেই,	
chinto,	চিন্তো,	চিনতো,	
madaspushto,	মাদাস্পুষ্ট,	মদদপুষ্ট,	
maradeha,	মরদেহ,	মরদেহ,	
nartana,	নারতানা,	নর্টন,	
senabahinikey,	সেনাবাহিনীকে,	সেনাবাহিনীকে,	
bane,	বানে,	বনে,	
agomone,	আগমনে,	আগমনে,	
jamjamat,	জমজামত,	জমজমাট,	
damodar,	দামোদার,	দামদর,	
prabhritite,	প্রভৃতিতে,	প্রভৃতিতে,	
deenes,	ডেনেস,	দীনেশ,	
tahalo,	তাহালো,	তাহলো,	
carloos,	কারলোস,	কার্লোস,	
nirbachokder,	নির্বাচকদের,	নির্বাচকদের,	
nachar,	নাচার,	নাচার,	
bardhitansh,	বা্ধিতনন্ধ,	বর্ধিতাংশ,	
korush,	করুষ,	ক্রুশ,	
bishashke,	বিষাষকে,	বিশ্বাসকে,	
heavy,	হেভি,	হেভি,	
tanu,	তানু,	তনু,	
kaalaam,	কালাম,	কালাম,	
shaater,	সাতের,	শ্যুটার,	
idipasha,	ইডিপাশা,	ইডিপাস,	
gaddaafee,	গ্যাডফাফি,	গাদ্দাফী,	
aashtikotaa,	আশ্তিকতা,	আস্তিকতা,	
apolokbhabe,	আপলকভাবে,	অপলকভাবে,	
lotharan,	লোথারান,	লুথেরান,	
soinyora,	সৈন্যরা,	সৈন্যরা,	
kalki,	কালকি,	কালকি,	
samashtike,	সমাষ্টীকে,	সমষ্টিকে,	
chhanada,	ছানাদা,	ছানাদা,	
porinoti,	পরিনতি,	পরিণতি,	
shresthoshcho,	শ্রেষ্ঠশ্চ,	শ্রেষ্ঠশ্চ,	
graambaaseeder,	গ্রামবাসীদের,	গ্রামবাসীদের,	
gabeshonar,	গবেশনার,	গবেষনার,	
browser,	ব্রাউসের,	ব্রাউজার,	
fuss,	ফাস,	ফাস,	
prasadhoni,	প্রসাধনী,	প্রসাধনী,	
aswasteekor,	অস্বস্তিকর,	অস্বস্তিকর,	
aatmobishwasi,	আত্মবিশ্বাসী,	আত্মবিশ্বাসী,	
subade,	সুবাদে,	সুবাদে,	
dhandu,	ধন্দু,	ধন্দু,	
vaibon,	ভাইবন,	ভাইবোন,	
tintir,	তিনটির,	তিনটির,	
qraima,	ক্রাইমা,	ক্রাইম,	
eupheike,	ইউফেইকে,	ইউফেইকে,	
rudiger,	রুদিগের,	রুদিগের,	
dooburir,	দুবুরির,	ডুবুরির,	
laiseensim,	লাইসনসিম,	লাইসেন্সিং,	
meridiane,	মেরিডিয়ানে,	মেরিডিয়ানে,	
bisnuke,	বিস্নুকে,	বিষ্ণুকে,	
societytey,	সোিটটিতে,	সোসাইটিতে,	
jati,	জাতি,	যাতি,	
amburi,	অম্বুরী,	আম্বুরি,	
shniper,	স্নিপের,	স্নাইপার,	
houzgulite,	হৌউজগুলিতে,	হাউজগুলিতে,	
mozdoor,	মজদুর,	মজদুর,	
oncoleo,	অনকোলেও,	অঞ্চলেও,	
khalid,	খালিদ,	খালিদ,	
batikromshalee,	বাতিক্রমোশলী,	ব্যতিক্রমধর্মী,	
faltu,	ফলতু,	ফালতু,	
chaalkee,	চালকি,	চালকে,	
mahibur,	মহিবুর,	মহিবুর,	
sookkho,	সুক্ষ,	সুক্ষ্ম,	
victor,	ভিক্টর,	ভিক্টর,	
bachhaikrito,	বাছাইকৃত,	বাছাইকৃত,	
debdebie,	দেবদীবে,	দেবদেবী,	
musalmani,	মুসলমানি,	মুসলমানই,	
susamo,	সুসামো,	সুসম,	
shangkalonti,	সংকলনটি,	সংকলনটি,	
gazeetteed,	গাজিটিড,	গেজেটেড,	
fulkapi,	ফুলকাপি,	ফুলকপি,	
bhowanipur,	ভোয়ানীপুর,	ভবানীপুর,	
kanader,	কানাদের,	কণাদের,	
laaz,	লাজ,	লাজ,	
monjooshree,	মঞ্জশরী,	মঞ্জুশ্রী,	
ramchander,	রামচন্দর,	রামচন্দরের,	
soori,	সুরী,	সুরি,	
dijmarescu,	ডিজমারুস্কু,	দিজমার্সাকু,	
nogore,	নগরে,	নগরে,	
abhiyojan,	অভিযযযজন,	অভিযোজন,	
sikarder,	সিকারদের,	শিকারদের,	
doloo,	দলু,	ডলু,	
somsher,	সমশের,	সমশের,	
kholdhular,	খোল্ধুলার,	খোলধূলার,	
seekkhaou,	সিক্ষাও,	শিক্ষাও,	
sthapanagulor,	স্থাপনাগুলোর,	স্থাপনাগুলোর,	
cheef,	চিফ,	শেফ,	
siitei,	সিইতেই,	শীতেই,	
kalirkhal,	কালিরখাল,	কালিরখাল,	
shariba,	শরিবা,	শরিবা,	
choudry,	চৌড়রি,	চৌধুরী,	
jounatar,	যৌনাতার,	যৌনতার,	
jolrang,	জোলরাং,	জলরঙ,	
oitijhyotike,	ঐতিহ্যটিকে,	ঐতিহ্যটিকে,	
obosan,	ওবসান,	অবসান,	
bosoben,	বসবেন,	বসবেন,	
shektor,	সেক্তর,	সেক্টর,	
bidghootey,	বিধগুতে,	বিদঘুটে,	
sucre,	সাক্রে,	সাকার,	
metrikoleshana,	মেত্রিকোলেশন,	মেট্রিকোলেশন,	
satarkabhabey,	সতর্কভাবে,	সতর্কভাবে,	
groundta,	গ্রুন্ডটা,	গ্রাউন্ডটা,	
collaborators,	কোলাবোটরর্স,	কলাবরেটরস,	
olpo,	অলপপো,	অল্প,	
poketchorder,	পকেটচর্দের,	পকেটচরদের,	
vaabnake,	ভাবনাকে,	ভাবনাকে,	
hoonayin,	হুনায়িন,	হুনাইন,	
sarollo,	সারোলো,	সারল্য,	
khudrokar,	ক্ষদ্রকার,	ক্ষুদ্রকার,	
protul,	প্রতুল,	প্রতুল,	
kaferder,	কাফেরদের,	কাফেরদের,	
hena,	হেনা,	হেনা,	
katiusha,	কাটিউশা,	কাতিউশা,	
porobortii,	পরবর্তীই,	পরর্বতী,	
amor,	আমর,	আমর,	
chikkingsasoho,	চিক্সিংসহ,	চিকিংসাসহ,	
shaahaabiike,	সাহাবাইকে,	সাহাবীকে,	
salchak,	সালচক,	সালচাক,	
madhobeer,	মধববীর,	মাধবীর,	
korijachilen,	করিযাছিলেন,	করিযাছিলেন,	
jaadrel,	জাড্রেল,	জাঁদরেল,	
mashtarsha,	মাশ্টর্শ,	মাস্টার্স,	
durbhagya,	দুর্ভাগ্য,	দূর্ভাগ্য,	
ohalyar,	ওহাল্যার,	অহল্যার,	
oisamoyer,	ঐসময়ের,	ঐসময়ের,	
notey,	নটী,	নোটে,	
fokskon,	ফকসককন,	ফক্সকন,	
teoner,	তেওনের,	টিওনার,	
dola,	দোলা,	দলা,	
shuchonakal,	শুচোনাকাল,	সূচনাকাল,	
hari,	হরি,	হরি,	
gaichhe,	গাইছে,	গাইছে,	
chandrimaa,	চন্দ্রিমা,	চন্দ্রিমা,	
dhaleshorii,	ধালেশরী,	ধলেশ্বরী,	
ganaparibahan,	গণপরিবহন,	গণপরিবহন,	
chirkut,	চিরকুট,	চিরকুট,	
ovidhaner,	ওভিধানের,	অভিধানের,	
saurce,	সার্স,	সোর্স,	
habol,	হাবল,	হাবোল,	
dakope,	ডাকোপে,	দাকোপ,	
yuroo,	যুুরুও,	ইউরো,	
corsin,	করসিন,	করসিন,	
ddebet,	দ্বেট,	ডিবেট,	
meshintao,	মেশিনটাও,	মেশিনটাও,	
shishupalgarh,	শিশুপললগরেহ,	শিশুপালগড়ে,	
teter,	টেটার,	টেটের,	
mail,	মেইল,	মাইল,	
janagononar,	জনগণনার,	জনগণনার,	
aansaareer,	আনসারীর,	আনসারীর,	
bedey,	বেদে,	বেদে,	
sangbadmadhyomgulote,	সংবাদমাধ্যমগুলোতে,	সংবাদমাধ্যমগুলোতে,	
niknayman,	নিকনাইমান,	নিকনেইমান,	
diiptii,	ডিপটিই,	ডেপুটি,	
gingbhalobasen,	গিংভাভাাাসেন,	গিংভালোবাসেন,	
forma,	ফরমা,	ফর্মা,	
phutbolarder,	ফুটবোলকারদের,	ফুটবলারদের,	
associatis,	অ্যাসোসিয়েটিস,	এসোসিয়েটস,	
songbadmadhyame,	সংবাদমাধ্যমে,	সংবাদমাধ্যমে,	
shamuker,	শামুকের,	শামুকের,	
landin,	ল্যান্ডিন,	ল্যান্ডিং,	
poste,	পস্তে,	পোস্টে,	
flexta,	ফ্লেক্সটা,	ফ্লেক্সটা,	
bisshaskey,	বিশ্াসকে,	বিশ্বাসকে,	
kyathlik,	ক্যাথলিক,	ক্যাথলিক,	
dharabahikotitey,	ধারাবাহিককিতে,	ধারাবাহিকটিতে,	
ghoomato,	ঘুমাতো,	ঘুমাতো,	
temonbhabe,	তেমনভাবে,	তেমনভাবে,	
shamshere,	শামশেরে,	শমসের,	
hossne,	হোস্ন,	হোসনে,	
expreshshion,	এক্সপ্রেশন,	এক্সপ্রেশন,	
gaj,	গাজ,	গেজ,	
ghuznavi,	ঘুজনাভী,	গজনভি,	
anyorup,	অন্যরূপ,	অন্যরূপ,	
oncholsomuho,	অঞ্চলসমূহ,	অঞ্চলসমূহ,	
bahati,	বহাতী,	বাহাতি,	
crime,	ক্রাইম,	ক্রাইম,	
chaudhuriyo,	চৌধুরীয়,	চৌধুরীও,	
kathghera,	কাঠেরা,	কাঠঘেরা,	
markeetim,	মার্কিটিং,	মার্কেটিং,	
khargosher,	খরগোষের,	খরগোসের,	
sinaake,	সিনাকে,	সিনাকে,	
rubala,	রুবালা,	রুবল,	
shoreefer,	শরেফের,	শরিফের,	
jeten,	জেতেন,	জেতেন,	
prakalpoguli,	প্রকল্পগুলি,	প্রকল্পগুলি,	
tookrokey,	টুকরকে,	টুকরোকে,	
dakkhinkare,	দক্ষিণকারে,	দক্ষিণকরে,	
zommu,	জম্মু,	জম্মু,	
koro,	করো,	করো,	
tenishe,	তেনিশে,	টেনিসে,	
sanghar,	সাংঘর,	সংহার,	
chalachchitrotike,	চলচ্চিত্ররটিকে,	চলচ্চিত্রটিকে,	
ponchaasjon,	পঞ্চাসজন,	পঞ্চাশজন,	
mah,	মাহ,	মাহে,	
karecho,	করেছো,	করেছো,	
nek,	নেক,	নেক,	
abhidhaaner,	অভিধানের,	অভিধানের,	
tongaa,	টঙ্গা,	টোঙ্গা,	
bhagno,	ভাগ্ন,	ভগ্ন,	
bm,	বিএমআই,	বিএম,	
humira,	হুমিরা,	হুমিরা,	
patochitra,	পাটোচিত্র,	পটচিত্র,	
potka,	পটকা,	পটকা,	
murad,	মুরাদ,	মুরাদ,	
prokolpotike,	প্রকল্পটিকে,	প্রকল্পটিকে,	
konroop,	কনরুপ,	কোনরূপ,	
ebham,	এভাম,	ইভিএম,	
kajangale,	কাজঙ্গলে,	কজঙ্গলে,	
bharatey,	ভাতাতে,	ভারতে,	
crucer,	ক্রুসার,	ক্রুশের,	
swostir,	স্বস্তির,	স্বস্তির,	
aaireshe,	আইরেশে,	আইরেসে,	
jor,	জর,	জ্বর,	
balabhadra,	বালাভররা,	বলভদ্র,	
taatey,	টাতে,	তাতে,	
jontrangshogulor,	যন্ত্রাংগগুলোর,	যন্ত্রাংশগুলোর,	
golghare,	গলঘরে,	গোলঘরে,	
cheekitshar,	চিকিৎশার,	চিকিত্সার,	
planeti,	প্লেনেটি,	প্লেনটি,	
kutubuddinke,	কুটুবুদ্দিনকে,	কুতুবুদ্দিনকে,	
votar,	ভোটার,	ভোটার,	
shatan,	শাতান,	শয়তান,	
ved,	ভেড,	বেদ,	
bhupal,	ভূপাল,	ভূপাল,	
auttacharer,	অট্টাচারের,	অত্যাচারের,	
shrichaitanyadev,	শ্রীচৈতাান্যেভেদ,	শ্রীচৈতন্যদেব,	
suraaropito,	সুরারপিত,	সুরারোপিত,	
samajikatar,	সমাজিকতার,	সামাজিকতার,	
purple,	পুর্পলে,	পার্পেল,	
tinhazar,	তিনহাজারের,	তিনহাজার,	
noitik,	নৈতিক,	নৈতিক,	
kiibord,	কাইবোর্ড,	কীবোর্ড,	
adarsho,	আদর্শ্,	আর্দশ,	
biswashi,	বিশ্বশী,	বিশ্বাসী,	
bhabanipur,	ভবনীপুর,	ভবানীপুর,	
deares,	ডিয়ারস,	ডিআরএস,	
chhutee,	ছুটি,	ছুটি,	
dabarer,	দাবারের,	দাবারের,	
distance,	ডিস্ট্যান্সে,	ডিসট্যান্স,	
elakatite,	এলাকাটিতে,	এলাকাটিকে,	
matthews,	ম্যাথহেস,	ম্যাথিউস,	
wictor,	উইক্টর,	ভিক্টর,	
bornolikhon,	বর্ণলিখন,	বর্ণলিখন,	
ispreedshiit,	ইস্প্রেশিয়ট,	স্প্রেডশীট,	
sookumari,	সুকুমারী,	সুকুমারী,	
zerusalemer,	জেরুসালেমের,	জেরুজালেমের,	
ratishilatai,	রতিশীলতাই,	রতিশীলতায়,	
roopmatro,	রূপমাত্র,	রূপমাত্র,	
residensa,	রেসিডেন্সা,	রেসিডেন্স,	
atorkitey,	অটোরকিতে,	অতর্কিতে,	
ishtone,	ইস্টোন,	স্টোন,	
baharamporer,	বহরামপরের,	বহরমপুরের,	
sampadoner,	সম্পাদনের,	সম্পাদনের,	
chintamani,	চিন্তামণি,	চিন্তামনি,	
chintakarma,	চিন্তাকর্ম,	চিন্তাকর্ম,	
dighol,	দিঘল,	দীঘল,	
laishensha,	লেশেন্স,	লাইসেন্স,	
ekirokom,	একিরকম,	একইরকম,	
literacy,	লিইটারেসি,	লিটারেসি,	
balithubar,	বালিটুবার,	বালিথুবার,	
directorete,	ডাইরেক্টরেট,	ডিরেক্টরেট,	
deefinition,	ডিফিনিশন,	ডেফিনেশন,	
wodka,	ওয়াকা,	ভদকা,	
evaner,	ইভানের,	ইভানের,	
hitokor,	হিতকোর,	হিতকর,	
antarbhutto,	অন্তর্ভূত্ত,	অন্তর্ভুক্ত,	
antorbhuktimulak,	আন্তর্ভূষ্তিমূলক,	অন্তর্ভুক্তিমূলক,	
gajiipur,	গাজীপুর,	গাজীপুর,	
soheensotar,	সোহিনসতার,	সহিংসতার,	
iub,	ইইউইউ,	আইইউবি,	
brindaboney,	বৃন্দাবনে,	বৃন্দাবনে,	
kisti,	কিস্তি,	কিস্তি,	
dienes,	ডিয়েনস,	ডিএনএস,	
aqram,	আকরাম,	আকরাম,	
teoyana,	তেওয়ানা,	তাইওয়ান,	
bodhukeo,	বধুকেও,	বধুকেও,	
taler,	তালের,	তালের,	
sharansthal,	শরনস্থল,	শরণস্থল,	
nirmalata,	নির্মলতা,	নির্মলতা,	
taufik,	তাফিক,	তৌফিক,	
keuoi,	কেওয়েই,	কেউই,	
informetion,	ইনফরমেশন,	ইনফরমেশন,	
sikarer,	সীকারের,	শিকারের,	
hukar,	হুকার,	হুকার,	
jontrototto,	যন্ত্রতত্ত্ব,	যন্ত্রতত্ত্ব,	
akpaase,	আকপাশে,	একপাশে,	
purushika,	পুরুষিকা,	পুরুষিকা,	
juktorastrer,	যুক্তরাষ্ত্রের,	যুক্তরাষ্ট্রের,	
hijrite,	হিজরিতে,	হিজরীতে,	
siima,	সিমা,	সীমা,	
rudroke,	রুদ্রকে,	রুদ্রকে,	
prarthitao,	প্রার্থীতাও,	প্রার্থীতাও,	
qarlosa,	কারলোসা,	কার্লোস,	
kortona,	কর্তনা,	করতনা,	
bonobhumi,	বনভূমি,	বনভূমি,	
hugeke,	হুগেকে,	হিউজকে,	
manober,	মানবের,	মানবের,	
grambaasi,	গ্রামবাসী,	গ্রামবাসী,	
firth,	ফার্থ,	ফার্থ,	
rajtantra,	রাজতন্ত্র,	রাজতন্ত্র,	
manjushri,	মঞ্জুশ্রী,	মঞ্জুশ্রী,	
kraim,	ক্রাইম,	ক্রাইম,	
emiratas,	এমিরাতাস,	এমিরেটাস,	
daakteekite,	ডাকটিকটিতে,	ডাকটিকিটে,	
balaruma,	বালারুমা,	বলরুম,	
horiddar,	হরিদ্দার,	হরিদ্বার,	
fatakasto,	ফতাকাস্ত,	ফাটাকেষ্ট,	
qaferder,	কাফারদের,	কাফেরদের,	
saifullahil,	সাইফুল্লাহিল,	সাইফুল্লাহিল,	
dhwajbhango,	ধ্বাভাঙ্গ,	ধ্বজভঙ্গ,	
graambaaseeo,	গ্রামবাসীও,	গ্রামবাসীও,	
sithilota,	সিথিলতা,	শিথিলতা,	
aarik,	আরিক,	আরিক,	
protistha,	প্রতিষ্ঠা,	প্রতিষ্টা,	
ajeem,	আজেম,	আজিম,	
dhanak,	ধনক,	ধানক,	
kaferderke,	কাফেরদেরকে,	কাফেরদেরকে,	
daaktikite,	ডাকটিকিতে,	ডাকটিকিটে,	
capsul,	ক্যাপসুল,	ক্যাপসুল,	
biprodas,	বিপ্রদাস,	বিপ্রদাস,	
maail,	মাইল,	মাইল,	
hert,	হার্ট,	হার্ট,	
akmato,	আকমাতো,	একমত,	
bishwaashshoi,	বিশ্বশ্যই,	বিশ্বাসই,	
dhaanche,	ধাঁছে,	ধাঁচে,	
uporitale,	উপরিতালে,	উপরিতলে,	
bosturoi,	বস্তুরই,	বস্তুরই,	
ritesh,	ঋীতেশ,	রিতেশ,	
review,	রিভিয়ে,	রিভিউও,	
oitijhya,	ঐতিহ্য,	ঐতিহ্য,	
babare,	বাবারে,	বাবারে,	
dipgulote,	ডিপগুলোতে,	দ্বীপগুলোতে,	
panchasjan,	পঞ্চসজন,	পঞ্চাশজন,	
sanstha,	সানস্থা,	সংস্থা,	
chikitsanirbhar,	চিকিৎসানির্ভর,	চিকিৎসানির্ভর,	
messengerer,	মেসেন্রারের,	মেসেঞ্জারের,	
jonesh,	জোনেশ,	জোন্স,	
nirbaahe,	নির্বাহে,	নির্বাহে,	
nichupattir,	নিচুপাট্টির,	নিচুপট্টির,	
daktickete,	ডাক্িকেটে,	ডাকটিকিটে,	
godabari,	গোদাবারী,	গোদাবরী,	
dhangsachchi,	ধ্বংসচচ্চি,	ধ্বংসাচ্ছি,	
teunar,	টেউনার,	টিউনার,	
ruble,	রাবল,	রুবল,	
premo,	প্রেমো,	প্রিমো,	
suchanakal,	সুচনাকাল,	সূচনাকাল,	
serology,	সেরোলজি,	সেরোলজি,	
shift,	শিফট,	শিফট,	
bonsho,	বংশ,	বংশ,	
kormoi,	কর্মই,	কর্মই,	
hundai,	হুন্ডাই,	হুন্দাই,	
roy,	রোয়,	রায়,	
kumbhalnar,	কুম্ভলনার,	কুম্ভালনার,	
ovinetar,	অভিনেতার,	অভিনেতার,	
atmabishvashi,	আত্মবিশভাষী,	আত্মবিশ্বাসী,	
miraclee,	মিরাকলি,	মিরাকেল,	
chatrorai,	ছাত্ররাই,	ছাত্ররাই,	
makong,	মাকং,	মেকং,	
jins,	জিনস,	জিন্স,	
assexe,	আসেেক্সে,	অ্যাসেক্সে,	
gaaddafee,	গাদ্ডফফী,	গাদ্দাফী,	
bondira,	বন্দিরা,	বন্দীরা,	
dewaben,	দেওয়াবেন,	দেওয়াবেন,	
pichte,	পিচতে,	পিছতে,	
abheedhaaneek,	অভিধানিক,	অভিধানিক,	
gaddaphii,	গড়্দাফি,	গাদ্দাফী,	
lungiti,	লুংগিটি,	লুঙ্গিটি,	
rekhapat,	রেখাপাত,	রেখাপাত,	
parishram,	পরিশ্রম,	পরিশ্রম,	
goolen,	গুলেন,	গুলেন,	
obosorer,	অবসরের,	অবসরের,	
angkita,	অঙ্কিতা,	অঙ্কিতা,	
qulim,	কুলিম,	কুলিং,	
gonona,	গোনোনা,	গননা,	
encidablu,	এনসিডাবল্দু,	এনসিডাব্লু,	
biplabeer,	বিপ্লাবীর,	বিপ্লবীর,	
bangalore,	বাঙ্গালোর,	ব্যাঙ্গালুরে,	
artherer,	আর্থারের,	আর্থারের,	
adorsho,	আদর্শ,	আর্দশ,	
mimgulor,	মিমগুলোর,	মিমগুলোর,	
manabmaner,	মানবমনের,	মানবমনের,	
monjurul,	মঞ্জুরুল,	মনজুরুল,	
provritike,	প্রভৃতিকে,	প্রভৃতিকে,	
suisharke,	সুইশারকে,	সুইশারকে,	
mardud,	মারদুদ,	মরদুদ,	
grambaashio,	গ্রামবাশিও,	গ্রামবাসীও,	
mane,	মানে,	মানে,	
baffer,	বাফার,	বাফার,	
aairish,	আইরিশ,	আইরিস,	
shikshagato,	শিক্ষাগত,	শিক্ষাগত,	
engrejra,	এংগেরজার,	ইংরেজরা,	
laatimer,	লাটিমের,	লাটিমের,	
dera,	দীরা,	ডেরা,	
middleton,	মিডলটটন,	মিডলটন,	
baman,	বামান,	বামন,	
shithilata,	শিথিলতা,	শিথিলতা,	
chandil,	চন্দীল,	চান্ডিল,	
hariner,	হরিণের,	হরিণের,	
khanabale,	খানাবালে,	খানাবলে,	
prrajanankaal,	প্রজানকাল,	প্রজননকাল,	
laaisens,	লাইসেনস,	লাইসেন্স,	
jatotaa,	যততা,	যতোটা,	
chhaikalo,	ছাইকললো,	ছাইকালো,	
sipa,	সিপা,	শিপ,	
pushtee,	পুষ্টি,	পুষ্টি,	
shulfate,	শুলফেট,	সালফেট,	
nischitobhave,	নিশ্চিতভাবে,	নিশ্চিতভাবে,	
suporichita,	সুপরিচিতা,	সুপরিচিত,	
ministara,	মিনিস্তারা,	মিনিস্টার,	
spredashiita,	স্প্রেদাশীতা,	স্প্রেডশীট,	
adhikartai,	অধিকারটাই,	অধিকর্তাই,	
mookhomandoler,	মুখহমণ্ডলের,	মুখমণ্ডলের,	
aamoode,	আমুডে,	আমুদে,	
manohputa,	মনঃপুতা,	মনঃপুত,	
jonoshongjog,	জনসঙ্যযোগ,	জনসংযোগ,	
taateo,	তাতেও,	তাতেও,	
janoganonar,	জনগনানার,	জনগণনার,	
mmadhuri,	ম্যামধুরি,	মাধুরী,	
thabai,	থাবাই,	থাবাই,	
abhidhaanick,	অভিধানিক,	অভিধানিক,	
halding,	হললিং,	হোল্ডিং,	
maailkhanek,	মাইলখানেক,	মাইলখানেক,	
ostad,	ওস্টাদ,	ওস্তাদ,	
dhamshrenite,	ধামশ্রেণীতে,	ধামশ্রেণীতে,	
nishad,	নিষাদ,	নিষাদ,	
neerbachoker,	নির্বাচকের,	নির্বাচকের,	
karecho,	করেছো,	করেছ,	
nabatamo,	নবতামো,	নবতম,	
kinsha,	কিনশা,	কিংস,	
obhijojan,	অভিযোজন,	অভিযোজন,	
korle,	করলে,	করলে,	
bossoben,	বসববেন,	বসবেন,	
spancer,	স্প্যান্সের,	স্পেন্সার,	
mohit,	মহিত,	মুহিত,	
suraropito,	সুরারপিত,	সুরারোপিত,	
nothivukto,	নথিভুক্ত,	নথিভুক্ত,	
gorjon,	গর্জন,	গর্জন,	
ghamtaa,	ঘামটা,	ঘোমটা,	
noitikota,	নৈতিকতা,	নৈতিকতা,	
taap,	টাপ,	ট্যাপ,	
land,	ল্যান্ড,	ল্যান্ড,	
seebiai,	সেবিয়াই,	সিবিআই,	
sotorkobhabey,	সতর্কভাবে,	সতর্কভাবে,	
militarite,	মিলিটারিতে,	মিলিটারিতে,	
toranganj,	তরঙ্গঞ্জ,	তোরাবগঞ্জ,	
hafsa,	হাফসা,	হাফসা,	
myathiou,	ম্যাথিওউ,	ম্যাথিউ,	
besur,	বেসুর,	বেসুর,	
baarnish,	বার্নিশ,	বার্নিশ,	
machgulo,	মাছগুলো,	মাছগুলো,	
shloker,	শ্লোকের,	শ্লোকের,	
lebina,	লেবিনা,	লেবিনা,	
uter,	উতের,	উটের,	
vugoley,	ভুগোলে,	ভূগোলে,	
taffsherer,	তাফশেরের,	তাফসীরের,	
foreks,	ফোরেক্স,	ফরেক্স,	
pader,	পাদির,	প্যাডের,	
abhirupbabuke,	অভিরূপবাবুকে,	অভিরূপবাবুকে,	
oncholke,	অঁছকলে,	অঞ্চলকে,	
sangsakti,	সংসক্তি,	সংসক্তি,	
taderek,	তাদেরেক,	তাদেরেক,	
shamshernagar,	শমশেরনগর,	শমশেরনগর,	
koota,	কোটা,	কোটা,	
eesa,	ইইএসএএ,	আইএএস,	
makhno,	মাখ্ন,	মাখনো,	
daakten,	ডাকততেন,	ডাকতেন,	
peengna,	পিংনা,	পিংনা,	
pratisthasaho,	প্রতিষ্ঠাসহ,	প্রতিষ্ঠাসহ,	
miitar,	মিটার,	মিত্র,	
ceramiker,	সেরামিকের,	সিরামিকের,	
asovyo,	অসভ্য,	অসভ্য,	
madhukori,	মধুকোরী,	মাধুকরী,	
doneta,	দোনেটা,	ডোনাট,	
pratijogider,	প্রতিযোগীদের,	প্রতিযোগীদের,	
kaia,	কাইয়া,	কায়া,	
yaak,	যাক,	ইয়াক,	
neshnosh,	নেশনোষ,	নেশনস,	
francine,	ফ্রান্সাইন,	ফ্রান্সিন,	
protishta,	প্রতিষ্টা,	প্রতিষ্টা,	
jerusaleme,	জেরুসালেমে,	জেরুসালেমে,	
kurdira,	কুরদিরার,	কুর্দিরা,	
eexpreession,	ইক্সপ্রেশন,	এক্সপ্রেশন,	
overholing,	ওভারহলিং,	ওভারহোলিং,	
direectoratee,	ডিরেক্টরাট,	ডিরেক্টরেট,	
pakhtunistan,	পাখতুনিস্তান,	পাখতুনিস্তান,	
sthapanagulo,	স্থাপানগুলো,	স্থাপনাগুলো,	
taigara,	টাইগারা,	টাইগার,	
tennis,	টেনিস,	টেনিস,	
amittrakkhor,	অমিত্রাক্ষর,	অমিত্রাক্ষর,	
anandamahale,	আনন্দমাহলে,	আনন্দমহলে,	
sanaktokaron,	সনক্তকারণ,	সনাক্তকরণ,	
firozaa,	ফিরোজা,	ফিরোজা,	
chalochchitraeer,	চালচ্ছিত্রীর,	চলচ্চিত্রের,	
bhandti,	ভাঁদটি,	ভাণ্ডটি,	
proboleme,	প্রবলেমে,	প্রবলেমে,	
pathanirdeshona,	পাঠানির্দেশনা,	পথনির্দেশনা,	
shahurgulor,	শহুরগুলোর,	শহুরগুলোর,	
purbancoler,	পূর্বান্কলের,	পূর্বাঞ্চলের,	
bibader,	বিবাদের,	বিবাদের,	
purbanchaler,	পূর্বাঞ্চলের,	পূর্বাঞ্চলের,	
bondhuvabaponyo,	বন্ধুবাবাপ্্য,	বন্ধুভাবাপন্ন,	
shrimoti,	শ্রীমতি,	শ্রীমতি,	
tolemy,	টলেমি,	টলেমির,	
mukharji,	মুখার্জি,	মুখার্জী,	
query,	কোরি,	কোয়েরি,	
taunsheep,	তৌনশীপ,	টাউনশিপ,	
kadakhonchar,	কাদাখোঁচার,	কাদাখোঁচার,	
institutione,	ইন্্টিটিটুউন,	ইনস্টিটিউশনে,	
mekapgulo,	মেকাপগুলো,	মেকআপগুলো,	
byabosthar,	ব্যবস্থার,	ব্যবস্থার,	
roopdaan,	রোপডান,	রুপদান,	
uponeesoder,	উপনেসদের,	উপনিষদের,	
godamjato,	গদামজাত,	গুদামজাত,	
abeganuvutir,	আবেগুনাভুতির,	আবেগানুভূতির,	
rahi,	রাহি,	রাহী,	
pyetarna,	প্যাটেরন,	প্যাটার্ন,	
disposes,	ডিসপোসেস,	ডিসপোজেস,	
jhonkar,	ঝোঁকার,	ঝঙ্কার,	
saifai,	সাইফাই,	সাইফাই,	
eura,	ইউরা,	ইউরো,	
khiladirao,	খিলাদিরাও,	খিলাড়িরাও,	
shubhag,	শুভাগ,	শুভাগ,	
chotogolper,	চতগগল্পের,	ছোটগল্পের,	
gyandas,	জ্ঞানদাস,	জ্ঞানদাস,	
niketon,	নিকেতন,	নিকেতন,	
deputy,	ডিপুটি,	ডেপুটি,	
sqirt,	স্কির্ট,	স্কার্ট,	
poripaker,	পরিপাকের,	পরিপাকের,	
pharn,	ফার্ন,	ফার্ন,	
byabaharkariderke,	ব্যবহারকারীদেরকে,	ব্যবহারকারীদেরকে,	
leaders,	লিডারস,	লিডার্স,	
bangulzai,	বাঙ্গুল্াই,	বঙ্গুলিজাই,	
marry,	মারি,	ম্যারি,	
sonaktokaran,	সনাক্তকারণ,	সনাক্তকরণ,	
tooku,	টুকু,	টুকু,	
kingsh,	কিংশ,	কিংস,	
rubidiyaam,	রুবিডিয়াম,	রুবিডিয়াম,	
vault,	ভাল্ট,	ভল্ট,	
baaiq,	বাইক,	বাইক,	
satarka,	সতর্ক,	সতর্ক,	
janamukhi,	জননমুখী,	জনমুখী,	
anchalgoolir,	অঞ্চলগুলোর,	অঞ্চলগুলির,	
concerter,	কনসারটের,	কানসাটের,	
pacchi,	পাচ্ছি,	পাচ্ছি,	
ebhara,	এভারা,	এভার,	
mulor,	মুলোর,	মুলোর,	
durlabhatwang,	দুর্লভভ্তং,	দুর্লভত্বং,	
jackey,	জ্যাকে,	জকি,	
addabaj,	আদ্দাবাজ,	আড্ডাবাজ,	
aabarte,	আবার্তে,	আবর্তে,	
ganochien,	গণছিয়েন,	গণচীন,	
asamonjasyopurno,	অসামঞ্জসমযপূর্ণ,	অসামঞ্জস্যপূর্ণ,	
sumita,	সুমিতা,	সুমিতা,	
mohammadi,	মোহা্মদী,	মুহাম্মদী,	
khali,	খালি,	খালি,	
chyeta,	চিয়াটা,	চ্যাট,	
turkeyder,	টুর্কিদের,	তুর্কিদের,	
shainyader,	শৈন্যদের,	সৈন্যদের,	
qonflict,	কনফ্লিক্ট,	কনফ্লিক্ট,	
mumtajer,	মুমতাজের,	মুমতাজের,	
tokeo,	টোকেও,	টোকেও,	
zeebonto,	জীবন্ত,	জীবন্ত,	
onchalti,	অন্চলটি,	অঞ্চলটি,	
gobeshonar,	গবেষণার,	গবেষনার,	
boiragirhat,	বৈরাগীরহাট,	বৈরাগিরহাট,	
maarmaader,	মার্মাদের,	মারমাদের,	
kayartara,	কায়ারটার,	কোয়ার্টার,	
qirq,	কির্ক,	কার্ক,	
vaider,	ভাইদের,	ভাইদের,	
saras,	সারাস,	সরস,	
thyachara,	থায়ারা,	থ্যাচার,	
dai,	দইই,	ডে,	
sabrakamer,	সব্রকামের,	সবরকমের,	
agamane,	আগামানে,	আগমনে,	
towraat,	তোরাত,	তওরাত,	
jomjamat,	জমজামাত,	জমজমাট,	
saabyastha,	সব্যস্থ,	সাব্যস্থ,	
rajendracholer,	রাজেন্দ্রাালোর,	রাজেন্দ্রচোলের,	
homshke,	হোমসকে,	হোমসকে,	
themekey,	থেমেকে,	থিমকে,	
adorso,	আদর্স,	আর্দশ,	
doorger,	ডুর্গের,	দুর্গের,	
bim,	বিআমআম,	বিম,	
airish,	আইরিশ,	আইরিস,	
courtcaser,	কোর্টকেসের,	কোর্টকেসের,	
chakundite,	চাকুণ্ডিতে,	চাকুন্দিতে,	
kiuti,	কিউটি,	কিউটি,	
chasee,	চাসী,	চেস,	
homeser,	হমেসের,	হোমসের,	
joumana,	যৌমানা,	জুমানা,	
akheli,	আখেলি,	আখেলী,	
madeling,	মেডেলিং,	মডেলিং,	
kailashrao,	কালাশরাও,	কৈলাশরাও,	
bamni,	বামনি,	বামনী,	
sausage,	সৌগেে,	সসেজ,	
rajyotiro,	রাজ্যপিরও,	রাজ্যটিরও,	
noditir,	নদীটির,	নদীটির,	
wagadada,	ওয়াগাদা,	বাগদাদ,	
taunship,	টাউনশিপ,	টাউনশিপ,	
mukhabandha,	মুখবন্ধ,	মুখবন্ধ,	
talgach,	তালগাছ,	তালগাছ,	
aaziz,	আজিজ,	আজিজ,	
oitijjo,	ঐতিহ্য,	ঐতিহ্য,	
asamorik,	আসামরিক,	অসামরিক,	
chikitsar,	চিকিৎসার,	চিকিত্সার,	
zoubankal,	যৌবানকাল,	যৌবনকাল,	
pillai,	পিল্লাই,	পিল্লাই,	
stona,	স্তোনা,	স্টোন,	
shakar,	শাকার,	সকার,	
bhittimul,	ভিত্তিমূল,	ভিত্তিমূল,	
bisshas,	বিশ্বাস,	বিশ্বাস,	
niutrino,	নিউট্রিনো,	নিউট্রিনো,	
bashoborty,	বাশবর্তী,	বশবর্তী,	
serveray,	সার্ভারে,	সার্ভারে,	
bhangle,	ভাঙ্গলে,	ভাঙলে,	
taholo,	তাহলো,	তাহলো,	
timoothi,	তিমোথি,	টিমোথি,	
vorkendra,	ভোরকেন্দ্র,	ভরকেন্দ্র,	
akeeb,	আকিব,	আকিব,	
olympicer,	অলিম্পাইর,	অলিম্পিকের,	
bairey,	বাইরে,	বাইরে,	
asovya,	অসভ্যা,	অসভ্য,	
eporjonto,	এপরজন্ত,	এপর্যন্ত,	
daaun,	ডাউন,	ডাউন,	
satan,	সাতান,	শয়তান,	
bisshonath,	বিশ্বনাথ,	বিশ্বনাথ,	
chalachchitro,	চলচ্চিত্র,	চলচ্চিত্র,	
satarkabhabe,	সতর্কভাবে,	সতর্কভাবে,	
gaje,	গাজে,	গেজ,	
notikotar,	নতিকতার,	নৈতিকতার,	
as,	এসেএ,	অস,	
somonnitobhabe,	সমোনিতভাবে,	সমন্বিতভাবে,	
asamanyo,	অসামন্য,	অসামান্য,	
champa,	চা্পা,	চাঁপা,	
sumi,	সুমি,	সুমি,	
foolkopi,	ফুলকোপি,	ফুলকপি,	
emarjenshi,	এমারজেন্সি,	এমার্জেন্সি,	
antarctica,	অ্যান্টররটিকটা,	অ্যান্টার্কটিকার,	
epiela,	এপিলে,	আইপিএল,	
seramiks,	সেরামিকস,	সিরামিকস,	
cholechi,	চলেছি,	চলেছি,	
shikhaboudi,	শিখাবৌদি,	শিখাবৌদি,	
ghoshanapatratio,	ঘোষণাপত্রটিও,	ঘোষণাপত্রটিও,	
shucharita,	শুচারিতা,	সুচরিতা,	
lidars,	লিদারস,	লিডার্স,	
mesenjjar,	মেসেনজার,	মেসেঞ্জার,	
noiteek,	নৈটিক,	নৈতিক,	
atmobonchito,	আত্মবঞ্চিত,	আত্মবঞ্চিত,	
headquartus,	হেডকুরাটা,	হেডকোয়ার্টাস,	
anagarikra,	অনাগারিকরা,	অনাগরিকরা,	
reshidensha,	রেশীডেন্স,	রেসিডেন্স,	
edseler,	এডসেলের,	এডসেলের,	
gronther,	গ্রন্থের,	গ্রন্থের,	
sangbadmadhyome,	সংবাদমাধ্যমে,	সংবাদমাধ্যমে,	
argead,	আরজেড,	আর্জিদ,	
roopdan,	রোপদান,	রুপদান,	
siddhanter,	সিদ্ধান্তের,	সিদ্ধান্তের,	
oxite,	অক্সটাইট,	অক্সাইট,	
garora,	গ্যারোরা,	গারোরা,	
moonshi,	মুনশি,	মুন্সি,	
sumoo,	সুমো,	সুমো,	
greenald,	গ্রিনাল্ড,	গ্রিনল্ড,	
uqeliptas,	ইকেলিপ্টাস,	ইউক্যালিপ্টাস,	
renoo,	রেনু,	রেনো,	
vimsen,	ভিমসেন,	ভীমসেন,	
chitlar,	চিতলার,	চিতলার,	
aajeej,	আজিজ,	আজিজ,	
matt,	ম্ট,	ম্যাট,	
dharmantor,	ধর্মান্তর,	ধর্মান্তর,	
addhattikotar,	আদ্ধাত্মিকতার,	আধ্যাত্মিকতার,	
bollov,	বল্লোভ,	বল্লভ,	
popke,	পপ্পকে,	পোপকে,	
torunosomriddho,	তরুণসমৃদ্ধ,	তরুণসমৃদ্ধ,	
pare,	প্যারে,	পাড়ে,	
dakten,	ডাকতেন,	ডাকতেন,	
sangkoolan,	সংকুলান,	সংকুলান,	
chaanoo,	চানু,	চানু,	
bhogiroth,	ভোগীরথ,	ভগীরথ,	
huk,	হুক,	হুক,	
debeting,	ডেবেটিং,	ডিবেটিং,	
uposhthit,	উপশ্থিত,	উপস্থিত,	
damakalkarmirao,	দমকলকর্মীরাও,	দমকলকর্মীরাও,	
vobani,	ভোবানী,	ভবানী,	
blasterke,	ব্লাস্টারকে,	ব্লাস্টারকে,	
byabaharkareederke,	ব্যবহারকারীদেরকে,	ব্যবহারকারীদেরকে,	
okritokarjo,	অক্তরাকর্য্য,	অকৃতকার্য,	
choritrotakeo,	চরিত্রতাকেও,	চরিত্রটাকেও,	
moshahidur,	মোশাহিদুর,	মোশাহিদুর,	
tintikey,	তিনটিকে,	তিনটিকে,	
dorneca,	ডর্নেকা,	ডরনেকা,	
cheerokoomari,	চীরকৌমারী,	চিরকুমারী,	
monohputo,	মনঃহপূত,	মনঃপুত,	
korimer,	করিমের,	করিমের,	
okkhorke,	অক্ষরকে,	অক্ষরকে,	
chet,	চেট,	চ্যাট,	
sikkharrtheerao,	শিক্ষার্থীরাও,	শিক্ষার্থীরাও,	
mukhobondho,	মুখবন্ধ,	মুখবন্ধ,	
ul,	ইলএল,	উল,	
ghotaibe,	ঘটাইবে,	ঘটাইবে,	
hariken,	হরিকেন,	হ্যারিকেন,	
mukhomandaler,	মুখোমণ্ডলের,	মুখমণ্ডলের,	
lambaate,	লাম্বাতে,	লম্বাটে,	
jansha,	জনশা,	জন্স,	
humner,	হামনার,	হামনার,	
ixprission,	আইক্সপ্রিশন,	এক্সপ্রেশন,	
adwanced,	অ্যাডব্যান্ড,	অ্যাডভান্সড,	
sahachke,	সহচকে,	সাহাচকে,	
oyebjin,	ওয়েবজিন,	ওয়েবজিন,	
eporzonto,	এপরজন্ত,	এপর্যন্ত,	
bohudin,	বহুদিন,	বহুদিন,	
besooro,	বেসুরও,	বেসুর,	
brahmanera,	ব্রাহ্মণেরা,	ব্রাহ্মণেরা,	
kanasarabheeshana,	কাসারীভীষণ,	কনসারভেশন,	
qrisenta,	ক্রিসেন্টা,	ক্রিসেন্ট,	
oikhan,	ঐখান,	ঐখান,	
graambasheeo,	গ্রামবাসীও,	গ্রামবাসীও,	
bonnypran,	বন্যিপ্রণ,	বন্যপ্রাণ,	
salphat,	সালফাত,	সালফেট,	
heart,	হার্ট,	হার্ট,	
suhayeler,	সুহায়েলের,	সুহায়েলের,	
tarkale,	তারকালে,	তারকালে,	
nirbahi,	নির্বাহী,	নির্বাহি,	
bbiseshyer,	ব্বীশেষ্যের,	বিশেষ্যের,	
golimodhye,	গলিমধ্যে,	গলিমধ্যে,	
dharmadasbabu,	ধর্মদাসবাবু,	ধর্মদাসবাবু,	
duio,	দুইও,	দুইও,	
nadike,	নাদিকে,	নদীকে,	
shkalarashhipa,	স্কললারশিপ,	স্কলারশিপ,	
marketing,	মার্কেটিং,	মার্কেটিং,	
brittakare,	বৃত্তাকারে,	বৃত্তাকারে,	
prajanankal,	প্রজানককল,	প্রজননকাল,	
hastamathun,	হস্তামথথুন,	হস্তমথুন,	
rijoor,	রিজুর,	রিজুর,	
oncholshomuher,	অন্ছলসমূহের,	অঞ্চলসমূহের,	
bhaibon,	ভাইবন,	ভাইবোন,	
bokul,	বকুল,	বকুল,	
omkar,	ওমকার,	ওঙ্কার,	
kinenni,	কিনেননি,	কিনেননি,	
holuder,	হলুদের,	হলুদের,	
taalaal,	তালাল,	তালাল,	
naubom,	নাবম,	নবম,	
oporishodhito,	অপরিষধিত,	অপরিশোধিত,	
shibraj,	শিবরাজ,	শিবরাজ,	
nirbahe,	নির্বাহে,	নির্বাহে,	
mandondo,	ম্যান্ডো,	মানদণ্ড,	
jandrel,	জান্দ্রেল,	জাঁদরেল,	
udvabani,	উদ্ভাবানী,	উদ্ভাবনী,	
gannaprakasham,	গণ্যপ্রকাশম,	গন্নাপ্রকাশম,	
jalarong,	জালারোং,	জলরঙ,	
manushera,	মনুষেরা,	মানুষেরা,	
contemporary,	কন্টেমোপরারি,	কন্টেম্পোরারি,	
lagto,	লাগতো,	লাগতো,	
bhikkharthe,	ভিক্ষার্থে,	ভিক্ষার্থে,	
zeeland,	জিল্যান্ড,	জিল্যান্ড,	
khaschandpur,	খাসছাঁদপুর,	খাসচাঁদপুর,	
akten,	আকতেন,	অকটেন,	
dalip,	দালিপ,	দালিপ,	
uttor,	উত্তর,	উওর,	
dharabahikvabe,	ধারাবাহিকভাবে,	ধারাবাহিকভাবে,	
geja,	গেজা,	গেজ,	
toching,	টচিং,	টোচিং,	
rilayensa,	রিলায়ন্স,	রিলায়েন্স,	
muhurtati,	মুহূর্ততি,	মুহুর্তটি,	
bsnleu,	বিএসএসএনএলও,	বিএসএনএলইইউ,	
louhojato,	লৌহজাত,	লৌহজাত,	
prarthonakokkher,	প্রার্থনাকক্ষের,	প্রার্থনাকক্ষের,	
rachonakal,	রচনাকাল,	রচনাকাল,	
azin,	আজিন,	আজিন,	
parqa,	পারকা,	পার্ক,	
railliner,	রেলিনের,	রেললাইনের,	
helly,	হেলি,	হিলি,	
asovarno,	অসভার্ণ,	অসবর্ণ,	
shringa,	শ্রিংগা,	শৃঙ্গ,	
chokhwala,	চোখওয়ালা,	চোখওয়ালা,	
mangoleek,	মঙ্গলীক,	মাঙ্গলিক,	
kaash,	কাশ,	কাস,	
bosano,	বসানো,	বসানো,	
chetanagato,	চেতানাগো,	চেতনাগত,	
neshnos,	নেশনস,	নেশনস,	
mexicoteo,	মেক্সিকিটোকোও,	মেক্সিকোতেও,	
bodhir,	বোধীর,	বধির,	
prodiiper,	প্রদীপীরের,	প্রদীপের,	
nirmol,	নির্মল,	নির্মল,	
duryogamoyee,	দূর্যগাময়ী,	দুর্যোগময়ী,	
sharthe,	শার্থে,	স্বার্থে,	
heena,	হীনা,	হেনা,	
biplabee,	বিপ্লাবী,	বিপ্লবী,	
bhangchur,	ভাংচুর,	ভাংচুর,	
ekekrokom,	একেক্রকম,	একেকরকম,	
bonke,	বনকে,	বনকে,	
elaakaate,	এলাকাতে,	এলাকাতে,	
skolastik,	স্কোলাস্তিক,	স্কলাস্টিক,	
hevy,	হেভি,	হেভি,	
sallallahu,	সাল্লাল্লাহু,	সল্লাল্লাহু,	
hol,	হল,	হোল,	
amudey,	আমুদে,	আমুদে,	
fising,	ফিসিং,	ফিসিং,	
aireshe,	আইরেশে,	আইরেসে,	
manoharpur,	মনোহরপুর,	মনোহরপুর,	
gejetade,	গেজেটাদে,	গেজেটেড,	
aizulke,	আইজালকে,	আইজুলকে,	
neshadrabyer,	নেশাদ্রব্যের,	নেশাদ্রব্যের,	
krus,	ক্রুস,	ক্রুশ,	
bojhe,	বোঝে,	বোঝে,	
asociatis,	অসোসিয়াটিস,	এসোসিয়েটস,	
chorban,	চোরবান,	চর্বন,	
palteche,	পালটেছে,	পাল্টেছে,	
buth,	বাথথ,	বুথ,	
pharanyeta,	ফরণ্যেতা,	ফরম্যাট,	
kanshat,	কানশাট,	কানসাট,	
felto,	ফেল্টো,	ফেলত,	
huqa,	হুকা,	হুক,	
teestar,	তেস্টার,	তিস্তার,	
romnar,	রোমনার,	রমনার,	
shangsthatikey,	সাংস্থাটিকে,	সংস্থাটিকে,	
talaal,	তালাল,	তালাল,	
manush,	মানুষ,	মানুষ,	
tecno,	টেকনো,	টেকনো,	
nirbaho,	নির্বাহ,	নির্বাহ,	
shikare,	শিকারে,	শিকারে,	
sarjur,	সররুর,	সরযূর,	
deefinishion,	ডিফিনিশন,	ডেফিনেশন,	
mehsus,	মেহসাস,	মেহসুস,	
spreadshiit,	স্প্রেডশাইট,	স্প্রেডশীট,	
akkharkey,	অক্ষারকে,	অক্ষরকে,	
anichchi,	অনিচ্ছি,	আনিচ্ছি,	
jaistho,	জৈইস্থ,	জ্যৈষ্ঠ,	
nibeditar,	নিবেদিতার,	নিবেদিতার,	
khorsed,	খোরসেড,	খোরশেদ,	
thanvi,	থানভি,	থানভী,	
glanio,	গ্লানিও,	গ্লানিও,	
venush,	ভেনুষ,	ভেনাস,	
starker,	স্টার্কের,	স্টার্কের,	
chhedon,	ছেদন,	ছেদন,	
bhalobasar,	ভালোবাসার,	ভালোবাসার,	
kings,	কিংস,	কিংস,	
teliha,	তেলিহা,	তেলিহা,	
chopol,	চপল,	চপল,	
kushumba,	কুশুম্ব,	কুশুম্বা,	
aakkaash,	আক্কাশ,	আককাস,	
mousumeo,	মৌসুমেও,	মৌসুমেও,	
chuti,	চুটি,	ছুটি,	
sithilotar,	সিথিলতার,	শিথিলতার,	
bhagnekeo,	ভাগনেকেও,	ভাগ্নেকেও,	
carlo,	কার্লো,	কার্লো,	
alimpiqa,	আলিমপিকা,	অলিম্পিক,	
ashonkai,	আশঙকাই,	আশঙ্কাই,	
sharoker,	শারকের,	স্মারকের,	
kourabe,	কৌরবে,	কৌরবে,	
torutoler,	তরুতলের,	তরুতলের,	
baieq,	বাইক,	বাইক,	
pratool,	প্রততুল,	প্রতুল,	
baire,	বাইরে,	বাইরে,	
remacry,	রিমেকারি,	রেমাক্রী,	
eigulor,	এইগুলোর,	এইগুলোর,	
orthisoho,	অর্থিসহ,	অর্থিসহ,	
conflikt,	কনফ্লিক্ট,	কনফ্লিক্ট,	
turbiner,	টারবিনের,	টারবাইনের,	
bifol,	বিফোল,	বিফল,	
poorohitder,	পুরোহিতদের,	পুরোহিতদের,	
oedipus,	ওড়িপাস,	ইডিপাস,	
elakaate,	এলাকাতে,	এলাকাতে,	
senior,	সেনিওর,	সিনিয়র,	
shchalastic,	স্যালাল্সটটিক,	স্কলাস্টিক,	
gandhiio,	গান্ধিও,	গান্ধীও,	
natshi,	নাটশি,	নাত্সি,	
siddhantoo,	সিদ্ধান্ত,	সিদ্ধান্তও,	
edaning,	এডানিং,	ইদানিং,	
naagaalyand,	নাগা্যান্দ,	নাগাল্যান্ড,	
modele,	মডেলে,	মডেলে,	
bhyatikaner,	ভ্যাটিকানের,	ভ্যাটিকানের,	
daltyagi,	দলত্যগগি,	দলত্যাগী,	
supreetira,	সুপ্রীতীরা,	সুপ্রীতিরা,	
hughes,	হুগেস,	হিউজেস,	
jarmaniteo,	জার্মানিতেও,	জার্মানিতেও,	
hertj,	হের্টজ,	হার্জ,	
adhyatmik,	আধ্যাত্মিক,	আধ্যাত্মিক,	
bbiswashi,	বিব্বিশ্বাসী,	বিশ্বাসই,	
carlos,	কার্লোস,	কার্লোস,	
munjur,	মুঞ্জুর,	মুনজুর,	
timathi,	তিমাথি,	টিমোথি,	
khalidke,	খালিদকে,	খালিদকে,	
oboshore,	অবশরে,	অবসরে,	
atmiyasulabh,	আত্মীয়সুলভ,	আত্মীয়সুলভ,	
akkheperi,	আক্ষেপেরই,	আক্ষেপেরই,	
deilee,	দেইলী,	ডেইলি,	
jerushalema,	জেরুশালেমা,	জেরুসালেম,	
hafej,	হাফেজ,	হাফেয,	
harysoner,	হ্যারিসনের,	হ্যারিসনের,	
nikela,	নিকেলা,	নিকেল,	
phiqsa,	ফিকসস,	ফিক্স,	
chhooteer,	ছুটির,	ছুটির,	
bharotiyotar,	ভারতীয়তার,	ভারতীয়তার,	
ghotolen,	ঘটলেন,	ঘটলেন,	
shikkhakram,	শিক্ষাক্রম,	শিক্ষাক্রম,	
refleks,	রেফলেক্স,	রিফ্লেক্স,	
noditei,	নদীতেই,	নদীতেই,	
dokaanei,	দকানেই,	দোকানেই,	
croak,	ক্রোক,	ক্রোক,	
stagecraft,	স্ট্যাগেক্রাফ্ট,	স্টেজক্রাফট,	
weelcomee,	বিলকমি,	ওয়েলকাম,	
ray,	রায়ে,	রায়,	
ahmed,	আহমেদ,	আহামদ,	
mutar,	মুতার,	মুতার,	
saalsa,	সালসা,	সালসা,	
prokolpogulikei,	প্রকল্পগুলিকেই,	প্রকল্পগুলিকেই,	
bhotomulyoke,	ভোটমূলয্যকে,	ভোটমূল্যকে,	
siropa,	সিরোপা,	শিরোপা,	
songkoloney,	সংকলনে,	সংকলনে,	
ahalyar,	অহল্যার,	অহল্যার,	
toroonraa,	তরূনরা,	তরুণরা,	
orbeet,	অর্বীত,	অরবিট,	
raagee,	র্যাগি,	রাগী,	
ingrejra,	ইংরেজরা,	ইংরেজরা,	
meropenemer,	মেরোপেনেমের,	মেরোপেনেমের,	
torabganj,	তোরাবগঞ্জ,	তোরাবগঞ্জ,	
liseensee,	লিসেন্সি,	লাইসেন্স,	
bhramapraban,	ভ্রমপ্রবণ,	ভ্রমপ্রবণ,	
chirkoot,	চিরকুট,	চিরকুট,	
pet,	পেট,	পেত,	
parabortee,	পারববর্তী,	পরর্বতী,	
phiksa,	ফিকসা,	ফিক্স,	
nimnosakkharkari,	নিম্নসাকরকারকী,	নিম্নস্বাক্ষরকারী,	
shikshakrom,	শিক্ষাকর্ম,	শিক্ষাক্রম,	
nikote,	নিকোটে,	নিকটে,	
deenesh,	দীনেশ,	দীনেশ,	
alaul,	আলাল,	আলাওল,	
unitgulo,	উনিতগুলো,	ইউনিটগুলো,	
bisshasi,	বিশ্বাসী,	বিশ্বাসী,	
mumtaj,	মুমতাজ,	মুমতাজ,	
onker,	অঙ্কের,	ওঙ্কার,	
mmehonoti,	ম্মেহনতি,	মেহনতি,	
shudhui,	শুধুই,	শুধুই,	
aasirbaad,	আশিরবাদ,	আশির্বাদ,	
naper,	নেপার,	ন্যাপের,	
birmuktijoddhagan,	বীরমুক্তিযোদ্ধগগন,	বীরমুক্তিযোদ্ধাগণ,	
shem,	শেম,	সেম,	
kooshumba,	কুশুম্বা,	কুশুম্বা,	
annanere,	আন্নানেরে,	অন্যানেরে,	
blyaka,	ব্লাযাক,	ব্ল্যাক,	
bikretara,	বিক্রেতারা,	বিক্রেতারা,	
acrolect,	অ্যার্রোলেক্ট,	অ্যাক্রোলেক্ট,	
elakaatite,	এলাকটিতে,	এলাকাটিকে,	
sangkulaan,	সংকুলান,	সংকুলান,	
cinemapremider,	সিনেমাপ্রেমীদের,	সিনেমাপ্রেমীদের,	
nagorikota,	নাগরিকতা,	নাগরিকতা,	
narishwar,	নারীশ্বর,	নারীশ্বরের,	
keu,	কেউ,	কেউ,	
ashamorthito,	অসামর্থিত,	অসমর্থিত,	
itastata,	ইতাস্ততা,	ইতস্তত,	
aakkas,	আক্কাস,	আককাস,	
deputi,	ডেপুটি,	ডেপুটি,	
soinyo,	সৈন্য,	সৈন্য,	
byabaharkareer,	ব্যবহারকারীর,	ব্যবহারকারীর,	
baibosthaar,	বাইবস্থার,	ব্যবস্থার,	
nazranar,	নাজরনার,	নাজরানার,	
grontho,	গ্রন্থ,	গ্রন্থ,	
gafeeloti,	গাফিলতি,	গাফিলতি,	
choopi,	চুপি,	চুপি,	
choukato,	চৌকাত,	চৌকাত,	
narsinghomgulor,	নর্সিংহগুলোর,	নার্সিংহোমগুলোর,	
marri,	মাররি,	ম্যারি,	
probhritike,	প্রভৃতিকে,	প্রভৃতিকে,	
pinglateo,	পিংলাটেও,	পিংলাতেও,	
sarsa,	সারসা,	সোর্স,	
motkey,	মটকেই,	মতকে,	
talgachh,	তালগাছ,	তালগাছ,	
karaponner,	কারাপণ্যের,	কারাপণ্যের,	
konar,	কোনার,	কণার,	
punosthaner,	পুনস্থানের,	পুনঃস্থানের,	
casper,	ক্যাসপার,	ক্যাসপার,	
shikshagata,	শিক্ষগত,	শিক্ষাগত,	
eshtonia,	এস্টোনিয়া,	এস্তোনিয়া,	
horeepur,	হরিপুর,	হরিপুর,	
gostigulo,	গোস্তিগুলো,	গোষ্ঠীগুলো,	
binakar,	বিনাকর,	বিনাকার,	
arthanitike,	অর্থনীতিকে,	অর্থনীতিকে,	
stana,	স্টানা,	স্টোন,	
orthonitir,	অর্থনীতির,	অর্থনীতির,	
protijogiitamulok,	প্রতিযোগিতামূলক,	প্রতিযোগীতামূলক,	
jhamala,	ঝামালা,	ঝামালা,	
dai,	দইই,	দিই,	
shangsthaner,	সাংস্থানের,	সংস্থানের,	
mandape,	মণ্ডপে,	মন্ডপে,	
dhadhiye,	ধাধীয়ে,	ধাধিয়ে,	
shingping,	সিংপিং,	শিংপিং,	
ghumachche,	ঘুমাচ্ছে,	ঘুমাচ্ছে,	
kanar,	কানার,	কণার,	
mastarsa,	মাস্তারস,	মাস্টার্স,	
bhandar,	ভাণ্ডার,	ভাণ্ডার,	
foks,	ফকস,	ফক্স,	
pravura,	প্রভুরা,	প্রভুরা,	
sooya,	সুয়া,	সোয়া,	
rojapalaner,	রোজাপালানের,	রোজাপালনের,	
biswashi,	বিশ্বশী,	বিশ্বাসই,	
pujito,	পুজিত,	পুজিত,	
pack,	পাক,	প্ল্যাক,	
farhetin,	ফরহেতিন,	ফারহেতিন,	
saoum,	সাওয়াম,	সাওম,	
akhando,	অখাঁদ,	অখন্ড,	
dipke,	ডিপকে,	দ্বীপকে,	
licencer,	লাইসেন্সের,	লাইসেন্সের,	
sainyader,	সান্যাদের,	সৈন্যদের,	
milea,	মিলেয়া,	মাইলে,	
murali,	মুরালি,	মুরলী,	
matrirup,	মাতৃরূপ,	মাতৃরূপ,	
rahee,	রহি,	রাহি,	
bhyaatikaner,	ভ্যাটিকানের,	ভ্যাটিকানের,	
bhromonkaale,	ভ্রমণকালে,	ভ্রমণকালে,	
saom,	সামম,	সাওম,	
ansareer,	আনসারীর,	আনসারীর,	
station,	স্টেশন,	ষ্টেশন,	
kanthar,	কাঁথার,	কাঁথার,	
inafarameshana,	ইনফফরমেশন,	ইনফরমেশন,	
chhuteete,	ছুটিতে,	ছুটিতে,	
armashtram,	আর্মশ্ট্রম,	আর্মস্ট্রং,	
orrgho,	অর্ঘ,	অর্ঘ্য,	
graambasi,	গ্রামবাসী,	গ্রামবাসী,	
augustine,	আগাস্তিন,	অগাস্টিন,	
change,	চাঙ্গে,	চেঞ্জ,	
vejjanno,	বেজ্ঞান্য,	ভেজানো,	
agaldar,	আগলদার,	আগলদার,	
bohorompurer,	বহরমপুরের,	বহরমপুরের,	
zonsa,	জোনসা,	জোন্স,	
songkolonti,	সংকলনটি,	সংকলনটি,	
marodeho,	মারোহেহ,	মরদেহ,	
sudrishya,	সুদৃশ্য,	সুদৃশ্য,	
hindutirtha,	হিন্দুতির্থ,	হিন্দুতীর্থ,	
dristiheen,	দৃহ্টিহীন,	দৃষ্টিহীন,	
cheekitsar,	চিকিৎসার,	চিকিত্সার,	
mulyabriddhikale,	মূল্যবৃদ্ধিকলকে,	মূল্যবৃদ্ধিকালে,	
cholchhee,	চলছি,	চলছে,	
bisheshyo,	বিশেষ্য,	বিশেষ্য,	
durgotsab,	দুর্গোৎসব,	দুর্গোৎসব,	
bishesyo,	বিশেষ্য,	বিশেষ্য,	
registaner,	রেজিস্টানের,	রেগিস্তানের,	
pluck,	প্লুক,	প্ল্যাক,	
ronodeep,	রোনীদ,	রণদীপ,	
ashanka,	আশঙ্কা,	আশংকা,	
basaake,	বাসাকে,	বাসাকে,	
osthisondhi,	অস্থিসন্ধি,	অস্থিসন্ধি,	
bhaisaho,	ভাইসহ,	ভাইসহ,	
uddharkarmirai,	উদ্ধারকর্মীরাই,	উদ্ধারকর্মীরাই,	
drissotir,	দৃশ্টটির,	দৃশ্যটির,	
nutoner,	নুটনের,	নূতনের,	
nibirbhabe,	নিবীর্ভাবে,	নিবিরভাবে,	
andamana,	আন্দমমানা,	আন্দামান,	
tricksguli,	ট্রিকসগুলি,	ট্রিকসগুলি,	
bishshasho,	বিশ্বাস,	বিশ্বাসও,	
khudhartara,	ক্ষুধার্তরা,	ক্ষুধার্তরা,	
byomkes,	ব্যামকেস,	ব্যোমকেশ,	
kk,	কেকেক,	কেকে,	
chhatrodiger,	ছাত্রদিগের,	ছাত্রদিগের,	
hights,	হাইটস,	হাইটস,	
cooda,	কুডা,	কোডা,	
simantarkkhibahinir,	সীমান্তরকববিহীনার,	সীমান্তরক্ষীবাহিনীর,	
panchashjan,	পঞ্চশশজন,	পঞ্চাশজন,	
unchuporjayer,	উঁচুপর্যায়ের,	উঁচুপর্যায়ের,	
purborekorde,	পূর্বরকেরদে,	পূর্বরেকর্ডে,	
suparichito,	সুপারিচিত,	সুপরিচিত,	
gabhaskaar,	গাভাসকার,	গাভাস্কার,	
diibug,	দিবুগে,	ডিবাগ,	
borlen,	বোরলেন,	বরলেন,	
minilosar,	মিনিলোসার,	মিনিলোসার,	
seguloi,	সেগুলোই,	সেগুলোই,	
huka,	হুকা,	হুক,	
hoteltite,	হোটেলটিতে,	হোটেলটিতে,	
toki,	টকি,	তকি,	
yatharthabhabe,	যঠথ্রথভাবে,	যথার্থভাবে,	
akatwa,	আকত্ব,	একাত্ব,	
faase,	ফেস,	ফাঁসে,	
paner,	পানের,	পানের,	
bulano,	বুলানো,	বুলান,	
wrighter,	ওরঘার,	রাইটের,	
fooloo,	ফুলু,	পোলো,	
cantan,	ক্যান্টান,	ক্যান্টন,	
shasankarta,	শাসনকর্তা,	শাসনকর্তা,	
bodna,	বোদনা,	বদনা,	
bodhirta,	বোধিরটা,	বধিরতা,	
sqalarashipa,	স্কললারশিপ,	স্কলারশিপ,	
samley,	সামলি,	সামলে,	
stoonahenja,	স্তফেনুঞ্জ,	স্টোনহেঞ্জ,	
jamjomat,	জামজোমাত,	জমজমাট,	
chapal,	চাপাল,	চপল,	
mahasava,	মহাসভ,	মহাসভা,	
saria,	সারিয়া,	সরিয়া,	
europia,	ইউরোপিয়া,	ইউরোপিয়া,	
koreempoor,	করিমপুর,	করিমপুর,	
nariderke,	নারীদেরকে,	নারীদেরকে,	
kuronir,	কূরণীর,	কুরনীর,	
gemske,	গেমসকে,	জেমসকে,	
podarthobidder,	পদার্থবিদ্যের,	পদার্থবিদদের,	
taunasipa,	তৌনসীপা,	টাউনশিপ,	
meghachchanno,	মেঘাচ্ছন্ন,	মেঘাচ্ছন্ন,	
karir,	কারির,	কারীর,	
meloonborroner,	মেলোবনার্নর,	মেলবোর্নের,	
laicenshe,	লইইেন্সে,	লাইসেন্স,	
uponishad,	উপনিষদ,	উপনিষদ,	
amarika,	আমারিকা,	আমেরিকা,	
obdi,	ওব্দি,	অব্দি,	
chalochchitraeeo,	চালচ্ছিত্রাও,	চলচ্চিত্রেও,	
edmeeral,	এডমিরাল,	এডমিরাল,	
kalenga,	কালেঙ্গা,	কালেঙ্গা,	
zarniz,	জার্নিজ,	জারনিজ,	
vromonkaley,	ভ্রমণকালে,	ভ্রমণকালে,	
guzober,	গুজবের,	গুজবের,	
bihar,	বিহার,	বিহার,	
gagee,	গাযাগি,	গেজ,	
khude,	খুদ়ে,	ক্ষুদে,	
ashor,	আসোর,	আসর,	
bhenus,	ভেনুস,	ভেনাস,	
poschime,	পশ্চিমে,	পশ্চিমে,	
bhenom,	ভেনোম,	ভেনম,	
shroddhabihin,	শ্রদ্ধাবিহীন,	শ্রদ্ধাবিহীন,	
sutir,	সুতির,	সুতির,	
sthaponagulo,	স্থাপনাগুলো,	স্থাপনাগুলো,	
churger,	চুরগের,	চার্জের,	
melborrone,	মেলবররোন,	মেলবোর্নে,	
maladabha,	মালাদাভা,	মলদোভা,	
manob,	মানব,	মানব,	
upacharjo,	উপাচার্য,	উপাচার্য,	
sip,	সিপ,	শিপ,	
valobase,	ভালোবাসে,	ভালোবাসে,	
dokaangulotey,	দোকানগুলোতে,	দোকানগুলোতে,	
antorvuktimulak,	আন্তর্ভূক্তিমূলক,	অন্তর্ভুক্তিমূলক,	
kathla,	কাতলা,	কাঠলা,	
ganochin,	গণচিন,	গণচীন,	
shrabasti,	শ্রবস্তি,	শ্রাবস্তী,	
protizogii,	প্রতিযোগী,	প্রতিযোগী,	
debdebyr,	দেবদীবির,	দেবদেবীর,	
trutimatra,	ত্রুতিমাত্র,	ত্রুটিমাত্র,	
obosore,	অবসরে,	অবসরে,	
cs,	সিএস,	সিএস,	
mekong,	মেকং,	মেকং,	
sudrissho,	সুদৃশ্,	সুদৃশ্য,	
tochhnochh,	তচ্নচ,	তছনছ,	
deepan,	দীপান,	দীপন,	
byepass,	ব্যাপেস,	বাইপাস,	
pulivendla,	পুলিভন্ডল,	পুলিভেন্ডলা,	
taxikeo,	ট্যাক্সিকেও,	ট্যাক্সিকেও,	
erajyobasi,	এরাজ্যবাসী,	এরাজ্যবাসী,	
azimpur,	আজিমপুরের,	আজিমপুর,	
schilling,	স্কিলিং,	শিলিং,	
jeelyaand,	জিল্যান্ড,	জিল্যান্ড,	
gazipur,	গাজিপুর,	গাজিপুর,	
bouddha,	বৌদ্ধ,	বৌদ্ধ,	
aamontrito,	আমন্ত্রিত,	আমন্ত্রিত,	
varma,	ভারমা,	ভার্মা,	
bhutbhut,	ভূতভূত,	ভুটভুট,	
chorchita,	চর্চিতা,	চর্চিত,	
neck,	নেক,	নেক,	
dala,	দালা,	দলা,	
saramukhe,	সারামুখে,	সারামুখে,	
jakso,	জক্স,	যক্ষ,	
bhittow,	ভিত্তু,	ভিত্তিও,	
oindrila,	ঐন্দ্রিলা,	ঐন্দ্রিলা,	
muchlima,	মুছলিমা,	মুছলিমা,	
teman,	টেমান,	তেমন,	
hughkey,	হুঘকে,	হিউজকে,	
shotodha,	শতধা,	শতধা,	
zohns,	জন্স,	জন্স,	
prakar,	প্রকার,	প্রকার,	
gejeted,	গেজেটেড,	গেজেটেড,	
swatantrata,	স্বাতন্ত্র্বতা,	স্বতন্ত্রতা,	
dojo,	দোজ,	ডোজো,	
providere,	প্রভীদেরে,	প্রভাইডারে,	
ardasha,	আরদাশা,	আর্দশ,	
ooipokar,	উপকার,	উইপোকার,	
cinematographar,	সিনেমোটাগ্রোফর,	সিনেমাটোগ্রাফার,	
shaddhi,	শাদ্ধি,	সাধ্বী,	
rakshanbhag,	রক্ষণভাগ,	রক্ষণভাগ,	
labonaktatar,	লবণকাতারা,	লবণাক্ততার,	
innahu,	ইন্নুহু,	ইন্নাহু,	
catholicbad,	ক্যাথোলিকবাদ,	ক্যাথলিকবাদ,	
uporitoler,	উপরিতলের,	উপরিতলের,	
khoor,	খুর,	ক্ষুর,	
engrejer,	এংগ্রেজের,	ইংরেজের,	
panchbar,	পাঁচবার,	পাঁচবার,	
kramp,	ক্রাম্প,	ক্র্যাম্প,	
chandanara,	চান্দানারা,	চন্দনারা,	
fatkabazare,	ফটকাবাজারে,	ফাটকাবাজারে,	
konagoolo,	কনাগুলো,	কণাগুলো,	
bii,	বিআইআই,	বি,	
thare,	থারে,	থরে,	
yura,	যুররা,	ইউরো,	
chalochchitro,	চালচ্ছিত্র,	চলচ্চিত্র,	
fol,	ফল,	ফল,	
teta,	টেট,	টেটা,	
horash,	হোরাশ,	হোরাস,	
iuro,	ইউরোও,	ইউরো,	
vittiteo,	ভিত্তিতেও,	ভিত্তিতেও,	
sheekar,	শীকার,	শিকার,	
touraat,	তৌরাত,	তওরাত,	
karim,	কারিম,	করিম,	
madhoboir,	মাধবইর,	মাধবীর,	
alpakichudin,	অল্পকচিছুিন,	অল্পকিছুদিন,	
mmadhukkori,	ম্যাধাক্করি,	মাধুকরী,	
distibutor,	দিস্তিবুতোর,	ডিস্টিবিউটারের,	
neemeette,	নিমিত্তে,	নিমিত্তে,	
nirbaaho,	নির্বাহ,	নির্বাহ,	
michhilti,	মিছিলটি,	মিছিলটি,	
nirbahey,	নির্বাহে,	নির্বাহে,	
venisey,	ভেনিসে,	ভেনিসে,	
chhintayikari,	ছিন্তায়িকারী,	ছিনতাইকারী,	
dreeshtiheen,	দৃষ্টিহীন,	দৃষ্টিহীন,	
sanghitar,	সঙ্ঘিতার,	সংহিতার,	
vushi,	ভুশী,	ভুষি,	
chalachchitrer,	চলচ্চিত্রের,	চলচ্চিত্রের,	
bijito,	বিজিত,	বিজিত,	
palbongsher,	পালবংশের,	পালবংশের,	
laesens,	লেসেনসস,	লাইসেন্স,	
cholocchitrer,	চলচিত্রের,	চলচ্চিত্রের,	
dipti,	দিপ্তি,	ডেপুটি,	
srisri,	শ্রীস্রি,	শ্রীশ্রী,	
gonohotyakey,	গণহত্যাকে,	গণহত্যাকে,	
dhauto,	ধৌতো,	ধৌত,	
jhumjhumita,	ঝুমঝুমিতা,	ঝুমঝুমিটা,	
siqh,	সিখ,	শিখ,	
steen,	স্তীন,	স্টেন,	
jatinke,	জাতিনকে,	যতীনকে,	
shahabike,	সাহাবীকে,	সাহাবীকে,	
russad,	রুসাদ,	রুশদ,	
talaa,	তালা,	তালা,	
anhu,	আনহু,	আনহু,	
digri,	ডিগ্রি,	ডিগ্রি,	
sheshdinti,	শেষদিনটি,	শেষদিনটি,	
bishwasho,	বিশ্বশো,	বিশ্বাসও,	
ateetkale,	অতীতকালে,	অতীতকালে,	
times,	টাইমস,	টাইমস্,	
remission,	রেমিশন,	রিমিশন,	
byabaharkarike,	ব্যবহারকারীকে,	ব্যবহারকারীকে,	
shten,	স্টেন,	স্টেন,	
akram,	আকরাম,	আকরাম,	
cholochchitrer,	চলচ্চিত্রের,	চলচ্চিত্রের,	
bhabatarini,	ভবতারিণী,	ভবতারিণী,	
vagni,	ভাগ্নি,	ভগ্নী,	
laaishenshh,	লাইসেনস্থ,	লাইসেন্স,	
tatey,	তাতেই,	তাতে,	
summer,	সামার,	সামার,	
nili,	নীলী,	নিলি,	
komanera,	কোমানেরা,	কমানেরা,	
kayech,	কয়েছ,	কায়েছ,	
nirgoon,	নির্গুণ,	নির্গুণ,	
nodimaatrik,	নদিমাত্রীক,	নদীমাতৃক,	
utpatti,	উৎপত্তি,	উতপত্তি,	
scoore,	স্কুরে,	স্কোর,	
kuldip,	কুলদিপ,	কুলদীপ,	
fake,	ফাকেক,	ফাকে,	
nischitvabe,	নিশ্চিতভাবে,	নিশ্চিতভাবে,	
prosadhoner,	প্রসাধনের,	প্রসাধনের,	
avinetar,	অভিনেতার,	অভিনেতার,	
laaishheshh,	লাইসেশ,	লাইসেন্স,	
jeher,	জেহের,	জেহের,	
langhaner,	লা্ঘনের,	লংঘনের,	
ghoor,	ঘুর,	ঘুর,	
liedtke,	লাইডটকে,	লইডটক,	
joubankal,	যৌবানকাল,	যৌবনকাল,	
varote,	ভারতে,	ভারতে,	
ponera,	পনেরা,	পনের,	
habshi,	হাবশি,	হাবশী,	
ekoirokom,	একইরকম,	একইরকম,	
granada,	গ্রানাদা,	গ্র্যানাডা,	
soommo,	সুম্মু,	সুমো,	
nagorikkey,	নাগরীককে,	নাগরিককে,	
madhuree,	মধুরী,	মাধুরী,	
kkomandar,	কোমোনার্ডার,	কমাণ্ডার,	
nirobota,	নিরববতা,	নিরবতা,	
saazano,	সাজানো,	সাজানো,	
mele,	মেলে,	মাইল,	
bhugol,	ভূগল,	ভূগোল,	
pohnpeic,	পোনপেন,	ফোনপেইক,	
prachando,	প্রাচান্ডো,	প্রচণ্ড,	
panchadadu,	পঞ্চাদাদু,	পঞ্চাদাদু,	
thakeni,	থাকেনি,	থাকেনি,	
kuthibarike,	কুথিবারীকে,	কুঠিবাড়ীকে,	
pracharanamulak,	প্রচারণমূলক,	প্রচারণামূলক,	
raunanganey,	রানাঙ্গনে,	রণাঙ্গনে,	
planea,	প্ল্যানে,	প্লেনে,	
rilayensha,	রিলায়েন্ষ,	রিলায়েন্স,	
ghurte,	ঘুরতে,	ঘুরতে,	
nutan,	নুতান,	নূতন,	
ayantarqatiqa,	অয়ন্তররটিকক,	অ্যান্টার্কটিকা,	
grambaseer,	গ্র্যামসাসীর,	গ্রামবাসীর,	
shootar,	শুতার,	শ্যুটার,	
bachai,	বাচাই,	বাছাই,	
dapadpi,	দাপদ্পি,	দাপাদপি,	
aakabar,	আকাবার,	আকাবার,	
khuizza,	খুইজ্জা,	খুইজ্জা,	
quata,	কোয়াটা,	কোটা,	
laesensh,	লেসেনস,	লাইসেন্স,	
bhoutikeshu,	ভৌতিকেশু,	ভৌতিকেষু,	
cheerontan,	চিরন্তন,	চিরন্তন,	
rabo,	রববো,	রব,	
nirgaman,	নির্গামান,	নির্গমন,	
bhittitei,	ভিত্তিতেই,	ভিত্তিতেই,	
manatmulak,	মনতমূলক,	মানতমূলক,	
phareeksa,	ফারেক্সা,	ফরেক্স,	
jolaatonko,	জলাতাঙ্কো,	জলাতঙ্ক,	
kada,	কাদা,	কোডা,	
sahozlabhbhatar,	সহজজ্লোভাতার,	সহজলভ্যতার,	
karima,	কারিমা,	করিম,	
debate,	দেবাতে,	ডিবেট,	
beauby,	বিউবি,	বিউবি,	
dantahin,	দন্তহীন,	দন্তহীন,	
baaik,	বাইক,	বাইক,	
prangulo,	প্রাণগুলো,	প্রানগুলো,	
somoibo,	সমযইব,	সমৈব,	
souripurang,	সৌরীপুরং,	সৌরিপুরং,	
khuliechilam,	খুলিয়েছিলাম,	খুলিয়েছিলাম,	
fevarite,	ফেভারিতে,	ফেভারিট,	
bishnu,	বিষ্ণু,	বিষ্ণু,	
akkaas,	আক্কাস,	আককাস,	
kanasharabheshhana,	কানারভেষণ,	কনসারভেশন,	
muradpur,	মুরাদপুরের,	মুরাদপুর,	
samajeek,	সমজাজিক,	সামাজিক,	
oitijje,	ঐতিহ্যে,	ঐতিহ্যে,	
mugdal,	মুগদাল,	মুগডাল,	
steeit,	স্টিট,	স্টেইট,	
dekaner,	দেকানের,	দেকানের,	
jaaygata,	জায়গাটা,	জায়গাটা,	
laaisheesh,	লাসিশ,	লাইসেন্স,	
proteemar,	প্রতিমার,	প্রতিমার,	
bandhubhaabaapanna,	বন্ধুভাপাপন্ন,	বন্ধুভাবাপন্ন,	
shasonamoleri,	শাসনামলেরই,	শাসনামলেরই,	
johny,	জোনি,	জনি,	
bhujangta,	ভূজাংতা,	ভুজঙ্গটা,	
shilpikuler,	শিল্পিকুলের,	শিল্পীকুলের,	
duple,	ডুপলে,	ডুপ্লে,	
charpanch,	চরপাঞ্চ,	চারপাঁচ,	
karmake,	কার্মকে,	কর্মকে,	
brail,	ব্রেইল,	ব্রেইল,	
chhuti,	ছুটি,	ছুটি,	
alpa,	আল্পা,	অল্প,	
mukhoshdharir,	মুখোষধারীর,	মুখোশধারীর,	
ghoomachhe,	ঘোমাচ্ছে,	ঘুমাচ্ছে,	
protijogi,	প্রতিযোগী,	প্রতিযোগী,	
sethai,	সেথাই,	সেথাই,	
gatibege,	গাতিবেগে,	গতিবেগে,	
upobaashee,	উপবাশী,	উপবাসী,	
sthaponagulor,	স্থাপনাগুলোর,	স্থাপনাগুলোর,	
songasthaner,	সংগ্ঠানের,	সংস্থানের,	
bisheshshyer,	বিশেষ্য্যের,	বিশেষ্যের,	
lat,	ল্যাট,	লাট,	
banshite,	বাণশীতে,	বাঁশিতে,	
daybhager,	দায়ভাগের,	দায়ভাগের,	
chheher,	ছেহের,	ছেহের,	
dep,	ডিপ,	ডেপ,	
artilary,	আর্টালারী,	আর্টিলারি,	
sportstar,	স্পোর্টস্টার,	স্পোর্টসস্টার,	
srk,	স্রেক,	শাহরুখ,	
sobche,	সবছে,	সবচে,	
somraatra,	সোমরাত্র,	সম্রাটরা,	
israelbahini,	ইস্রায়ালবাহিনি,	ইস্রায়েলবাহিনী,	
aieesha,	আইইএএ,	আইএএস,	
khonjena,	খোঁজেনা,	খোঁজেনা,	
rubidium,	রুবিডিয়াম,	রুবিডিয়াম,	
vitti,	ভিত্তি,	ভিত্তিই,	
jegulur,	যেগুলুর,	যেগুলুর,	
bhenkates,	ভেঙ্কটেস,	ভেঙ্কটেশ,	
dabliudabliui,	ডাব্লিউডাব্যুলি,	ডাব্লিউডাব্লিউই,	
rajyabhogi,	রাজ্যভোগী,	রাজ্যভোগী,	
sompadon,	সম্পাদন,	সম্পাদন,	
nothivookta,	নথিভুক্তা,	নথিভুক্ত,	
progresh,	প্রোগ্রেশ,	প্রগ্রেস,	
ala,	অলা,	আলা,	
rudrasagar,	রুদ্রসাগরের,	রুদ্রসাগরের,	
hetimganje,	হেতিমগঞ্জে,	হেতিমগঞ্জে,	
ghoorchen,	ঘোরছেন,	ঘুরেছেন,	
naitikatavodh,	নৈতিকতাবোধ,	নৈতিকতাবোধ,	
shanno,	শান্ন,	সান্নো,	
cheento,	চীন্তো,	চিনতো,	
amar,	আমার,	আমর,	
subader,	সুবাদের,	সুবাদে,	
bosonte,	বসন্তে,	বসন্তে,	
ragei,	রাগেই,	রাগেই,	
metropolitan,	মেট্রোপোলাটিন,	মেট্রোপলিটন,	
salapheeta,	সালফফিত,	সালফেট,	
asthishondhi,	অস্থিনন্ধি,	অস্থিসন্ধি,	
lagche,	লাগছে,	লাগছে,	
nirgamon,	নির্গামন,	নির্গমন,	
shommoteer,	সম্মতির,	সম্মতির,	
youth,	যৌথথ,	ইয়ুথ,	
rajotta,	রাজোত্তা,	রাজত্ব,	
torkarir,	তরকারির,	তরকারীর,	
angibhutovabe,	অঙ্গীভুতভাবে,	অঙ্গীভূতভাবে,	
jibanto,	জীবন্ত,	জীবন্ত,	
byboshthar,	বাইস্থার,	ব্যাবস্থার,	
dubaate,	দুবাতে,	ডুবাতে,	
cheentaikaree,	চিন্চাতারী,	ছিনতাইকারী,	
ujobekeestaner,	উজববেকস্তানের,	উজবেকিস্তানের,	
oncholtee,	অনচোলটি,	অঞ্চলটি,	
salsa,	সালসা,	সালসা,	
ekjoge,	একযোগে,	একযোগে,	
bolechile,	বলেছিলে,	বলেছিলে,	
promothesh,	প্রমথােস,	প্রমথেশ,	
milekhaanek,	মিলেখানাকেক,	মাইলখানেক,	
barnis,	বার্নিস,	বার্নিশ,	
khelechen,	খেলেছেন,	খেলেছেন,	
palbongser,	পালবংসের,	পালবংশের,	
site,	সীতে,	সিটে,	
bondhukey,	বন্ধুকে,	বন্ধুকে,	
paikgachha,	পাইকগাছা,	পাইকগাছা,	
sondhisthaponer,	সন্ধিস্থাপনের,	সন্ধিস্থাপনের,	
murader,	মুরাদের,	মুরাদের,	
mosharroph,	মোশারোফ,	মশাররফ,	
everestey,	ইভারসেটে,	এভারেস্টে,	
asaciates,	অসাসিয়েটস,	এসোসিয়েটস,	
sinakey,	সিনাকে,	সিনাকে,	
bishaashke,	বিষাষকে,	বিশ্বাসকে,	
protisthar,	প্রতিষ্ঠার,	প্রতিষ্ঠার,	
hugheke,	হুঘেকে,	হিউজকে,	
pariyech,	পারিয়েছ,	পরিয়েছ,	
aaeerese,	আইসারেসে,	আইরেসে,	
madrasa,	মাদ্রাসা,	মাদ্রাসা,	
bhebechili,	ভেবেছিলি,	ভেবেছিলি,	
bonvumitey,	বনভূমিতে,	বনভূমিতে,	
batikromee,	বাতিক্রমি,	ব্যতিক্রমী,	
graambashee,	গ্রামবাসী,	গ্রামবাসী,	
utotoro,	উততর,	উততর,	
mette,	মেটে,	ম্যাট,	
saqara,	সাকারা,	সাকার,	
mochlekha,	মোচলেখা,	মোছলেখা,	
karore,	কাররে,	কারোর,	
deciliter,	ডেসিলিটের,	ডেসিলিটার,	
gabhaaskar,	গাভাসককর,	গাভাস্কার,	
logotype,	লোগোটিপে,	লোগোটাইপ,	
naraphoka,	নারাফোকা,	নরফোক,	
qara,	কারা,	কর,	
fishing,	ফিশিং,	ফিসিং,	
seshardhe,	সেষার্ধে,	শেষার্ধে,	
achintyabhedaved,	অচিন্ত্যভেদেব,	অচিন্ত্যভেদাভেদ,	
pingna,	পিংগানা,	পিংনা,	
pradoshik,	প্রদোশিক,	প্রাদশিক,	
karmojog,	কর্মযোগ,	কর্মযোগ,	
uporitaley,	উপরতিলে,	উপরিতলে,	
samoshtigato,	সমষ্টিগত,	সমষ্টিগত,	
volapuk,	ভোলাপুক,	ভোলাপুক,	
munim,	মুনিম,	মুনিম,	
vittimul,	ভিত্তিমূল,	ভিত্তিমূল,	
chetanagoto,	চেতানগত,	চেতনাগত,	
nothivukta,	নথিভুক্ত,	নথিভুক্ত,	
mathieu,	মাথিউই,	ম্যাথিউ,	
moreecha,	মরিচা,	মরিচা,	
gyada,	গ্যালা,	গ্যাদা,	
fanding,	ফ্যান্ডিং,	ফান্ডিং,	
geejeeteeda,	গীজেটিডা,	গেজেটেড,	
drissogoolote,	দৃশ্যগৌলোতে,	দৃশ্যগুলোতে,	
iraner,	ইরানের,	ইরানের,	
kagbeni,	কাগবেনি,	কাগবেনি,	
vandar,	ভান্ডার,	ভাণ্ডার,	
bbosben,	বেববসেন,	বসবেন,	
gavaskar,	গাভাসকার,	গাভাস্কার,	
goteehin,	গতিহীন,	গতিহীন,	
bojata,	বোজাতা,	বোজাটা,	
bolvodro,	বলভোদ্র,	বলভদ্র,	
title,	টিটলে,	টাইটেল,	
scholars,	স্কলারস,	স্কলার্স,	
ponchashjon,	পঞ্চাশযোন,	পঞ্চাশজন,	
semai,	সেমাই,	সেমাই,	
dhos,	ধোস,	ধস,	
jaruri,	জরুরি,	জরূরী,	
nobotomo,	নবতম,	নবতম,	
dhalur,	ধালুর,	ঢালুর,	
bishhnu,	বিষ্ণু,	বিষ্ণু,	
parkin,	পারকিন,	পার্কিং,	
gore,	গোর,	গোর,	
hool,	হুল,	হুল,	
mausumer,	মাউসমের,	মৌসুমের,	
plusey,	প্লুসে,	প্লাসে,	
delibhara,	ডেলিভার,	ডেলিভার,	
duiekdiner,	দুই়কদিনের,	দুইএকদিনের,	
ashok,	আশোক,	আশোক,	
ghoomachhilo,	ঘোমাছিল,	ঘুমাচ্ছিল,	
megacaldera,	মেগাকালদারা,	মেগাক্যাল্ডেরা,	
dhrubaker,	ধ্রুবাকের,	ধ্রুবকের,	
dhanche,	ধাঁচে,	ধাঁচে,	
abhidhanick,	অভিধানিক,	অভিধানিক,	
deejeejer,	দীজীজীরের,	ডিজিজের,	
zerusaleme,	জেরুসালেমে,	জেরুসালেমে,	
grooth,	গ্রুথ,	গ্রোথ,	
pretty,	প্রেটি,	প্রিটি,	
reflex,	রিফ্লেক্স,	রিফ্লেক্স,	
olympik,	অলিম্পিক,	অলিম্পিক,	
ghotleo,	ঘটলেও,	ঘটলেও,	
ghoshito,	ঘোষিত,	ঘোষিত,	
machkabar,	মাচকাবার,	মাচকাবার,	
ajibon,	অজিবন,	আজীবন,	
srabosty,	স্র্যাবস্তি,	শ্রাবস্তী,	
rejidens,	রেজিডেন্স,	রেসিডেন্স,	
sahocorje,	সহকর্যে,	সাহচর্যে,	
byathapather,	ব্যথপথথের,	ব্যথাপথের,	
drissogulote,	দৃস্মগুলোতে,	দৃশ্যগুলোতে,	
mayily,	মেয়লি,	মাইলি,	
vabuk,	ভাবুক,	ভাবুক,	
baptics,	ব্যাপটিক্স,	ব্যাপটিকস,	
laishensh,	লইসেনস,	লাইসেন্স,	
shahjapur,	শাহজাপুর,	শাহজাপুর,	
osamanno,	ওসামান্য,	অসামান্য,	
shomser,	শমসের,	সমশের,	
sectore,	সেক্টরে,	সেক্টরে,	
boshoborty,	বশবর্তী,	বশবর্তী,	
shasheja,	শশেজা,	সসেজ,	
sqolastiq,	স্কোলাস্টিক,	স্কলাস্টিক,	
tyap,	ত্যাপ,	ট্যাপ,	
hondooras,	হন্ডুরাস,	হন্ডুরাস,	
sohinsotar,	সোহিনসতার,	সহিংসতার,	
dorgaaho,	দর্গাহ,	দরগাহ,	
bike,	বিকে,	বাইক,	
aakaabaar,	আকাবার,	আকাবার,	
evereste,	ইভারেস্টে,	এভারেস্টে,	
rajshri,	রাজশ্রী,	রাজশ্রী,	
kushakhali,	কুশখখালী,	কুশাখালি,	
zibonnogor,	জীবনযোগর,	জীবননগর,	
orbi,	ওরবি,	ওরবি,	
directorate,	ডাইরেক্টরেট,	ডিরেক্টরেট,	
pratista,	প্রতিস্তা,	প্রতিষ্টা,	
chalachchitroke,	চলচ্চিত্রকে,	চলচ্চিত্রকে,	
arsie,	আরসি,	আরসিএ,	
khoka,	খোকা,	খোকা,	
horidbar,	হরিদবার,	হরিদ্বার,	
nirmolotaa,	নির্মলতা,	নির্মলতা,	
ghumunoi,	ঘুমুনোই,	ঘুমুনোই,	
kortam,	কোতাম,	করতাম,	
madrasi,	মাদ্রাসী,	মাদ্রাজি,	
nakkal,	নককাল,	নক্কল,	
futote,	ফুটোতে,	ফুটোতে,	
paramartha,	পরমারথথ,	পরমার্থ,	
aosafur,	আওসাফুর,	আওশাফুর,	
sbajan,	স্বজান,	স্বজন,	
baipass,	বাইপাস,	বাইপাস,	
platform,	প্ল্যাটফরর্ম,	প্লাটফর্ম,	
bayii,	বাইই,	বাঈ,	
setike,	সেতিকে,	সেটিকে,	
deliver,	ডেলিভার,	ডেলিভার,	
girilal,	গিরিলাল,	গিরিলাল,	
manjushree,	মঞ্জশ্রী,	মঞ্জুশ্রী,	
motabolombira,	মতাবলম্বীরা,	মতাবলম্বীরা,	
superheiroo,	সুপারহীরও,	সুপারহিরো,	
bajhyo,	বাঝ্য,	বাহ্য,	
spredsheet,	স্প্রেডশিট,	স্প্রেডশীট,	
antarvuktimulak,	অন্তর্ভূক্তিমূলক,	অন্তর্ভুক্তিমূলক,	
liceensee,	লাইসেন্সি,	লাইসেন্স,	
sahojatprobritti,	সহযাপতার্তৃতি,	সহজাতপ্রবৃত্তি,	
chalchhe,	চালছে,	চলছে,	
chhon,	ছোন,	ছোঁ,	
durotamo,	দূরতম,	দূরতম,	
goodamjato,	গুদামজাত,	গুদামজাত,	
ongkush,	অংকুশ,	অংকুশ,	
beshyasdone,	বেশ্যাদ্দনে,	বেশ্যাসদনে,	
chhooti,	ছুটি,	ছুটি,	
paste,	পাস্টে,	পেষ্ট,	
borkhastokritora,	বরখাস্তকৃতরা,	বরখাস্তকৃতরা,	
niurolaji,	নিউরোলাজি,	নিউরোলজি,	
onkush,	ওঙ্কুশ,	অংকুশ,	
dinar,	দিনার,	ডিনার,	
arthurer,	অর্থারের,	আর্থারের,	
chilahaati,	চিলাহাটি,	চিলাহাটি,	
shasyadi,	শাস্যাদি,	শস্যাদি,	
kantojir,	কন্তজীর,	কান্তজির,	
suri,	সুরি,	সুরি,	
armshtrong,	আর্ম্্টরর্ং,	আর্মস্ট্রং,	
shansthagulo,	শাংস্থাগুলো,	সংস্থাগুলো,	
bosontoke,	বসন্তকে,	বসন্তকে,	
ameettrakkhor,	আমিত্রাক্ষর,	অমিত্রাক্ষর,	
ajuhath,	অজুহাথ,	অজুহাত,	
byabaharkaree,	ব্যবহারকারী,	ব্যবহারকারী,	
karmakarke,	কার্মারককে,	কর্মকারকে,	
dharavassokar,	ধারাভাষাকার,	ধারাভাষ্যকার,	
flux,	ফ্লাক্স,	ফ্লাস্ক,	
gandogol,	গণ্ডগোল,	গন্ডগোল,	
laiseensee,	লাইসনিস্,	লাইসেন্স,	
ajij,	অজিজ,	আজিজ,	
protisthan,	প্রতিষ্ঠান,	প্রতিষ্টান,	
qyapasula,	ক্যাপাসুলা,	ক্যাপসুল,	
manushe,	মানুষে,	মানুষে,	
rastagulikeo,	রাস্তাগুলিকেও,	রাস্তাগুলিকেও,	
ongshogrohoner,	অংশগ্রহণের,	অংশগ্রহনের,	
ujbekistaner,	উজ্বেকিস্তানের,	উজবেকিস্তানের,	
benojir,	বেনোজির,	বেনজীর,	
jamaanor,	জামানোর,	জমানোর,	
simons,	সিমোস্,	সিমন্স,	
moomtaj,	মোমতাজ,	মুমতাজ,	
jhalkanite,	ঝালকানীতে,	ঝলকানীতে,	
mukhyo,	মুখ্য,	মুখ্য,	
dhanijomite,	ধনিযোমীতে,	ধানিজমিতে,	
graambasider,	গ্রামসাসীদের,	গ্রামবাসীদের,	
jaubankal,	যৌবনকাল,	যৌবনকাল,	
jeebonnogor,	জীবনযনগর,	জীবননগর,	
shitei,	শিতেই,	শীতেই,	
gardeen,	গার্ডিন,	গার্ডেন,	
hoteltee,	হোটেলটি,	হোটেলটি,	
swastir,	স্বস্তির,	স্বস্তির,	
proshadhoner,	প্রশাধনের,	প্রসাধনের,	
sommoteer,	সম্মতির,	সম্মতির,	
mukhbondho,	মুখবন্ধ,	মুখবন্ধ,	
hisabagyan,	হিসাব্ঞান,	হিসাবজ্ঞান,	
songasthatike,	সংগ্ঠাটিকে,	সংস্থাটিকে,	
mankisundar,	মানকিসুন্দর,	মানকিসুন্দর,	
bapio,	বাপিও,	বাপিও,	
bonshi,	বনষী,	বংশী,	
saranor,	সারানোর,	সরানোর,	
heepatitis,	হিপাটিটিস,	হেপাটাইটিস,	
gandhike,	গান্ধিকে,	গান্ধীকে,	
daraider,	দরাইদের,	দরাইদের,	
difinision,	ডিফিনিশন,	ডেফিনেশন,	
bamon,	বামন,	বামন,	
porbotmala,	পর্বতমালা,	পর্বতমালা,	
dei,	দেই,	দিই,	
mosjidsoho,	মসজিদসহ,	মসজিদসহ,	
ucchosito,	উচ্চসিত,	উচ্ছসিত,	
jatinkey,	জাতিনকে,	যতীনকে,	
postay,	পোস্টে,	পোস্টে,	
nirapattamulok,	নিরাপত্তামূলক,	নিরাপত্তামূলক,	
saainyo,	সাইন্য,	সৈন্য,	
mojdur,	মজদুর,	মজদুর,	
ingrezeeteo,	ইংরেজিতেও,	ইংরেজিতেও,	
keyboarder,	কেবোর্ডের,	কীবোর্ডের,	
uponeeshod,	উপনেশদ,	উপনিষদ,	
sector,	সেক্টর,	সেক্টর,	
shikhra,	শিখরা,	শিখরা,	
loombinee,	লম্বিনি,	লুম্বিনী,	
lahano,	লাহানো,	লাহানো,	
panthar,	পান্থার,	পন্থার,	
postac,	পোস্টাক,	পোস্টকে,	
katbe,	কাতবে,	কাটবে,	
faskari,	ফসসকারী,	ফাঁসকারী,	
koyeeri,	কয়েরি,	কোয়েরি,	
venus,	ভেন্স,	ভেনাস,	
danaqana,	ডানাকানা,	ডানকান,	
khabarsoho,	খাবারসহ,	খাবারসহ,	
ramnathbabur,	রামনথথাবাবুর,	রামনাথবাবুর,	
binee,	বিনী,	বেনি,	
protyokkhovabey,	প্রত্যক্ষোভাবে,	প্রত্যক্ষভাবে,	
phuda,	ফুদা,	ফুড,	
dadar,	দাদার,	দাদার,	
anektai,	অনেকটাই,	অনেকটাই,	
hurricane,	হুযারিকানে,	হ্যারিকেন,	
muhuriganj,	মুহুরীগঞ্জ,	মুহুরীগঞ্জ,	
tantubayer,	তন্তুবায়ের,	তন্তুবায়ের,	
shasankorta,	শাসনকর্তা,	শাসনকর্তা,	
karadando,	করাদান্ডো,	কারাদণ্ড,	
nirmankarmisaha,	নির্মণকর্মীসহ,	নির্মাণকর্মীসহ,	
magar,	মাগার,	মাগার,	
aporishodhito,	অপরিশোধিত,	অপরিশোধিত,	
kompeeto,	কম্পিত,	কম্পিত,	
spashtotai,	স্পষ্টটাই,	স্পষ্টতই,	
dumaa,	দুমা,	দুমা,	
kharavel,	খারাভেল,	খারবেল,	
lyaandeeng,	ল্যানডিং,	ল্যান্ডিং,	
soorsa,	সুর্সা,	সোর্স,	
jhimochchilo,	ঝিমোছ্ছিল,	ঝিমোচ্ছিলো,	
saqara,	সাকারা,	সকার,	
windo,	উইন্ডো,	উইন্ডো,	
shatodha,	সতধা,	শতধা,	
oncoltike,	অনকলটিকে,	অঞ্চলটিকে,	
bupher,	বাফার,	বাফার,	
phutonta,	ফুটনটা,	ফুটন্ত,	
gandhariir,	গান্ধারির,	গান্ধারীর,	
ekroop,	একরুপ,	একরূপ,	
kaathhaamaandu,	কাঠামান্দু,	কাঠমান্ডু,	
bulan,	বুলান,	বুলান,	
gronthoti,	গ্রন্থটি,	গ্রন্থটি,	
kazianis,	কাজিয়ানিস,	কাজানিস,	
paripakey,	পরিপাকে,	পরিপাকে,	
azijer,	আজিজের,	আজিজের,	
madelim,	মেদেলিম,	মডেলিং,	
mukhomandoler,	মুখোমণ্ডলের,	মুখমণ্ডলের,	
avetar,	আভেতার,	অবতার,	
dormitory,	ডরমিটরি,	ডরমিটরি,	
atwabishvashi,	অত্ববিশ্বাষী,	আত্মবিশ্বাসী,	
yaq,	যাক,	ইয়াক,	
aarke,	আর্কে,	আরকে,	
suraaropeeto,	সুরারোপিত,	সুরারোপিত,	
votarer,	ভোারের,	ভোটারের,	
basab,	বাসাব,	বাসাব,	
torunderke,	তরুণদেরকে,	তরুণদেরকে,	
giitikobitar,	গীবিকিতবিতার,	গীতিকবিতার,	
bhorkendra,	ভোরকেন্দ্র,	ভরকেন্দ্র,	
sakshatkarer,	সাক্ষাতকারের,	সাক্ষাৎকারের,	
pakistanira,	পাকিস্তানিরা,	পাকিস্তানীরা,	
hozot,	হজোট,	হজত,	
mirakela,	মিরাকেলা,	মিরাকেল,	
braqe,	ব্রেক,	ব্রেক,	
langhoner,	লঙ্ঘনের,	লংঘনের,	
saamaanya,	সামান্যা,	সামান্য,	
lakshmir,	লক্ষ্মীর,	লক্ষ্মীর,	
sthapanar,	স্থাপনার,	স্থাপনার,	
chire,	চিরে,	চিরে,	
pranidero,	প্রাণীদেরও,	প্রানীদেরও,	
horippur,	হরিপপুর,	হরিপুর,	
sten,	স্টেন,	স্টেন,	
adbhanced,	অ্যাডভান্ডেড,	অ্যাডভান্সড,	
dibet,	দিবেত,	ডিবেট,	
shrabostee,	শ্রাবস্তি,	শ্রাবস্তী,	
spredasita,	স্প্রেদাসিতা,	স্প্রেডশীট,	
sangram,	সংগ্রাম,	সঙ্গ্রাম,	
codeti,	কোডেটি,	কোডটি,	
slatgulor,	স্ল্যাটগুলোর,	স্ল্যাটগুলোর,	
ashirbadatri,	আশির্বাদাত্রী,	আশীর্বাদাত্রী,	
doorotaumo,	দূরোতমৌ,	দূরতম,	
cn,	সিএইএন,	সিএন,	
kabutorer,	কাবুতরের,	কবুতরের,	
samajik,	সামাজিক,	সামাজিক,	
bonnopran,	বন্পপ্রাণ,	বন্যপ্রাণ,	
mahakabi,	মহাকাবি,	মহাকবি,	
madhnagar,	মধনগর,	মাধনগরের,	
soundorjotakei,	সৌন্দর্যটাকেই,	সৌন্দর্যটাকেই,	
bejiye,	বেজিয়ে,	বেজিয়ে,	
municipal,	মুনিসিপাল,	মিউনিসিপ্যাল,	
rajbondir,	রাজবন্দির,	রাজবন্দীর,	
spredshiit,	স্প্রেডশিয়ট,	স্প্রেডশীট,	
koordider,	কৌর্দীদের,	কুর্দিদের,	
kaande,	কাঁদে,	কাণ্ডে,	
anusvara,	অনুসভরা,	অনুস্বার,	
nottee,	নতী,	নোটটি,	
nanir,	নানীর,	নানীর,	
ivil,	ইভিল,	ইভিল,	
brekthrough,	ব্রেক্টরুঘ,	ব্রেকথ্রু,	
sarbhare,	সারভারে,	সার্ভারে,	
breq,	ব্রেক,	ব্রেক,	
atibiplabi,	অতিবিপ্লবী,	অতিবিপ্লবি,	
sukumaree,	সুকুমারী,	সুকুমারী,	
aachhis,	আছিস,	আছিস,	
chongar,	চঙ্গার,	চোঙ্গার,	
tanshree,	তাঁশ্রী,	তানশ্রী,	
grotha,	গ্রোথা,	গ্রোথ,	
sikkhokder,	শিক্ষকদের,	শিক্ষকদের,	
darji,	দার্জি,	দরজি,	
chahidapotrer,	চাহিদাপত্রের,	চাহিদাপত্রের,	
amarjito,	অমর্জিত,	অমার্জিত,	
nutaner,	নুতানের,	নূতনের,	
cholochchitraeeo,	চলচ্চিত্রাও,	চলচ্চিত্রেও,	
nirvachokder,	নির্ভাচকদের,	নির্বাচকদের,	
shhow,	শো,	শো,	
samanwitovabe,	সমানিত্ভভাবে,	সমন্বিতভাবে,	
juddhahato,	যুদ্ধাহাত,	যুদ্ধাহত,	
deil,	ডেইল,	ডেইল,	
aembed,	আম্বেড,	এম্বেড,	
eucalyptus,	ইউক্লাললাইপাস,	ইউক্যালিপ্টাস,	
robot,	রোবট,	রোবোট,	
peeth,	পিথ,	পীঠ,	
scorey,	স্কোরে,	স্কোরে,	
skirt,	স্কির্ট,	স্কার্ট,	
chokrantosoho,	চক্রান্তসহ,	চক্রান্তসহ,	
sadadyarao,	সদা্যদারাও,	সদদ্যরাও,	
aansareer,	আনসাীীর,	আনসারীর,	
obhaarbhiu,	অভারভি,	ওভারভিউ,	
lendal,	লেন্ডাল,	লেন্ডল,	
kamla,	কামলা,	কামলা,	
nirvachaker,	নির্ভাচকের,	নির্বাচকের,	
shringgo,	শৃঙ্গ,	শৃঙ্গ,	
juboke,	যুবকে,	যুবকে,	
deqe,	ডেক,	ডেকে,	
bedantodhormo,	বেদান্তধর্ম,	বেদান্তধর্ম,	
opohoron,	অপহরণ,	অপহরন,	
sollallhu,	সল্লালহল্লু,	সল্লাল্লাহু,	
reliance,	রিলিয়েন্স,	রিলায়েন্স,	
deaubande,	ডিউব্যান্ডে,	দেওবন্দে,	
bite,	বিতে,	বাইট,	
santaa,	সান্তা,	সান্তা,	
bulichev,	বুলিচেভ,	বুলিচেভ,	
plack,	প্ল্যাক,	প্ল্যাক,	
jamanataswarup,	যমনাতস্বরূপ,	জামানতস্বরূপ,	
poderthobid,	পদার্থবিদ,	পদার্থবিদ,	
drishi,	দৃশী,	দৃশ্যই,	
udbhaboni,	উদ্ভাবনী,	উদ্ভাবনী,	
lubitz,	লুবিৎজ,	লুবিৎজ,	
lesense,	লেসেন্সে,	লাইসেন্স,	
jaatti,	জাত্তি,	জাতটি,	
daakticketer,	ডাক্িকটের,	ডাকটিকিটের,	
masto,	মাস্টো,	মাস্ত,	
ernad,	এরনাড,	এরনাড,	
nirabota,	নিরাবতা,	নিরবতা,	
chaudhurider,	চৌধুরীদের,	চৌধুরীদের,	
nowel,	নোঅেল,	নভেল,	
himchi,	হিমছি,	হিমচি,	
upbasher,	উপবাশের,	উপবাসের,	
sikara,	সিকারা,	শিকার,	
kobutorer,	কবুতরের,	কবুতরের,	
shtonehenge,	স্টোনেহেঙ্গে,	স্টোনহেঞ্জ,	
haripur,	হরিপুর,	হরিপুর,	
lajik,	লাজিক,	লজিক,	
bouddho,	বৌদ্ধ,	বৌদ্ধ,	
prosadhoni,	প্রসাধনী,	প্রসাধনী,	
milayatane,	মিলায়তনে,	মিলায়তনে,	
rakhtokkharone,	রাখ্ষকথরণে,	রক্তক্ষরণে,	
iqbalke,	ইকবালকে,	ইকবালকে,	
shfingtar,	শিনিংটার,	স্ফিংটার,	
shashtra,	শশ্্র্,	শাস্ত্র,	
akhandota,	অখণ্ডতা,	অখণ্ডতা,	
valobasen,	ভালোবাসেন,	ভালোবাসেন,	
tawnship,	তাউংশীপ,	টাউনশিপ,	
hajeerhatt,	হাজীরহাট,	হাজিরহাট,	
bhiktara,	ভিক্তারা,	ভিক্টর,	
panda,	পাণ্ডা,	পান্ডে,	
toler,	টোলের,	তালের,	
matis,	মাতিস,	ম্যাটিস,	
byaboharkariyi,	ব্যবহারকারীয়,	ব্যবহারকারীই,	
marmaraa,	মারমারা,	মারমারা,	
orhan,	ওরহান,	ওরহান,	
bhenasha,	ভেনাশা,	ভেনাস,	
dong,	ডোং,	ডং,	
chinito,	চিনিত,	চিনতো,	
edaningkale,	এদানীকলকালে,	ইদানীংকালে,	
ganjana,	গঞ্জনা,	গঞ্জনা,	
abdi,	আবদদি,	অব্দি,	
sahojlovyotar,	সহজ্লোভ্যতার,	সহজলভ্যতার,	
thailand,	থাইল্্যান্ড,	থাইল্যান্ড,	
bishnoo,	বিষ্ণু,	বিষ্ণু,	
deputee,	দেপুটি,	ডেপুটি,	
tetela,	টেটেলা,	টাইটেল,	
patjata,	পাটজাতা,	পাটজাত,	
grambasheeo,	গ্রামবাসীও,	গ্রামবাসীও,	
shilpajata,	শিল্পজাত,	শিল্পজাত,	
brindabane,	বৃন্দাবানে,	বৃন্দাবনে,	
shommotite,	সম্মতিতে,	সম্মতিতে,	
rakkhanbhag,	রক্ষণভাগ,	রক্ষণভাগ,	
jaandrel,	জান্দ্রেল,	জাঁদরেল,	
nothibhukta,	নথিভুক্ত,	নথিভুক্ত,	
zerusalem,	জেরুসালেম,	জেরুসালেম,	
thailandshoho,	থাইলান্ডসহ,	থাইল্যান্ডসহ,	
kanshater,	কাশশাতের,	কানসাটের,	
kandy,	কান্দি,	ক্যান্ডি,	
phutanta,	ফুটানটা,	ফুটন্ত,	
manushsoho,	মানুষসহ,	মানুষসহ,	
alaoler,	আলাওলের,	আলাওলের,	
sachetanvabe,	সচেতনভাবে,	সচেতনভাবে,	
kormoke,	কর্মকে,	কর্মকে,	
khalidkay,	খালিদকায়,	খালিদকে,	
harbur,	হারবুর,	হারবার,	
crashlands,	ক্র্ল্যাডল্যাস্ড,	ক্র্যাশল্যান্ডস,	
reshmirekha,	রেশমিরেখা,	রেশমীরেখা,	
afzol,	আফজল,	আফজল,	
bagdad,	বাগদাদ,	বাগদাদে,	
liaodong,	লিয়াডুং,	লিয়াওদং,	
shuri,	শুরি,	সুরি,	
ramachandranke,	রামাচন্দ্রনকে,	রামাচন্দ্রনকে,	
photanor,	ফটানোর,	ফোটানোর,	
shakankti,	শাকাককটি,	শকাঙ্কটি,	
chalochchitreer,	চালচ্তিত্রীর,	চলচ্চিত্রের,	
toroonra,	তরুনরা,	তরুণরা,	
anchalgulir,	অঞ্চলগুলির,	অঞ্চলগুলির,	
pustir,	পুস্তির,	পুষ্টির,	
thechar,	থেচার,	থ্যাচার,	
gasthii,	গাস্থি,	গোষ্ঠীই,	
ghotol,	ঘটল,	ঘটল,	
bharotchilo,	ভারতছিল,	ভারতছিল,	
holding,	হোল্ডিং,	হোল্ডিং,	
dhila,	ধীলা,	ঢিলা,	
domonmulok,	দোমনমূলক,	দমনমূলক,	
monchostho,	মন্থস্থ,	মঞ্চস্থ,	
mentither,	মেন্টিথার,	মেনটিথের,	
vins,	ভিন্স,	ভিন্স,	
projanankal,	প্রজাননকাল,	প্রজননকাল,	
byaboharkarike,	ব্যবহারকারীকে,	ব্যবহারকারীকে,	
nojder,	নজদের,	নজদের,	
tigmanshu,	তিগমানশু,	তিগ্মাংশু,	
welaqama,	ওয়েলামা,	ওয়েলকাম,	
fanse,	ফেন্সে,	ফাঁসে,	
torkarite,	তরকারিতে,	তরকারিতে,	
rupantarer,	রূপান্তরের,	রুপান্তরের,	
shangkulaan,	শংকুলান,	সংকুলান,	
tapdei,	তাপদেই,	তাপড়েই,	
keyu,	কেয়ু,	কেউ,	
umedpoor,	উমেদপুর,	উমেদপুর,	
aborto,	আবর্ত,	আবর্ত,	
monzeele,	মঞ্জিলে,	মঞ্জিলে,	
mitrota,	মিত্রটা,	মিত্রতা,	
kareer,	কারীর,	কারীর,	
kram,	ক্রম,	ক্রম,	
deobonde,	দেওবন্দে,	দেওবন্দে,	
durgatsob,	দুর্গাতসব,	দুর্গোৎসব,	
calabe,	কালাবে,	চালাবে,	
poscater,	পোস্কাটের,	পশ্চাতের,	
asaktibandhan,	অসক্তিবন্ধন,	আসক্তিবন্ধন,	
kolkarkhana,	কোলকররখানা,	কলকারখানা,	
agomoney,	অগমনে,	আগমনে,	
dokan,	দোকান,	দোকান,	
mathews,	ম্যাথেউস,	ম্যাথিউস,	
titarer,	তিতারের,	তিতারের,	
sima,	সীমা,	সীমা,	
turista,	টুরিস্টা,	টুরিস্ট,	
pothon,	পথন,	পঠন,	
prity,	প্রীই,	প্রিটি,	
addata,	আদ্ডাটা,	আড্ডাটা,	
kaleo,	কালেও,	কালেও,	
dayitta,	দায়ত্বা,	দায়িত্ব,	
atarkitey,	আটারকিতে,	অতর্কিতে,	
serup,	সেরূপ,	সেরূপ,	
attacharito,	অটাচারিত,	অত্যাচারিত,	
shikara,	শিকারা,	শিকার,	
bongshokey,	বংশকে,	বংশকে,	
ghetu,	ঘেটু,	ঘেটু,	
baasaate,	বাসাতে,	বাসাতে,	
palkee,	পালকি,	পাল্কি,	
teentir,	তীনটির,	তিনটির,	
indra,	ইন্দ্রা,	ইন্দ্র,	
phokser,	ফকসের,	ফক্সের,	
mukhamandoler,	মুখামণ্ডলের,	মুখমণ্ডলের,	
awrbit,	অবরিবিত,	অরবিট,	
totokhon,	ততখখন,	ততক্ষন,	
boner,	বনের,	বনের,	
bhenicer,	ভেনিসের,	ভেনিসের,	
smarak,	স্মরক,	স্মারক,	
ansarir,	আনসারির,	আনসারীর,	
sohojlovyotar,	সহজজ্লভতার,	সহজলভ্যতার,	
karmokarke,	কার্মকারকে,	কর্মকারকে,	
kode,	কোড,	কোড,	
arthonitir,	অর্থনীতির,	অর্থনীতির,	
juktarashtrasaha,	যুক্তরত্রস্রাহ,	যুক্তরাষ্ট্রসহ,	
grauth,	গ্রাউথ,	গ্রোথ,	
kul,	কুল,	কুল,	
andra,	আন্দ্রা,	আন্ড্রা,	
hitlere,	হিটলারে,	হিটলারে,	
dheke,	ধেকে,	ঢেকে,	
kormobuddhite,	কর্মবুদ্ধিতে,	কর্মবুদ্ধিতে,	
chamski,	চামস্কি,	চমস্কি,	
pratiyogita,	প্রতিযোগিতা,	প্রতিযোগীতা,	
taranee,	তরনে,	তরণী,	
dipon,	ডিপন,	দীপন,	
pretti,	প্রেতি,	প্রিটি,	
boikalyo,	বৈকাল্য,	বৈকল্য,	
phonekari,	ফোনেকারী,	ফোনকারী,	
elakasoho,	এলাকাসহ,	এলাকাসহ,	
samyuktha,	সম্যুক্থ,	সামিউক্তা,	
rayyalati,	রাইয়ালতি,	রয়্যালটি,	
rananganey,	রণনঙ্গে,	রণাঙ্গনে,	
hastantar,	হস্তান্তর,	হস্তান্তর,	
ciima,	সিইমা,	সীমা,	
dupleks,	ডুপ্লেক্স,	ডুপ্লে,	
shhashtra,	শশ্্র্,	শাস্ত্র,	
oichchheek,	ঐচ্ছিক,	ঐচ্ছিক,	
veenis,	ভানিস,	ভেনিস,	
furio,	ফুরিও,	ফুরিও,	
manushti,	মানুষটি,	মানুষটি,	
gronthao,	গ্রন্থাও,	গ্রন্থও,	
niroja,	নিরোজা,	নিরোজা,	
kaalki,	কালকি,	কালকি,	
provur,	প্রভূর,	প্রভুর,	
krom,	ক্রম,	ক্রম,	
ekspression,	এক্সপ্রেশন,	এক্সপ্রেশন,	
safin,	সাফিন,	সাফিন,	
granthatyke,	গ্রান্থটিকে,	গ্রন্থটিকে,	
setikey,	সেতিকে,	সেটিকে,	
dharabahiktite,	ধারাবাহিকটিতে,	ধারাবাহিকটিতে,	
arekdol,	আরেকদোল,	আরেকদল,	
manibhaijaner,	মণিভাইজানের,	মণিভাইজানের,	
krusher,	ক্রুশের,	ক্রুশের,	
attorkite,	অটযাটরকিটিতে,	অতর্কিতে,	
uparjoner,	উপার্জনের,	উপার্জনের,	
ashociatesh,	অশোচিয়েশ,	এসোসিয়েটস,	
mohajote,	মহাজতে,	মহাজোট,	
remacri,	রিমেকারি,	রেমাক্রী,	
srivatsalakshanang,	শ্রীবৎসলল্ষকং,	শ্রীবৎসলক্ষণং,	
nagorikke,	নাগরিককে,	নাগরিককে,	
aziboner,	আজিবনের,	আজীবনের,	
kichutei,	কিছুতেই,	কিছুতেই,	
jakatke,	জাকাতকে,	যাকাতকে,	
generalissimo,	জেনারালালিসিমো,	জেনারেলিসিমো,	
bonbhumi,	বনভূমি,	বনভূমি,	
puding,	পুদিং,	পুডিং,	
dijijer,	দিজিজের,	ডিজিজের,	
uindos,	ইইন্ডোস,	উইন্ডোস,	
licenshe,	লাইসেন্সে,	লাইসেন্স,	
jalbe,	জলবে,	জ্বলবে,	
lyaataa,	ল্যাট,	ল্যাটা,	
maunchostho,	মৌন্চস্থ,	মঞ্চস্থ,	
porjotoker,	পর্যটকের,	পর্যটকের,	
shuperheiro,	শুপারহীরও,	সুপারহিরো,	
bajpa,	বাজপা,	বাজপা,	
upobaasee,	উপবাসী,	উপবাসী,	
oncholgulir,	অঞ্চলগুলির,	অঞ্চলগুলির,	
sikkhagata,	শিক্ষাগত,	শিক্ষাগত,	
qor,	কোর,	কর,	
sylvi,	সিলভি,	সিলভি,	
aakaabar,	আকাবার,	আকাবার,	
nopdnodir,	নপ্দনদির,	নদনদীর,	
ceramicsh,	সেরিমিক্স,	সিরামিকস,	
vogno,	ভগ্ন,	ভগ্ন,	
bhogni,	ভগ্নী,	ভগ্নী,	
icelands,	আইকাল্যান্ডস,	আইসল্যান্ডসহ,	
esoosiyetasa,	এসুসিয়েটাস,	এসোসিয়েটস,	
nirarthak,	নিরার্থক,	নিরর্থক,	
motke,	মটকে,	মতকে,	
dobhaar,	দভার,	ডোভার,	
larson,	লারসন,	লারসন,	
militarir,	মিলিটারির,	মিলিটারির,	
jothartho,	যথার্থ,	যথার্থ,	
katui,	কাতুই,	কাতুই,	
porizoner,	পরিজনের,	পরিজনের,	
phartha,	ফার্থ,	ফার্থ,	
difinisian,	ডিফিনিসিয়ান,	ডেফিনেশন,	
sharif,	শাফিফ,	শরিফ,	
bossonte,	বসন্তে,	বসন্তে,	
elaakate,	এলাকাতে,	এলাকাতে,	
beatleser,	বিটলেসের,	বিটলসের,	
firoza,	ফিরোজা,	ফিরোজা,	
vesselli,	ভেসেলি,	ভেসেলি,	
nilfamarir,	নীলফামারীর,	নীলফামারীর,	
samaveshke,	সমাভেশকে,	সমাবেশকে,	
satyaky,	সত্যাকি,	সাত্যকি,	
chereche,	চেরেছে,	ছেড়েছে,	
rohosyo,	রহস্য,	রহস্য,	
eeksapreeshana,	ইক্সপ্রেশন,	এক্সপ্রেশন,	
nirgomon,	নির্গমন,	নির্গমন,	
adhyattikota,	আধ্যাত্মিকতা,	আধ্যাত্মিকতা,	
shlok,	শ্লোক,	শ্লোক,	
abheedhaaneeck,	অভিআান্যিক,	অভিধানিক,	
sangharshik,	সংঘারশিক,	সাংঘর্ষিক,	
kadapaker,	কড়াপাকের,	কড়াপাকের,	
siddhanto,	সিদ্ধান্ত,	সিদ্ধান্তও,	
zubokder,	যুবকদের,	যুবকদের,	
rifleksa,	রিফ্লেক্স,	রিফ্লেক্স,	
atwobishvashi,	অত্ববিশ্বাসী,	আত্মবিশ্বাসী,	
ghomtaa,	ঘোমটা,	ঘোমটা,	
turisht,	টুরিষ্ট,	টুরিস্ট,	
basermick,	বেসরমিক,	বেসারমিক,	
catholicder,	ক্যাথলিকদের,	ক্যাথলিকদের,	
lokhindorer,	লোখিন্দরের,	লখিন্দরের,	
dikpal,	দিকপাল,	দিকপাল,	
caroline,	ক্যারোলিনে,	ক্যরোলিন,	
highcommissionay,	হাইকমমিনোহনা,	হাইকমিশনে,	
anyarup,	অন্যরূপ,	অন্যরূপ,	
dadapur,	দাদাপুরের,	দাদাপুর,	
elakatir,	এলাকাটির,	এলাকাটির,	
samany,	সামানি,	সামান্য,	
mirina,	মিরিনা,	মিরিনা,	
satarkokari,	সতর্ককারী,	সতর্ককারী,	
marketin,	মার্কেটিন,	মার্কেটিং,	
pachak,	পাচাক,	পাচক,	
siraju,	সিরাজু,	সিরাজু,	
nischitobhabe,	নিশ্চিতভাবে,	নিশ্চিতভাবে,	
sikkhakbrinda,	শিক্ষাকৃব্দ,	শিক্ষকবৃন্দ,	
gondogol,	গণ্ডগোল,	গন্ডগোল,	
hojurer,	হজুরের,	হজুরের,	
nagorikra,	নাগরীকরা,	নাগরিকরা,	
shudhir,	শুধীর,	শুধীর,	
poroborti,	পরবর্তী,	পরর্বতী,	
baibosthar,	বৈবস্থার,	ব্যবস্থার,	
barrageke,	ব্যারাগেকে,	ব্যারেজকে,	
shakara,	শাকারা,	সাকার,	
patininda,	পাতিনিন্দা,	পতিনিন্দ,	
siddhantei,	সিদ্ধান্তেই,	সিদ্ধান্তেই,	
ponero,	পনেরও,	পনের,	
jotharthovabey,	যথার্থভাবে,	যথার্থভাবে,	
seconder,	সেকন্ডার,	সেকেন্ডের,	
lendl,	লেন্ডল,	লেন্ডল,	
ayumi,	আয়ুমি,	আয়ুমি,	
pratijogitamulak,	প্রতিযোগীতামূলক,	প্রতিযোগীতামূলক,	
fasir,	ফাসির,	ফাসীর,	
uddhrito,	উদ্ধৃত,	উদ্ধৃত,	
krechi,	ক্রেচি,	করেছি,	
korkotkraantee,	কর্কটটরান্তি,	কর্কটক্রান্তি,	
niketaner,	নিকেটানের,	নিকেতনের,	
sarboshokteeman,	সর্বশক্তিম্যাণ,	সর্বশক্তিমান,	
ekbakke,	একবাককে,	একবাক্যে,	
shoriph,	শরফিফ,	শরিফ,	
pnouchute,	পৌঁছুতে,	পৌঁছুতে,	
dhhaloor,	ঢালুর,	ঢালুর,	
meshenjar,	মেশেঞ্জার,	মেসেঞ্জার,	
suparichiti,	সুপারিচিতি,	সুপরিচিতি,	
elahabade,	এলাহাবাদে,	এলাহাবাদে,	
romarder,	রোমারদের,	রোমারদের,	
sorano,	সরানো,	সরানো,	
moresbai,	মোরেসবাই,	মোরেসবাই,	
chowdhurir,	চৌধুরির,	চৌধুরীর,	
eenameela,	ইনামেলা,	এনামেল,	
akhandata,	অখান্দতা,	অখণ্ডতা,	
bostubad,	বস্তুবাদ,	বস্তুবাদ,	
ghumacchilo,	ঘুমাচ্ছিল,	ঘুমাচ্ছিল,	
gandharir,	গান্ধারির,	গান্ধারীর,	
masjidtir,	মসজিদটির,	মসজিদটির,	
shorifer,	শরীফের,	শরিফের,	
bheenisa,	ভীনিসা,	ভেনিস,	
nepchooner,	নেপছৌনের,	নেপচুনের,	
kampita,	কম্পিতা,	কম্পিত,	
kottar,	কোট্তার,	কট্টর,	
chakurijibirao,	চাকুরীজীবীরাও,	চাকুরীজীবীরাও,	
pleena,	প্লিনা,	প্লেন,	
probhuder,	প্রভুদের,	প্রভুদের,	
kindom,	কিন্ডম,	কিংডম,	
vogiroth,	ভোগিরথ,	ভগীরথ,	
gujob,	গুজব,	গুজব,	
aarmstrong,	আ্যাম্সট্রাং,	আর্মস্ট্রং,	
pachattar,	পাচাত্টার,	পাচাত্তার,	
kloud,	ক্লৌড,	ক্লাউড,	
dalee,	দালী,	ডালে,	
khoakshir,	খোয়াক্সির,	খোয়াক্ষীর,	
dormetori,	ডরমেটরি,	ডরমিটরি,	
veniser,	ভেনিসের,	ভেনিসের,	
fibergulote,	ফাইবারগুলোতে,	ফাইবারগুলোতে,	
ganosochetonota,	গণসচেতনতা,	গণসচেতনতা,	
seekkhokbrindo,	সীক্ষকবৃন্দ,	শিক্ষকবৃন্দ,	
doltyagi,	দল্ত্যগী,	দলত্যাগী,	
ship,	শিপ,	শিপ,	
engreziteo,	এংরেজিতেও,	ইংরেজিতেও,	
transform,	ট্রান্সফর্ম,	ট্রান্সফর্ম,	
latsaheb,	লাৎসাহেব,	লাটসাহেব,	
ponjikar,	পঞ্জিকার,	পঞ্জিকার,	
elaakaa,	এলাকা,	এলাকা,	
barbadoj,	বারবাদজ,	বার্বাডোজ,	
harishankar,	হরিশঙ্করের,	হরিশংকর,	
hijritey,	হিজরিতে,	হিজরীতে,	
shalook,	শালুক,	শালুক,	
chenza,	চেঞ্জা,	চেঞ্জ,	
bishwaashshke,	বিশ্বশ্্কে,	বিশ্বাসকে,	
lekhaksattwar,	লেখকসত্বত্বর,	লেখকসত্ত্বার,	
bisshasyi,	বিশ্বস্যি,	বিশ্বাসই,	
bizito,	বিজিত,	বিজিত,	
mohajot,	মহাজত,	মহাজোট,	
bikargrosto,	বিকারগ্রস্ত,	বিকারগ্রস্ত,	
engrezder,	এংগেরজদের,	ইংরেজদের,	
bhuushito,	ভূষিত,	ভূষিত,	
abhijitda,	অভিজিতদা,	অভিজিতদা,	
muradkey,	মুরাদকে,	মুরাদকে,	
footbalarer,	ফুটবলারের,	ফুটবলারের,	
becha,	বেচা,	বেচা,	
monur,	মনুর,	মনুর,	
prakare,	প্রকারে,	প্রকারে,	
bosontokke,	বসন্তককে,	বসন্তকে,	
akkelpure,	আক্কেলপুরে,	আক্কেলপুরে,	
kaalengaa,	কালেঙ্গা,	কালেঙ্গা,	
erythrian,	এরিথ্রিয়ান,	এরিথ্রিয়ান,	
koordira,	কোর্দিরার,	কুর্দিরা,	
polashir,	পোলাশির,	পলাশীর,	
dhormokorme,	ধর্মকর্মে,	ধর্মকর্মে,	
treend,	ট্রিন্ড,	ট্রেন্ড,	
karadandey,	কররাদন্দে,	কারাদণ্ডে,	
nabatarange,	নবতরঙ্গে,	নবতরঙ্গে,	
poriskoron,	পরিস্করণ,	পরিষ্করণ,	
bee,	বী,	বি,	
saptahokal,	সপ্তাহকাল,	সপ্তাহকাল,	
uchchotara,	উচ্চতারা,	উচ্চতর,	
masjidke,	মাসজীদকে,	মসজিদকে,	
capshule,	ক্যাপশুলে,	ক্যাপসুল,	
gandhikey,	গান্ধিকে,	গান্ধীকে,	
bipti,	বিপ্তি,	বিপ্তি,	
phiksim,	ফিকসিং,	ফিক্সিং,	
rajashri,	রাজশ্রী,	রাজশ্রী,	
dhache,	ধাচে,	ধাঁচে,	
amontronkarider,	আমন্তরনকারীদের,	আমন্ত্রণকারীদের,	
kirke,	কিরকে,	কিরকে,	
seo,	সেই,	সেও,	
transapharma,	ট্রান্সফার্মা,	ট্রান্সফর্ম,	
supparak,	সুপ্রারক,	সুপ্পারক,	
kobulennechha,	কবুলেন্েেছা,	কবুলেন্নেছা,	
aro,	আরো,	আরও,	
baugey,	বাউগে,	বাগে,	
upobasee,	উপবাসী,	উপবাসী,	
kathmandu,	কাঠমণ্ডু,	কাঠমান্ডু,	
chhayi,	ছাই,	ছাই,	
adhunikkale,	আধুনিককালে,	আধুনিককালে,	
bhaangchur,	ভাংচুর,	ভাংচুর,	
kotibondhe,	কতিবন্ধে,	কটিবন্ধে,	
barder,	বারদের,	বার্ডের,	
install,	ইনস্টল,	ইন্সটল,	
temonvabe,	তেমনভাবে,	তেমনভাবে,	
maner,	মানের,	মানে,	
shector,	শেক্টর,	সেক্টর,	
bhadaka,	ভাদাকা,	ভদকা,	
atighataner,	অতিঘাটানের,	অতিঘটনের,	
balokarak,	বালোকরক,	বলকারক,	
rajnaiteek,	রাজনৈতিক,	রাজনৈতীক,	
laagche,	লাগছে,	লাগছে,	
udyem,	উদ্যেম,	উদ্যেম,	
eekbalke,	ইববালকে,	ইকবালকে,	
ap,	এপিপি,	আপ,	
akar,	আকার,	একার,	
nisshongotake,	নিশ্ংগতকাকে,	নিঃসঙ্গতাকে,	
plaiin,	প্লাইন,	প্লেন,	
bage,	বাগে,	বাগে,	
soomita,	সুমিতা,	সুমিতা,	
stoic,	স্টোইক,	স্টোয়িক,	
aditisaha,	আদিতিসহ,	অদিতিসহ,	
nirikhe,	নিরিখে,	নিরিখ,	
ganakantha,	গণকান্থ,	গণকণ্ঠ,	
afrazuler,	আফরাজুলের,	আফরাজুলের,	
harja,	হারওজা,	হার্জ,	
horidwar,	হরিদ্বার,	হরিদ্বার,	
mitroder,	মিত্রদের,	মিত্রদের,	
daaktikit,	ডাক্কিটি,	ডাকটিকিট,	
jerusalemer,	জেরুসালেমের,	জেরুজালেমের,	
sikkharthirao,	শিক্ষার্থীরাও,	শিক্ষার্থীরাও,	
ase,	এসেইএ,	আসে,	
onshogrohoner,	অংশগ্রহণের,	অংশগ্রহনের,	
lambi,	লমম্বি,	লম্বি,	
peethey,	পিথে,	পীঠে,	
waal,	ওয়াল,	উল,	
scholastik,	স্কলাস্তিক,	স্কলাস্টিক,	
somraatder,	সম্রাটদের,	সম্রাটদের,	
sombhobonaao,	সম্ভবনাও,	সম্ভবনাও,	
heelser,	হেলসের,	হিলসের,	
elakatay,	এলাকাটায়,	এলাকাতে,	
bibadey,	বিবাদে,	বিবাদে,	
oswasteekor,	সস্বাস্তিকর,	অস্বস্তিকর,	
gandhiir,	গানধধির,	গান্ধীর,	
vange,	ভাঙ্গে,	ভাঙ্গে,	
dhhaabi,	ঢাবী,	ঢাবি,	
venuser,	ভেনুসের,	ভেনাসের,	
pratishthanik,	প্রতিষ্ঠানিক,	প্রাতিষ্ঠানিক,	
brojomohun,	ব্রজমোহন,	ব্রোজোমোহন,	
eoki,	ইওকি,	এওকি,	
rohasyer,	রোহস্যের,	রহস্যের,	
bbiswashke,	বিবিষ্বাসকে,	বিশ্বাসকে,	
abanishankar,	অবনিষণকর,	অবনিশংকর,	
dajjha,	দাঝঝা,	দাহ্য,	
prapokkey,	প্রাপকক্যে,	প্রাপককে,	
marathi,	মারাঠি,	মরাঠি,	
ruby,	রুবি,	রুবী,	
shikkharthirao,	শিক্ষার্থীরাও,	শিক্ষার্থীরাও,	
shahoshikatar,	শহশিকতার,	সাহসিকতার,	
fastara,	ফাস্তারা,	ফস্টার,	
madhobi,	মাধবী,	মাধবী,	
premoronge,	প্রেমরঙ্গে,	প্রেমরঙে,	
logic,	লজিক,	লজিক,	
somraat,	সমরাত,	সম্রাট,	
byaboharkarir,	ব্যবহারকারীর,	ব্যবহারকারীর,	
deebug,	দীবুগ,	ডিবাগ,	
chalaabi,	চালাবি,	চালাবে,	
dolphiny,	ডলফিনি,	ডলফিনি,	
arashie,	আরাশী,	আরসিএ,	
sangitanusthane,	সঙ্গীতানুষ্ঠানে,	সঙ্গীতানুষ্ঠানে,	
tarunra,	তরুণরা,	তরুণরা,	
vetrillocuism,	ভেট্রিলুকোিস,	ভেট্রিলোকুইজম,	
laishenshim,	লেইসেনশিম,	লাইসেন্সিং,	
rotheen,	রথিন,	রথীন,	
kormopontha,	কর্মপন্থা,	কর্মপন্থা,	
angshogrohon,	অংশগ্রহণ,	অংশগ্রহন,	
said,	সাইদ,	সাইদ,	
mahafezkhanar,	মহাফেঝখানার,	মহাফেজখানার,	
raiialati,	রাওয়ালাটি,	রয়্যালটি,	
baibasthaar,	বৈবস্থার,	ব্যবস্থার,	
sexperter,	সেক্সপারটার,	সেক্সপার্টের,	
elaakati,	এলাকাটি,	এলাকাটি,	
rohasyati,	রোহস্যাটি,	রহস্যটি,	
path,	প্যাথ,	পাথ,	
irish,	ইরিশ,	আইরিস,	
bidyadanke,	বিদ্যাদানকে,	বিদ্যাদানকে,	
ashamarthita,	অশমার্থিত,	অসমর্থিত,	
manobikotao,	মানবিকতাও,	মানবিকতাও,	
quartar,	কোয়ার্টারের,	কোয়ার্টার,	
nimitte,	নিমিত্তে,	নিমিত্তে,	
rakkhandurga,	রক্ষণদূর্গ,	রক্ষণদুর্গ,	
tookror,	তুকরর,	টুকরোর,	
gobeshakgon,	গবেষকগণ,	গবেষকগণ,	
sontoshpur,	সন্তোষপুর,	সন্তোষপুর,	
akpashe,	আকপাশে,	একপাশে,	
cathalic,	ক্যাথালিক,	ক্যাথলিক,	
utsahamulak,	উৎ্াহমূলক,	উৎসাহমূলক,	
choudhursoho,	চৌধুরসহ,	চৌধুরসহ,	
prothakey,	প্রথাকে,	প্রথাকে,	
feemalee,	ফিমালি,	ফিমেল,	
turbine,	টার্বইন,	টারবাইন,	
naabyota,	নব্যতা,	নাব্যতা,	
bonorajite,	বনরাজিতে,	বনরাজিতে,	
dharmee,	ধর্মী,	ধর্মী,	
konistho,	কনিষ্ঠ,	কনিষ্ঠ,	
madhabi,	মাধবী,	মাধবী,	
sachetonvabe,	সচেতনভাবে,	সচেতনভাবে,	
bosantake,	বসন্তাকে,	বসন্তকে,	
chrystal,	ক্রিস্টাল,	ক্রাইস্টাল,	
sweety,	স্বিতি,	সুইটি,	
rajbandi,	রাজবন্দি,	রাজবন্দী,	
muktijuddhojato,	মুক্তিযুদ্ধতু,	মুক্তিযুদ্ধজাত,	
hingsar,	হিংসার,	হিংসার,	
deraa,	দীরা,	ডেরা,	
turkamena,	তুর্কমেনা,	তুর্কমেন,	
musolmanera,	মুসলমানেরা,	মুসলমানেরা,	
ghotleyo,	ঘটলেও,	ঘটলেও,	
proteemake,	প্রতিমাকে,	প্রতিমাকে,	
vittio,	ভিত্তিও,	ভিত্তিও,	
janosamaj,	জনসমাজ,	জনসমাজ,	
esasiyetasa,	এসএসিয়েটাস,	এসোসিয়েটস,	
nathivookto,	নাথিভক্ত,	নথিভুক্ত,	
carlosh,	কার্লোল,	কার্লোস,	
corymb,	করিম্ব,	করিম,	
karuna,	করুনা,	করুণা,	
video,	ভিদেও,	ভিডিয়োও,	
jahangirbad,	জাহাঙ্গীরবাদ,	জাহাঙ্গীরবাদ,	
pachchi,	পাচ্ছি,	পাচ্ছি,	
mawdeel,	মাউডিল,	মডেল,	
chilona,	চিলনা,	ছিলনা,	
chittronatyokar,	চিত্রনাত্যকার,	চিত্রনাট্যকার,	
onupater,	অনুপাতের,	অনুপাতের,	
taufiq,	তাফিক,	তৌফিক,	
doula,	দৌলা,	দৌলা,	
arg,	আর্গ,	আর্গ,	
gudamjat,	গুদ্জমত,	গুদামজাত,	
sahajlabhbhotar,	সহজ্ললভ্বতার,	সহজলভ্যতার,	
vezano,	ভেজানো,	ভেজানো,	
eshiyetika,	এশিএেটিকা,	এশিয়াটিক,	
pleto,	প্লেটো,	প্লেটো,	
shardotsobei,	শার্দতসবেই,	শারদোৎসবেই,	
hazat,	হাজাত,	হজত,	
mitrer,	মিত্রের,	মিত্রের,	
kosambir,	কোসাম্বীর,	কোসাম্বীর,	
yathaarthabhaabe,	যথথ্রথথভাবে,	যথার্থভাবে,	
annimated,	অ্যানিমেটাড,	এনিমেটেড,	
hizrite,	হিজরিতে,	হিজরীতে,	
nabayug,	নবয়ুগু,	নবযুগ,	
pravritir,	প্রভৃতির,	প্রভৃতির,	
mugdha,	মুগ্ধ,	মুগ্ধ,	
johor,	জহর,	জহর,	
fostar,	ফোস্টার,	ফস্টার,	
kyatagorir,	ক্যাটাগরির,	ক্যাটাগরির,	
shommotir,	সম্মটির,	সম্মতির,	
chalachchitroi,	চলচ্চিত্রই,	চলচ্চিত্রই,	
monroe,	মনরো,	মনেরোর,	
soolke,	সুলকে,	শুল্কে,	
diniphition,	ডিনিফিশন,	ডেফিনেশন,	
mangolic,	ম্যাঙগলিক,	মাঙ্গলিক,	
firoze,	ফিরোজে,	ফিরোজ,	
norpholk,	নরফলক,	নরফোক,	
akhhunno,	অখুন্ন,	অক্ষুণ্ণ,	
shipley,	শিপলি,	শিপলে,	
eesosiyeetasa,	ইসসিয়েতিসা,	এসোসিয়েটস,	
gujab,	গুজবব,	গুজব,	
vabaponno,	ভবপান্ন,	ভাবাপন্ন,	
hepatitis,	হেপাটাটাটিস,	হেপাটাইটিস,	
tiunara,	তিউনারা,	টিউনার,	
ganonanatto,	গণনানত্ত,	গণনাট্য,	
shektore,	সেকতরে,	সেক্টরে,	
parqim,	পারকিম,	পার্কিং,	
minishtarer,	মিনিস্তারের,	মিনিস্টারের,	
rahimed,	রহিমেদ,	রহিমেদ,	
torabgonj,	তোরাবগঞ্জ,	তোরাবগঞ্জ,	
prachirer,	প্রাচীরের,	প্রাচিরের,	
armshtronj,	আর্মস্ট্রঞ্জ,	আর্মস্ট্রং,	
bujhechhila,	বুঝেছিলা,	বুঝেছিল,	
bangladesh,	বাংলাদেশ,	বঙ্গালাদেস,	
shajano,	শাজানো,	সাজানো,	
mumtaz,	মুমতাজ,	মুমতাজ,	
ipl,	আইপিএল,	আইপিএল,	
bodhirota,	বোধিরতা,	বধিরতা,	
uthe,	উঠে,	উঠে,	
mase,	মাসে,	মাসে,	
tata,	তাতা,	তাতা,	
beila,	বেইলা,	বেইলা,	
promodwara,	প্রমোদ্বারা,	প্রমদ্বারা,	
rohosyoti,	রহস্যটি,	রহস্যটি,	
zakharovar,	যাখারোভার,	জাখারোভার,	
qarqa,	কার্কা,	কার্ক,	
shoori,	শূরী,	সুরি,	
sadeep,	সাদীপ,	সদীপ,	
confliqt,	কনফ্লিক্ট,	কনফ্লিক্ট,	
haitasha,	হাইতাশা,	হাইটস,	
jemy,	জেমি,	জেমি,	
mozlis,	মজিিস,	মজলিশ,	
rachanakal,	রচনাকাল,	রচনাকাল,	
suparahiro,	সুপারাহিরও,	সুপারহিরো,	
bisheshya,	বিশেষ্য,	বিশেষ্য,	
ingreziteo,	ইংরেজিতেও,	ইংরেজিতেও,	
chal,	চাল,	চাল,	
karmasampadon,	কর্মসম্পাদন,	কর্মসম্পাদন,	
nabbata,	নব্বতা,	নাব্যতা,	
byaboharkari,	ব্যবহারকারী,	ব্যবহারকারী,	
dolu,	দোলু,	ডলু,	
priseflex,	প্রিইসেলফেক্স,	প্রাইজফ্লেক্স,	
bondi,	বন্দী,	বন্দী,	
iksaprishana,	এক্সপ্রশান,	এক্সপ্রেশন,	
tikto,	তিক্ত,	তিক্ত,	
satarkatar,	সতর্কতার,	সতর্কতার,	
songasthatir,	সংগ্ঠাটির,	সংস্থাটির,	
protiakromonei,	প্রতিয়াক্রমণেই,	প্রতিআক্রমণেই,	
naazee,	নাজে,	নাত্সি,	
ancholgoolir,	অঞ্চলগুলির,	অঞ্চলগুলির,	
klaud,	ক্লাউড,	ক্লাউড,	
ostheesandhi,	অস্থিসন্ধী,	অস্থিসন্ধি,	
urey,	উরে,	ইউরি,	
mercedes,	মার্সডেস,	মার্সেডেস,	
mandarbani,	মন্দরবানি,	মন্দারবাণী,	
durgotsabe,	দুর্গোৎসবে,	দুর্গোৎসবে,	
jones,	জোনেস,	জোন্স,	
bikromei,	বিক্রমেই,	বিক্রমেই,	
hosney,	হোসেন,	হোসনে,	
chiroharit,	চিরোহারিত,	চিরহরিৎ,	
jhijhi,	ঝিঝি,	ঝিঝি,	
remakri,	রেমাক্রি,	রেমাক্রী,	
akkhunno,	আক্ষুণ্ন,	অক্ষুণ্ণ,	
pacbar,	পাসবার,	পাঁচবার,	
sikha,	সিখা,	শিখ,	
bhejaano,	ভেজানো,	ভেজানো,	
balakarak,	বালাকরক,	বলকারক,	
abdoone,	আবদুনে,	আবদুন,	
sahab,	সাহাব,	সাহাব,	
samratder,	সম্রাদের,	সম্রাটদের,	
holdim,	হোল্ডিম,	হোল্ডিং,	
parshwer,	পারশ্বের,	পার্শ্বের,	
nibondhocheler,	নিবন্ধভেলের,	নিবন্ধছেলের,	
echhti,	এছতি,	এছটি,	
direqtareta,	ডিরেক্রেটা,	ডিরেক্টরেট,	
pratijogira,	প্রতিযোগীরা,	প্রতিযোগীরা,	
kinto,	কিন্তো,	কিনত,	
transformaarer,	ট্রান্সফর্মারের,	ট্রান্সফরমারের,	
shukraanoo,	শুক্রানো,	শুক্রানু,	
kidambi,	কিদাম্বি,	কিদম্বি,	
mag,	ম্যাগ,	এমএজি,	
uthaney,	উঠানে,	উঠানে,	
windows,	উইনডাওস,	উইন্ডোস,	
protizogiita,	প্রতিযোগিতা,	প্রতিযোগীতা,	
segulo,	সেগুলো,	সেগুলো,	
bhaandar,	ভান্দার,	ভাণ্ডার,	
tachnach,	তাচনাচ,	তছনছ,	
protishtan,	প্রতিষ্টান,	প্রতিষ্টান,	
wilderske,	উইল্ডার্সকে,	উইল্ডার্সকে,	
qaro,	কারো,	কারো,	
footballerra,	ফুটবলাররা,	ফুটবলাররা,	
choshon,	চোষণ,	চোষণ,	
monzooshree,	মঞ্জুররী,	মঞ্জুশ্রী,	
ispredseet,	ইস্প্রোডিসটট,	স্প্রেডশীট,	
alpo,	অল্পো,	অল্প,	
nothibhukto,	নথিভুক্ত,	নথিভুক্ত,	
ghamta,	ঘামটা,	ঘোমটা,	
govindarajan,	গোবিন্দরাজন,	গোবিন্দরাজন,	
metropalitana,	মেট্রোপালিটান,	মেট্রোপলিটন,	
prokalpagulo,	প্রকলপপাগুলো,	প্রকল্পগুলো,	
kuresher,	কুরেশের,	কুরেশের,	
ispredsiit,	ইস্প্রোডিসিট,	স্প্রেডশীট,	
arasie,	আরাসী,	আরসিএ,	
plato,	প্ল্যাটো,	প্লেটো,	
armeeniyana,	আর্মীনয়ন,	আর্মেনিয়ান,	
sarbhaarti,	সারভার্তি,	সার্ভারটি,	
purohitder,	পুরোহিতদের,	পুরোহিতদের,	
weenis,	উইনিস,	ভেনিস,	
colgirl,	কলগার্ল,	কলগার্ল,	
antercticker,	অ্যান্টার্টিকের,	অ্যান্টার্কটিকের,	
karpeter,	কারপেটের,	কার্পেটের,	
chaalaabi,	চালাবী,	চালাবে,	
miraqela,	মিরাকেলা,	মিরাকেল,	
chakradhare,	চক্রধারে,	চক্রধরে,	
parisankhanvid,	পরিসংখান্ষদী,	পরিসংখ্যানবিদ,	
proshtutkarok,	প্রষ্টুতকরাক,	প্রস্তুতকারক,	
kadam,	কাদম,	কদম,	
pray,	প্রয়ে,	প্রায়,	
dipankar,	দিপাঙ্কার,	দিপঙ্কর,	
amanisa,	আমানিসা,	অমানিশা,	
antorvukta,	আন্তর্ভুক্ত,	অন্তর্ভুক্ত,	
machsoho,	মাচসহ,	মাছসহ,	
rushod,	রুষোদ,	রুশদ,	
black,	ব্ল্যাক,	ব্ল্যাক,	
steena,	স্তীনা,	স্টেন,	
prothati,	প্রথাতি,	প্রথাটি,	
jamseder,	জামসেদের,	জামসেদের,	
shit,	শিট,	শীত,	
brittakarey,	বৃত্তককরেে,	বৃত্তাকারে,	
osoborno,	অসবর্ণ,	অসবর্ণ,	
duuma,	দুমা,	দুমা,	
rata,	রাতা,	রত,	
sulfatee,	সুলফতি,	সালফেট,	
khappar,	খাপ্পার,	খপ্পর,	
somabeshti,	সমাবেশ্তি,	সমাবেশটি,	
disni,	ডিসনি,	ডিজনী,	
yukeliptash,	যুলুলিক্পসা,	ইউক্যালিপ্টাস,	
daap,	ডাপ,	ড্যাপ,	
ashiatic,	আশিয়াটিক,	এশিয়াটিক,	
firozapure,	ফিরোজাপুরে,	ফিরোজাপুরে,	
kommandar,	কোম্নাদর,	কমাণ্ডার,	
ghumachchila,	ঘুমাচ্ছিলা,	ঘুমাচ্ছিল,	
nodimatrik,	নদিমাত্রিক,	নদীমাতৃক,	
torunra,	তরুণরা,	তরুণরা,	
krisenta,	ক্রিসেন্টা,	ক্রিসেন্ট,	
cholchhe,	চলছে,	চলছে,	
monzushree,	মঞ্জুশ্রী,	মঞ্জুশ্রী,	
hajirhat,	হাজিরহাট,	হাজিরহাট,	
jolrong,	জলরং,	জলরঙ,	
uzobekeestaan,	উজোবেকসিত্তান,	উজবেকিস্তান,	
lirikti,	লিরিকটি,	লিরিকটি,	
treebhuj,	ত্রিভুজ,	ত্রিভূজ,	
bopoon,	বপূন,	বপন,	
bowie,	বোউয়ে,	বওই,	
chomski,	চমস্কি,	চমস্কি,	
bahubar,	বাহুবার,	বহুবার,	
siddhantoke,	সিদ্ধান্তকে,	সিদ্ধান্তকে,	
bhimsen,	ভীমসেন,	ভীমসেন,	
arke,	আর্কে,	আরকে,	
sanghatakder,	সংঘাটকদের,	সংঘটকদের,	
nazad,	নাজাদ,	নজদ,	
modhyekar,	মধ্যেকার,	মধ্যেকার,	
porishongkhanbid,	পরিশঙ্খনবাদিির,	পরিসংখ্যানবিদ,	
mach,	মাচ,	মাছ,	
telakucha,	তেলাকুচা,	তেলাকুচা,	
ralf,	রেল্ফ,	রালফ,	
grambaaseeder,	গ্রামবাসীদের,	গ্রামবাসীদের,	
zaire,	জায়ের,	জাইরে,	
sikkhakromer,	শিক্ষাক্রমের,	শিক্ষাক্রমের,	
spenser,	স্পেন্সের,	স্পেন্সার,	
byaktikegreptar,	ব্যক্তিকুগ্রেপ্তর,	ব্যক্তিকেগ্রেপ্তার,	
jathartho,	যথার্থ,	যথার্থ,	
thandabhabe,	ঠান্ডাভাবে,	ঠাণ্ডাভাবে,	
bo,	বোবো,	বু,	
oxfordey,	অক্সফোর্ডে,	অক্সফোর্ডে,	
shilbar,	শিলবার,	সিলভার,	
cxt,	সিসসসিটি,	সিএক্সটি,	
ganosachetanata,	গনসচেতনতা,	গণসচেতনতা,	
battery,	ব্যাটারি,	ব্যাটারী,	
soundarja,	সৌন্দর্যা,	সৌর্ন্দয্য,	
basakey,	বাসাকে,	বাসাকে,	
utpotti,	উৎপত্তি,	উতপত্তি,	
patigoniter,	পাতিগণিতের,	পাটিগণিতের,	
boshoborti,	বশবর্তী,	বশবর্তী,	
bandhan,	বাঁধান,	বাঁধন,	
nathivukteer,	নাথিভুক্তির,	নথিভুক্তির,	
bitlaser,	বিটলাসের,	বিটলসের,	
desiseyer,	ডেসিসিয়ের,	ডিজিজের,	
swadhinotatukui,	স্বাধীনতাটুকুই,	স্বাধীনতাটুকুই,	
gamdan,	গামদান,	গামদান,	
bastubad,	বস্তুবাদ,	বস্তুবাদ,	
bayshorkarikarone,	বায়শেরকারীকরণে,	বেসরকারিকরণ,	
besirbhaagi,	বেসিরভাগী,	বেশিরভাগই,	
prosadhaner,	প্রসাধনের,	প্রসাধনের,	
rushad,	রুশাদ,	রুশদ,	
jonmobhumitir,	জন্মভূমির,	জন্মভূমিটির,	
naobihar,	নওবিহার,	নৌবিহার,	
nirmankaaj,	নির্মানকাজ,	নির্মাণকাজ,	
jens,	জেন্স,	জিন্স,	
batistambhatike,	বাটিস্তমভভটটিকে,	বাতিস্তম্ভটিকে,	
prottokkhovabe,	প্রত্যক্ষোাবে,	প্রত্যক্ষভাবে,	
moushum,	মৌশুম,	মৌসুম,	
hypar,	হাইপার,	হাইপার,	
proshikkhane,	প্রশিক্ষণে,	প্রশিক্ষণে,	
monir,	মনির,	মনির,	
romancha,	রোমাঞ্চ,	রোমাঞ্চ,	
lyandim,	ল্যান্ডিম,	ল্যান্ডিং,	
syfy,	সিফি,	সাইফাই,	
vodqa,	ভোডকা,	ভদকা,	
santoshpore,	সান্তোষপরে,	সন্তোষপুর,	
anchalei,	আঞ্চালেই,	অঞ্চলেই,	
sobaiderke,	সবাইদেরকে,	সবাইদেরকে,	
ishton,	ইস্তন,	স্টোন,	
morathee,	মরাঠি,	মরাঠি,	
lettere,	লেটারে,	লেটারে,	
shilpojaat,	শিল্পজাত,	শিল্পজাত,	
shomostigoto,	শমস্তিগত,	সমষ্টিগত,	
lutheerana,	লুথিরানা,	লুথেরান,	
shhikara,	শিকারা,	শিকার,	
hooldim,	হুল্ডিম,	হোল্ডিং,	
orthoneeti,	অর্থনীতি,	অর্থনীতির,	
bhogno,	ভগ্ন,	ভগ্ন,	
sthapanatir,	স্থাপনাটির,	স্থাপনাটির,	
antennal,	অ্যান্টেন্যাল,	অ্যান্টেনাল,	
gloria,	গ্লোরিয়া,	গ্লোরিয়া,	
jinsa,	জিনসা,	জিন্স,	
chirantan,	চিরনন্তন,	চিরন্তন,	
durarohini,	দুরারোহিনী,	দুরারোহিণী,	
debholopar,	দেভোলার,	ডেভলপার,	
bhalobaas,	ভালোবাস,	ভালোবাসা,	
niropekshtar,	নিরপেক্ষ্টার,	নিরপেক্ষতার,	
peterke,	পেটারকে,	পিটারকে,	
himsrot,	হিমস্রোট,	হিমস্রোত,	
gaujano,	গাজানো,	গজানো,	
moshjidke,	মশজীদদে,	মসজিদকে,	
dada,	দাদা,	দাদা,	
elakaai,	এলাকাই,	এলাকাই,	
grushko,	গ্রাষ্কো,	গ্রুশকো,	
drishyogulotey,	দৃশ্যগুলোতে,	দৃশ্যগুলোতে,	
bhageri,	ভাগেরি,	ভাগেরই,	
qredita,	ক্রেদিতা,	ক্রেডিট,	
ganoporibahon,	গণপরিবাহন,	গণপরিবহন,	
abti,	আবতি,	আবতি,	
ishter,	ইসতের,	ইস্টের,	
ikboler,	ইকবলের,	ইকবলের,	
ganohotyake,	গণহত্যাকে,	গণহত্যাকে,	
asantosh,	অসন্তোষ,	অসন্তোষ,	
dhormoprobortokder,	ধর্মপ্রবর্তকদের,	ধর্মপ্রবর্তকদের,	
bbosonto,	ব্ববসন্ত,	বসন্ত,	
chalai,	চালাই,	চালাবে,	
labonaaktotaar,	লবণণক্ততার,	লবণাক্ততার,	
torkareer,	তরকারীর,	তরকারীর,	
kaatbey,	কাটবে,	কাটবে,	
soomitrar,	সুমিত্রার,	সুমিত্রার,	
khamotagulor,	ক্ষমতাগুলোর,	ক্ষমতাগুলোর,	
naajii,	নাজিই,	নাত্সি,	
poorohitra,	পুরোহিত্র,	পুরোহিতরা,	
graminphonor,	গ্রামিনফোনর,	গ্রামীণফোনর,	
durgotshob,	দুর্গোৎশব,	দুর্গোৎসব,	
jhanjra,	ঝঞঁজরা,	ঝাঁজরা,	
dhangsantup,	ধ্বংসন্তূপ,	ধ্বংসন্তুপ,	
utsahi,	উৎসাহী,	উৎসাহী,	
hisaber,	হিসাবের,	হিসাবের,	
fongli,	ফোঙ্গলি,	ফংলি,	
dakter,	ডাক্তের,	ডাকতের,	
nirbachakder,	নির্বাচকদের,	নির্বাচকদের,	
gyandaas,	জ্ঞানদাস,	জ্ঞানদাস,	
sayatana,	সায়াতন,	শয়তান,	
si,	সিআই,	এসআই,	
sonaicha,	সোনাইচা,	সোনাইচা,	
morodeho,	মরদেহ,	মরদেহ,	
dibya,	দিব্যা,	দিব্যা,	
dembakreeti,	দেম্বাকৃতি,	ডিম্বাকৃতি,	
pronoti,	প্রণতি,	প্রণতি,	
torikher,	তরিখের,	তরিখের,	
konflict,	কনফ্লিক্ট,	কনফ্লিক্ট,	
gaichey,	গাইছে,	গাইছে,	
internship,	ইন্টারনেশিপ,	ইন্টার্নশিপ,	
sanaktakaran,	সনক্তকরণ,	সনাক্তকরণ,	
donat,	ডোনাত,	ডোনাট,	
shikkhadikkhay,	শিক্ষাদিক্ষায়,	শিক্ষাদিক্ষায়,	
ponchasjon,	পঞ্চাসজন,	পঞ্চাশজন,	
kaansaat,	কানসাট,	কানসাট,	
jothon,	যথন,	যথন,	
olympic,	অলিম্পিক,	অলিম্পিক,	
kanasarabhesana,	কানাসরভেশন,	কনসারভেশন,	
probeshkari,	প্রবেশকারী,	প্রবেশকারী,	
chikitshar,	চিকিতশার,	চিকিত্সার,	
shishu,	শিশু,	শিশু,	
eokee,	ইওকি,	এওকি,	
booroon,	বোরুন,	বোরন,	
lakkhero,	লক্ষেরও,	লক্ষেরও,	
jolbe,	জলবে,	জ্বলবে,	
deefinision,	ডিফিনিশন,	ডেফিনেশন,	
artore,	আর্তোরে,	আর্টরে,	
milton,	মিলটন,	মিলটন,	
aatto,	আট্টো,	আত্ম,	
bosben,	বসবেন,	বসবেন,	
alsaar,	আলসার,	আলসার,	
plainey,	প্লেনি,	প্লেনে,	
elaakaati,	এলাকাটি,	এলাকাটি,	
otyacharito,	অত্যাচারিত,	অত্যাচারিত,	
prakalpatike,	প্রকলপটিকে,	প্রকল্পটিকে,	
blacker,	ব্ল্যাকারের,	ব্ল্যাকের,	
aairees,	আইরেস,	আইরিস,	
kayed,	কায়েদ,	কায়েদ,	
grambaasheeo,	গ্রমমবাসীও,	গ্রামবাসীও,	
porirshoder,	পরির্ষদের,	পরির্ষদের,	
sombhobonao,	সম্ভবনাও,	সম্ভবনাও,	
sangbadmadhyame,	সংবাদমাধ্যমে,	সংবাদমাধ্যমে,	
choddo,	চদ্য,	চোদ্দো,	
daayitto,	দায়িত্ব,	দায়িত্ব,	
juakhelar,	যুয়াখেলার,	জুয়াখেলার,	
ranangane,	রণাঙ্গনে,	রণাঙ্গনে,	
palestine,	পালেস্টাইন,	প্যালেস্টাইনে,	
taronee,	তারণী,	তরণী,	
chowdhuryke,	চৌধুরীকে,	চৌধুরীকে,	
nischoy,	নিশ্চয়,	নিশ্চয়,	
vobanipur,	ভোবানীপুর,	ভবানীপুর,	
jumlalancer,	জুমলালান্সের,	জুমলাল্যান্সার,	
naabbota,	নাব্বতা,	নাব্যতা,	
babona,	বাবোনা,	বাবনা,	
thyachar,	থায়াচার,	থ্যাচার,	
asbab,	আসবাব,	আসবাব,	
toufik,	তৌফিক,	তৌফিক,	
bhushito,	ভূষিত,	ভূষিত,	
nariderke,	নারীদেরকে,	নারিদেরকে,	
faaj,	ফজ,	ফাজ,	
asommoti,	অসম্মতি,	অসম্মতি,	
khaaneker,	খানেকের,	খানেকের,	
uddhritir,	উদ্ধৃতির,	উদ্ধৃতির,	
jeebnagore,	জীবনাগরে,	জীবননগর,	
phund,	ফান্ড,	ফান্ড,	
nyeta,	ন্যাট,	ম্যাট,	
munshiji,	মুন্সিজি,	মুনশীজি,	
ikbaaler,	ইকবালের,	ইকবালের,	
ganoporibahoner,	গণপরিবাহনের,	গণপরিবহনের,	
definition,	ডিফিনিশন,	ডেফিনেশন,	
oncholeo,	অনছোলেও,	অঞ্চলেও,	
ramolino,	রামোলিনো,	রামোলিনো,	
daktikit,	ডাক্তিকিট,	ডাকটিকিট,	
kheshar,	খেসার,	খেশার,	
navaratri,	নবরতত্রী,	নবরাত্রি,	
bohudeen,	বহুদীন,	বহুদিন,	
muktilav,	মুক্তিলাভ,	মুক্তিলাভ,	
lendol,	লেন্ডোল,	লেন্ডল,	
ummool,	উম্মুল,	উম্মুল,	
shabkam,	শাবকম,	শবকাম,	
baganoto,	বাগাতত,	বাগানত,	
dhojovongo,	ধ্বজঙ্গ,	ধ্বজভঙ্গ,	
popaike,	পপাইকে,	পপাইকে,	
with,	উইথ,	ভিত,	
niemond,	নিওমান্ড,	নিমন্ড,	
fatakesto,	ফাতাকেস্তো,	ফাটাকেষ্ট,	
mojlish,	মোজলিশ,	মজলিশ,	
difinishian,	ডিফিনিশিয়ান,	ডেফিনেশন,	
orgho,	অর্ঘ,	অর্ঘ্য,	
taroni,	তারণী,	তরণী,	
fimela,	ফিমেলা,	ফিমেল,	
kash,	কাশ,	কাস,	
dwibidho,	দ্বিবিধ,	দ্বিবিধ,	
ched,	েেড,	ছেদ,	
kade,	কাদে,	কোড,	
jacksoner,	জ্যাকসনের,	জ্যাকসনের,	
khanonkaj,	খননোকাজ,	খননকাজ,	
tikta,	টিকটা,	তিক্ত,	
dagmukta,	ডামগুক্ত,	দাগমুক্ত,	
koyekbare,	কয়েকবারে,	কয়েকবারে,	
arshie,	আরশি,	আরসিএ,	
dokanei,	দোকানেই,	দোকানেই,	
basaalt,	বাসাল্ট,	ব্যাসল্ট,	
lobbytey,	লব্বেতে,	লবিতে,	
poddhotitei,	পদ্ধতিতেই,	পদ্ধতিতেই,	
kraanti,	ক্রান্টি,	ক্রান্তি,	
cbi,	সিবিআই,	সিবিআই,	
autopromotioner,	অটটপ্রমিশনের,	অটোপ্রমোশনের,	
srichoitonnodeb,	শ্রীচৈতন্ন্েব,	শ্রীচৈতন্যদেব,	
bojhey,	বোঝে,	বোঝে,	
uddhritto,	উদ্ধৃত্ব,	উদ্ধৃত,	
karmoi,	কর্মই,	কর্মই,	
shahidputra,	শহিদপুত্র,	শহীদপুত্র,	
dalnata,	দালনাটা,	ডালনাটা,	
teemothi,	তীমোথি,	টিমোথি,	
sarajibonbyapi,	সারাজীবনবায়পপী,	সারাজীবনব্যাপী,	
sobrakomer,	সব্রককমের,	সবরকমের,	
masjidti,	মসজিদটি,	মসজিদটি,	
pranibigyani,	প্রাণীবিজ্ঞানী,	প্রাণীবিজ্ঞানী,	
kale,	কালে,	কালে,	
bunot,	বুনোট,	বুনট,	
elaaka,	এলাকা,	এলাকা,	
unchiyechilo,	আঁচিয়েছিল,	উঁচিয়েছিল,	
drishyer,	দৃশ্যের,	দৃশ্যের,	
poripake,	পরিপাকে,	পরিপাকে,	
soource,	সুর্স,	সোর্স,	
shef,	শেফ,	শেফ,	
degreeo,	ডিগ্রিও,	ডিগ্রিও,	
rakkhanvag,	রক্ষণভাগ,	রক্ষণভাগ,	
ajeeboner,	আজিবনের,	আজীবনের,	
nosihote,	নসীহতে,	নসিহতে,	
simaa,	সিমা,	সীমা,	
irana,	ইরানা,	ইরান,	
satarkakari,	সতর্ককারী,	সতর্ককারী,	
hydrological,	হাইড্রোলজিক্যাল,	হাইড্রোলজিক্যাল,	
veemsen,	ভীমসেন,	ভীমসেন,	
venice,	ভেনিস,	ভেনিস,	
degree,	ডিগ্রী,	ডিগ্রি,	
besirvagei,	বেসিরভাগেই,	বেশিরভাগেই,	
kartona,	কার্তনা,	করতনা,	
ssahocorze,	স্যাহকোর্জে,	সাহচর্যে,	
majlishpur,	মজলিশপুর,	মজলিশপুর,	
baarbadoj,	বারবাদজ,	বার্বাডোজ,	
nomo,	নোমো,	নমো,	
orbit,	অরবিট,	অরবিট,	
yanqee,	যানকি,	ইয়াংকি,	
vaticaner,	ভ্যাটিকানের,	ভ্যাটিকানের,	
elakatikay,	এলাকাটিকা,	এলাকাটিকে,	
nuhas,	নুহাস,	নুহাশ,	
heerani,	হিরানী,	হিরানি,	
bapokotor,	বাপকতর,	ব্যাপকতর,	
shekarone,	শেকারণে,	সেকারণে,	
gobeshana,	গোবেশনা,	গবেষনা,	
madhuri,	মধুরী,	মাধুরী,	
dormroome,	দরমুরমুমে,	ডর্মরুমে,	
maaktoome,	মাক্মুমে,	মাকতুম,	
dinifitian,	ডিনিফিটিয়ান,	ডেফিনেশন,	
batikromi,	বাতিক্রমি,	ব্যতিক্রমী,	
kyatgarite,	ক্যাটাগারিতে,	ক্যাটগারিতে,	
jund,	জান্ড,	জুন্দ,	
ekoghore,	একঘরে,	একঘরে,	
seoul,	সেওল,	সোল,	
bhenise,	ভেনিসে,	ভেনিসে,	
mosjidtir,	মসজিদটির,	মসজিদটির,	
dosha,	দোষা,	দোসা,	
sarboporee,	সর্বপরী,	সর্বোপরী,	
tinage,	টিনেজ,	টিনেজ,	
edic,	ইডিক,	এডিক,	
karaa,	কারা,	কারো,	
antarctica,	অ্যান্টররটিকটা,	অ্যান্টার্কটিকা,	
qlauda,	ক্লাউডা,	ক্লাউড,	
ramonar,	রমমনার,	রমনার,	
phakay,	ফাকায়,	ফাকে,	
elakaasoho,	এলাকাসহ,	এলাকাসহ,	
upbrazillian,	উপব্রাজিয়ালিন,	আপব্রাজিলিয়ান,	
maila,	মাইলা,	মাইল,	
madrasake,	মাদ্রাসাকে,	মাদ্রাসাকে,	
enjineers,	ইনজিনিরস,	ইঞ্জিনিয়ার্স,	
konorup,	কনরররূপ,	কোনরূপ,	
kalakushalir,	কললকৌশলীর,	কলাকুশলীর,	
chat,	চটট,	চ্যাট,	
banglota,	বাংলোটা,	বাংলোটা,	
jokkher,	যক্ষের,	যক্ষের,	
bagicha,	বাগিছা,	বাগিচা,	
chalachchitrei,	চলচ্চিত্রেই,	চলচ্চিত্রেই,	
jyaqasana,	জ্যাকাসন,	জ্যাকসন,	
taitela,	টাইতেলা,	টাইটেল,	
hosbaleke,	হোসবালেকে,	হোসবালেকে,	
tep,	টেপ,	ট্যাপ,	
patrol,	পাটরোল,	পেট্রোল,	
gabinius,	গেবিনিয়াস,	গাবিনিআস,	
nathivookteer,	নাথিভকক্তির,	নথিভুক্তির,	
shoodhooi,	সুধৌই,	শুধুই,	
mononiitoder,	মনননিতাদের,	মনোনীতদের,	
uindoos,	উইন্ডুস,	উইন্ডোস,	
awatar,	আওয়াতার,	অবতার,	
selim,	সেলিম,	সেলিম,	
byabostho,	ব্যবস্থ,	ব্যাবস্থা,	
dombhoke,	দম্ভকে,	দম্ভকে,	
injiniyarim,	ইনজিনিয়ারিম,	ইঞ্জিনিয়ারিং,	
mukhmondole,	মুখমণ্ডলে,	মুখমণ্ডলে,	
aalaa,	আলা,	আলা,	
shrabastee,	শ্রবস্তী,	শ্রাবস্তী,	
dorgah,	দোরগা,	দরগাহ,	
dologuloo,	দলগগুলোও,	দলগুলোও,	
plak,	প্ল্যাক,	প্ল্যাক,	
aamor,	আমর,	আমর,	
dibate,	দিবাতে,	ডিবেট,	
janghu,	জাংঘু,	জঙ্ঘু,	
dharavahikbhabe,	ধারাভাহিকভাবে,	ধারাবাহিকভাবে,	
planey,	প্ল্যানি,	প্লেনে,	
prashikkhane,	প্রশিক্ষণে,	প্রশিক্ষণে,	
mozdur,	মোজদুর,	মজদুর,	
udbodhaney,	উদ্বোধনে,	উদ্বোধনে,	
medilek,	মেডিলেক,	মেডিলেক,	
madhabike,	মাধাবিকে,	মাধবীকে,	
mausumeo,	মৌসুমেও,	মৌসুমেও,	
prosadhani,	প্রসাধনী,	প্রসাধনী,	
surke,	সুরকে,	সুরকে,	
khagen,	খাগেন,	খগেন,	
satjaner,	সাতজনের,	সাতজনের,	
dhyana,	ধ্যানা,	ধ্যান,	
gandagol,	গণ্ডাগল,	গন্ডগোল,	
kormyi,	কর্মই,	কর্মই,	
fand,	ফেন্দ,	ফান্ড,	
abikaul,	অবিউকাল,	অবিকল,	
sangasthagulo,	সংস্ঠাগুলো,	সংস্থাগুলো,	
jesh,	জেশ,	জেস,	
charban,	চারবান,	চর্বন,	
darjiling,	দার্জিলিং,	দার্জিলিং,	
indrani,	ইন্দ্রানী,	ইন্দ্রাণী,	
badargaji,	বদর্গজী,	বদরগাজী,	
neermol,	নির্মল,	নির্মল,	
teennis,	তীনিস,	টেনিস,	
bosante,	বোসান্তে,	বসন্তে,	
pinogbagke,	পিনোবাগকে,	পিনগবাগকে,	
manbe,	মানবে,	মানবে,	
abdan,	আবদান,	আব্দান,	
doobate,	দুবাতে,	ডুবাতে,	
soteciety,	সোটেকিওটি,	সোসাইটিতে,	
rahshahi,	রাহশাহী,	রাহশাহী,	
byapoktor,	ব্যাপটক্তর,	ব্যাপকতর,	
hakone,	হাকোনে,	হাকোনে,	
shtona,	স্টনা,	স্টোন,	
alonkaran,	আলনকরণ,	অলঙ্করণ,	
rena,	রেনা,	রেনো,	
primoo,	প্রিমু,	প্রিমো,	
seniar,	সেনিয়ার,	সিনিয়র,	
rayyaleti,	রায়য়লেতি,	রয়্যালটি,	
bedanta,	বেদান্ত,	বেদান্ত,	
tukroke,	টুকরোকে,	টুকরোকে,	
sursur,	সুরসুর,	সুরসুর,	
detik,	দেতিক,	দেতিক,	
windos,	উইন্ডস,	উইন্ডোস,	
booponer,	বুপনের,	বপনের,	
sarder,	সার্ডের,	সরদার,	
chalochchitrei,	চালচ্চিত্রেই,	চলচ্চিত্রেই,	
byaptikaler,	ব্যাপতিকালের,	ব্যাপ্তিকালের,	
rajbandir,	রাজবন্দির,	রাজবন্দীর,	
ancholsaha,	অঞ্চলসহ,	অঞ্চলসহ,	
moshzidtike,	মশজিদটিকে,	মসজিদটিকে,	
prime,	প্রাইম,	প্রাইম,	
proshtotto,	প্রষ্টত্ত,	প্রস্ত্তত,	
sahozlabhbhotar,	সহজজ্লোভোাতার,	সহজলভ্যতার,	
shukrabab,	শুক্রবাব,	শুক্রবাব,	
megh,	মেঘ,	মেঘ,	
gronthowo,	গ্রন্থও,	গ্রন্থও,	
obharbhiu,	অভর্ি,	ওভারভিউ,	
townshhip,	টউনশিপ,	টাউনশিপ,	
shringey,	শ্রিঙ্গে,	শৃঙ্গে,	
stanahenja,	স্তননেহঞ্জ,	স্টোনহেঞ্জ,	
gara,	গারা,	গোর,	
reejideencee,	রেজিডিইন্সি,	রেসিডেন্স,	
niropekkho,	নিরপেক্ষ,	নিরপেক্ষ,	
lutherana,	লুথেরান,	লুথেরান,	
bokahoke,	বকাহকে,	বকাহকে,	
romjaner,	রোমানের,	রমযানের,	
volivoler,	ভোলিভোলের,	ভলিভলের,	
yuro,	যুয়েরো,	ইউরো,	
gaziipur,	গাজীপুর,	গাজীপুর,	
gate,	গেতে,	গ্যেটে,	
yucalyptus,	যুুক্লাইপাস্,	ইউক্যালিপ্টাস,	
nibobondhonkrito,	নিববন্ধনবৃক্ত,	নিববন্ধনকৃত,	
sadbi,	সাদবি,	সাধ্বী,	
hoondayi,	হুন্যায়ি,	হুন্দাই,	
vedanta,	ভেদান্ত,	বেদান্ত,	
samanyai,	সামন্যাই,	সামান্যই,	
vagini,	ভাগিনি,	ভগিনী,	
karmazog,	কার্মযোগ,	কর্মযোগ,	
kalkarkhana,	কলকর্খানা,	কলকারখানা,	
futonta,	ফুটনটা,	ফুটন্ত,	
achintopurer,	অচিন্তপুরের,	অচিন্তপুরের,	
saseza,	সাসেজা,	সসেজ,	
guha,	গুহা,	গোহ,	
jibnagore,	জীবনাগরে,	জীবননগর,	
konoroop,	কনোরুপ,	কোনরূপ,	
giitikobita,	গীবিকোতিবাতা,	গীতিকবিতা,	
rokkhonabekkhoner,	রক্ষণাবেষ্যণের,	রক্ষণাবেক্ষণের,	
ganokantha,	গণকান্ঠ,	গণকণ্ঠ,	
armeenian,	আর্মিনীয়,	আর্মেনিয়ান,	
aalkaatra,	আলকাত্র,	আলকাতরা,	
bagdadii,	বাগদাদী,	বাগদাদী,	
armstronz,	আর্মস্ট্রোজ,	আর্মস্ট্রং,	
duburir,	ডুবারির,	ডুবুরির,	
gunje,	গুঞ্জে,	গুঁজে,	
malinga,	মালিঙ্গা,	মালিংগা,	
scholarsip,	স্কলারসিপ,	স্কলারশিপ,	
musalmanderke,	মুসলমানদেরকে,	মুসলমানদেরকে,	
norfolk,	নরফলক,	নরফোক,	
sbaajan,	স্ববজান,	স্বজন,	
aakik,	আকিক,	আকিক,	
dharabahikbhabe,	ধারাবাহিকভাবে,	ধারাবাহিকভাবে,	
sponsorshipe,	স্পন্সরশিপে,	স্পন্সরশীপে,	
naneer,	নানীর,	নানীর,	
aranyani,	অরণ্যনী,	অরণ্যানী,	
cloring,	ক্লরিং,	ক্লোরিং,	
somosto,	সমস্ত,	সমস্ত,	
mukhomondoler,	মুখমন্ডলের,	মুখমণ্ডলের,	
dhaleshwari,	ধলেে্বরী,	ধলেশ্বরী,	
charukala,	চরুকালা,	চারুকলা,	
dibi,	দিবি,	দিবি,	
qanasarabheshana,	কানাসরভেশন,	কনসারভেশন,	
mooney,	মুনে,	মুনে,	
aflatoxin,	আললাটক্সিন,	আ্যফ্ল্যাটক্সিন,	
spredashita,	স্প্রেদাশিতা,	স্প্রেডশীট,	
hyaloyin,	হ্যালোয়িন,	হ্যালোইন,	
hames,	হেমেস,	হোমস,	
totokson,	টটকস্যন,	ততক্ষন,	
raia,	রাইয়া,	রায়,	
sobchey,	সবচে,	সবচে,	
meghacchonno,	মেঘাচক্ন,	মেঘাচ্ছন্ন,	
gotihin,	গতিহীন,	গতিহীন,	
konnoder,	কন্যদের,	কন্যদের,	
bolatkar,	বলাটকর,	বলাৎকার,	
breqathru,	ব্রেকাটরু,	ব্রেকথ্রু,	
heze,	হেজে,	হেজ,	
oblivion,	অব্লাভিন,	অবলিভিয়ন,	
jubokti,	যুবক্তি,	যুবকটি,	
booksar,	বুকসার,	বুক্সার,	
hosto,	হস্তো,	হস্ত,	
mukhomandaley,	মুখোমণ্ডলে,	মুখমণ্ডলে,	
vobobibhuti,	ভববিভূতি,	ভববিভূতি,	
rupert,	রাপার্ট,	রুপার্ট,	
pathkrom,	পাঠক্রম,	পাঠক্রম,	
neemeetto,	নীমেত্ত,	নিমিত্ত,	
jonosomaj,	জনসমাজ,	জনসমাজ,	
barack,	বারাক,	বারাক,	
moushumei,	মৌশুমেই,	মৌসুমেই,	
themeke,	থেমেকে,	থিমকে,	
suparharo,	সুপারহারও,	সুপারহিরো,	
soleel,	সোলিল,	সলিল,	
bonvumi,	বনভূমি,	বনভূমি,	
sokkhomotabriddhi,	সক্ষমতাবৃদ্ধি,	সক্ষমতাবৃদ্ধি,	
udbodhani,	উদ্বোধনী,	উদ্বোধনী,	
dweepgoolotey,	দ্বীপগুলোতে,	দ্বীপগুলোতে,	
bhabaaponno,	ভাবপন্ন,	ভাবাপন্ন,	
onucheeder,	অনুচীদের,	অনুচ্ছেদের,	
sheets,	শীটস,	শীটস,	
dhyanastha,	ধ্যানাস্থ,	ধ্যানস্থ,	
ghomta,	ঘোমটা,	ঘোমটা,	
salmanul,	সালমানুল,	সালমানুল,	
jyesttha,	জ্যেষ্ঠা,	জ্যেষ্ঠা,	
jiland,	জিল্যান্ড,	জিল্যান্ড,	
punorabortonte,	পুনরাবর্তনন্তে,	পুনরাবর্তন্তে,	
nobotom,	নবতম,	নবতম,	
ovarview,	ওভারভিউ,	ওভারভিউ,	
flirt,	ফ্লার্ট,	ফ্লার্ট,	
transhapharma,	ট্র্ন্সফর্মা,	ট্রান্সফর্ম,	
sanaktokaran,	সনক্তকরণ,	সনাক্তকরণ,	
orthobochorke,	অর্থবছরকে,	অর্থবছরকে,	
dholeshwari,	ধোলেশ্বরী,	ধলেশ্বরী,	
scholastic,	স্কলোস্টিক,	স্কলাস্টিক,	
modyer,	মদ্যের,	মদ্যের,	
shpredshiit,	স্প্রেডশিয়িট,	স্প্রেডশীট,	
shilver,	শিলভার,	সিলভার,	
jwar,	জ্বর,	জ্বর,	
protijogii,	প্রতিযোগী,	প্রতিযোগী,	
asiatic,	এসিয়াটিক,	এশিয়াটিক,	
kachhakaachhi,	কাচাকাছি,	কাছাকাছি,	
brookoleen,	ব্রুকললিন,	ব্রুকলিন,	
gaandaas,	গান্দাস,	জ্ঞানদাস,	
boiporiityen,	বৈপরিত্যেন,	বৈপরীত্যেন,	
difinishion,	ডিফিনিশন,	ডেফিনেশন,	
bhramarotsab,	ভ্রামোতরসব,	ভ্রমরোৎসব,	
aholya,	আহল্যা,	অহল্যা,	
keui,	কেউই,	কেউই,	
rajtontro,	রাজতন্ত্র,	রাজতন্ত্র,	
parq,	পার্ক,	পার্ক,	
hooq,	হুক,	হুক,	
sheetke,	শীতকে,	শীতকে,	
alexanderke,	আলেক্সান্ডারকে,	আলেকজান্ডারকে,	
emerjency,	ইমেরজেন্কি,	এমার্জেন্সি,	
cuti,	কিউটি,	কিউটি,	
laps,	ল্যাপস,	ল্যাপস,	
chanoo,	চানু,	চানু,	
peshto,	পেষ্টো,	পেষ্ট,	
shekender,	সেকেন্দের,	সেকেন্ডের,	
bharpur,	ভারপুর,	ভরপুর,	
byabosthar,	ব্যবস্থার,	ব্যাবস্থার,	
habathu,	হাবাথু,	হাবাথু,	
whole,	হোল,	হোল,	
jonee,	জনী,	জনি,	
grambaashi,	গ্রামবাসী,	গ্রামবাসী,	
sambhabonao,	সম্ভাবনাও,	সম্ভবনাও,	
munsi,	মুন্সি,	মুন্সী,	
bitertrate,	বিটেরট্রেট,	বাইটারট্রেট,	
safiha,	সাফিহা,	সাফিহা,	
hamburgey,	হ্যামবার্গে,	হামবুর্গে,	
vushito,	ভুষিত,	ভূষিত,	
chapchap,	চাপচাপ,	চাপচাপ,	
harees,	হ্যারিস,	হ্যারিস,	
bisnukey,	বিস্নুকে,	বিষ্ণুকে,	
turkii,	টুর্কি,	তুর্কি,	
odeb,	ওদেব,	ওদেব,	
vool,	ভুল,	উল,	
ekghore,	একঘরে,	একঘরে,	
vugorvey,	ভূগর্ভে,	ভূগর্ভে,	
shhepha,	সেফা,	শেফ,	
tigmanshu,	তিগমানশু,	তিগমংশু,	
lutharen,	লুথারেন,	লুথেরান,	
tasminer,	তাসমিনের,	তাসমিনের,	
kodorer,	কদরের,	কদরের,	
licencedhari,	লাইসেন্দধারী,	লাইসেন্সধারী,	
freelancerra,	ফ্রিলেন্সরার,	ফ্রিল্যান্সাররা,	
tistar,	তিস্টার,	তিস্তার,	
prokolpow,	প্রকল্প,	প্রকল্পও,	
folleni,	ফলেনি,	ফলেনি,	
ronangane,	রোনাঙ্গনে,	রণাঙ্গনে,	
lampot,	ল্যাম্পট,	লম্পট,	
relance,	রিল্যান্স,	রিলায়েন্স,	
jontropatigulite,	যন্ত্রপাতিগুলিতে,	যন্ত্রপাতিগুলিতে,	
wishnu,	উইষ্ণু,	বিষ্ণু,	
judge,	যুদগে,	জাজ,	
hepatetisa,	হেপাটেটিসা,	হেপাটাইটিস,	
freekeh,	ফ্রীকেহ,	ফ্রিকেহ,	
bhimsenkei,	ভীমসেনকেই,	ভীমসেনকেই,	
pharmesigulote,	ফার্মেসিগুলোতে,	ফার্মেসীগুলোতে,	
pathanatak,	পাঠানাটক,	পথনাটক,	
naazi,	নাজি,	নাত্সি,	
orthanitike,	অর্থানীটিকে,	অর্থনীতিকে,	
boikolyo,	বৈকল্য,	বৈকল্য,	
paab,	পাব,	পাব,	
creshcent,	ক্রেশসেন্ট,	ক্রিসেন্ট,	
bidhirnityang,	বিধির্নিত্যং,	বিধির্নিত্যং,	
madhoori,	মধরুরি,	মাধুরী,	
parijaner,	পারিজনের,	পরিজনের,	
mahbunur,	মাহবুনুর,	মাহবুনুর,	
teksuser,	টেকসুসের,	টেক্সাসের,	
habsi,	হাবসি,	হাবশী,	
harasta,	হারাস্তা,	হারাস্তা,	
poschimey,	পশ্চিমে,	পশ্চিমে,	
jeshh,	যেশ,	জেস,	
maadla,	মাডল,	মাদলা,	
shamijir,	সামিজীর,	স্বামীজীর,	
kaathhmaandute,	কাঠমন্্ডুতে,	কাঠমান্ডুতে,	
poriharsoho,	পরিহারসহ,	পরিহারসহ,	
bboponer,	ব্বপ্নের,	বপনের,	
plasse,	প্ল্যাসে,	প্লাসে,	
oxforde,	অক্সফোর্ডে,	অক্সফোর্ডে,	
phood,	ফুড,	ফুড,	
kuttake,	কুট্টাকে,	কুত্তাকে,	
dharavahiker,	ধারাভাহিকের,	ধারাবাহিকের,	
myat,	ম্যাট্,	ম্যাট,	
danab,	ডানাব,	দানব,	
shatoke,	শতকে,	শতকে,	
drishyogulote,	দৃশ্যগুলোতে,	দৃশ্যগুলোতে,	
sqalastiqa,	স্কলালটিকা,	স্কলাস্টিক,	
utshahomulok,	উত্যাহলমূলক,	উৎসাহমূলক,	
rashedul,	রাশেদুল,	রাশিদুল,	
anubhutimalar,	অনুভূতিমালার,	অনুভূতিমালার,	
kaale,	কালে,	কালে,	
narbur,	নারবুর,	নরবুর,	
salmaner,	সালম্যানের,	সালমানের,	
atmira,	আতমীরা,	আত্মীরা,	
hattey,	হ্যাটে,	হাঁটতে,	
langhangulir,	লাংহাঙ্গুলির,	লঙ্ঘনগুলির,	
osamarik,	ওসামারিক,	অসামরিক,	
neutrinoo,	নিউট্রিনো,	নিউট্রিনো,	
lettar,	লেত্তার,	লেটার,	
phormat,	ফরমাত,	ফরম্যাট,	
sures,	সুরেস,	সুরেশ,	
mokhmoley,	মখমালে,	মখমলে,	
rinattak,	ঋণত্মক,	ঋনাত্মক,	
rakhtokkharoner,	রাখ্ষকথরণের,	রক্তক্ষরণের,	
lisense,	লাসেন্সে,	লাইসেন্স,	
niharkantibabu,	নিহারকন্তিবাবু,	নিহারকান্তিবাবু,	
shnaipara,	স্নাইপারা,	স্নাইপার,	
songbadmadhyomer,	সংবাদমাধ্যমের,	সংবাদমাধ্যমের,	
ahong,	আহং,	অহং,	
ekbakye,	একবাক্যে,	একবাক্যে,	
majdur,	মাজদুর,	মজদুর,	
brekethru,	ব্রেকেট্রু,	ব্রেকথ্রু,	
surakarder,	সুরাকরদের,	সুরকারদের,	
gajano,	গাজানো,	গজানো,	
gajetted,	গেজেটেড,	গেজেটেড,	
podotyagsongkranto,	পদত্যাসংগ্রান্ত,	পদত্যাগসংক্রান্ত,	
canflikt,	ক্যানফিলিক্ট,	কনফ্লিক্ট,	
falasrutite,	ফলাস্রুটিতে,	ফলশ্রুতিতে,	
bujhtepari,	বুঝতেপারি,	বুঝতেপারি,	
agora,	আগোরা,	আগোরা,	
abarte,	আবার্তে,	আবর্তে,	
chadake,	চাদাকে,	চড়াকে,	
ghatleo,	ঘাটলেও,	ঘটলেও,	
mesenjarer,	মেসেনজারের,	মেসেঞ্জারের,	
shikshakbrindo,	শিক্ষাকবৃন্দ,	শিক্ষকবৃন্দ,	
gurmukh,	গুরমুখ,	গুরমুখ,	
digreeke,	ডিগ্রীকে,	ডিগ্রিকে,	
stander,	স্ট্যান্ডার,	স্ট্যাণ্ডের,	
bajite,	বাজিতে,	বাজিতে,	
ahalya,	অহল্যা,	অহল্যা,	
ghurechen,	ঘুরেছেন,	ঘুরেছেন,	
thailandsaho,	থাইলান্ডসহ,	থাইল্যান্ডসহ,	
sushposhtolikhito,	সুষ্পত্লশিল্িত,	সুষ্পষ্টলিখিত,	
romantik,	রোমান্তিক,	রোমান্টিক,	
shasonkarta,	শাসনকারটা,	শাসনকর্তা,	
jotsna,	জৎস্না,	জ্যোৎস্না,	
abheedhaneek,	অভিধানিক,	অভিধানিক,	
ardasho,	আরদাশো,	আর্দশ,	
jaunotar,	যৌনতার,	যৌনতার,	
durtomo,	দূর্তম,	দূরতম,	
chalachchitra,	চলচ্চিত্র,	চলচ্চিত্র,	
raghubar,	রঘুবার,	রঘুবীর,	
vaisoho,	ভাইসহ,	ভাইসহ,	
trabuco,	ট্র্যাবুকো,	ট্র্যাবুকো,	
templet,	টেম্পলেট,	টেম্পলেট,	
redcrosser,	রেড্রকেসের,	রেডক্রসের,	
elakayi,	এলাকাই,	এলাকাই,	
thaanobhi,	থানভভি,	থানভী,	
shikh,	শিখ,	শিখ,	
deh,	দেহ,	দেহ্,	
pratiyogitar,	প্রতিযোগিতার,	প্রতিযোগীতার,	
soceitytey,	সকিটটেই,	সোসাইটিতে,	
nagorikra,	নাগরীকরা,	নাগরিকেরা,	
nodnodeer,	নদনীদীর,	নদনদীর,	
byke,	বাইকে,	বাইক,	
suiti,	সুইটি,	সুইটি,	
poripakey,	পরিপাকে,	পরিপাকে,	
sardar,	সারদার,	সরদার,	
jansa,	জানসা,	জন্স,	
amorendro,	অমোরেন্দ্র,	অমরেন্দ্র,	
probolshoktio,	প্রবলশক্তিও,	প্রবলশক্তিও,	
indrakanan,	ইন্দ্রকানান,	ইন্দ্রকানন,	
korimpur,	করিমপুর,	করিমপুর,	
bishasey,	বিষাসে,	বিশ্বাসে,	
myari,	ম্যারি,	ম্যারি,	
sahittopritite,	সাহিত্যপ্রীতিতে,	সাহিত্যপ্রীতিতে,	
skolarsip,	স্কোলারলিপ,	স্কলারশিপ,	
shourshe,	সূর্ষে,	সোর্স,	
bhabaponno,	ভাবপন্ন,	ভাবাপন্ন,	
joones,	যোনস,	জোন্স,	
america,	আমেরিকা,	আমেরিকা,	
nirikh,	নিরিখ,	নিরিখ,	
protibedokrao,	প্রতিবেদকরাও,	প্রতিবেদকরাও,	
shunani,	শুনানি,	শুনানী,	
parka,	পারকা,	পার্ক,	
narsaari,	নার্ারি,	নার্সারি,	
esprito,	এসপ্রিত,	এস্পিরিটো,	
somonwitobhabey,	সমন্বিভতাবে,	সমন্বিতভাবে,	
paira,	পাইরা,	পাইরা,	
ancholgoolote,	অঞ্চলগুলোতে,	অঞ্চলগুলোতে,	
sangosrobomukto,	সংস্রববুমুক্ত,	সংস্রবমুক্ত,	
byatikrami,	ব্যতিক্রমি,	ব্যতিক্রমী,	
dorun,	দরুন,	দরুণ,	
shikshakbrinda,	শিক্ষকবৃন্দ,	শিক্ষকবৃন্দ,	
chaaktir,	চাক্ির,	চাকতির,	
koruna,	কোরুনা,	করুণা,	
gosthike,	গোষ্ঠীকে,	গোষ্ঠীকে,	
kruser,	ক্রুসের,	ক্রুশের,	
kogake,	কোগাকে,	কোগাকে,	
hood,	হুড,	হুড,	
samle,	সামলে,	সামলে,	
bandra,	বন্দ্রা,	বন্দীরা,	
commissionvogider,	কমিমনভোগীদের,	কমিশনভোগীদের,	
aaps,	এপিএস,	এএপিএস,	
wedanta,	ওয়ান্টা,	বেদান্ত,	
rajan,	রাজান,	রাজন,	
infarmatian,	ইনফারমমিিয়ান,	ইনফরমেশন,	
mulbhitti,	মূলভিত্তি,	মূলভিত্তি,	
poste,	পস্তে,	পোষ্টে,	
debdebier,	দেবদেবিয়ের,	দেবদেবীর,	
graambaashee,	গ্রামবাশী,	গ্রামবাসী,	
nothiboddho,	নথিবদ্ধ,	নথিবদ্ধ,	
ajijer,	অজিজের,	আজিজের,	
fiksing,	ফিকসিং,	ফিক্সিং,	
alraji,	আলরাজি,	আলরাজী,	
pleta,	প্লেট,	প্লেটো,	
bijepi,	বিজেপি,	বিজেপি,	
saarbharti,	সারভর্তি,	সার্ভারটি,	
jamkaalo,	জামকালো,	জমকালো,	
ukeliptas,	উকেলেপ্তাস,	ইউক্যালিপ্টাস,	
lyaanding,	ল্যানডিং,	ল্যান্ডিং,	
nick,	নিক,	নিক্,	
jipiusamriddha,	জিপিসমুদ্দ্ধ,	জিপিউসমৃদ্ধ,	
peerry,	পিররি,	পেরি,	
karu,	কারু,	কারু,	
sofie,	সফিয়,	সোফি,	
swajan,	স্বজন,	স্বজন,	
shoreefpur,	শরিফপুর,	শরিফপুর,	
istoone,	ইস্তুনে,	স্টোন,	
rashider,	রশিদের,	রশিদের,	
jorury,	জরুরি,	জরূরী,	
prokar,	প্রকার,	প্রকার,	
ruptan,	রাপতান,	রূপটান,	
noiteekotar,	নৈতিকতার,	নৈতিকতার,	
ghatiti,	ঘাটিটি,	ঘাঁটিটি,	
grootha,	গ্রুথা,	গ্রোথ,	
spreedashita,	স্প্রীদাশিত,	স্প্রেডশীট,	
byatari,	ব্যাতারি,	ব্যাটারী,	
beem,	বিম,	বিম,	
sommotitey,	সম্মতিতে,	সম্মতিতে,	
ooipoka,	ওইপকা,	উইপোকা,	
smarok,	স্মারক,	স্মারক,	
dephinishion,	ডেফিনিশন,	ডেফিনেশন,	
omeettrakkhor,	অমিত্রাক্ষর,	অমিত্রাক্ষর,	
rajtantro,	রাজতান্ত্র,	রাজতন্ত্র,	
hansasya,	হাসসস্য,	হংসস্য,	
peeri,	পীরী,	পেরি,	
beam,	বিম,	বিম,	
poscime,	পস্চিমে,	পশ্চিমে,	
dankaan,	ডানকান,	ডানকান,	
tukroti,	তুক্রটি,	টুকরোটি,	
zozyota,	জোজ্যতা,	যোজ্যতা,	
feroza,	ফেরোজা,	ফিরোজা,	
eshtoniya,	এস্তনীয়,	এস্তোনিয়া,	
chopal,	চোপাল,	চপল,	
chhutir,	ছুটির,	ছুটির,	
katateo,	কটটাতেও,	কাটাতেও,	
firti,	ফিরটি,	ফিরতি,	
average,	এভারেজ,	এভারেজ,	
bolbo,	বলবো,	বলবো,	
dekhso,	দেখসও,	দেখসো,	
paadee,	পাড়ে,	পাড়ে,	
mandanda,	মান্ডানদা,	মানদণ্ড,	
homsher,	হোমশের,	হোমসের,	
noteti,	নটটটি,	নোটটি,	
piulir,	পিউলির,	পিউলির,	
dimbacriti,	ডিম্বাকৃতি,	ডিম্বাকৃতি,	
lagchhe,	লাগছে,	লাগছে,	
nanabornobishishto,	নানবর্ণবিশিষ্ট,	নানাবর্ণবিশিষ্ট,	
palashir,	পললশীর,	পলাশীর,	
monchosthol,	মন্থস্থল,	মঞ্চস্থল,	
nirdesika,	নির্দেসিকা,	নির্দেশিকা,	
xpose,	এক্সপোস,	এক্সপোজ,	
sahinsatar,	সহিনসততার,	সহিংসতার,	
shcholastic,	স্কললাসটটিক,	স্কলাস্টিক,	
gaphiloti,	গফিলোটি,	গাফিলতি,	
vince,	ভিন্স,	ভিন্স,	
jerusalema,	জেরুসালেমা,	জেরুসালেম,	
gasthi,	গাস্থি,	গোষ্ঠী,	
balatkar,	বালাটকর,	বলাৎকার,	
ujobekeestan,	উজবেকস্তান,	উজবেকিস্তান,	
dufresne,	ডাফ্রেননে,	ডুফরেস্ন,	
antarctika,	অন্তর্টিকটা,	অ্যান্টার্কটিকা,	
terlarang,	টেরলারাং,	তেরলারং,	
musabbirul,	মুসাব্বিরুল,	মুসাব্বিরুল,	
footbalarra,	ফুটবললার,	ফুটবলাররা,	
protijogitamulok,	প্রতিযোগিতামূলক,	প্রতিযোগীতামূলক,	
sheshardhe,	শেষার্ধে,	শেষার্ধে,	
chiraharit,	চিরাহারিত,	চিরহরিৎ,	
survative,	সারভেটিভ,	সারভেটিভ,	
moorali,	মুরললি,	মুরলী,	
maktum,	মাক্তুম,	মাকতুম,	
amiya,	আমিয়া,	অমিয়,	
registrikrito,	রেজিস্ট্রিকৃত,	রেজিস্ট্রীকৃত,	
bishshaasho,	বিষ্বশ,	বিশ্বাসও,	
vabook,	ভাবুক,	ভাবুক,	
chai,	চাই,	ছাই,	
chhutochhuti,	ছুটোছুটি,	ছুটোছুটি,	
chakti,	চাক্তি,	চাকতি,	
drissogulo,	দৃস্মগুলো,	দৃশ্যগুলো,	
gananatyo,	গণনত্্য,	গণনাট্য,	
caramiks,	কারামিকস,	সিরামিকস,	
ganaporibahaner,	গণপরিবাহনের,	গণপরিবহনের,	
birishiritey,	বিরিশিরীতে,	বিরিশিরিতে,	
magrey,	ম্যাগরে,	ম্যাগ্রে,	
nabotom,	নাবোতম,	নবতম,	
kurdider,	কুরদিদের,	কুর্দিদের,	
hupile,	হুপিলে,	হুপিলে,	
dhanyi,	ধননই,	ধন্যি,	
tarkareer,	তারকারীর,	তরকারীর,	
shandra,	শান্দ্রার,	শান্দ্রার,	
kleentoner,	ক্লিন্টনের,	ক্লিনটনের,	
abhidhaanic,	অভিধানিক,	অভিধানিক,	
danakana,	দানাকানা,	ডানকান,	
rokibul,	রোকিবুল,	রকিবুল,	
parther,	পার্থের,	পার্থের,	
dokkhinangsho,	দক্ষিণাংশ,	দক্ষিণাংশ,	
senabahineekey,	সেনাবাহিনীকে,	সেনাবাহিনীকে,	
minister,	মিনিস্টার,	মিনিস্টার,	
dito,	দিতো,	দিতো,	
milekhanek,	মিলেখানেক,	মাইলখানেক,	
ragee,	রেগ,	রাগী,	
dhani,	ধনী,	ধানি,	
ganesh,	গণেশ,	গণেশ,	
boudhher,	বৌধের,	বৌদ্ধের,	
kaley,	কালে,	কালে,	
nationalser,	নেশনালসের,	ন্যাশনালসের,	
recondishon,	রেকনডিশন,	রিকন্ডিশন,	
coons,	কুন্স,	কুনস,	
hizriite,	হিজরিতে,	হিজরীতে,	
ateetkaale,	অটীটকালে,	অতীতকালে,	
procharjontrogulo,	প্রচারযন্ত্রগুলো,	প্রচারযন্ত্রগুলো,	
laat,	লেট,	লাট,	
uthhaane,	উঠানে,	উঠানে,	
behrampurer,	বেরমারপুরের,	বহরমপুরের,	
mythological,	মিথোলিক্যাল,	মাইথলজিকাল,	
inphormeshon,	ইনফরমেশন,	ইনফরমেশন,	
chalochchitraeei,	চালচ্ছিত্রায়,	চলচ্চিত্রেই,	
societyke,	সোিটিকে,	সোসাইটিকে,	
zerusalem,	জেরুসালেম,	জেরুজালেম,	
akreetokarjo,	আকৃতকার্য্য,	অকৃতকার্য,	
protectionism,	প্রোটেকশনিসম,	প্রোটেকশনিজম,	
krimlin,	ক্রিমলিন,	ক্রিমলিন,	
jomoker,	জমকের,	জমকের,	
muchi,	মুচি,	মুচি,	
philipiner,	ফিলিপিনের,	ফিলিপাইনের,	
shatokeo,	শতোকেও,	শতকেও,	
gopalrao,	গোপালরাও,	গোপালরাও,	
krishibigyani,	কৃষিবিজ্ঞানী,	কৃষিবিজ্ঞানী,	
gratha,	গ্রাথা,	গ্রোথ,	
shumo,	শুমো,	সুমো,	
makame,	মাকামে,	মাকামে,	
heteler,	হেতেলের,	হেটেলের,	
badhamuktovabe,	বাধামুক্তভাবে,	বাধামুক্তভাবে,	
jounotar,	যৌনতার,	যৌনতার,	
falak,	ফালাক,	ফলক,	
swarther,	স্বার্থের,	স্বার্থের,	
kani,	কানী,	কানি,	
rinobodh,	ঋণবোধ,	ঋণবোধ,	
kei,	কেই,	কেই,	
choson,	চসন,	চোষণ,	
tigre,	তিগ্রে,	টাইগার,	
fotanor,	ফটানোর,	ফোটানোর,	
temone,	টেমনে,	তেমনই,	
abheedhanik,	অভিধানিক,	অভিধানিক,	
masjidsaha,	মসজিদসহ,	মসজিদসহ,	
jyesthaa,	জ্যেষ্ঠা,	জ্যেষ্ঠা,	
jyaqa,	জ্যাক,	জ্যাক,	
hank,	হ্যাংক,	হাঙ্ক,	
pyor,	প্যার,	পিওর,	
uddhrita,	উদ্ধৃত,	উদ্ধৃত,	
probeshan,	প্রবেশন,	প্রবেশন,	
salafeta,	সালাফেট,	সালফেট,	
chilahatee,	চিলাহাটি,	চিলাহাটি,	
pettern,	পেটার্ন,	প্যাটার্ন,	
qonfliqt,	কনফ্লিক্ট,	কনফ্লিক্ট,	
perry,	পেরি,	পেরি,	
qarpeta,	কারপেটা,	কার্পেট,	
daqten,	ডাকতেন,	ডাকতেন,	
ultrasonography,	আলট্রোসনোগারফফি,	আলট্রাসনোগ্রাফিও,	
angsogrohone,	অংসগ্রহণে,	অংশগ্রহনের,	
diznee,	দিজনী,	ডিজনী,	
daaoon,	দাওন,	ডাউন,	
adhunikkaley,	আধুনিকলাযে,	আধুনিককালে,	
maudelti,	মাডেলটি,	মডেলটি,	
durgatsabe,	দুর্গতসভাবে,	দুর্গোৎসবে,	
nirikho,	নিরিখো,	নিরিখ,	
bhabotarini,	ভাবতারিণী,	ভবতারিণী,	
canservatian,	কান্সারভিয়ান,	কনসারভেশন,	
dakteekiter,	ডাক্তিকিতের,	ডাকটিকিটের,	
rezidence,	রেজিডেন্সে,	রেসিডেন্স,	
ancholtike,	অঞ্চলটিকে,	অঞ্চলটিকে,	
dacope,	ড্যাকোপে,	দাকোপ,	
panchashjon,	পঞ্চাশযোন,	পঞ্চাশজন,	
ceramicer,	সেরিমিসের,	সিরামিকের,	
cena,	সেনা,	সিনা,	
azaan,	আজান,	আজান,	
lutharan,	লুথারান,	লুথেরান,	
assaciates,	অ্যাসাসিয়েটস,	এসোসিয়েটস,	
societykey,	সোিটিকে,	সোসাইটিকে,	
saver,	সাভার,	সেভার,	
probondhobhittik,	প্রবন্ধভিত্তিক,	প্রবন্ধভিত্তিক,	
aagera,	আগেরা,	আগোরা,	
meloonborrone,	মেলোনবররনে,	মেলবোর্নে,	
shiqara,	শিকারা,	শিকার,	
mukherjee,	মুখের্যে,	মুখার্জী,	
ancholsomuho,	অঞ্চলসমূহ,	অঞ্চলসমূহ,	
nodiitei,	নদীতেই,	নদীতেই,	
nagarikera,	নাগারিকেরা,	নাগরিকেরা,	
jamarate,	জামারাতে,	জামারাতে,	
tunaita,	টুনাইটা,	টুনাইট,	
rakim,	রকিং,	রাকিম,	
beshirbhaagei,	বেশিরভাগেই,	বেশিরভাগেই,	
dara,	দারা,	দারা,	
gitikobita,	গীতকবিবতা,	গীতিকবিতা,	
kormokarke,	কর্মকারকে,	কর্মকারকে,	
korley,	করলে,	করলে,	
shattoki,	শাত্যকি,	সাত্যকি,	
kalnir,	কালনীর,	কালনীর,	
patishapta,	পাতিপট্ট,	পাটিসাপটা,	
ispredsheet,	ইস্প্রেশিড,	স্প্রেডশীট,	
krisenter,	ক্রিসেন্টের,	ক্রিসেন্টের,	
sealvi,	সেলভি,	সিলভি,	
hillse,	হিলসে,	হিলসে,	
firalem,	ফিরালেম,	ফিরালেম,	
madhumati,	মধুমতি,	মধুমতী,	
shiropar,	শিরোপার,	শিরোপার,	
shchalastik,	শ্ক্লাস্তিক,	স্কলাস্টিক,	
ekok,	একক,	একক,	
phising,	ফিসিং,	ফিসিং,	
dubureer,	ডুবুরীর,	ডুবুরির,	
horipur,	হরিপুর,	হরিপুর,	
bhittiti,	ভিত্তিটি,	ভিত্তিটি,	
kanuner,	কানুনের,	কানুনের,	
horiddare,	হরিদ্দারে,	হরিদ্বারে,	
nikate,	নিকাতে,	নিকটে,	
mekon,	মেকন,	মেকং,	
guzon,	গুজন,	গুজব,	
poribahokotto,	পরিবাহকত্ব,	পরিবাহকত্ব,	
pabo,	পাবো,	পাব,	
alexandar,	আলেক্সান্দার,	আলেকজান্ডার,	
dibug,	দিবুগ,	ডিবাগ,	
goonoman,	গৌনমান,	গুণমান,	
dajhyo,	দাঝ্য,	দাহ্য,	
dovaar,	দোভার,	ডোভার,	
raagei,	রাগেই,	রাগেই,	
tirmijii,	তিরমিজি,	তিরমিজি,	
indro,	ইন্দ্র,	ইন্দ্র,	
plator,	প্ল্যাটর,	প্লেটোর,	
shringge,	শ্রেগে,	শৃঙ্গে,	
sheepha,	শীফ,	শেফ,	
jeebanjapon,	জীবনজাপন,	জীবনযাপন,	
sift,	সিফট,	শিফট,	
farna,	ফার্না,	ফার্ন,	
saarbhaarti,	সারভারটি,	সার্ভারটি,	
ekshoti,	একশটি,	একশোটি,	
ranangone,	রণনঙ্গণে,	রণাঙ্গনে,	
bairer,	বাইরের,	বাইরের,	
eukalyptus,	ইউকালাইপ্টাস,	ইউক্যালিপ্টাস,	
doorotomo,	দূরতম,	দূরতম,	
poriikkhateo,	পরীক্ষাতেও,	পরীক্ষাতেও,	
chargar,	চাগর,	চার্জার,	
chirontan,	চিরন্তন,	চিরন্তন,	
bade,	বাদে,	বাদে,	
sthitiko,	স্থিতিক,	স্থিতিকো,	
sahooseekotar,	সহুসিকতার,	সাহসিকতার,	
avisongson,	অ্যাসিসংকন,	অভিশংসন,	
udbhaboney,	উদ্ভাবনে,	উদ্ভাবনে,	
uparjon,	উপার্জন,	উপার্জন,	
beetloser,	বিটলসের,	বিটলসের,	
bondishalatei,	বন্দীশালাতেই,	বন্দিশালাতেই,	
byomkesh,	ব্যামকেশ,	ব্যোমকেশ,	
eevil,	ইভিল,	ইভিল,	
toxoid,	টক্সযড,	টক্সয়েড,	
daacktickete,	ডাক্িটকেট,	ডাকটিকিটে,	
jotota,	যততা,	যতোটা,	
ponthaar,	পন্থার,	পন্থার,	
audioguloke,	অডিওগুলোকে,	অডিওগুলোকে,	
militaryr,	মিলিটারির,	মিলিটারির,	
sommotite,	সম্মতিতে,	সম্মতিতে,	
haridware,	হরিদ্বারে,	হরিদ্বারে,	
batsmanei,	ব্যাটসম্যানই,	ব্যাটসম্যানই,	
dhonni,	ধন্নী,	ধন্যি,	
shurugulo,	শুরুগুলো,	শুরুগুলো,	
ekghare,	একঘরে,	একঘরে,	
swartho,	স্বা্থ,	স্বার্থ,	
nazad,	নাজাদ,	নাজাদ,	
rajnikant,	রাজনীকান্ত,	রাজনীকান্ত,	
chaloke,	চালোকে,	চালকে,	
ajuhat,	অজুহাত,	অজুহাত,	
alankorana,	আলাঙ্করণা,	অলঙ্করণ,	
breel,	ব্রিল,	ব্রিল,	
duhsthanostho,	দুঃস্থানস্থ,	দুঃস্থানস্থ,	
chhooteete,	ছুটিতে,	ছুটিতে,	
samajikotar,	সমাজিকতার,	সামাজিকতার,	
shahanara,	শাহানারা,	শাহানারা,	
bisheshshyo,	বিশেষ্য,	বিশেষ্য,	
chakrapani,	চাকরাপানি,	চক্রপানী,	
songkulan,	সংকুলান,	সংকুলান,	
turkyder,	টার্কিডের,	তুর্কিদের,	
husni,	হুসনি,	হুসনি,	
ekhate,	এখাতে,	একহাতে,	
pratisthanikvabe,	প্রতিষ্ঠানিকভাবে,	প্রাতিষ্ঠানিকভাবে,	
deool,	দেওল,	দেউল,	
prokolpoti,	প্রকল্পটি,	প্রকল্পটি,	
anusthane,	অনুষ্ঠানে,	অনুষ্ঠানে,	
prothar,	প্রথার,	প্রথার,	
abosare,	অবসারে,	অবসরে,	
ajeejer,	আজেজির,	আজিজের,	
aviyojan,	অভিযোজন,	অভিযোজন,	
jetam,	জেতাম,	যেতাম,	
protijogiider,	প্রতিযোগীদের,	প্রতিযোগীদের,	
harbare,	হারবারে,	হারবারে,	
dobhara,	দোভারা,	ডোভার,	
purohitra,	পুরোহিত্র,	পুরোহিতরা,	
nothivuktir,	নথিভুক্তির,	নথিভুক্তির,	
arifin,	আরিফিন,	আরিফিন,	
oncolsoho,	অন্কোলসহ,	অঞ্চলসহ,	
chaiten,	চাইতেন,	চাইতেন,	
pyore,	প্যোরের,	পিওর,	
sazanor,	সাজানোর,	সাজানোর,	
nehle,	নেহলে,	নেহলে,	
konruup,	কন্রূপ,	কোনরূপ,	
swairacharibirodhi,	স্বৈরাৈিবিরোধী,	স্বৈরাচারীবিরোধী,	
ramantic,	র্যামান্টিক,	রোমান্টিক,	
bangobandhu,	বঙ্গবন্ধু,	বঙ্গবন্ধু,	
vabnakey,	ভাবনাকে,	ভাবনাকে,	
abhidhaaneeck,	অিিধায়ান্ক,	অভিধানিক,	
farid,	ফরিদ,	ফরিদ,	
khitkar,	খিতকার,	ক্ষিতকর,	
pyatarne,	প্যাটার্নে,	প্যাটার্নে,	
mile,	মিলে,	মিলে,	
probhur,	প্রভুর,	প্রভুর,	
bufer,	বুফার,	বাফার,	
sthapona,	স্থাপনা,	স্থাপনা,	
enamela,	এনামেলা,	এনামেল,	
suiza,	সুইজা,	সুইজা,	
rasunkunchi,	রসুুনকুঞ্চি,	রসুনকুঁচি,	
yak,	যকক,	ইয়াক,	
osomorthito,	অসমর্থিত,	অসমর্থিত,	
raiji,	রাইজি,	রাইজি,	
kusumeshu,	কুসেমেষু,	কুসুমেষু,	
scuvi,	স্কুভি,	স্কুভি,	
tyapa,	ট্যাপ,	ট্যাপ,	
superheroo,	সুপারহেরও,	সুপারহিরো,	
vangley,	ভাং্লে,	ভাঙলে,	
ji,	জি,	জি,	
existing,	এক্সিস্টিং,	এক্সিসটিং,	
bbiswash,	বিব্বিশ্বাস,	বিশ্বাস,	
soketgulor,	সোকেটগুলোর,	সকেটগুলোর,	
chaudhurio,	চৌধুরিও,	চৌধুরীও,	
goshthiti,	গোষটিটি,	গোষ্ঠীটি,	
jibonnogor,	জীবন্যগর,	জীবননগর,	
plate,	প্লেইট,	প্লেটে,	
kakhnoba,	কাখনবা,	কখনওবা,	
sedikei,	সেদিকেই,	সেদিকেই,	
roktokhoron,	রক্তখরণ,	রক্তক্ষরণের,	
dushtogone,	দুষ্টগণে,	দুষ্টগণে,	
paolasthi,	পাওলাস্থি,	পাওলাসথি,	
standards,	স্ট্যান্ডারডস,	স্টান্ডার্ডস,	
nadnadeer,	নদনাদীর,	নদনদীর,	
amanisha,	আমানিশা,	অমানিশা,	
rodney,	রডনি,	রেডনি,	
abosan,	অবসান,	অবসান,	
maailey,	মাইলে,	মাইলে,	
licensedhari,	লাইসেন্সারি,	লাইসেন্সধারী,	
soommita,	সুমিতা,	সুমিতা,	
euqalyptus,	ইউক্যাললিউটাস,	ইউক্যালিপ্টাস,	
chhootochhuti,	ছুওছুটি,	ছুটোছুটি,	
aprasangikbhabei,	অপ্রাসংগীকভাবেই,	অপ্রাসঙ্গিকভাবেই,	
neelfamarir,	নীলফামারীর,	নীলফামারীর,	
batom,	বাতোম,	বাটম,	
aasar,	আসার,	আসর,	
gej,	গেজ,	গেজ,	
nichols,	নিকোলস,	নিকলস,	
shekarmani,	শেকারমানি,	শেকরমানি,	
cholochchitrake,	চলচ্চিত্রাকে,	চলচ্চিত্রকে,	
mishal,	মিশাল,	মিশাল,	
brittakar,	বৃত্তককার,	বৃত্তাকার,	
foxer,	ফক্সার,	ফক্সের,	
sampadon,	সম্পাদন,	সম্পাদন,	
karlei,	কারলেই,	করলেই,	
maley,	মেলি,	মালে,	
daaradaa,	দররাড়া,	দারদা,	
shikhbe,	শিখবে,	শিখবে,	
oswastikor,	অস্বাস্তিকোর,	অস্বস্তিকর,	
choudhurike,	চৌধুরীকে,	চৌধুরীকে,	
beekaargrasta,	বিকারগ্রস্ত,	বিকারগ্রস্ত,	
charger,	চার্জার,	চার্জার,	
modelkey,	মডেলকে,	মডেলকে,	
machhti,	মাছটি,	মাছটি,	
chhutochhooti,	ছুটোছুটি,	ছুটোছুটি,	
bibecchyo,	বিবেচ্ছ,	বিবেচ্য,	
bhoolapuka,	ভূলাপুকা,	ভোলাপুক,	
haris,	হারিস,	হ্যারিস,	
chitronattakar,	চিত্রনাত্যকার,	চিত্রনাট্যকার,	
dip,	ডিপ,	দীপ,	
prithibir,	পৃথিবীর,	পৃথবীর,	
kirti,	কীরটি,	কীর্তি,	
manab,	মানাব,	মানব,	
harris,	হ্যারিস,	হ্যারিস,	
bhromoner,	ভ্রমনের,	ভ্রমণের,	
greep,	গ্রীপ,	গ্রিপ,	
sayanaida,	সায়ানাইদ,	সায়ানাইড,	
obdee,	অব্দী,	অব্দি,	
segular,	সেগুলার,	সেগুলোর,	
chalochchitrogulor,	চালচ্্তিরগুলোর,	চলচ্চিত্রগুলোর,	
nariider,	নারীদের,	নারীদের,	
puroheetder,	পুরোহীতদের,	পুরোহিতদের,	
ekatitto,	একাতিত্ব,	একাতিত্ব,	
anisa,	আনিসা,	আনিস,	
avidur,	আভিদুর,	আভিদুর,	
dwijenbabuder,	দ্বিজেনবাবুদের,	দ্বিজেনবাবুদের,	
mandope,	মাণ্ডপে,	মন্ডপে,	
qaferderkey,	কাফেরদেরকে,	কাফেরদেরকে,	
showtey,	শতে,	শোতে,	
prakalpagulor,	প্রকল্পগুলোর,	প্রকল্পগুলোর,	
sangbadmadhyamgulote,	সংবাদমাধ্যমগুলোতে,	সংবাদমাধ্যমগুলোতে,	
landey,	ল্যান্ডে,	ল্যান্ডে,	
safiin,	সাফিন,	সাফিন,	
nothibhukteer,	নথিভুক্তির,	নথিভুক্তির,	
shapad,	শাপাদ,	শ্বাপদ,	
kantajir,	কন্তাজির,	কান্তজির,	
jocqey,	জকে,	জকি,	
swadesh,	স্বদেশ,	স্বদেশ,	
basturoi,	বস্তুরই,	বস্তুরই,	
akai,	আকাই,	একাই,	
dishani,	দিশানী,	দিশানি,	
sumitrar,	সুমিত্রার,	সুমিত্রার,	
mukhomandal,	মুখোমণ্ডল,	মুখমণ্ডল,	
saatzoner,	সাতজনের,	সাতজনের,	
shudden,	শুদ্দেন,	সাডেন,	
jommu,	জমম্,	জম্মু,	
everage,	এভারেজ,	এভারেজ,	
abhidhaner,	অভিধানের,	অভিধানের,	
joubanbatee,	যৌবনববতী,	যৌবনবতী,	
ddheela,	ঢিলা,	ঢিলা,	
hunine,	হুনিনে,	হুনাইন,	
gondhe,	গন্ধে,	গন্ধে,	
eduardo,	এডুরিয়ার্ডো,	এডুয়ার্দো,	
shiulijhra,	শিলুলঝরা,	শিউলিঝরা,	
gobeshokgon,	গবেষকগণ,	গবেষকগণ,	
buddhitii,	বুদ্ধিটিই,	বুদ্ধিটিই,	
aniyantrita,	অনিয়ন্ত্রীত,	অনিয়ন্ত্রিত,	
madraser,	মাদ্রাসের,	মাদ্রাজের,	
residence,	রেসিডেন্সে,	রেসিডেন্স,	
daqop,	ডাকোপ,	দাকোপ,	
munot,	মুনোট,	মুনোট,	
biphal,	বিফাল,	বিফল,	
melbourner,	মেলবোর্নের,	মেলবোর্নের,	
brake,	ব্রেকে,	ব্রেক,	
pratisthanik,	প্রতিস্থানিক,	প্রাতিষ্ঠানিক,	
tennys,	টেনিস,	টেনিস,	
veenish,	ভিনিস,	ভেনিস,	
harza,	হারজা,	হার্জ,	
bojhaao,	বোঝাও,	বোঝাও,	
emargency,	ইমারজেন্সি,	এমার্জেন্সি,	
sharifpur,	শরিফপুরের,	শরিফপুর,	
krush,	ক্রুশ,	ক্রুশ,	
mast,	মাস্ট,	মাস্ত,	
senabahineeow,	সেনাবাহিন্য,	সেনাবাহিনীও,	
rajnoitik,	রাজনৈতিক,	রাজনৈতীক,	
vaphara,	ভাফারা,	বাফার,	
mulvitti,	মুলভিত্তি,	মূলভিত্তি,	
hijri,	হিজরি,	হিজরী,	
pisach,	পিসাচ,	পিশাচ,	
chhadite,	ছাড়িতে,	ছড়িতে,	
ghatla,	ঘাটলা,	ঘটল,	
senabahinio,	সেনাবাহিনীও,	সেনাবাহিনীও,	
mukhya,	মুখ্যা,	মুখ্য,	
mithener,	মিথেনের,	মিথেনের,	
billaho,	বিল্লাহ,	বিল্লাহ,	
edipass,	ইডিপাস,	ইডিপাস,	
toufiq,	তৌফিক,	তৌফিক,	
breakthrough,	ব্রেকটটরুঘ,	ব্রেকথ্রু,	
rajtantrey,	রাজতন্ত্রে,	রাজতন্ত্রে,	
kkhur,	ক্ষুর,	ক্ষুর,	
neerbahi,	নিরবাহী,	নির্বাহি,	
bisnoo,	বিস্নু,	বিষ্ণু,	
stonehenje,	স্টনহেহেঞ্জে,	স্টোনহেঞ্জ,	
bahjya,	বাহজ্যা,	বাহ্য,	
mercial,	মার্সিয়াল,	মার্শিয়াল,	
female,	ফেমালে,	ফিমেল,	
biplobi,	বিপ্লবী,	বিপ্লবী,	
bbiswasho,	বিবিব্শাসহ,	বিশ্বাসও,	
itostatah,	ইতোস্তাতাহ,	ইতস্ততঃ,	
oshtader,	ওষ্টাদের,	ওস্তাদের,	
badaghat,	বাদাঘাট,	বাদাঘাট,	
karam,	কারাম,	কেরাম,	
zoojyota,	যুজ্যতা,	যোজ্যতা,	
oncholshomuh,	অন্চলসমূহ,	অঞ্চলসমূহ,	
muradke,	মুরাদকে,	মুরাদকে,	
ajibooner,	অজিবুনের,	আজীবনের,	
cheess,	চিইএস,	চেস,	
blacq,	ব্ল্যাক,	ব্ল্যাক,	
turky,	টার্কি,	তুর্কি,	
graambaasheeo,	গ্রামবাসীও,	গ্রামবাসীও,	
vortuki,	ভর্তুকি,	ভর্তুকি,	
kuhelika,	কুহেলিকা,	কুহেলিকা,	
anchalsaho,	অঞ্চলসহ,	অঞ্চলসহ,	
chaka,	চাকা,	চাকা,	
laga,	ল্যাগা,	লগ,	
sumeeta,	সুমিতা,	সুমিতা,	
jitpur,	জিতপুর,	জিতপুরের,	
gonesher,	গনেশের,	গণেশের,	
helloin,	হেললয়ন,	হ্যালোইন,	
joki,	জকি,	জকি,	
tukrowti,	তুকরৌটি,	টুকরোটি,	
parikha,	পারিখা,	পরিখার,	
bhumija,	ভূমিজা,	ভূমিজ,	
geographics,	জিওগ্রাফিকস,	জিওগ্রাফিকস,	
khelaphate,	খেলাফাতে,	খেলাফতে,	
patengar,	পাতেঙ্গার,	পতেঙ্গার,	
daebug,	ডাবেগ,	ডিবাগ,	
atak,	আতাক,	আটক,	
ponchaashjon,	পঞ্চাশযন,	পঞ্চাশজন,	
mitrata,	মিত্রটা,	মিত্রতা,	
bibechyo,	বিবেচ্য,	বিবেচ্য,	
padee,	পাদে,	পাড়ে,	
utkhaat,	উৎকাাা,	উত্খাত,	
sossar,	সোসার,	সকার,	
sangkalanti,	সংকলনটি,	সংকলনটি,	
lyataa,	ল্যাট,	ল্যাটা,	
pothnirdeshona,	পথনির্দেশনা,	পথনির্দেশনা,	
quary,	কোর্যি,	কোয়েরি,	
parswer,	পার্সব্যের,	পার্শ্বের,	
chandrima,	চন্দ্রিমা,	চন্দ্রিমা,	
baarnis,	বার্নিস,	বার্নিশ,	
tolemyr,	টলেমির,	টলেমির,	
tokee,	টোকি,	তকি,	
andon,	অ্যান্ডন,	আন্দোন,	
elakatike,	এলাকাটিকে,	এলাকাটিকে,	
phox,	ফক্স,	ফক্স,	
neelkamal,	নীলকামাল,	নীলকমল,	
accountdharira,	অকান্তুধরীরা,	একাউন্টধারীরা,	
fastag,	ফাস্তাগ,	ফ্যাসট্যাগ,	
tomader,	তোমাদের,	তোমাদের,	
hitaishi,	হিটাইসি,	হিতৈষী,	
bondiira,	বন্ডিরা,	বন্দীরা,	
tateo,	তাতেও,	তাতেও,	
hosne,	হোসনে,	হোসনে,	
prasadhani,	প্রসাধনী,	প্রসাধনী,	
anutpadanshil,	অনুতপদনশীল,	অনুৎপাদনশীল,	
foloshrutite,	ফলশ্রুতিতে,	ফলশ্রুতিতে,	
bethikata,	বেথিকাটা,	বেঠিকতা,	
gazetted,	গ্যাজেটেড,	গেজেটেড,	
teamothy,	টিমথি,	টিমোথি,	
enginiiring,	ইঞ্জিনিয়ারিং,	ইঞ্জিনিয়ারিং,	
venkates,	ভেঙ্কটেস,	ভেঙ্কটেশ,	
tiger,	টিগার,	টাইগার,	
masjidsaho,	মসজিদসহ,	মসজিদসহ,	
kaaferder,	কাফারদের,	কাফেরদের,	
elakai,	এলাকাই,	এলাকাই,	
neemitte,	নিমিত্তে,	নিমিত্তে,	
parjotaker,	পার্যটাকের,	পর্যটকের,	
seekkharthirao,	শীক্ষার্থীরাও,	শিক্ষার্থীরাও,	
oiteejye,	ঐতিজ্যে,	ঐতিহ্যে,	
graambaaseer,	গ্রামবাসীর,	গ্রামবাসীর,	
udvaboney,	উদ্ভাবনে,	উদ্ভাবনে,	
elgoridom,	এলগোরিডম,	এলগরিদম,	
landing,	ল্যান্ডিং,	ল্যান্ডিং,	
arthonitite,	আর্থনীতিতে,	অর্থনীতিতে,	
siddharther,	সিদ্ধার্থের,	সিদ্ধার্থের,	
toptoshele,	তপ্তশেলে,	তপ্তশেলে,	
nilkuthir,	নীলকুঠির,	নীলকুঠির,	
bone,	বনে,	বনে,	
fitarsaho,	ফিতারসহ,	ফিতরসহ,	
welcome,	ওয়েলমি,	ওয়েলকাম,	
brixfield,	ব্রিক্সফিল্ড,	ব্রিক্সফিল্ড,	
marpit,	মারপিট,	মারপিট,	
siit,	সিত,	শীত,	
byaboharkarie,	ব্যবহারকারী,	ব্যবহারকারীই,	
cheenja,	চিঞ্জা,	চেঞ্জ,	
omanisa,	ওমানিসা,	অমানিশা,	
macbeth,	ম্যাকবেট,	ম্যাকবেথ,	
bhabanir,	ভাবানীর,	ভবানীর,	
fud,	ফাউড,	ফুড,	
pooshti,	পুষ্টি,	পুষ্টি,	
longhan,	লোংহান,	লংঘন,	
dharavahik,	ধারাভাহিক,	ধারাবাহিক,	
onchalgulir,	অঞ্ছালগুলির,	অঞ্চলগুলির,	
parking,	পারকিং,	পার্কিং,	
peri,	পেরি,	পেরি,	
juktorashtreo,	যুক্তরাষ্ট্রেও,	যুক্তরাষ্ট্রেও,	
samaptir,	সমাপ্তির,	সমাপ্তির,	
mujuru,	মুজুরু,	মুজুরু,	
tiuning,	টিউনিং,	টিউনিং,	
parkasa,	পারকাশা,	পার্কস,	
rajotwo,	রাজত্ব,	রাজত্ব,	
konisttha,	কোনিস্থথ,	কনিষ্ঠ,	
abodamaner,	অবদামানের,	অবদমনের,	
mitro,	মিত্রো,	মিত্র,	
maryir,	মারির,	ম্যারির,	
aholyar,	আহল্যার,	অহল্যার,	
kinsa,	কিনসা,	কিংস,	
bipradas,	বিপ্রদাস,	বিপ্রদাস,	
chemjong,	চেমজং,	চেমজং,	
uporoshtho,	অপরস্থ,	উপরস্থ,	
chupani,	চুপানী,	চুপানি,	
tophaat,	টোফাত,	তফাৎ,	
drabyatah,	দ্রব্যতঃঃ,	দ্রব্যতঃ,	
carbus,	কার্বাস,	কারবাস,	
heawy,	হিউবি,	হেভি,	
alaol,	আলাওল,	আলাওল,	
kheylechen,	খেয়েলেছেন,	খেলেছেন,	
orunima,	অরুনিমা,	অরুণিমা,	
streegon,	স্ট্রীগন,	স্ত্রীগণ,	
umb,	ইউএমবি,	ইউএমবি,	
tuni,	তুনী,	টুনি,	
pancbaar,	প্যানসবার,	পাঁচবার,	
chouhate,	চৌহাতে,	চৌহাটে,	
jonoikaa,	জনবকা,	জনৈকা,	
playtey,	প্লেটি,	প্লেটে,	
zubokra,	যুবকরা,	যুবকরা,	
niphelheim,	নিফেলাইম,	নিফেলহেইম,	
pleeta,	প্লিট,	প্লেট,	
meshmeshya,	মেশমেশ্য,	মেশহমেশহিইয়া,	
ramzaner,	রামজানের,	রমযানের,	
durgatsober,	দুর্গাতসবের,	দুর্গোৎসবে,	
kiandi,	কিয়ান্দি,	ক্যান্ডি,	
zesa,	জেস,	জেস,	
sahapathike,	সহপাঠীকে,	সহপাঠীকে,	
sathik,	সাথিক,	সঠিক,	
manir,	মণির,	মনির,	
hock,	হক,	হুক,	
nyata,	ন্যাট,	ম্যাট,	
teemothy,	তিমথি,	টিমোথি,	
emarjensi,	ইমারজেন্সি,	এমার্জেন্সি,	
directarate,	ডিরেক্টরেট,	ডিরেক্টরেট,	
saraiki,	সারাইকি,	সরাইকি,	
deep,	ডিপ,	দীপ,	
bongsho,	বংশ,	বংশ,	
danata,	দানাতা,	ডোনাট,	
ogovir,	ওগোভির,	অগভীর,	
lavta,	লাভতা,	লাভটা,	
horas,	হোরাস,	হোরাস,	
bhardwaj,	ভার্দ্বজ,	ভরদ্বাজ,	
somratra,	সোমরাত্র,	সম্রাটরা,	
tonoo,	টনু,	তনু,	
asabhya,	অসভ্য,	অসভ্য,	
bandhano,	বানধানো,	বাঁধানো,	
tecnokret,	টেকনোক্রেট,	টেকনোক্র্যাট,	
onurbar,	অনুর্বার,	অনুর্বর,	
mookhomaundoler,	মুখহমণ্ডলের,	মুখমণ্ডলের,	
sawam,	সায়াম,	সাওম,	
plate,	প্লেইট,	প্লেট,	
conservetion,	কনজারভেশন,	কনসারভেশন,	
siramikasa,	সিরামিকাসা,	সিরামিকস,	
nutunotto,	নুতুনোত্ত,	নতুনত্ব,	
ghaghat,	ঘাঘাট,	ঘাঘট,	
chhotogolper,	ছোটগল্পের,	ছোটগল্পের,	
silabhara,	সিলাভরা,	সিলভার,	
impaction,	ইমপ্যাকশন,	ইমপ্যাকশন,	
palta,	পাল্টা,	পালটা,	
cloudbook,	ক্লউডবুক,	ক্লাউডবুক,	
reetesh,	রীতেশ,	রিতেশ,	
argho,	অর্ঘ,	অর্ঘ্য,	
ganoparibahaner,	গণপরিবাহনের,	গণপরিবহনের,	
rakhete,	রাখেতে,	রাখেতে,	
elbamtite,	এলবামটিতে,	এলবামটিতে,	
byaktigotovabeo,	ব্যক্তিগতভাবেও,	ব্যাক্তিগতভাবেও,	
cocaine,	কোকাইন,	কোকেইন,	
mumtazer,	মুমতাজের,	মুমতাজের,	
aalkatraa,	আলকাত্রা,	আলকাতরা,	
carzar,	কারজার,	চার্জার,	
tookrote,	টুকরতে,	টুকরোতে,	
digree,	ডিগ্রী,	ডিগ্রি,	
paroner,	পারণের,	পারণের,	
ghumachhe,	ঘুমাচ্ছে,	ঘুমাচ্ছে,	
shho,	শো,	শো,	
ishahak,	ইশাহাক,	ইসাহাক,	
teenej,	তেনেজ,	টিনেজ,	
siqhar,	সিখার,	শিকার,	
ekatto,	একাত্ত,	একাত্ব,	
edmiral,	এডমিরাল,	এডমিরাল,	
riphleksa,	রিফলেক্সা,	রিফ্লেক্স,	
probhura,	প্রভুরা,	প্রভুরা,	
digrir,	ডিগ্রির,	ডিগ্রির,	
pujit,	পুজিত,	পুজিত,	
agomonke,	আগমনকে,	আগমনকে,	
vvimsenn,	ভিভিমেন্ন,	ভীমসেন,	
erokomer,	এরকমের,	এরকমের,	
karmosansthan,	কর্মসানস্থান,	কর্মসংস্থান,	
shrabosty,	শ্রাবস্তি,	শ্রাবস্তী,	
rohinibabu,	রোহিনীবাবু,	রোহিনীবাবু,	
chalake,	চালাকে,	চালকে,	
otyacharer,	অত্যাচারের,	অত্যাচারের,	
taims,	টাইমস,	টাইমস্,	
omarader,	ওমারাদের,	ওমারাদের,	
suchonakal,	সূচনাকাল,	সূচনাকাল,	
procharona,	প্রচারণা,	প্রচারণা,	
ankanshilpe,	আঙ্কানশিল্পে,	অঙ্কনশিল্পে,	
somoodrotote,	সমুদ্রততে,	সমুদ্রতটে,	
prasadhoner,	প্রাসাধনের,	প্রসাধনের,	
dooburira,	দুবুরীরা,	ডুবুরিরা,	
orthanitir,	অর্থানীটির,	অর্থনীতির,	
tahorir,	তহরীর,	তাহরীর,	
phaltu,	ফালটু,	ফালতু,	
restuarant,	রেস্টুয়ারান্ট,	রেষ্টুরেন্ট,	
jaanar,	যানার,	জানার,	
rahee,	রহি,	রাহী,	
baju,	বাজু,	বাজু,	
lishenshe,	লিশেন্সে,	লাইসেন্স,	
osommotite,	অসম্মতিতে,	অসম্মতি,	
bikretaara,	বিক্রেতারা,	বিক্রেতারা,	
armori,	আরমোরি,	আরমোরি,	
aanaan,	আনান,	আনান,	
philo,	ফিলো,	ফিলো,	
deeares,	ডিয়ারেস,	ডিআরএস,	
songrahak,	সংগ্রহক,	সংগ্রাহক,	
neerbahe,	নিরবাহে,	নির্বাহে,	
nachiketa,	নচিকেতা,	নচিকেতা,	
laaisensh,	লাইসেন্স,	লাইসেন্স,	
highcomissione,	হাইকমিশনে,	হাইকমিশনে,	
rajdhani,	রাজধানি,	রাজধানি,	
fakhrul,	ফখরুল,	ফাখরুল,	
sompadonkaree,	সম্পাদনকারী,	সম্পাদনকারী,	
apad,	আপাদ,	আপদ,	
chhuteer,	ছুটির,	ছুটির,	
supplenza,	সাপ্লেনজা,	সাপলেঞ্জা,	
kaamij,	কামিজ,	কামিজ,	
suhasini,	সুহাসিনী,	সুহাসিনী,	
gorrer,	গোরের,	গোরের,	
bipajjanak,	বিপজ্জাকাক,	বিপজ্জনক,	
dakshinangsho,	দক্ষিণাংশ,	দক্ষিণাংশ,	
shiter,	শীতের,	শীতের,	
uparzoner,	উপার্জনের,	উপার্জনের,	
zeland,	জেল্যান্ড,	জিল্যান্ড,	
taposgoner,	তাপসগণের,	তাপসগণের,	
grahoksebai,	গ্রাহকসেবাই,	গ্রাহকসেবায়,	
balatarin,	বালাতারিন,	বালাতারিয়ান,	
michir,	মিচির,	মিচির,	
joisttho,	জৈস্থ্য,	জ্যৈষ্ঠ,	
nederlande,	নেডারল্যান্ডে,	নেদারল্যান্ডে,	
osthishondhi,	অস্থিসন্ধি,	অস্থিসন্ধি,	
amiretus,	আমিরেটাস,	এমিরেটাস,	
ukeliptash,	উকেলেপ্তাশ,	ইউক্যালিপ্টাস,	
maudelder,	মাউডলের,	মডেলদের,	
seqtara,	সেক্তারা,	সেক্টর,	
siddhante,	সিদ্ধান্তে,	সিদ্ধান্তে,	
modhumotii,	মধুমতিই,	মধুমতী,	
sorsa,	সর্সা,	সোর্স,	
forex,	ফোরেক্স,	ফরেক্স,	
dokaangoolote,	দোকানগুলোতে,	দোকানগুলোতে,	
ramantika,	রমণনটিকা,	রোমান্টিক,	
temanti,	তেমন্তি,	তেমনটি,	
parisankhanbid,	পরিসংখানবিদ,	পরিসংখ্যানবিদ,	
bojhao,	বোঝাও,	বোঝাও,	
khilaphat,	খিলাফাত,	খিলাফত,	
rca,	আরএসিএ,	আরসিএ,	
byan,	ব্যান,	ব্যাং,	
maritimer,	মারিটিমের,	মেরিটাইমের,	
thaii,	থাই,	থাই,	
jaanachhe,	যানাছে,	জানাচ্ছে,	
maudelgulo,	মাদেলগুলো,	মডেলগুলো,	
baipash,	বাইপাশ,	বাইপাস,	
foxcon,	ফক্সকন,	ফক্সকন,	
boudher,	বৌধের,	বৌদ্ধের,	
parikhar,	পারিখার,	পরিখার,	
marmader,	মারমাদের,	মারমাদের,	
riazuddin,	রিয়াজউদ্দিন,	রিয়াজউদ্দীন,	
nabyata,	নব্যতা,	নাব্যতা,	
nanilalke,	নানিলালকে,	ননীলালকে,	
fasi,	ফাসি,	ফাঁসী,	
mailkhanek,	মাইলখানেক,	মাইলখানেক,	
rockibul,	রকিবুল,	রকিবুল,	
abheedhanic,	অভিধানিক,	অভিধানিক,	
kaloniir,	কালনীর,	কালনীর,	
swasthohinotay,	স্বাস্থ্যহীনতায়,	স্বাস্থ্যহীনতায়,	
jahara,	জাহারা,	যাহরা,	
ekbai,	একবাই,	একবাই,	
qyantana,	ক্যান্নাটান,	ক্যান্টন,	
kormokarer,	কর্মকারের,	কর্মকারের,	
nisader,	নিসাদের,	নিষাদের,	
perri,	পেরী,	পেরি,	
lopjonito,	লোপজনিত,	লোপজনিত,	
kichudinpar,	কিছুদিনপার,	কিছুদিনপর,	
koomarir,	কুমারির,	কুমারীর,	
nathibhuktir,	নাঠিভুক্তির,	নথিভুক্তির,	
shite,	সীতে,	শীতে,	
inziniyarsa,	ইনজিনিয়ারসা,	ইঞ্জিনিয়ার্স,	
hoil,	হইল,	হইল,	
blogarra,	ব্লোগাররা,	ব্লগাররা,	
nodiiteyi,	নদীতীই,	নদীতেই,	
sahittekder,	সাহিত্যকদের,	সাহিত্যেকদের,	
rajtontre,	রাজতন্ত্রে,	রাজতন্ত্রে,	
scholarship,	স্কলারশিপ,	স্কলারশিপ,	
snehban,	স্নেহবান,	স্নেহবান,	
deelibhara,	দিলিভার,	ডেলিভার,	
camerapersoner,	ক্যামেরাপার্সনের,	ক্যামেরাপার্সনের,	
harbore,	হারবোর,	হারবারে,	
muhaiminer,	মুহাইমিনের,	মুহাইমিনের,	
nirvaha,	নির্ভহ,	নির্বাহ,	
dakticket,	ডাক্িকট,	ডাকটিকিট,	
ekla,	একলা,	একলা,	
trenda,	ট্রেন্ডা,	ট্রেন্ড,	
bohoodin,	বহুদিন,	বহুদিন,	
vishnuu,	বিশ্নু,	বিষ্ণু,	
mulyayonsapekkhe,	মূল্যায়নপায়েক্ষে,	মূল্যায়নসাপেক্ষে,	
dwipke,	দ্বিপকে,	দ্বীপকে,	
alumni,	আলূমনি,	অ্যালমনি,	
ooporoshtho,	অপরস্থ,	উপরস্থ,	
gotirodh,	গতিরোধ,	গতিরোধ,	
tukrote,	টুকরোতে,	টুকরোতে,	
uporzon,	উপরজন,	উপার্জন,	
kathmandute,	কাঠমাণ্ডুতে,	কাঠমান্ডুতে,	
protinito,	প্রতীনীত,	প্রতিনিত,	
notti,	নটি,	নোটটি,	
alkatra,	অলকাত্র,	আলকাতরা,	
shikkhartheerao,	শিক্ষার্থীতারাও,	শিক্ষার্থীরাও,	
miley,	মাইলি,	মিলে,	
sangaskritipreme,	সংস্কৃতিপ্রমে,	সংস্কৃতিপ্রেমে,	
nagorikderkey,	নাগরীকদেরকে,	নাগরিকদেরকে,	
aashanka,	আশঙ্কা,	আশংকা,	
dinara,	দিনারা,	ডিনার,	
tottorat,	তত্বরত,	তওরাত,	
ceramiksh,	সেরামিক্স,	সিরামিকস,	
drissoteer,	দৃশ্মতির,	দৃশ্যটির,	
poddhotiteyi,	পদ্ধতিতেই,	পদ্ধতিতেই,	
ghenshei,	ঘেঁসেই,	ঘেঁষেই,	
ashankai,	আশঙকাই,	আশঙ্কাই,	
bornanukrome,	বর্ণানুক্রমে,	বর্নানুক্রমে,	
kekru,	কেকরু,	কেকরু,	
codee,	কোডী,	কোডে,	
jeshtha,	যেষ্ঠা,	জ্যেষ্ঠা,	
pitiler,	পিতিলের,	পিটিলের,	
tuleche,	তুলেছে,	তুলেছে,	
udor,	উদোর,	উদর,	
sambatsarkal,	সম্বাতকরকাল,	সম্বৎসরকাল,	
kokeyin,	কোকেনিন,	কোকেইন,	
queri,	কোররি,	কোয়েরি,	
proo,	প্রুও,	প্রো,	
janar,	জানার,	জানার,	
bojiye,	বজিয়ে,	বজিয়ে,	
neker,	নেকের,	নেকের,	
postar,	পোস্টার,	পোস্টের,	
aziza,	আজিজা,	আজিজা,	
shikkharrthirao,	শিক্ষার্থীরাও,	শিক্ষার্থীরাও,	
manushgulor,	মানুষগুলোর,	মানুষগুলোর,	
sobrakamer,	সবরকামার,	সবরকমের,	
borendroke,	বরেন্দ্রকে,	বরেন্দ্রকে,	
idyi,	ইদ্লি,	আইডিই,	
prokolpogulor,	প্রকল্পগুলোর,	প্রকল্পগুলোর,	
sorting,	সরটটিং,	সর্টিং,	
kamti,	কামটি,	কমতি,	
byaboharkareer,	ব্যবহারকারীর,	ব্যবহারকারীর,	
graambaashio,	গ্রামবাসীও,	গ্রামবাসীও,	
baet,	বিএট,	বাইট,	
inapharameshana,	ইনফফরমেশন,	ইনফরমেশন,	
matorom,	মাটোরম,	মাতরম,	
rajpur,	রাজপুর,	রাজপুর,	
krema,	ক্রেমা,	ক্রাইম,	
modelgulo,	মডেলগুলো,	মডেলগুলো,	
udbhabaney,	উদ্ভাবনে,	উদ্ভাবনে,	
