bhenasha,	ভেনাশা,	ভেনাস,	
ekspression,	এক্সপ্রেশন,	এক্সপ্রেশন,	
fising,	ফিসিং,	ফিসিং,	
jaubankal,	যৌবনকাল,	যৌবনকাল,	
generalissimo,	জেনারালিসিমিও,	জেনারেলিসিমো,	
khorsed,	খোরসেড,	খোরশেদ,	
queri,	কুয়েরি,	কোয়েরি,	
vushito,	ভুশিত,	ভূষিত,	
mahasava,	মহাসব,	মহাসভা,	
ekghare,	একঘরে,	একঘরে,	
ixprission,	এক্সপ্রিশন,	এক্সপ্রেশন,	
dibug,	দিবুগ,	ডিবাগ,	
chaanoo,	চানু,	চানু,	
probhuder,	প্রভুদের,	প্রভুদের,	
cheenja,	চিনজা,	চেঞ্জ,	
tenishe,	তেনিশে,	টেনিসে,	
bhotomulyoke,	ভোটমুল্যকে,	ভোটমূল্যকে,	
zibonnogor,	জিবননগর,	জীবননগর,	
dhaleshorii,	ধলেশরিই,	ধলেশ্বরী,	
lyaandeeng,	ল্যান্ডিং,	ল্যান্ডিং,	
kobutorer,	কবুতরের,	কবুতরের,	
shotodha,	শতধা,	শতধা,	
teentir,	তেনটির,	তিনটির,	
kathla,	কাথলা,	কাঠলা,	
umb,	উম্ব,	ইউএমবি,	
gyandaas,	জ্ঞানদাস,	জ্ঞানদাস,	
oncolsoho,	অঙ্কলসহ,	অঞ্চলসহ,	
farna,	ফার্না,	ফার্ন,	
jeten,	জেটেন,	জেতেন,	
daaktikit,	ডাক্তিকটি,	ডাকটিকিট,	
elakaai,	এলাকাই,	এলাকাই,	
maudelti,	মডেলটি,	মডেলটি,	
karadando,	কারাদান্দো,	কারাদণ্ড,	
samratra,	সম্রাত্র,	সম্রাটরা,	
hisaber,	হিসাবের,	হিসাবের,	
dokaanei,	দোকানেই,	দোকানেই,	
laat,	লাট্ট,	লাট,	
maradeha,	মারেদহ,	মরদেহ,	
jalarong,	জালারং,	জলরঙ,	
gore,	গোরে,	গোর,	
asaktibandhan,	অসকততিবন্ধন,	আসক্তিবন্ধন,	
dhamshrenite,	ধামশ্রেণীতে,	ধামশ্রেণীতে,	
proteemar,	প্রতিমার,	প্রতিমার,	
ghatiti,	ঘাটিটি,	ঘাঁটিটি,	
swarther,	স্বার্থের,	স্বার্থের,	
sonaicha,	সোনাইছা,	সোনাইচা,	
karir,	করির,	কারীর,	
nabayug,	নবযয়ুগ,	নবযুগ,	
taffsherer,	তাফশেরের,	তাফসীরের,	
bite,	বিটে,	বাইট,	
chakradhare,	চক্রাধরে,	চক্রধরে,	
antarvuktimulak,	অন্তর্ভুতিমূলক,	অন্তর্ভুক্তিমূলক,	
muchi,	মুচি,	মুচি,	
vagni,	ভাগনি,	ভগ্নী,	
munshiji,	মুন্িজি,	মুনশীজি,	
jotsna,	জোটস্না,	জ্যোৎস্না,	
nirgomon,	নির্গমন,	নির্গমন,	
nariderke,	নারীদেরকে,	নারিদেরকে,	
moorali,	মুরালী,	মুরলী,	
poschimey,	পশ্চিমে,	পশ্চিমে,	
direectoratee,	ডিরেক্টরেট,	ডিরেক্টরেট,	
iraner,	ইরানের,	ইরানের,	
naobihar,	নওওবিহার,	নৌবিহার,	
anchalei,	অঞ্চলেই,	অঞ্চলেই,	
sofie,	সোফি,	সোফি,	
sharoker,	শারকের,	স্মারকের,	
rakim,	রাকিম,	রাকিম,	
shho,	শো,	শো,	
laaisensh,	লাইসেন,	লাইসেন্স,	
sqolastiq,	স্কোলাস্টিক,	স্কলাস্টিক,	
scoore,	স্কার,	স্কোর,	
armshtronj,	আর্মশ্রোনজ,	আর্মস্ট্রং,	
shrabosty,	শ্রাবস্টি,	শ্রাবস্তী,	
obdi,	অবদি,	অব্দি,	
hyaloyin,	হ্যালোয়িন,	হ্যালোইন,	
fitarsaho,	ফিতারসহ,	ফিতরসহ,	
dolu,	দোলু,	ডলু,	
apolokbhabe,	অপলকবভাবে,	অপলকভাবে,	
nirdesika,	নির্দেসিকা,	নির্দেশিকা,	
alexandar,	আলেক্সান্দার,	আলেকজান্ডার,	
neemitte,	নেমিত্তে,	নিমিত্তে,	
bojhey,	বঝঝে,	বোঝে,	
nathibhuktir,	নাঠিভুক্তির,	নথিভুক্তির,	
torkareer,	তর্করের,	তরকারীর,	
sip,	সিপ,	শিপ,	
bulichev,	বুলিচেভ,	বুলিচেভ,	
argead,	আর্জেড,	আর্জিদ,	
alraji,	আলরাজি,	আলরাজী,	
humner,	হুমেনের,	হামনার,	
marri,	মারি,	ম্যারি,	
daaktikite,	ডাক্িিটিতে,	ডাকটিকিটে,	
gotihin,	গতিহীন,	গতিহীন,	
seo,	সেও,	সেও,	
noitik,	নৈতিক,	নৈতিক,	
siima,	সিমা,	সীমা,	
poderthobid,	পদের্থবিদ,	পদার্থবিদ,	
abhidhanick,	অভিধানিক,	অভিধানিক,	
renoo,	রেনো,	রেনো,	
juddhahato,	যুদ্ধাহাত,	যুদ্ধাহত,	
hames,	হামেস,	হোমস,	
chandanara,	চন্দনারা,	চন্দনারা,	
subade,	সুবাদে,	সুবাদে,	
suporichita,	সুপরিচিতা,	সুপরিচিত,	
pet,	পেট,	পেত,	
dojo,	দজজো,	ডোজো,	
sbajan,	স্বজন,	স্বজন,	
cheess,	চেস,	চেস,	
votarer,	ভোটারের,	ভোটারের,	
badargaji,	বাদারগাজী,	বদরগাজী,	
langhoner,	লা্ঘনের,	লংঘনের,	
hepatetisa,	হেপাটেটিসা,	হেপাটাইটিস,	
elaakaate,	এলাকাতে,	এলাকাতে,	
ishton,	ইই্তন,	স্টোন,	
koyekbare,	কয়েকবারে,	কয়েকবারে,	
beshakbar,	বেশকবার,	বেশকবার,	
nobotomo,	নবতম,	নবতম,	
gosthike,	গোষ্ঠীকে,	গোষ্ঠীকে,	
vimsen,	ভিমসেন,	ভীমসেন,	
nojder,	নজদের,	নজদের,	
asamonjasyopurno,	আসামঞ্জস্যূপন্র,	অসামঞ্জস্যপূর্ণ,	
naagaalyand,	নাগল্যান্দ,	নাগাল্যান্ড,	
grotha,	গ্রোথা,	গ্রোথ,	
nanir,	নানির,	নানীর,	
mujuru,	মুজুরু,	মুজুরু,	
simons,	সিমোস্,	সিমন্স,	
suchanakal,	সূচনাকাল,	সূচনাকাল,	
prokolpoti,	প্রকল্পটি,	প্রকল্পটি,	
nirgoon,	নিরগুন,	নির্গুণ,	
dokaangoolote,	দোকানগুলোতে,	দোকানগুলোতে,	
ghoomato,	ঘুমাতো,	ঘুমাতো,	
baaik,	বাইক,	বাইক,	
abeganuvutir,	আবেগানুহূতির,	আবেগানুভূতির,	
skolarsip,	স্কোলরসিপ,	স্কলারশিপ,	
chakti,	চাকতি,	চাকতি,	
jaanar,	যানার,	জানার,	
poribahokotto,	পরিবাহকত্ব,	পরিবাহকত্ব,	
onupater,	অনুপাতের,	অনুপাতের,	
aholya,	অহল্যা,	অহল্যা,	
prarthonakokkher,	প্রার্থনাক্ষষের,	প্রার্থনাকক্ষের,	
mast,	মসস্ট,	মাস্ত,	
khargosher,	খরগোশের,	খরগোসের,	
dormroome,	ডর্োরিম,	ডর্মরুমে,	
bone,	বনে,	বনে,	
victor,	ভিক্টর,	ভিক্টর,	
olpo,	ওলপ,	অল্প,	
alaol,	আলাওল,	আলাওল,	
greep,	গ্রিপ,	গ্রিপ,	
teestar,	তেস্তার,	তিস্তার,	
karmokarke,	কর্মকারকে,	কর্মকারকে,	
shommotir,	সম্মতির,	সম্মতির,	
snehban,	স্নেহবান,	স্নেহবান,	
faase,	ফাসে,	ফাঁসে,	
dushtogone,	দুষ্টগণে,	দুষ্টগণে,	
sikkharthirao,	শিক্ষার্থীরাও,	শিক্ষার্থীরাও,	
sangosrobomukto,	সংস্রবূমকু্ত,	সংস্রবমুক্ত,	
boshoborty,	বশবর্তী,	বশবর্তী,	
debdebyr,	দেবদেবীর,	দেবদেবীর,	
musolmanera,	মুসোলমেনারা,	মুসলমানেরা,	
probeshan,	প্রবেশন,	প্রবেশন,	
antarctica,	অন্তারক্সিকা,	অ্যান্টার্কটিকা,	
bhalobaas,	ভালোবাস,	ভালোবাসা,	
hepatitis,	হেপাটাটিস,	হেপাটাইটিস,	
goolen,	গুলেন,	গুলেন,	
nabatarange,	নবতরঙ্গে,	নবতরঙ্গে,	
cn,	সিএনএ,	সিএন,	
elakatir,	এলাকাটির,	এলাকাটির,	
bhogno,	ভগ্ন,	ভগ্ন,	
iuro,	আইআরও,	ইউরো,	
byke,	বিএইকে,	বাইক,	
bhadaka,	ভাদাকা,	ভদকা,	
paner,	পানের,	পানের,	
jeebanjapon,	জীবনজাপন,	জীবনযাপন,	
oojbekistan,	ওজবেকিৎসান,	উজবেকিস্তান,	
shakankti,	শকনক্তি,	শকাঙ্কটি,	
hindutirtha,	হিন্দুতীর্থ,	হিন্দুতীর্থ,	
qredita,	ক্রেডিটা,	ক্রেডিট,	
notey,	নটে,	নোটে,	
laagche,	লাগছে,	লাগছে,	
elakasoho,	এলাকাসহ,	এলাকাসহ,	
kheshar,	খেশার,	খেশার,	
prachando,	প্রাচাণ্ড,	প্রচণ্ড,	
soheensotar,	সহিনসতার,	সহিংসতার,	
inziniyarsa,	ইঞ্জিনিয়ারসসা,	ইঞ্জিনিয়ার্স,	
rajyabhogi,	রাজ্যভোগী,	রাজ্যভোগী,	
shahanara,	শাহানারা,	শাহানারা,	
pustir,	পুস্তির,	পুষ্টির,	
bakhyateet,	বাযাখ্যাটিত,	ব্যাখ্যাতীত,	
shlok,	শ্লোক,	শ্লোক,	
bayshorkarikarone,	বাযস্ররকীরণকরণে,	বেসরকারিকরণ,	
okkhorke,	অক্ষরকে,	অক্ষরকে,	
anektai,	অনেকটাই,	অনেকটাই,	
bokul,	বকুল,	বকুল,	
primoo,	প্রিমও,	প্রিমো,	
protyokkhovabey,	প্রত্যক্ষভাবে,	প্রত্যক্ষভাবে,	
ruble,	রাবল,	রুবল,	
alaul,	আলাউল,	আলাওল,	
jaunotar,	যৌনতার,	যৌনতার,	
title,	টিটল,	টাইটেল,	
chikkingsasoho,	চিক্কিংবাসহ,	চিকিংসাসহ,	
lampot,	লাম্পট,	লম্পট,	
senabahineeow,	সেনাবাহিনভ,	সেনাবাহিনীও,	
chokrantosoho,	চক্রান্তসহ,	চক্রান্তসহ,	
aro,	আরো,	আরও,	
nischitobhave,	নিশ্চিতভাবে,	নিশ্চিতভাবে,	
masto,	মাস্তো,	মাস্ত,	
nirvachokder,	নির্বাচকদের,	নির্বাচকদের,	
goteehin,	গতিহীন,	গতিহীন,	
mahakabi,	মহাকাবী,	মহাকবি,	
vabuk,	ভাবুক,	ভাবুক,	
bisshas,	বিশ্বাস,	বিশ্বাস,	
goodamjato,	গুদামজাত,	গুদামজাত,	
ved,	ভেড,	বেদ,	
danakana,	দনকানা,	ডানকান,	
fud,	ফুড,	ফুড,	
chirkut,	চিরকুট,	চিরকুট,	
bahubar,	বাহুবার,	বহুবার,	
samajik,	সামাজিক,	সামাজিক,	
taroni,	তারনি,	তরণী,	
ovidhaner,	অভিধানের,	অভিধানের,	
teunar,	টেউনার,	টিউনার,	
yaq,	যাক,	ইয়াক,	
kruser,	ক্রুসের,	ক্রুশের,	
vandar,	ভান্ডার,	ভাণ্ডার,	
chalaabi,	চালাবি,	চালাবে,	
neshnosh,	নেশনোষ,	নেশনস,	
mukhya,	মুখ্যা,	মুখ্য,	
edmiral,	এদমিরাল,	এডমিরাল,	
chyeta,	চ্যেট,	চ্যাট,	
bhittiti,	ভিত্তিটি,	ভিত্তিটি,	
oncholshomuher,	অঞ্চলসমূহের,	অঞ্চলসমূহের,	
miraqela,	মিরাকেলা,	মিরাকেল,	
diiptii,	দিপপ্তিই,	ডেপুটি,	
bhageri,	ভাগেরি,	ভাগেরই,	
souripurang,	সৌরিপূর্ং,	সৌরিপুরং,	
sheshdinti,	শেষদিনটি,	শেষদিনটি,	
noiteek,	নৈটিক,	নৈতিক,	
mythological,	ম্থোলোজিক্যাল,	মাইথলজিকাল,	
hillse,	হিলসে,	হিলসে,	
nischitobhabe,	নিশ্চিতভাবে,	নিশ্চিতভাবে,	
mane,	ম্যান,	মানে,	
monjooshree,	মঞ্জর্ষী,	মঞ্জুশ্রী,	
bhushito,	ভূষিত,	ভূষিত,	
graminphonor,	গ্রামিনপনুর,	গ্রামীণফোনর,	
dormitory,	ডরমিটরী,	ডরমিটরি,	
blyaka,	ব্লেয়াকা,	ব্ল্যাক,	
towraat,	টোবরাট,	তওরাত,	
sadeep,	সাদীপ,	সদীপ,	
byabostho,	ব্যবস্থ,	ব্যাবস্থা,	
madhnagar,	মধনগর,	মাধনগরের,	
basermick,	বেসরর্মিক্স,	বেসারমিক,	
mirakela,	মিরাকেলা,	মিরাকেল,	
ahalyar,	অহল্যার,	অহল্যার,	
shchalastic,	স্কালাস্টিক,	স্কলাস্টিক,	
premoronge,	প্রেমরণ্গে,	প্রেমরঙে,	
taitela,	তাইতেলা,	টাইটেল,	
senabahinikey,	সেনাবাহিনীকে,	সেনাবাহিনীকে,	
bhogni,	ভগ্নি,	ভগ্নী,	
carlos,	কারলোোস,	কার্লোস,	
bishwaashshoi,	বিশ্বশ্বই,	বিশ্বাসই,	
breakthrough,	ব্রেক্ষরুঘ্,	ব্রেকথ্রু,	
vabaponno,	ভববপন্ন,	ভাবাপন্ন,	
durgotsabe,	দুর্গোৎসবে,	দুর্গোৎসবে,	
farid,	ফারিদ,	ফরিদ,	
popaike,	পোপাইকে,	পপাইকে,	
itastata,	ইটাসটাটা,	ইতস্তত,	
okritokarjo,	অকৃতকার্য্য,	অকৃতকার্য,	
phiqsa,	ফিকেস,	ফিক্স,	
abosan,	অবসান,	অবসান,	
residence,	রেসিডেন্সে,	রেসিডেন্স,	
infarmatian,	ইনফারমেটন,	ইনফরমেশন,	
billaho,	বিল্লাহ,	বিল্লাহ,	
bhejaano,	ভেজানো,	ভেজানো,	
drissogoolote,	দৃকশগুলোতে,	দৃশ্যগুলোতে,	
chhon,	ছন,	ছোঁ,	
eoki,	ইওকি,	এওকি,	
dubureer,	ডুবুরির,	ডুবুরির,	
dwipke,	দ্বিপকে,	দ্বীপকে,	
mashtarsha,	মাষ্টার্শা,	মাস্টার্স,	
nutunotto,	নুতুনত্ব,	নতুনত্ব,	
sosoa,	সোসো,	শশা,	
deobonde,	দেওবন্দে,	দেওবন্দে,	
bikretara,	বিক্রেতারা,	বিক্রেতারা,	
nagorikra,	নাগরিকরা,	নাগরিকরা,	
supplenza,	সাপলেনজেজা,	সাপলেঞ্জা,	
debate,	দেবাতে,	ডিবেট,	
dhwajbhango,	ধ্বাভগঙ্গ,	ধ্বজভঙ্গ,	
pronoti,	প্রণতি,	প্রণতি,	
chiroharit,	চিরোহারিত,	চিরহরিৎ,	
jontrangshogulor,	যন্ত্রাংশগুলোর,	যন্ত্রাংশগুলোর,	
fanse,	ফ্যান্সে,	ফাঁসে,	
shasankorta,	শাসনকর্তা,	শাসনকর্তা,	
rodney,	রডনে,	রেডনি,	
bulan,	বুলান,	বুলান,	
protijogiider,	প্রতিযোগীদের,	প্রতিযোগীদের,	
kanasarabheeshana,	কনসরাশেশন,	কনসারভেশন,	
chupani,	চুপানী,	চুপানি,	
shingping,	শিংফিং,	শিংপিং,	
nili,	নিলী,	নিলি,	
zoojyota,	যোযজ্যতা,	যোজ্যতা,	
jerushalema,	জেরুশালেমা,	জেরুসালেম,	
muktijuddhojato,	মুক্তিযুদ্ধতাও,	মুক্তিযুদ্ধজাত,	
mukharji,	মুখররজি,	মুখার্জী,	
nirbaahe,	নির্বাহে,	নির্বাহে,	
makhno,	মাখনো,	মাখনো,	
balokarak,	বালোকারক,	বলকারক,	
kosambir,	কোসাম্বীর,	কোসাম্বীর,	
mehsus,	মেহসুস,	মেহসুস,	
dinifitian,	ডিনিফিটিয়ান,	ডেফিনেশন,	
saramukhe,	সরমুখে,	সারামুখে,	
feemalee,	ফিমলে,	ফিমেল,	
drishyer,	দৃশ্যের,	দৃশ্যের,	
bayii,	বাইয়ি,	বাঈ,	
adorsho,	আদর্শ,	আর্দশ,	
rananganey,	রণাঙ্গনে,	রণাঙ্গনে,	
creshcent,	ক্রিসেন্ট,	ক্রিসেন্ট,	
siraju,	সিরাজু,	সিরাজু,	
ghomta,	ঘোমটা,	ঘোমটা,	
panchashjan,	পঞ্চাশ্যন,	পঞ্চাশজন,	
graambasheeo,	গ্রামবাশেও,	গ্রামবাসীও,	
srisri,	শ্রীশ্রি,	শ্রীশ্রী,	
punorabortonte,	পুনরাবর্তন্তে,	পুনরাবর্তন্তে,	
bhenom,	ভেনম,	ভেনম,	
purbanchaler,	পূর্বাঞ্চলের,	পূর্বাঞ্চলের,	
dacope,	ডাকোপ,	দাকোপ,	
shattoki,	শাত্তকী,	সাত্যকি,	
priseflex,	প্রাইসফিল্সক,	প্রাইজফ্লেক্স,	
minister,	মিনিস্টার,	মিনিস্টার,	
abhidhaanic,	অভিধানিক,	অভিধানিক,	
aziza,	আজিজা,	আজিজা,	
balatkar,	বালাটকর,	বলাৎকার,	
kinsa,	কিনস,	কিংস,	
bee,	বীইই,	বি,	
iling,	ইলিং,	ইলিং,	
capsule,	ক্যাপসুল,	ক্যাপ্সুল,	
mukhabandha,	মুখবন্ধ,	মুখবন্ধ,	
dooburira,	দুবুরিরা,	ডুবুরিরা,	
makong,	মাকং,	মেকং,	
attorkite,	আত্তরকিতে,	অতর্কিতে,	
jeelyaand,	জিল্যান্দ,	জিল্যান্ড,	
catholicbad,	ক্যাথলিবাদ,	ক্যাথলিকবাদ,	
chinto,	চিন্তো,	চিনতো,	
kade,	কাড়ে,	কোড,	
ratishilatai,	রতিশীলতাই,	রতিশীলতায়,	
bosonte,	বসন্তে,	বসন্তে,	
probhura,	প্রভুরা,	প্রভুরা,	
aarke,	আরকে,	আরকে,	
beam,	বিয়াম,	বিম,	
aamoode,	আমোদে,	আমুদে,	
parking,	পারকিং,	পার্কিং,	
shasankarta,	শাসনকর্তা,	শাসনকর্তা,	
volivoler,	ভলিভলের,	ভলিভলের,	
poriikkhateo,	পরীক্ষাতেও,	পরীক্ষাতেও,	
kul,	কুল,	কুল,	
qarlosa,	কারলোসা,	কার্লোস,	
reetesh,	রিতেশ,	রিতেশ,	
fibergulote,	ফাইবারগুলোতে,	ফাইবারগুলোতে,	
brekthrough,	ব্রেকৃতগুধ,	ব্রেকথ্রু,	
shahoshikatar,	শাহসিকতার,	সাহসিকতার,	
manushti,	মানুষ্টি,	মানুষটি,	
kamti,	কামটি,	কমতি,	
kormoke,	কর্মকে,	কর্মকে,	
dip,	ডিপ,	দীপ,	
gazetted,	গ্যাজেট্ডে,	গেজেটেড,	
coons,	কুন্স,	কুনস,	
rezidence,	রেজিডেন্সে,	রেসিডেন্স,	
bouddho,	বৌদ্ধ,	বৌদ্ধ,	
prity,	প্রিযি,	প্রিটি,	
sommotite,	সম্মতিতে,	সম্মতিতে,	
abadamoner,	আবাদামনের,	অবদমনের,	
jaandrel,	যাঁদ্রেল,	জাঁদরেল,	
khalidkay,	খলিকদা,	খালিদকে,	
doorger,	দুর্গের,	দুর্গের,	
charban,	চারবান,	চর্বন,	
pretti,	প্রেট্টি,	প্রিটি,	
shamijir,	শামিজীর,	স্বামীজীর,	
eshtonia,	এষ্টনিয়া,	এস্তোনিয়া,	
europia,	ইউরোপিয়া,	ইউরোপিয়া,	
durarohini,	দুরারোহিনী,	দুরারোহিণী,	
dokaangulotey,	ডোকানগুলোতে,	দোকানগুলোতে,	
hilser,	হিলসার,	হিলসের,	
nisader,	নিসাদের,	নিষাদের,	
teman,	টেম্যান,	তেমন,	
poripake,	পরিপাকে,	পরিপাকে,	
aizulke,	আইজুলকে,	আইজুলকে,	
volapuk,	ভোলাপুক,	ভোলাপুক,	
porinoti,	পরিণতি,	পরিণতি,	
jibnagore,	জীবনাগরে,	জীবননগর,	
pleto,	প্লেটো,	প্লেটো,	
gorrer,	গোরের,	গোরের,	
dwibidho,	দ্বিবিধো,	দ্বিবিধ,	
tookrote,	টুকরোট,	টুকরোতে,	
onker,	অঙ্কের,	ওঙ্কার,	
review,	রেভিউ,	রিভিউও,	
rajbondir,	রাজবন্দির,	রাজবন্দীর,	
suiza,	সুইজা,	সুইজা,	
qarqa,	কারকা,	কার্ক,	
osoborno,	অসবর্ণ,	অসবর্ণ,	
addabaj,	আড্ডাবাজ,	আড্ডাবাজ,	
fimela,	ফাইমলা,	ফিমেল,	
domone,	ডমনে,	দমনে,	
firozaa,	ফিরোজা,	ফিরোজা,	
mitroder,	মিত্রোদের,	মিত্রদের,	
patishapta,	পাটিশাপ্ত,	পাটিসাপটা,	
rudroke,	রুদ্রকে,	রুদ্রকে,	
smarok,	স্মারক,	স্মারক,	
dhanijomite,	ধনিজমিতে,	ধানিজমিতে,	
manohputa,	মনোহপুতা,	মনঃপুত,	
oxforde,	ওক্সফোর্ডে,	অক্সফোর্ডে,	
mitrata,	মিত্রাটা,	মিত্রতা,	
pinogbagke,	পিনবগাগকে,	পিনগবাগকে,	
konagoolo,	কোনাগুলো,	কণাগুলো,	
mekong,	মেকং,	মেকং,	
akatwa,	আকাত্ব,	একাত্ব,	
ghoomachhe,	ঘুমাচ্ছে,	ঘুমাচ্ছে,	
musabbirul,	মুসাববিরুল,	মুসাব্বিরুল,	
krus,	ক্রুস,	ক্রুশ,	
sazanor,	সাজানোর,	সাজানোর,	
blacq,	ব্ল্যাক,	ব্ল্যাক,	
bojata,	বোজাতা,	বোজাটা,	
qraima,	ক্রেইমা,	ক্রাইম,	
naabyota,	নব্যতা,	নাব্যতা,	
riphleksa,	রিপলেককা,	রিফ্লেক্স,	
graambasider,	গ্রামবাসিদের,	গ্রামবাসীদের,	
sethai,	সেথাই,	সেথাই,	
doneta,	দোনেটা,	ডোনাট,	
harbur,	হারবুর,	হারবার,	
kotibondhe,	কতিবন্ধে,	কটিবন্ধে,	
meshintao,	মেশিনটাও,	মেশিনটাও,	
ghetu,	ঘেটু,	ঘেটু,	
hughkey,	হুথকে,	হিউজকে,	
rajotta,	রাজট্ব,	রাজত্ব,	
reshidensha,	রেশিদেনশা,	রেসিডেন্স,	
neker,	নেকের,	নেকের,	
pleta,	প্লেটা,	প্লেটো,	
asommoti,	অসম্মতি,	অসম্মতি,	
utshahomulok,	উৎ্াহমূলক,	উৎসাহমূলক,	
bishesyo,	বিশেষ্য,	বিশেষ্য,	
maunchostho,	মঞ্চস্থ,	মঞ্চস্থ,	
pleeta,	প্লেট,	প্লেট,	
zommu,	জম্বু,	জম্মু,	
aqram,	আকরাম,	আকরাম,	
engrejra,	এংরেজরা,	ইংরেজরা,	
bhagnekeo,	ভাগনেকেও,	ভাগ্নেকেও,	
ekbai,	একবাই,	একবাই,	
bairey,	বেইরে,	বাইরে,	
audioguloke,	অডিওগুলোকে,	অডিওগুলোকে,	
madrasake,	মাদ্রাসাকে,	মাদ্রাসাকে,	
dhormokorme,	ধর্মকর্মে,	ধর্মকর্মে,	
pray,	প্রি,	প্রায়,	
karmazog,	কারমাজোগ,	কর্মযোগ,	
rajtontre,	রাজতন্ত্রে,	রাজতন্ত্রে,	
nodimaatrik,	নোীমাতার্দিক,	নদীমাতৃক,	
siramikasa,	সিরামিকাসা,	সিরামিকস,	
quartar,	কোয়ারতার,	কোয়ার্টার,	
upobasee,	উপবাসী,	উপবাসী,	
alimpiqa,	আলিম্পিকা,	অলিম্পিক,	
besur,	বেসুর,	বেসুর,	
brittakare,	বৃত্তকারে,	বৃত্তাকারে,	
aaireshe,	আইরেশে,	আইরেসে,	
stoic,	স্টোইক,	স্টোয়িক,	
chetanagoto,	চেতানগত,	চেতনাগত,	
jonomukhi,	জনমুখি,	জনমুখী,	
prokolpotike,	প্রকল্পটিকে,	প্রকল্পটিকে,	
moushumei,	মৌশুমেই,	মৌসুমেই,	
konorup,	কোনরূপ,	কোনরূপ,	
buddhitii,	বুদ্ধিটিই,	বুদ্ধিটিই,	
pratijogider,	প্রতিযোগীদের,	প্রতিযোগীদের,	
marodeho,	মারোদেহ,	মরদেহ,	
peshto,	পেশতো,	পেষ্ট,	
teenej,	তেনেজ,	টিনেজ,	
mukhobondho,	মুখবন্ধ,	মুখবন্ধ,	
hitaishi,	হিতাইশি,	হিতৈষী,	
sarder,	সারদের,	সরদার,	
kirti,	কীরটি,	কীর্তি,	
ikbaaler,	ইকবালের,	ইকবালের,	
nomo,	নমো,	নমো,	
deep,	ডীপ্,	দীপ,	
dewaben,	দেবাবেন,	দেওয়াবেন,	
quary,	কোয়ারি,	কোয়েরি,	
arke,	আরকে,	আরকে,	
oxfordey,	অক্সফোরডে,	অক্সফোর্ডে,	
batikromi,	বাটিকরমমি,	ব্যতিক্রমী,	
heavy,	হিভি,	হেভি,	
aansareer,	আলসারীর,	আনসারীর,	
miley,	মিলে,	মিলে,	
qaferder,	কাফারদের,	কাফেরদের,	
hafsa,	হাফসা,	হাফসা,	
karaa,	কারা,	কারো,	
firoza,	ফিরোজা,	ফিরোজা,	
plak,	প্ল্যাক,	প্ল্যাক,	
lekhaksattwar,	লেখকস্তত্বার,	লেখকসত্ত্বার,	
madhumati,	মধুমতি,	মধুমতী,	
corymb,	করমম্ব,	করিম,	
nishad,	নিষাদ,	নিষাদ,	
ishtone,	ইস্তনে,	স্টোন,	
phox,	ফককসস,	ফক্স,	
oiteejye,	ঐতিব্যে,	ঐতিহ্যে,	
rajbandi,	রাজবন্দী,	রাজবন্দী,	
armstronz,	আরমস্ট্রোন,	আর্মস্ট্রং,	
jorury,	জরুরির,	জরূরী,	
chalake,	চালাকে,	চালকে,	
licencedhari,	লাইসেন্সধারী,	লাইসেন্সধারী,	
shorifer,	শরীফের,	শরিফের,	
bo,	বোবিও,	বু,	
nazad,	নাজাদ,	নজদ,	
fol,	ফোল,	ফল,	
shhow,	শোভ,	শো,	
roktokhoron,	রক্তখরণ,	রক্তক্ষরণের,	
benojir,	বেনোজির,	বেনজীর,	
dibate,	দিবাতে,	ডিবেট,	
adhyatmikata,	অধ্যাতিকমমতা,	আধ্যাত্মিকতা,	
danab,	দানাব,	দানব,	
setikey,	সেতিকে,	সেটিকে,	
alaoler,	আলাওলের,	আলাওলের,	
hock,	হক,	হুক,	
atmira,	আত্মীরা,	আত্মীরা,	
ekla,	একলা,	একলা,	
pharanyeta,	ফররণ্েটা,	ফরম্যাট,	
irish,	ইরিশ,	আইরিস,	
onchalgulir,	অঞ্চলগুলির,	অঞ্চলগুলির,	
dajjha,	দাজঝা,	দাহ্য,	
bonshi,	বনশি,	বংশী,	
guzon,	গুজন,	গুজব,	
bisshonath,	বিশ্বনাথ,	বিশ্বনাথ,	
tukroti,	তুকরোটি,	টুকরোটি,	
prakare,	প্রকারে,	প্রকারে,	
kleentoner,	ক্লিন্টনের,	ক্লিনটনের,	
airish,	আইরিশ,	আইরিস,	
lungiti,	লুংগিটি,	লুঙ্গিটি,	
jakso,	জ্যাকোসো,	যক্ষ,	
satan,	সাতান,	শয়তান,	
tarunra,	তরুণরা,	তরুণরা,	
gejeted,	গেজেটেড,	গেজেটেড,	
shurugulo,	শুরুগুলো,	শুরুগুলো,	
chaalaabi,	চালাবি,	চালাবে,	
dakter,	ডাক্তের,	ডাকতের,	
alpo,	অল্পো,	অল্প,	
somoibo,	সমৈবব,	সমৈব,	
steen,	স্টিন,	স্টেন,	
palbongser,	পালবংসের,	পালবংশের,	
groth,	গ্রোথ,	গ্রোথ,	
aaps,	এপিএস,	এএপিএস,	
bapokotor,	বাপকতর,	ব্যাপকতর,	
raagee,	রাগগী,	রাগী,	
templet,	টেম্পলেট,	টেম্পলেট,	
miitar,	মিতার,	মিত্র,	
louhojato,	লৌহজাত,	লৌহজাত,	
mozdur,	মজদুর,	মজদুর,	
themeke,	থেমেকে,	থিমকে,	
talgachh,	তালগাছ,	তালগাছ,	
manoharpur,	মনোহরাপুর,	মনোহরপুর,	
stonehenje,	স্টোনেহ্যে,	স্টোনহেঞ্জ,	
ashiatic,	অ্যাশিয়াটিক,	এশিয়াটিক,	
bohudin,	বহুদিন,	বহুদিন,	
grambaseer,	গ্রামবাসীর,	গ্রামবাসীর,	
tanshree,	তানশ্রী,	তানশ্রী,	
paolasthi,	পাওলাস্থি,	পাওলাসথি,	
romarder,	রোমারদের,	রোমারদের,	
mojlish,	মজলিশ,	মজলিশ,	
kuresher,	কুরেশের,	কুরেশের,	
shfingtar,	স্ফিংটার,	স্ফিংটার,	
choritrotakeo,	চরিত্রটাকেও,	চরিত্রটাকেও,	
chadake,	চড়াকে,	চড়াকে,	
makame,	মাকামে,	মাকামে,	
sohinsotar,	সোহিনসতার,	সহিংসতার,	
arthanitike,	অর্থনীতিকে,	অর্থনীতিকে,	
bashoborty,	বাশবর্তী,	বশবর্তী,	
ghatleo,	ঘাটলেও,	ঘটলেও,	
bosante,	বসান্তে,	বসন্তে,	
conservetion,	কনজারভেশন,	কনসারভেশন,	
alsaar,	অলসার,	আলসার,	
greenald,	গ্রিনাল্ড,	গ্রিনল্ড,	
dakticket,	ডক্িিেেট,	ডাকটিকিট,	
zarniz,	জার্নিজ,	জারনিজ,	
suparichiti,	সুপারিচাটি,	সুপরিচিতি,	
peeri,	পীরি,	পেরি,	
maley,	মালি,	মালে,	
dufresne,	ডাফরেন্স,	ডুফরেস্ন,	
mathews,	ম্যাথভস,	ম্যাথিউস,	
jolaatonko,	জলাযত্ন,	জলাতঙ্ক,	
heawy,	হিইয়ি,	হেভি,	
motabolombira,	মতাবলম্বীরা,	মতাবলম্বীরা,	
uddhrita,	উদ্ধিতা,	উদ্ধৃত,	
mokhmoley,	মোখলমে,	মখমলে,	
tata,	তাতা,	তাতা,	
bollov,	বলয়লভ,	বল্লভ,	
prajanankal,	প্রজননকাল,	প্রজননকাল,	
restuarant,	রেস্টুরেয়ান্ট,	রেষ্টুরেন্ট,	
zakharovar,	জখরাওবার,	জাখারোভার,	
echhti,	এছতি,	এছটি,	
casper,	ক্যাসপার,	ক্যাসপার,	
songasthaner,	সংস্থানের,	সংস্থানের,	
khalid,	খালিদ,	খালিদ,	
chal,	চাল,	চাল,	
siqhar,	সিখার,	শিকার,	
girilal,	গিরিলাল,	গিরিলাল,	
prodiiper,	প্রদিপের,	প্রদীপের,	
poroborti,	পরবর্তী,	পরর্বতী,	
chanoo,	চানু,	চানু,	
dong,	ডং,	ডং,	
tigmanshu,	টিগমানশু,	তিগমংশু,	
aakaabaar,	আকাবার,	আকাবার,	
muhurtati,	মুহুর্তটি,	মুহুর্তটি,	
aanaan,	অনান,	আনান,	
utpotti,	উৎপত্তি,	উতপত্তি,	
daakteekite,	ডাক্তিটিতে,	ডাকটিকিটে,	
thyachar,	থ্যাচার,	থ্যাচার,	
satjaner,	সাতজনের,	সাতজনের,	
niharkantibabu,	নীহারকৃনিতবাবু,	নিহারকান্তিবাবু,	
orthonitir,	অর্থনীতির,	অর্থনীতির,	
naajii,	নাজি,	নাত্সি,	
anusthane,	অনুষ্ঠানে,	অনুষ্ঠানে,	
sohokari,	সহকারী,	সহকারী,	
institutione,	ইনষ্টিটিউনন,	ইনস্টিটিউশনে,	
jackey,	জ্যাকে,	জকি,	
dooburir,	ডুবুরির,	ডুবুরির,	
dobhara,	ডোভারা,	ডোভার,	
mulor,	মুলোর,	মুলোর,	
antercticker,	এন্টারকেটিকসের,	অ্যান্টার্কটিকের,	
seekkhokbrindo,	শাক্ষকবৃন্দ,	শিক্ষকবৃন্দ,	
sallallahu,	সাল্লালাহুলু,	সল্লাল্লাহু,	
aditisaha,	আদিতিসহ,	অদিতিসহ,	
rahee,	রাহি,	রাহী,	
lajik,	লাজিক,	লজিক,	
monchostho,	মঞ্চস্থ,	মঞ্চস্থ,	
batikromee,	বাটিক্রমি,	ব্যতিক্রমী,	
kindom,	কিন্দম,	কিংডম,	
qara,	কারা,	কর,	
nabyata,	নব্যতা,	নাব্যতা,	
manobikotao,	মানবিকতাও,	মানবিকতাও,	
shiulijhra,	শিউলিগরা,	শিউলিঝরা,	
shourshe,	শৌর্শে,	সোর্স,	
grambaashi,	গ্রামবাশী,	গ্রামবাসী,	
ganosachetanata,	গণসচেতনত,	গণসচেতনতা,	
soinyora,	সৈন্যরা,	সৈন্যরা,	
sift,	সিফট,	শিফট,	
firti,	ফিরটি,	ফিরতি,	
graambaaseer,	গ্রামবাসীর,	গ্রামবাসীর,	
install,	ইন্সটেল,	ইন্সটল,	
bandra,	বান্দ্রার,	বন্দীরা,	
anagarikra,	অনাগারিকরা,	অনাগরিকরা,	
kayech,	কায়েচ,	কায়েছ,	
pakistanira,	পাকিস্তানিরা,	পাকিস্তানীরা,	
dishani,	দিশানী,	দিশানি,	
istoone,	ইস্তুনে,	স্টোন,	
overholing,	ওভারহলিং,	ওভারহোলিং,	
harasta,	হারাস্তা,	হারাস্তা,	
chomski,	চমস্কি,	চমস্কি,	
taranee,	তারানী,	তরণী,	
helly,	হেলি,	হিলি,	
charpanch,	চরপাঞ্চ,	চারপাঁচ,	
karmakarke,	কারমাকারকে,	কর্মকারকে,	
ceramiker,	সেরামিকের,	সিরামিকের,	
protishta,	প্রতিষ্টা,	প্রতিষ্টা,	
banglota,	বাংলোটা,	বাংলোটা,	
canservatian,	ক্যানসেরভটশা,	কনসারভেশন,	
rubidium,	রুবিদিউম,	রুবিডিয়াম,	
dharabahikvabe,	ধারাবাহিকভাবে,	ধারাবাহিকভাবে,	
bhupal,	ভুপাল,	ভূপাল,	
obhaarbhiu,	অভারভিউ,	ওভারভিউ,	
jatotaa,	জাতোতা,	যতোটা,	
mekon,	মেকন,	মেকং,	
sondhisthaponer,	সন্ধিস্থাপনের,	সন্ধিস্থাপনের,	
teoyana,	তেওয়ান,	তাইওয়ান,	
sheshardhe,	শেষার্ধে,	শেষার্ধে,	
rahee,	রাহি,	রাহি,	
granada,	গ্র্যানাডা,	গ্র্যানাডা,	
batsmanei,	ব্যাটসম্যানেই,	ব্যাটসম্যানই,	
elahabade,	এলাহাবাদে,	এলাহাবাদে,	
manob,	মনোব,	মানব,	
kheylechen,	খেয়েলেছেন,	খেলেছেন,	
machhti,	মাছটি,	মাছটি,	
paripakey,	পরিপাকে,	পরিপাকে,	
gloria,	গ্লোরিয়া,	গ্লোরিয়া,	
ancholsomuho,	অ্যাঙ্চলসমূহ,	অঞ্চলসমূহ,	
ala,	আলা,	আলা,	
mag,	ম্যাগ,	এমএজি,	
noiteekotar,	নৈতিকতার,	নৈতিকতার,	
shikkhakram,	শিক্ষাক্রম,	শিক্ষাক্রম,	
sulfatee,	সুলফাতে,	সালফেট,	
eevil,	ইভিল,	ইভিল,	
siddhantoke,	সিদ্ধান্তকে,	সিদ্ধান্তকে,	
skolastik,	স্কোলস্টিক,	স্কলাস্টিক,	
ajeem,	আজেম,	আজিম,	
choddo,	চোদ্দো,	চোদ্দো,	
qanasarabheshana,	কনসারেশন,	কনসারভেশন,	
ponero,	পনেরও,	পনের,	
bharpur,	ভারপুর,	ভরপুর,	
kanader,	কানাদের,	কণাদের,	
gostigulo,	গোস্তিগুলো,	গোষ্ঠীগুলো,	
banshite,	বাঁশিতে,	বাঁশিতে,	
pluck,	প্লোক,	প্ল্যাক,	
bhangchur,	ভাংচুর,	ভাংচুর,	
ikboler,	ইকবলের,	ইকবলের,	
ovinetar,	অভিনেতার,	অভিনেতার,	
dara,	দারা,	দারা,	
dhrubaker,	ধ্রুবাকের,	ধ্রুবকের,	
peerry,	পিরি,	পেরি,	
saamaanya,	সমম্নয,	সামান্য,	
latsaheb,	লটসাহেব,	লাটসাহেব,	
kaathhaamaandu,	কাঠামন্দু,	কাঠমান্ডু,	
dhanche,	ধাঁচে,	ধাঁচে,	
societykey,	সোসিটিকে,	সোসাইটিকে,	
manibhaijaner,	মণিভাইজানের,	মণিভাইজানের,	
golghare,	গোলঘরে,	গোলঘরে,	
paira,	পাইরা,	পাইরা,	
conflict,	কনফ্লিক্ট,	কনফ্লিক্ট,	
samany,	স্যামানি,	সামান্য,	
karuna,	করুনা,	করুণা,	
khalidke,	খালিদকে,	খালিদকে,	
scholars,	স্কলার্স,	স্কলার্স,	
ajeejer,	আজিজের,	আজিজের,	
emargency,	এমারজেন্সি,	এমার্জেন্সি,	
shikkharrthirao,	শিক্ষার্থীরারও,	শিক্ষার্থীরাও,	
jamseder,	জাসমেদের,	জামসেদের,	
sangkulaan,	সংকুলন,	সংকুলান,	
byaboharkareer,	ব্যবহারকারীর,	ব্যবহারকারীর,	
neelkamal,	নীলকামাল,	নীলকমল,	
shansthagulo,	শান্তখাগুলো,	সংস্থাগুলো,	
falak,	ফালাক,	ফলক,	
farhetin,	ফারহেটিন,	ফারহেতিন,	
ekekrokom,	একেকরকম,	একেকরকম,	
colgirl,	কলগার্ল,	কলগার্ল,	
tintikey,	টিনটিকে,	তিনটিকে,	
ongshogrohoner,	অংশগ্রহণের,	অংশগ্রহনের,	
dubaate,	দুবাতে,	ডুবাতে,	
koomarir,	কুমারির,	কুমারীর,	
bosontokke,	বসন্তককে,	বসন্তকে,	
konisttha,	কোনষষ্ঠা,	কনিষ্ঠ,	
sinaake,	সিনাকে,	সিনাকে,	
bonke,	বনকে,	বনকে,	
toler,	টোলের,	তালের,	
bishhnu,	বিষ্ণু,	বিষ্ণু,	
artilary,	আর্টিলারি,	আর্টিলারি,	
damodar,	দামোদার,	দামদর,	
hupile,	হুপিলে,	হুপিলে,	
puroheetder,	পুরোহিতদের,	পুরোহিতদের,	
baaiq,	বাইক,	বাইক,	
scholastic,	স্কোলাস্টিক,	স্কলাস্টিক,	
serology,	সেরোলজি,	সেরোলজি,	
manushe,	মানুষে,	মানুষে,	
sthaponagulo,	স্থাপনাগুলো,	স্থাপনাগুলো,	
bhangle,	ভাংলে,	ভাঙলে,	
ganoporibahoner,	গণপরিবহণের,	গণপরিবহনের,	
pratiyogita,	প্রতিয়গীত,	প্রতিযোগীতা,	
gardeen,	গার্ডিন,	গার্ডেন,	
uporitoler,	উপরিতলের,	উপরিতলের,	
saifullahil,	সাইফুল্লাহিল,	সাইফুল্লাহিল,	
safiha,	সফিহা,	সাফিহা,	
hojurer,	হজুরের,	হজুরের,	
aalkatraa,	আলকাত্রা,	আলকাতরা,	
erajyobasi,	এরাজ্যবাসী,	এরাজ্যবাসী,	
sipa,	সিপা,	শিপ,	
qrisenta,	ক্রিসেন্টা,	ক্রিসেন্ট,	
charukala,	চারুকালা,	চারুকলা,	
dristiheen,	দৃষ্টিহীন,	দৃষ্টিহীন,	
asamorik,	আসামরিক,	অসামরিক,	
vittimul,	ভিত্তিমূল,	ভিত্তিমূল,	
tolemyr,	টোলেমির,	টলেমির,	
prarthitao,	প্রার্থীতাও,	প্রার্থীতাও,	
jonosomaj,	জনসমাজ,	জনসমাজ,	
bolatkar,	বলাতকর,	বলাৎকার,	
parkin,	পারকিন,	পার্কিং,	
rajtontro,	রাজতন্ত্র,	রাজতন্ত্র,	
nirbahe,	নির্বাহে,	নির্বাহে,	
milayatane,	মিলয়টনে,	মিলায়তনে,	
paroner,	পারণের,	পারণের,	
sadbi,	সাদবি,	সাধ্বী,	
dumaa,	দুমায়া,	দুমা,	
tep,	টিইপি,	ট্যাপ,	
larson,	লারসন,	লারসন,	
ujobekeestan,	উজবেকসিতান,	উজবেকিস্তান,	
jaaygata,	জাইগাটা,	জায়গাটা,	
khanonkaj,	খানকনজজ,	খননকাজ,	
carlo,	কারলো,	কার্লো,	
pratiyogitar,	প্রতিয়গীতার,	প্রতিযোগীতার,	
ghaghat,	ঘাঘাট,	ঘাঘট,	
harris,	হারিস,	হ্যারিস,	
dokkhinangsho,	দক্ষিণাংশ,	দক্ষিণাংশ,	
chokhwala,	চোখভালা,	চোখওয়ালা,	
koordira,	কোর্দিরা,	কুর্দিরা,	
anisa,	আনিসা,	আনিস,	
footbalarer,	ফুটবারের,	ফুটবলারের,	
asovya,	অসোভ্য,	অসভ্য,	
samajeek,	সমজিক,	সামাজিক,	
pillai,	পিল্লাই,	পিল্লাই,	
zerusalem,	জেরুসালেম,	জেরুসালেম,	
omarader,	ওমারাদের,	ওমারাদের,	
karmosansthan,	কারমোসনস্থান,	কর্মসংস্থান,	
ancholtike,	অঞ্চলটিকে,	অঞ্চলটিকে,	
bii,	বইআইআই,	বি,	
dabarer,	দাবারের,	দাবারের,	
anchalsaho,	অঞ্চলসহ,	অঞ্চলসহ,	
poorohitder,	পুরোহিতদের,	পুরোহিতদের,	
shem,	শেম,	সেম,	
sahojatprobritti,	সহযাতবর্তীপ্তি,	সহজাতপ্রবৃত্তি,	
parq,	পার্ক,	পার্ক,	
jeshh,	জেশ,	জেস,	
boner,	বনের,	বনের,	
matorom,	ম্যাটোম,	মাতরম,	
cholochchitrai,	চলচ্চিত্রায়,	চলচ্চিত্রই,	
nothivukto,	নথিভুক্ত,	নথিভুক্ত,	
doula,	দৌলা,	দৌলা,	
azijer,	আজিজের,	আজিজের,	
lakkhero,	লক্ষেরও,	লক্ষেরও,	
maailey,	মেইলি,	মাইলে,	
aansaareer,	আলসারীর,	আনসারীর,	
olympik,	অল্ম্পিক,	অলিম্পিক,	
sommotitey,	সম্মতিতে,	সম্মতিতে,	
seconder,	সেকন্ডের,	সেকেন্ডের,	
ramantika,	রামান্তিকা,	রোমান্টিক,	
bbosben,	বিবএসববেইন,	বসবেন,	
ajibon,	আজিবন,	আজীবন,	
phood,	ফোড,	ফুড,	
venkates,	ভেঙ্কটেস,	ভেঙ্কটেশ,	
gujob,	গুজব,	গুজব,	
ancholgoolote,	আঞ্চলগুলোতে,	অঞ্চলগুলোতে,	
dharmiyabhabei,	ধর্মিয়ভাবেই,	ধর্মীয়ভাবেই,	
pooshteer,	পুষ্টির,	পুষ্টির,	
prosadhani,	প্রসাধনী,	প্রসাধনী,	
stagecraft,	স্টেযাগক্রাফট,	স্টেজক্রাফট,	
byabaharkareederke,	ব্যবহারকারীদেরকে,	ব্যবহারকারীদেরকে,	
tochhnochh,	তচন্চ,	তছনছ,	
byaktigotovabeo,	ব্যক্তিগতভাবেও,	ব্যাক্তিগতভাবেও,	
laiseensee,	লেসেনিস,	লাইসেন্স,	
saatzoner,	সাতজনের,	সাতজনের,	
champa,	চম্পা,	চাঁপা,	
pranibigyani,	প্রাণীব্জীঞ্যই,	প্রাণীবিজ্ঞানী,	
venush,	ভেনুস,	ভেনাস,	
ishahak,	ইশাহাক,	ইসাহাক,	
nirmol,	নির্মল,	নির্মল,	
tintir,	তিনটির,	তিনটির,	
obharbhiu,	ওভারভিউ,	ওভারভিউ,	
safiin,	সাফিন,	সাফিন,	
swatantrata,	স্বতন্ত্র্যটা,	স্বতন্ত্রতা,	
angibhutovabe,	অঙ্গিতভূতভাবে,	অঙ্গীভূতভাবে,	
maadla,	মাদলা,	মাদলা,	
firth,	ফির্থ,	ফার্থ,	
jyesttha,	জ্যেষ্টাও,	জ্যেষ্ঠা,	
dai,	দাই,	দিই,	
carlosh,	কারলোশ,	কার্লোস,	
horiddar,	হরিদদার,	হরিদ্বার,	
sqalarashipa,	স্কলারাশিপ,	স্কলারশিপ,	
roy,	রয়ে,	রায়,	
orbit,	অরবিট,	অরবিট,	
matrirup,	মাতৃরূপ,	মাতৃরূপ,	
turbine,	টারবিন,	টারবাইন,	
deputi,	দেপুটি,	ডেপুটি,	
orunima,	ওরুনিমা,	অরুণিমা,	
raunanganey,	রানাঙ্গনে,	রণাঙ্গনে,	
kandy,	কান্ডি,	ক্যান্ডি,	
ultrasonography,	আল্ট্রাস্ারগোরাথি,	আলট্রাসনোগ্রাফিও,	
dipankar,	দীপানকার,	দিপঙ্কর,	
mutar,	মুতার,	মুতার,	
durotamo,	দুরতামো,	দূরতম,	
nibirbhabe,	নিবির্ভাবে,	নিবিরভাবে,	
drissogulote,	দৃষ্যগুলোতে,	দৃশ্যগুলোতে,	
elaakaati,	এলাকাটি,	এলাকাটি,	
abhidhaner,	অভিধানের,	অভিধানের,	
ciima,	সিমা,	সীমা,	
raiialati,	রাইয়ালাতি,	রয়্যালটি,	
bisheshshyer,	বিশেষ্যের,	বিশেষ্যের,	
torabgonj,	তরাবগঞ্জ,	তোরাবগঞ্জ,	
amorendro,	অমরেন্দ্র,	অমরেন্দ্র,	
erokomer,	এরকমের,	এরকমের,	
shrabasti,	শ্রাবস্তি,	শ্রাবস্তী,	
difinishion,	ডিফিনিশন,	ডেফিনেশন,	
torkarir,	তর্করির,	তরকারীর,	
chhaikalo,	ছাইকালো,	ছাইকালো,	
bhalobasar,	ভালোবাসার,	ভালোবাসার,	
mukhbondho,	মুখবন্ধ,	মুখবন্ধ,	
halding,	হ্যালিংং,	হোল্ডিং,	
protibedokrao,	প্রতিবেদকরাও,	প্রতিবেদকরাও,	
kisti,	কিস্তি,	কিস্তি,	
byaboharkarie,	ব্যবহারকারী,	ব্যবহারকারীই,	
fatakasto,	ফাটাকাস্ত,	ফাটাকেষ্ট,	
poschime,	পশ্চিমে,	পশ্চিমে,	
chhutochhooti,	ছুটোছুটি,	ছুটোছুটি,	
holuder,	হলুদের,	হলুদের,	
ramchander,	রামচন্দের,	রামচন্দরের,	
mooney,	মননে,	মুনে,	
bisshasyi,	বিশ্বস্যী,	বিশ্বাসই,	
kourabe,	কৌরাবে,	কৌরবে,	
dep,	ডিপ,	ডেপ,	
ghumachhe,	ঘুমোচ্ছে,	ঘুমাচ্ছে,	
rasunkunchi,	রসুনকুন্চি,	রসুনকুঁচি,	
mausumer,	মৌসুমের,	মৌসুমের,	
chorchita,	চরছিতা,	চর্চিত,	
highcomissione,	হাইকমিশনে,	হাইকমিশনে,	
chalochchitraeei,	চালচচিত্রায়েই,	চলচ্চিত্রেই,	
argho,	আরঘো,	অর্ঘ্য,	
turkeyder,	টার্কেডের,	তুর্কিদের,	
rekhapat,	রেখাপাত,	রেখাপাত,	
ganoparibahaner,	গণপরিবাহনের,	গণপরিবহনের,	
vaisoho,	ভাইসহ,	ভাইসহ,	
ajuhat,	অজুহাত,	অজুহাত,	
majdur,	মাজদুর,	মজদুর,	
chopal,	চোপাল,	চপল,	
ruptan,	রূপতান,	রূপটান,	
vorkendra,	ভোরকেন্দ্র,	ভরকেন্দ্র,	
postac,	পোস্ট্যাক,	পোস্টকে,	
soomita,	সুমিতা,	সুমিতা,	
dharabahikbhabe,	ধারাবাহিকভাবে,	ধারাবাহিকভাবে,	
buth,	বুথ,	বুথ,	
totokson,	তোটকসন,	ততক্ষন,	
bouddher,	বৌদ্ধের,	বৌদ্ধের,	
shahidputra,	সহিদপুত্র,	শহীদপুত্র,	
asovyo,	অসভ্য,	অসভ্য,	
borkhastokritora,	বরখাস্তকৃতারা,	বরখাস্তকৃতরা,	
beauby,	বিউবি,	বিউবি,	
chakundite,	চাকুন্ডিতে,	চাকুন্দিতে,	
byomkesh,	ব্যামকেশ,	ব্যোমকেশ,	
bhumija,	ভূমিজা,	ভূমিজ,	
baptics,	ব্যাপটিক্স,	ব্যাপটিকস,	
sikkharrtheerao,	শিক্ষার্থীরাও,	শিক্ষার্থীরাও,	
antarctika,	এন্তারক্সিকা,	অ্যান্টার্কটিকা,	
suiti,	সুইটি,	সুইটি,	
mozdoor,	মজুদুর,	মজদুর,	
uter,	উতের,	উটের,	
sarsa,	সারসা,	সোর্স,	
shootar,	সুতার,	শ্যুটার,	
elaaka,	এলাকা,	এলাকা,	
tottorat,	তত্ত্রাট,	তওরাত,	
graambaashee,	গ্রামবাশী,	গ্রামবাসী,	
evaner,	ইভানের,	ইভানের,	
poscime,	পশ্চিম,	পশ্চিমে,	
rijoor,	রিজুর,	রিজুর,	
land,	ল্যান্ড,	ল্যান্ড,	
rohasyer,	রোহস্যের,	রহস্যের,	
konnoder,	কন্যদের,	কন্যদের,	
khali,	খালি,	খালি,	
zeland,	জেল্যান্ড,	জিল্যান্ড,	
durgotshob,	দুর্গোষ্ব,	দুর্গোৎসব,	
rubidiyaam,	রুবিদিয়াম,	রুবিডিয়াম,	
chuti,	চুটি,	ছুটি,	
santoshpore,	সন্তোশপরে,	সন্তোষপুর,	
ponthaar,	পন্থার,	পন্থার,	
choukato,	চৌকাতো,	চৌকাত,	
joones,	জুনেস,	জোন্স,	
abheedhaaneek,	অভিধানকে,	অভিধানিক,	
toranganj,	তরাঙগঞ্জ,	তোরাবগঞ্জ,	
vaphara,	ভাফারা,	বাফার,	
shangkulaan,	সংকুলন,	সংকুলান,	
aborto,	আবর্ত,	আবর্ত,	
ashonkai,	আশঙ্কাই,	আশঙ্কাই,	
bisnuke,	বিস্ণুকে,	বিষ্ণুকে,	
chaudhuriyo,	চৌধুরিও,	চৌধুরীও,	
nirikh,	নিরিখ,	নিরিখ,	
oboshore,	অবশরে,	অবসরে,	
janmat,	জন্মত,	জন্মাত,	
deefinision,	ডেফিনিসন,	ডেফিনেশন,	
inafarameshana,	ইনফারেমনশন,	ইনফরমেশন,	
somraatra,	সম্রাট্র,	সম্রাটরা,	
tetela,	টেটেলা,	টাইটেল,	
esoosiyetasa,	এসুিয়াইটিসা,	এসোসিয়েটস,	
choudry,	চৌদ্রি,	চৌধুরী,	
neerbahi,	নির্বাহী,	নির্বাহি,	
shibraj,	শিবরাজ,	শিবরাজ,	
nogore,	নগরে,	নগরে,	
arshie,	আর্সি,	আরসিএ,	
huk,	হুক,	হুক,	
dokanei,	দোকানেই,	দোকানেই,	
nationalser,	নেশনালসের,	ন্যাশনালসের,	
stoonahenja,	স্তননহঙ্জা,	স্টোনহেঞ্জ,	
jones,	জোনেস,	জোন্স,	
sainyader,	সৈন্যদের,	সৈন্যদের,	
mesenjjar,	মেসেনজ্জার,	মেসেঞ্জার,	
sausage,	সৌসাগে,	সসেজ,	
osthisondhi,	অস্থিসন্ধি,	অস্থিসন্ধি,	
spenser,	স্পেন্সের,	স্পেন্সার,	
ummool,	উম্মুল,	উম্মুল,	
bosantake,	বসন্তাকে,	বসন্তকে,	
satyaky,	সত্যক্য,	সাত্যকি,	
beshyasdone,	বেশ্যাস্ননে,	বেশ্যাসদনে,	
sangasthagulo,	সংস্থাগুলো,	সংস্থাগুলো,	
karam,	কারাম,	কেরাম,	
amudey,	আমুদে,	আমুদে,	
somsher,	সম্শের,	সমশের,	
darjiling,	দার্জিলিং,	দার্জিলিং,	
shiropar,	শিরোপার,	শিরোপার,	
kharavel,	খারাভেল,	খারবেল,	
injiniyarim,	ইঞ্জিনিয়ারি,	ইঞ্জিনিয়ারিং,	
paadee,	পাড়ি,	পাড়ে,	
kuttake,	কুট্টাকে,	কুত্তাকে,	
srk,	এঙ্রিক,	শাহরুখ,	
chandrimaa,	চন্দ্রীমা,	চন্দ্রিমা,	
masjidsaho,	মাসজিদসহ,	মসজিদসহ,	
arsie,	আর্সি,	আরসিএ,	
khelechen,	খেলেছেন,	খেলেছেন,	
modele,	মডেলে,	মডেলে,	
chowdhuryke,	চৌষহউরকে,	চৌধুরীকে,	
homsher,	হোমশের,	হোমসের,	
mercial,	মার্সিয়াল,	মার্শিয়াল,	
prokar,	প্রকার,	প্রকার,	
shukraanoo,	শুক্রানু,	শুক্রানু,	
spredashiita,	স্প্রেডাশিটা,	স্প্রেডশীট,	
mithener,	মিথেনের,	মিথেনের,	
drishi,	দৃশি,	দৃশ্যই,	
nibeditar,	নিবেদিটার,	নিবেদিতার,	
akkharkey,	অক্ষরকেই,	অক্ষরকে,	
chalochchitraeer,	চলচ্চিত্রীয়ের,	চলচ্চিত্রের,	
yathaarthabhaabe,	যথার্থভাবে,	যথার্থভাবে,	
chalochchitreer,	চলচ্চিত্রীর,	চলচ্চিত্রের,	
bhandti,	ভাঁদটি,	ভাণ্ডটি,	
monzeele,	মনজিলে,	মঞ্জিলে,	
digrir,	দিগ্রির,	ডিগ্রির,	
croak,	ক্রোক,	ক্রোক,	
ekghore,	একঘরে,	একঘরে,	
taler,	তালের,	তালের,	
phiksa,	ফিক্সা,	ফিক্স,	
diznee,	দিজনী,	ডিজনী,	
labonaaktotaar,	লাবণাক্ততার,	লবণাক্ততার,	
oindrila,	ঐন্দ্রিলা,	ঐন্দ্রিলা,	
pacbar,	পাকবার,	পাঁচবার,	
mitro,	মিত্রো,	মিত্র,	
abhiyojan,	অভিয়াজন,	অভিযোজন,	
kushakhali,	কুশাখালি,	কুশাখালি,	
atorkitey,	অতর্কিতে,	অতর্কিতে,	
breq,	ব্রেক,	ব্রেক,	
taateo,	তাতেও,	তাতেও,	
rupert,	রাপার্ট,	রুপার্ট,	
rastagulikeo,	রাস্তাগুলিকেও,	রাস্তাগুলিকেও,	
sikha,	সিখা,	শিখ,	
shudhir,	শুধীর,	শুধীর,	
alumni,	আলুমনি,	অ্যালমনি,	
bharatey,	ভারাতে,	ভারতে,	
narsaari,	নারসারি,	নার্সারি,	
navaratri,	নবরত্রি,	নবরাত্রি,	
oncholeo,	অঞ্চলেও,	অঞ্চলেও,	
hul,	হোল,	হুল,	
juboke,	যুবকে,	যুবকে,	
bhaangchur,	ভাংচুর,	ভাংচুর,	
kale,	কালে,	কালে,	
krom,	ক্রম,	ক্রম,	
mishal,	মিশাল,	মিশাল,	
udbhabaney,	উদ্ভাবনে,	উদ্ভাবনে,	
sheetke,	শীতকে,	শীতকে,	
rakshanbhag,	রক্ষণভাগ,	রক্ষণভাগ,	
murali,	মুরালি,	মুরলী,	
societytey,	সোশিটেটি,	সোসাইটিতে,	
cheef,	চেয়াফ,	শেফ,	
shulfate,	সুলফাতে,	সালফেট,	
kaalengaa,	কালেঙ্গা,	কালেঙ্গা,	
difinishian,	ডিফিনিশিয়ান,	ডেফিনেশন,	
redcrosser,	রেড্রকরসের,	রেডক্রসের,	
naper,	নাপের,	ন্যাপের,	
torunra,	তরুণরা,	তরুণরা,	
talaa,	তালা,	তালা,	
turkamena,	তুরকামেনা,	তুর্কমেন,	
sealvi,	সিলভি,	সিলভি,	
shhikara,	শিকারা,	শিকার,	
hijritey,	হিজৃিতে,	হিজরীতে,	
sobchey,	সবকে,	সবচে,	
purohitder,	পুরোহিতদের,	পুরোহিতদের,	
neerbachoker,	নির্বাচকের,	নির্বাচকের,	
sompadon,	সম্পাদন,	সম্পাদন,	
remission,	রিমিশন,	রিমিশন,	
brookoleen,	ব্রুকোলিন,	ব্রুকলিন,	
drissoteer,	দৃষ্টির,	দৃশ্যটির,	
probhritike,	প্রভৃতিকে,	প্রভৃতিকে,	
edic,	এডিক,	এডিক,	
mosjidtir,	মসজিদটির,	মসজিদটির,	
rca,	আরসিএ,	আরসিএ,	
gananatyo,	গণনা্্য,	গণনাট্য,	
eesa,	ইস্সা,	আইএএস,	
ajijer,	আজিজের,	আজিজের,	
madhukori,	মধুকোরি,	মাধুকরী,	
norfolk,	নরফলক,	নরফোক,	
mmadhuri,	মমমুধিরি,	মাধুরী,	
melbourner,	মেলবোর্নের,	মেলবোর্নের,	
narishwar,	নারীশ্বর,	নারীশ্বরের,	
windows,	উইন্ডোস,	উইন্ডোস,	
hena,	হেনা,	হেনা,	
byabosthar,	ব্যবস্থার,	ব্যবস্থার,	
mulyabriddhikale,	মূল্যবৃদ্ধিকালে,	মূল্যবৃদ্ধিকালে,	
protijogi,	প্রতিযোগী,	প্রতিযোগী,	
ghotaibe,	ঘোটাইবে,	ঘটাইবে,	
cheerokoomari,	চিরকৌমারী,	চিরকুমারী,	
eupheike,	ইউফেইকে,	ইউফেইকে,	
phartha,	ফার্থা,	ফার্থ,	
francine,	ফ্রানসিন,	ফ্রান্সিন,	
shishu,	শিশু,	শিশু,	
durgatsober,	দুর্গাৎসবের,	দুর্গোৎসবে,	
bamni,	বামনি,	বামনী,	
corsin,	করসিন,	করসিন,	
saptahokal,	সপ্তাহকাল,	সপ্তাহকাল,	
himsrot,	হিমস্রুট,	হিমস্রোত,	
khelaphate,	খেলাফাতে,	খেলাফতে,	
iksaprishana,	এক্সপ্রশশন,	এক্সপ্রেশন,	
onchalti,	অঞ্চলটি,	অঞ্চলটি,	
dadar,	ডাদার,	দাদার,	
modyer,	মদ্যের,	মদ্যের,	
sqirt,	স্ক্রিট,	স্কার্ট,	
graambasi,	গ্রামবাসী,	গ্রামবাসী,	
niemond,	নিমম্যান্ড,	নিমন্ড,	
akar,	আকার,	একার,	
toufiq,	তৌফিক,	তৌফিক,	
majlishpur,	মজলিশপুর,	মজলিশপুর,	
aasirbaad,	আসিরবাদ,	আশির্বাদ,	
bornolikhon,	বর্ণলিখন,	বর্ণলিখন,	
babona,	বাবোনা,	বাবনা,	
jaatti,	যাত্তি,	জাতটি,	
pettern,	পেটার্ন,	প্যাটার্ন,	
pleena,	প্লেইন,	প্লেন,	
neck,	নেক,	নেক,	
sahittopritite,	সাহিত্যপ্রীতিতে,	সাহিত্যপ্রীতিতে,	
rojapalaner,	রোজাপললনের,	রোজাপালনের,	
chitronattakar,	চিত্রনাট্মকার,	চিত্রনাট্যকার,	
chalachchitro,	চলচ্চিত্র,	চলচ্চিত্র,	
kaley,	কালি,	কালে,	
tinhazar,	তিনহাজার,	তিনহাজার,	
cheerontan,	চিরনটান,	চিরন্তন,	
sanghar,	সংঘর,	সংহার,	
tophaat,	টোফাত,	তফাৎ,	
bojhao,	বঝঝাও,	বোঝাও,	
utkhaat,	উৎখাট,	উত্খাত,	
akpaase,	একপাসে,	একপাশে,	
kidambi,	কিদাম্বি,	কিদম্বি,	
nirvachaker,	নির্বাচকের,	নির্বাচকের,	
atarkitey,	অতারকিতে,	অতর্কিতে,	
dreeshtiheen,	দৃষ্টিহীন,	দৃষ্টিহীন,	
indrakanan,	ইন্দ্রকানন,	ইন্দ্রকানন,	
foxer,	ফক্সার,	ফক্সের,	
sumeeta,	সুমিতা,	সুমিতা,	
rachonakal,	রচনাকাল,	রচনাকাল,	
guha,	গুহা,	গোহ,	
horas,	হোরাস,	হোরাস,	
zaire,	জায়ার,	জাইরে,	
parshwer,	পার্শ্বের,	পার্শ্বের,	
uthe,	উঠে,	উঠে,	
ahalya,	অহল্যা,	অহল্যা,	
juktarashtrasaha,	যুক্তারশস্্রাসহ,	যুক্তরাষ্ট্রসহ,	
protiakromonei,	প্রতিয়ক্রমণেই,	প্রতিআক্রমণেই,	
parjotaker,	পার্যটাকের,	পর্যটকের,	
gaujano,	গৌজানো,	গজানো,	
cena,	সেইএন,	সিনা,	
maladabha,	মালাদাভা,	মলদোভা,	
abarte,	আবার্তে,	আবর্তে,	
dorgah,	দোরগাা,	দরগাহ,	
korkotkraantee,	করককটর্নান্তে,	কর্কটক্রান্তি,	
existing,	এক্সিস্টিং,	এক্সিসটিং,	
khitkar,	খিৎকার,	ক্ষিতকর,	
nanilalke,	নানীলালকে,	ননীলালকে,	
suparichito,	সুপারিচাত,	সুপরিচিত,	
phareeksa,	ফরেক্স,	ফরেক্স,	
byepass,	বিপেপাস,	বাইপাস,	
niropekshtar,	নিরপেক্ষ্টার,	নিরপেক্ষতার,	
ekatto,	একাত্ম,	একাত্ব,	
shrabastee,	শ্রাবস্তে,	শ্রাবস্তী,	
baet,	বিট,	বাইট,	
somosto,	সমস্ত,	সমস্ত,	
kodorer,	কোদরের,	কদরের,	
tikta,	তিক্তা,	তিক্ত,	
russad,	রুসাদ,	রুশদ,	
khuizza,	খুইজ্জা,	খুইজ্জা,	
drissogulo,	দৃষ্যগুলো,	দৃশ্যগুলো,	
tyap,	ত্যাপ,	ট্যাপ,	
pitiler,	পিতিলের,	পিটিলের,	
turkii,	তুরকি,	তুর্কি,	
khiladirao,	খিলাড়িরাও,	খিলাড়িরাও,	
cholchhe,	চলছে,	চলছে,	
shiqara,	শিকারা,	শিকার,	
kram,	ক্রাম,	ক্রম,	
sahozlabhbhotar,	সহযোলভভভতার,	সহজলভ্যতার,	
pulivendla,	পুলিভেন্ডল,	পুলিভেন্ডলা,	
gaddaafee,	গাড্ডাফ়ি,	গাদ্দাফী,	
spreadshiit,	স্প্রেডশিটি,	স্প্রেডশীট,	
landing,	ল্যান্ডিং,	ল্যান্ডিং,	
ashamorthito,	আশামর্থিত,	অসমর্থিত,	
ronodeep,	রণদিপ,	রণদীপ,	
torunosomriddho,	তরুণসমৃদ্ধ,	তরুণসমৃদ্ধ,	
teemothy,	টিমোথি,	টিমোথি,	
udvaboney,	উদ্ভাবনে,	উদ্ভাবনে,	
konroop,	কোনরুপ,	কোনরূপ,	
artore,	আর্তোরে,	আর্টরে,	
dholeshwari,	ধলেেশ্বরী,	ধলেশ্বরী,	
uparjon,	উপার্জন,	উপার্জন,	
sudrissho,	সুদৃষ্শ,	সুদৃশ্য,	
ispreedshiit,	ইস্প্রিসিচটি,	স্প্রেডশীট,	
shariba,	শারিবা,	শরিবা,	
canflikt,	ক্যানফ্লিক্ট,	কনফ্লিক্ট,	
gyandas,	জ্ঞানদাস,	জ্ঞানদাস,	
ekroop,	একরূপ,	একরূপ,	
patininda,	পাতিনীন্দ,	পতিনিন্দ,	
soource,	সাউরস,	সোর্স,	
ujobekeestaner,	উজবেক্তিতানের,	উজবেকিস্তানের,	
yaak,	ইক,	ইয়াক,	
husni,	হুসনি,	হুসনি,	
cloring,	ক্লোরিং,	ক্লোরিং,	
quata,	কুয়াতা,	কোটা,	
bojiye,	বজিয়ে,	বজিয়ে,	
chilona,	চিলোনা,	ছিলনা,	
liseensee,	লিসিন্সি,	লাইসেন্স,	
uporitaley,	উপরিতালে,	উপরিতলে,	
morodeho,	মরদেহ,	মরদেহ,	
mimgulor,	মিমগুলোর,	মিমগুলোর,	
oncholtee,	অঞ্চলটি,	অঞ্চলটি,	
heena,	হীনা,	হেনা,	
mmehonoti,	মেমোহনটি,	মেহনতি,	
marmaraa,	মারমারা,	মারমারা,	
monur,	মনুর,	মনুর,	
somonwitobhabey,	সমন্ভিতভাবে,	সমন্বিতভাবে,	
hool,	হোল,	হুল,	
ponchaashjon,	পঞ্চাশজন,	পঞ্চাশজন,	
soteciety,	সটেসিটি,	সোসাইটিতে,	
amontronkarider,	আমনন্তরকারীদের,	আমন্ত্রণকারীদের,	
kuronir,	কুরোনির,	কুরনীর,	
timoothi,	টিমোথি,	টিমোথি,	
ceramiksh,	সেরামিকশ,	সিরামিকস,	
katui,	কাটুই,	কাতুই,	
zesa,	জেস,	জেস,	
shuperheiro,	শুপারহেইরো,	সুপারহিরো,	
tokee,	তকই,	তকি,	
ekbakye,	একবাক্যে,	একবাক্যে,	
sikkhakbrinda,	শিক্ষাকবৃন্দ,	শিক্ষকবৃন্দ,	
abhidhaaner,	অভিধানের,	অভিধানের,	
bostubad,	বস্তুবাদ,	বস্তুবাদ,	
santaa,	সান্তা,	সান্তা,	
prijon,	প্রিজন,	প্রিজন,	
krechi,	ক্রেচি,	করেছি,	
amburi,	অম্বুরি,	আম্বুরি,	
remacry,	রিমাক্রি,	রেমাক্রী,	
steena,	স্টেন,	স্টেন,	
ghotolen,	ঘটলেন,	ঘটলেন,	
sobaiderke,	সোবাইদেরকে,	সবাইদেরকে,	
sangbadmadhyomgulote,	সংবাদমাধ্যমগুলোতে,	সংবাদমাধ্যমগুলোতে,	
barnis,	বার্নিস,	বার্নিশ,	
irana,	ইরানা,	ইরান,	
akhando,	আখণ্ড,	অখন্ড,	
tookrokey,	টুকরোকে,	টুকরোকে,	
ajij,	আজিজ,	আজিজ,	
sardar,	সরদার,	সরদার,	
sahachke,	সহচককে,	সাহাচকে,	
nek,	নেক,	নেক,	
boiporiityen,	বইপরিত্যেন,	বৈপরীত্যেন,	
grahoksebai,	গ্রাহকসেবাই,	গ্রাহকসেবায়,	
porjotoker,	পর্যটকের,	পর্যটকের,	
bhoolapuka,	ভুলপুকা,	ভোলাপুক,	
rajpur,	রাজপুর,	রাজপুর,	
bedey,	বেদে,	বেদে,	
purohitra,	পুরোহিত্র,	পুরোহিতরা,	
catholicder,	ক্যাথলিকদের,	ক্যাথলিকদের,	
byomkes,	ব্যামকেস,	ব্যোমকেশ,	
dito,	দিতো,	দিতো,	
ghurechen,	ঘুরেছেন,	ঘুরেছেন,	
akram,	আকরাম,	আকরাম,	
mail,	মাল,	মাইল,	
elakatikay,	এলাকাতিকায়,	এলাকাটিকে,	
gandagol,	গণ্ডগগল,	গন্ডগোল,	
bouddha,	বৌদ্ধা,	বৌদ্ধ,	
birmuktijoddhagan,	বীরমুক্তিদোধ্ধগণ,	বীরমুক্তিযোদ্ধাগণ,	
mach,	মাচ,	মাছ,	
samoshtigato,	সমত্ষিগত,	সমষ্টিগত,	
sithilota,	সিথিলতা,	শিথিলতা,	
taunship,	তাঁশশিপ,	টাউনশিপ,	
nothivookta,	নথিভক্ত,	নথিভুক্ত,	
orthisoho,	অর্থিসহ,	অর্থিসহ,	
hariner,	হরিণের,	হরিণের,	
nirmolotaa,	নির্মলতা,	নির্মলতা,	
mahbunur,	মাহবুনুর,	মাহবুনুর,	
monroe,	মনরো,	মনেরোর,	
homshke,	হমম্কে,	হোমসকে,	
parqim,	পারকিম,	পার্কিং,	
nikote,	নিকটে,	নিকটে,	
gara,	গারা,	গোর,	
societyke,	সোসিটিকে,	সোসাইটিকে,	
jetam,	জেতাম,	যেতাম,	
alankorana,	আলঙ্করণা,	অলঙ্করণ,	
achintyabhedaved,	অচিন্ত্যভেবাদে,	অচিন্ত্যভেদাভেদ,	
protistha,	প্রতিষ্ঠা,	প্রতিষ্টা,	
saurce,	সার্স,	সোর্স,	
rena,	রেনা,	রেনো,	
anyorup,	অন্যরূপ,	অন্যরূপ,	
ghotleyo,	ঘোটলিও,	ঘটলেও,	
charger,	চার্গের,	চার্জার,	
teter,	তেটের,	টেটের,	
gagee,	গাগি,	গেজ,	
ap,	এপিএ,	আপ,	
fevarite,	ফেভারিতে,	ফেভারিট,	
hooq,	হুক,	হুক,	
path,	পাথ,	পাথ,	
shiter,	শীতের,	শীতের,	
shanno,	শান্ন,	সান্নো,	
playtey,	প্লেয়েট,	প্লেটে,	
barbadoj,	বারবাদজ,	বার্বাডোজ,	
lebina,	লেবিনা,	লেবিনা,	
veenish,	ভিনিশ,	ভেনিস,	
aosafur,	আওসাফুর,	আওশাফুর,	
masjidti,	মসজিদটি,	মসজিদটি,	
monzushree,	মঞ্ুুশ্রী,	মঞ্জুশ্রী,	
progresh,	প্রোগ্রেশ,	প্রগ্রেস,	
duhsthanostho,	দুঃস্থানস্থ,	দুঃস্থানস্থ,	
courtcaser,	কোর্টোক্সের,	কোর্টকেসের,	
ghuznavi,	ঘুজনাভি,	গজনভি,	
aaziz,	আজিজ,	আজিজ,	
iub,	আইববি,	আইইউবি,	
gazeetteed,	গেজিত্বেদ,	গেজেটেড,	
daybhager,	দয়ভাগের,	দায়ভাগের,	
sumoo,	সুমো,	সুমো,	
aajeej,	আজেজ,	আজিজ,	
nutaner,	নুতানের,	নূতনের,	
shudhui,	শুধুই,	শুধুই,	
thakeni,	থাকেনি,	থাকেনি,	
ansarir,	আনসারির,	আনসারীর,	
kathmandute,	কাঠমন্ডুতে,	কাঠমান্ডুতে,	
rajnoitik,	রাজনৈতিক,	রাজনৈতীক,	
dormetori,	দর্মেতরি,	ডরমিটরি,	
cloudbook,	ক্লাডববক,	ক্লাউডবুক,	
saranor,	সারানোর,	সরানোর,	
deenes,	দীনেস,	দীনেশ,	
hossne,	হোসেন,	হোসনে,	
shit,	শিত,	শীত,	
shansthaner,	শান্স্থানের,	সংস্থানের,	
mukhamandoler,	মুখামন্ডলের,	মুখমণ্ডলের,	
dologuloo,	দলগুলোও,	দলগুলোও,	
onkush,	অঙ্কুশ,	অংকুশ,	
vobanipur,	ভবানীপুর,	ভবানীপুর,	
ray,	রেয়ি,	রায়,	
humira,	হুমিরা,	হুমিরা,	
horidwar,	হরিদ্বার,	হরিদ্বার,	
aieesha,	আইইসএ,	আইএএস,	
adarsho,	আদর্শ,	আর্দশ,	
sheets,	শিটস,	শীটস,	
labonaktatar,	লাবণক্তাটার,	লবণাক্ততার,	
sangsakti,	সংসক্তি,	সংসক্তি,	
firoze,	ফিরোজে,	ফিরোজ,	
tooku,	টুকু,	টুকু,	
jonoshongjog,	জনশঙ্গোগ,	জনসংযোগ,	
pachchi,	পাচ্ছি,	পাচ্ছি,	
byapoktor,	ব্যাপক্তর,	ব্যাপকতর,	
weelcomee,	ভিলকমি,	ওয়েলকাম,	
lobbytey,	লবটি,	লবিতে,	
nanabornobishishto,	নানাবরববিশিষ্ট,	নানাবর্ণবিশিষ্ট,	
firozapure,	ফিরোজাপুরে,	ফিরোজাপুরে,	
dhaanche,	ধান্চে,	ধাঁচে,	
lokhindorer,	লোখিন্দরের,	লখিন্দরের,	
khoor,	খুর,	ক্ষুর,	
kholdhular,	খোলদুহোলার,	খোলধূলার,	
akreetokarjo,	আকৃতকরর্য্য,	অকৃতকার্য,	
everage,	এভারেজ,	এভারেজ,	
soolke,	সুলকে,	শুল্কে,	
annimated,	অ্যানিমেযাটেড,	এনিমেটেড,	
jolbe,	জলবে,	জ্বলবে,	
tikto,	তিক্ত,	তিক্ত,	
kartona,	কারততনা,	করতনা,	
donat,	দোনাট,	ডোনাট,	
maktum,	মাকতুম,	মাকতুম,	
karore,	কারোরে,	কারোর,	
ancholgoolir,	আঞ্চলগুলির,	অঞ্চলগুলির,	
kanuner,	কানুনের,	কানুনের,	
dosha,	দোশা,	দোসা,	
daraider,	দারাইদের,	দরাইদের,	
jhonkar,	ঝনকার,	ঝঙ্কার,	
bibadey,	বিবাদে,	বিবাদে,	
mawdeel,	মাপদিল,	মডেল,	
naitikatavodh,	নৈতিকতাবোধ,	নৈতিকতাবোধ,	
postay,	পোস্টা,	পোস্টে,	
shten,	স্টেন,	স্টেন,	
silabhara,	সিলাভারা,	সিলভার,	
ghurte,	ঘুরতে,	ঘুরতে,	
binee,	বিনী,	বেনি,	
agora,	আগোরা,	আগোরা,	
deilee,	দেইলি,	ডেইলি,	
prosadhoni,	প্রসাধনী,	প্রসাধনী,	
basakey,	বাসকে,	বাসাকে,	
atwabishvashi,	অত্ববিশ্বাসী,	আত্মবিশ্বাসী,	
akpashe,	আকপাশে,	একপাশে,	
erythrian,	এরিথ্রিয়ান,	এরিথ্রিয়ান,	
thailandshoho,	থাইনান্দিসহ,	থাইল্যান্ডসহ,	
cheekitshar,	চিকিৎশার,	চিকিত্সার,	
michhilti,	মিছিলটি,	মিছিলটি,	
mandarbani,	মন্দরবনি,	মন্দারবাণী,	
myat,	ম্যাট,	ম্যাট,	
ispredsheet,	ইস্প্রেডশিট,	স্প্রেডশীট,	
asantosh,	অসন্তোষ,	অসন্তোষ,	
krimlin,	ক্রিমলিন,	ক্রিমলিন,	
si,	সিএই,	এসআই,	
neshadrabyer,	নেশাদ্রব্যের,	নেশাদ্রব্যের,	
thailandsaho,	থেলান্দসহ,	থাইল্যান্ডসহ,	
jothartho,	যথার্থ,	যথার্থ,	
ghumachche,	ঘুমাচ্ছে,	ঘুমাচ্ছে,	
qonflict,	কনফ্লিক্ট,	কনফ্লিক্ট,	
bopoon,	বুপুন,	বপন,	
qirq,	কির্ক,	কার্ক,	
tiuning,	টিউনিং,	টিউনিং,	
footballerra,	ফুটবলাররা,	ফুটবলাররা,	
balabhadra,	বালাভাদরা,	বলভদ্র,	
kabutorer,	কাবুতোরের,	কবুতরের,	
segular,	সেগুলার,	সেগুলোর,	
upobashii,	উপবাশী,	উপবাসী,	
moshzidtike,	মসগিদটিকে,	মসজিদটিকে,	
subader,	সুবাদের,	সুবাদে,	
ovidhanik,	অভিধানিক,	অভিধানিক,	
godamjato,	গোদামজাত,	গুদামজাত,	
ekshoti,	একশোটি,	একশোটি,	
rejidens,	রেজিডেনস,	রেসিডেন্স,	
johny,	জননি,	জনি,	
chhuti,	ছুটি,	ছুটি,	
pancbaar,	প্যান্সবার,	পাঁচবার,	
ashor,	আশর,	আসর,	
byaboharkarike,	ব্যবহারকারীকে,	ব্যবহারকারীকে,	
rayyaleti,	রায়়়েতি,	রয়্যালটি,	
proshikkhane,	প্রশিক্ষণে,	প্রশিক্ষণে,	
laatimer,	লাতিমের,	লাটিমের,	
shringge,	শ্রিংগে,	শৃঙ্গে,	
cholochchitro,	চলচ্চিত্র,	চলচ্চিত্র,	
masjidke,	মাসজিদকে,	মসজিদকে,	
chittronatyokar,	চিত্রনাট্যকার,	চিত্রনাট্যকার,	
angkita,	অংকিতা,	অঙ্কিতা,	
pakhtunistan,	পাখতুনিস্তান,	পাখতুনিস্তান,	
chet,	চেট,	চ্যাট,	
machkabar,	মাচকাবার,	মাচকাবার,	
aakabar,	আকাবার,	আকাবার,	
raiji,	রাইজি,	রাইজি,	
piulir,	পিউলির,	পিউলির,	
chalachchitrer,	চলচ্চিত্রের,	চলচ্চিত্রের,	
dighol,	দিঘল,	দীঘল,	
cholochchitraeeo,	চলচ্চিত্রীও,	চলচ্চিত্রেও,	
karu,	কারু,	কারু,	
qyapasula,	ক্যাপাসুলা,	ক্যাপসুল,	
jacksoner,	জ্যাকসনের,	জ্যাকসনের,	
dokan,	দোকান,	দোকান,	
motkey,	মটকে,	মতকে,	
manabmaner,	মানবমনের,	মানবমনের,	
omkar,	ওমকার,	ওঙ্কার,	
oporishodhito,	অপরিধধিত,	অপরিশোধিত,	
lidars,	লিডার্স,	লিডার্স,	
chaaktir,	চাকটির,	চাকতির,	
shoriph,	শরীফ,	শরিফ,	
oswasteekor,	অস্বাস্তিকর,	অস্বস্তিকর,	
krisenter,	ক্রিসেন্টের,	ক্রিসেন্টের,	
baieq,	বাই়ক,	বাইক,	
bim,	বিআইএম,	বিম,	
bhyatikaner,	ভ্যাটিকানের,	ভ্যাটিকানের,	
sucre,	সুক্রে,	সাকার,	
uparzoner,	উপার্জনের,	উপার্জনের,	
jinsa,	জিনসা,	জিন্স,	
zubokra,	যুবকরা,	যুবকরা,	
bharotiyotar,	ভারতীয়তার,	ভারতীয়তার,	
maail,	মাইল,	মাইল,	
phonekari,	ফোনেকারি,	ফোনকারী,	
bamon,	বামোন,	বামন,	
carbus,	কারবাস,	কারবাস,	
paramartha,	পরমার্থ,	পরমার্থ,	
elaakaa,	এলাকায়,	এলাকা,	
bejiye,	বেজিয়ে,	বেজিয়ে,	
ekbakke,	একবাককে,	একবাক্যে,	
rajendracholer,	রাজেন্দ্রচোলের,	রাজেন্দ্রচোলের,	
kooshumba,	কুশুম্বা,	কুশুম্বা,	
sthitiko,	স্থিতিকো,	স্থিতিকো,	
meshmeshya,	মেশমেশ্য,	মেশহমেশহিইয়া,	
idipasha,	ইডিপোশা,	ইডিপাস,	
madhoboir,	মাধবৈর,	মাধবীর,	
ivil,	ইভিল,	ইভিল,	
madelim,	মাদেলিম,	মডেলিং,	
harbore,	হারবোর,	হারবারে,	
amanisa,	আমানিসা,	অমানিশা,	
trabuco,	ট্র্যাবুকো,	ট্র্যাবুকো,	
graambashee,	গ্রামবাশী,	গ্রামবাসী,	
philo,	ফিলো,	ফিলো,	
prasadhoni,	প্রসাধনই,	প্রসাধনী,	
aamontrito,	আমন্ত্রিত,	আমন্ত্রিত,	
patochitra,	পাটচিত্র,	পটচিত্র,	
crime,	ক্রাইম,	ক্রাইম,	
tarkale,	তারকালে,	তারকালে,	
chhooteer,	ছুটুর,	ছুটির,	
susamo,	সুসামো,	সুসম,	
bishnoo,	বিষ্ণু,	বিষ্ণু,	
shkalarashhipa,	স্কলারশিপ,	স্কলারশিপ,	
thyachara,	থ্যাচার,	থ্যাচার,	
rotheen,	রথিন,	রথীন,	
hertj,	হার্টজ,	হার্জ,	
zeeland,	জিল্যান্ড,	জিল্যান্ড,	
ghatla,	ঘাটলা,	ঘটল,	
saainyo,	সাইন্য,	সৈন্য,	
shahurgulor,	শহুরগুলোর,	শহুরগুলোর,	
acrolect,	অ্যাক্রোলটিক্সের,	অ্যাক্রোলেক্ট,	
pradoshik,	প্রদোশিক,	প্রাদশিক,	
temonvabe,	তেমনভাবে,	তেমনভাবে,	
talgach,	তালগাছ,	তালগাছ,	
procharona,	প্রচারণা,	প্রচারণা,	
eeksapreeshana,	ইক্সপ্রেশন,	এক্সপ্রেশন,	
phaltu,	ফালতু,	ফালতু,	
saalsa,	সালসা,	সালসা,	
apad,	আপাদ,	আপদ,	
bedantodhormo,	বেদান্তধর্ম,	বেদান্তধর্ম,	
timathi,	তিমাঠি,	টিমোথি,	
dharavahik,	ধারাভাহিক,	ধারাবাহিক,	
nyata,	ন্যাট,	ম্যাট,	
antarctica,	অন্তারক্সিকা,	অ্যান্টার্কটিকার,	
karecho,	কারেছো,	করেছো,	
tasminer,	তাসমিনের,	তাসমিনের,	
jins,	জিন্স,	জিন্স,	
ganakantha,	গণকন্ঠ,	গণকণ্ঠ,	
bosano,	বসানো,	বসানো,	
bisshasi,	বিশ্বাসী,	বিশ্বাসী,	
bipti,	বিপ্তিআই,	বিপ্তি,	
faskari,	ফাসকারি,	ফাঁসকারী,	
thaii,	থাইই,	থাই,	
protisthan,	প্রতিষ্ঠান,	প্রতিষ্টান,	
panthar,	পান্থার,	পন্থার,	
gudamjat,	গুদামজাত,	গুদামজাত,	
hattey,	হ্যাটে,	হাঁটতে,	
orrgho,	অর্ঘ,	অর্ঘ্য,	
rayyalati,	রায়়়তলতি,	রয়্যালটি,	
prrajanankaal,	প্রজ্জানক্কল,	প্রজননকাল,	
kompeeto,	কম্পিত,	কম্পিত,	
behrampurer,	বেহরাপুরের,	বহরমপুরের,	
nariderke,	নারীদেরকে,	নারীদেরকে,	
kusumeshu,	কুসুমেশু,	কুসুমেষু,	
turkyder,	টার্কদার,	তুর্কিদের,	
oxite,	অক্সিতে,	অক্সাইট,	
gazipur,	গাজিপুর,	গাজিপুর,	
andon,	আন্দন,	আন্দোন,	
rakkhanvag,	রক্ষণভাগ,	রক্ষণভাগ,	
rahi,	রাহি,	রাহী,	
proo,	প্রোরি,	প্রো,	
standards,	স্ট্যান্ডার্ডসহ,	স্টান্ডার্ডস,	
melborrone,	মেলবর্ণে,	মেলবোর্নে,	
dwijenbabuder,	দ্বিজেনবাবুদের,	দ্বিজেনবাবুদের,	
duple,	ডুপলে,	ডুপ্লে,	
ji,	জিয়,	জি,	
meloonborrone,	মেলুনবর্ণে,	মেলবোর্নে,	
awatar,	আওয়াতার,	অবতার,	
dorneca,	ডর্নেকা,	ডরনেকা,	
thanvi,	থানভি,	থানভী,	
qlauda,	ক্লোউদা,	ক্লাউড,	
windo,	উইন্ডো,	উইন্ডো,	
besirvagei,	বেসিরভাগেই,	বেশিরভাগেই,	
kaale,	কালে,	কালে,	
ponchasjon,	পঞ্চাসন,	পঞ্চাশজন,	
oncholke,	অঞ্চলকে,	অঞ্চলকে,	
sobrakomer,	সব্রাকমের,	সবরকমের,	
fasi,	ফাসি,	ফাঁসী,	
mookhomandoler,	মুখমন্ডলের,	মুখমণ্ডলের,	
bedanta,	বেদান্ত,	বেদান্ত,	
ddebet,	ধিগেবেট,	ডিবেট,	
jontrototto,	যন্ত্রত্বত,	যন্ত্রতত্ত্ব,	
chhutir,	ছুটির,	ছুটির,	
aasar,	আসার,	আসর,	
olympic,	অলিম্পিক,	অলিম্পিক,	
surke,	সুরকে,	সুরকে,	
madhabi,	মাধবী,	মাধবী,	
kaferder,	কাফারদের,	কাফেরদের,	
fanding,	ফ্যান্ডিং,	ফান্ডিং,	
hansasya,	হাঁসস্য,	হংসস্য,	
kortona,	কর্তোনা,	করতনা,	
horippur,	হরিপুর,	হরিপুর,	
xpose,	এক্সপোজ,	এক্সপোজ,	
prakalpatike,	প্রকল্পটিকে,	প্রকল্পটিকে,	
kiuti,	কিউটি,	কিউটি,	
bhenkates,	ভেনকাটেস,	ভেঙ্কটেশ,	
chhotogolper,	ছোটগল্পের,	ছোটগল্পের,	
ekjoge,	একযোগে,	একযোগে,	
udbhaboni,	উদ্ভাবনী,	উদ্ভাবনী,	
ase,	এসে,	আসে,	
sahinsatar,	সহিনসতার,	সহিংসতার,	
rakhtokkharone,	রাখতককরণে,	রক্তক্ষরণে,	
niketaner,	নিকেতানের,	নিকেতনের,	
licensin,	লাইসেনসিন,	লাইসেন্সিং,	
nibondhocheler,	নিবন্ধচেলের,	নিবন্ধছেলের,	
sthapanagulor,	স্থাপানগুলোর,	স্থাপনাগুলোর,	
suparahiro,	সুপারাহিরো,	সুপারহিরো,	
saqara,	সাকারা,	সকার,	
jommu,	জম্মু,	জম্মু,	
bapio,	বাপিও,	বাপিও,	
yanqee,	যানকি,	ইয়াংকি,	
ponjikar,	পঞ্জিকার,	পঞ্জিকার,	
asif,	আসিফ,	আসিফ,	
ganochin,	গণছচন,	গণচীন,	
sthapona,	স্থাপনা,	স্থাপনা,	
chamski,	চ্মাস্কি,	চমস্কি,	
bodna,	বদনা,	বদনা,	
sqalastiqa,	স্কললস্টিকা,	স্কলাস্টিক,	
gitikobita,	গীতিকবিতা,	গীতিকবিতা,	
adhyattikota,	আধ্যাত্মিকতা,	আধ্যাত্মিকতা,	
bhimsen,	ভীমসেন,	ভীমসেন,	
chilahatee,	চিলাহাটি,	চিলাহাটি,	
darji,	দার্জি,	দরজি,	
bolechile,	বলেছিলে,	বলেছিলে,	
karadandey,	কারাদান্দে,	কারাদণ্ডে,	
nirgamon,	নির্গামন,	নির্গমন,	
jothon,	যথন,	যথন,	
tirmijii,	তির্মিজিই,	তিরমিজি,	
akeeb,	আকীব,	আকিব,	
harees,	হারেস,	হ্যারিস,	
noditei,	নদীতেই,	নদীতেই,	
mozlis,	মজলিস,	মজলিশ,	
ghoshito,	ঘোষিত,	ঘোষিত,	
licensedhari,	লাইসেন্সধারী,	লাইসেন্সধারী,	
heepatitis,	হেপাটিটিস,	হেপাটাইটিস,	
soketgulor,	সোকেটগুলোর,	সকেটগুলোর,	
vushi,	ভুষি,	ভুষি,	
bahjya,	বাহ্যা,	বাহ্য,	
krusher,	ক্রুশের,	ক্রুশের,	
suisharke,	সুইশারকে,	সুইশারকে,	
liaodong,	লিয়াডোং,	লিয়াওদং,	
tuleche,	তুলেছে,	তুলেছে,	
vangley,	ভ্যাঙলে,	ভাঙলে,	
obosore,	অবসরে,	অবসরে,	
katateo,	কাটাতেও,	কাটাতেও,	
vezano,	ভেজানো,	ভেজানো,	
mukhomondoler,	মুখোনন্ডলের,	মুখমণ্ডলের,	
shashtra,	শাস্ত্রা,	শাস্ত্র,	
sepha,	সেফা,	শেফ,	
osamarik,	ওসামারিক,	অসামরিক,	
spredashita,	স্প্রেডশাসিতা,	স্প্রেডশীট,	
lambaate,	লম্ববেট,	লম্বাটে,	
kayed,	কায়েদ,	কায়েদ,	
rohinibabu,	রোহিনীবাবু,	রোহিনীবাবু,	
roopdan,	রূপডান,	রুপদান,	
nikate,	নিকাতে,	নিকটে,	
proboleme,	প্রবলেমে,	প্রবলেমে,	
hadisti,	হাদিস্তি,	হাদিসটি,	
dhyana,	ধ্যানা,	ধ্যান,	
dovaar,	ডোভায়ার,	ডোভার,	
kottar,	কোত্তার,	কট্টর,	
daayitto,	দায়িত্ব,	দায়িত্ব,	
chhintayikari,	ছিন্তায়কারী,	ছিনতাইকারী,	
nothivuktir,	নথিভুক্তির,	নথিভুক্তির,	
khanabale,	খানাবালে,	খানাবলে,	
devolapar,	দেবলাপার,	ডেভলপার,	
hizriite,	হিজরিতে,	হিজরীতে,	
sahab,	সাহাব,	সাহাব,	
cholochchitrer,	চলচ্চিত্রের,	চলচ্চিত্রের,	
gondhe,	গন্ধে,	গন্ধে,	
mulbhitti,	মূলভিত্তি,	মূলভিত্তি,	
shikshakrom,	শিক্ষাক্রম,	শিক্ষাক্রম,	
paab,	পবব,	পাব,	
aakik,	আকিক,	আকিক,	
joubanbatee,	যৌবনবাতি,	যৌবনবতী,	
footbalarra,	ফুটবলারা,	ফুটবলাররা,	
dakshinangsho,	দক্ষিণাংশ,	দক্ষিণাংশ,	
fatkabazare,	ফাটকাবাজারে,	ফাটকাবাজারে,	
bade,	বাদে,	বাদে,	
churger,	চার্গের,	চার্জের,	
obdee,	অবদে,	অব্দি,	
laicenshe,	লাইসেন্স,	লাইসেন্স,	
orthobochorke,	অর্থবছরকে,	অর্থবছরকে,	
qaro,	কারো,	কারো,	
oitijje,	ঐতিহ্যে,	ঐতিহ্যে,	
kanar,	কানার,	কণার,	
aabarte,	আবার্তে,	আবর্তে,	
kaferderke,	কাফারদেরকে,	কাফেরদেরকে,	
siitei,	সিটেই,	শীতেই,	
bipajjanak,	বিপজ্জননক,	বিপজ্জনক,	
oitijjo,	ঐতিহ্য্য,	ঐতিহ্য,	
vortuki,	ভর্তুকি,	ভর্তুকি,	
upacharjo,	উপাচার্য,	উপাচার্য,	
gobeshonar,	গবেষণার,	গবেষনার,	
gabhaskaar,	গভাসকর,	গাভাস্কার,	
taderek,	তাদেরেক,	তাদেরেক,	
mardud,	মারদদদ,	মরদুদ,	
dalnata,	দলনতা,	ডালনাটা,	
padee,	পাড়ি,	পাড়ে,	
chapal,	চাপাল,	চপল,	
ponchashjon,	পঞ্চাশ্যন,	পঞ্চাশজন,	
enjineers,	ইঞ্জিনিয়ারস,	ইঞ্জিনিয়ার্স,	
fasir,	ফাসির,	ফাসীর,	
shomostigoto,	সমস্তিগত,	সমষ্টিগত,	
shikhbe,	শিখবে,	শিখবে,	
urey,	ইউরেই,	ইউরি,	
sombhobonao,	সম্ভবনাও,	সম্ভবনাও,	
survative,	সুরভাটিভ,	সারভেটিভ,	
sampadoner,	সম্পাদনের,	সম্পাদনের,	
adhikartai,	অধিকর্তই,	অধিকর্তাই,	
platform,	প্ল্যাটফর্ম,	প্লাটফর্ম,	
hank,	হ্যাংক,	হাঙ্ক,	
skirt,	স্ক্রিট,	স্কার্ট,	
gratha,	গ্রাথা,	গ্রোথ,	
hastamathun,	হস্তমথুন,	হস্তমথুন,	
torikher,	তরিখের,	তরিখের,	
mandope,	ম্যান্ডপে,	মন্ডপে,	
digri,	দিগ্রি,	ডিগ্রি,	
satarka,	সতর্ক,	সতর্ক,	
elakayi,	এলাকায়ি,	এলাকাই,	
procharjontrogulo,	প্রচারযন্ত্রগুলো,	প্রচারযন্ত্রগুলো,	
grambaaseeder,	গ্রামবাসীদের,	গ্রামবাসীদের,	
planey,	প্ল্যানে,	প্লেনে,	
dikpal,	দিকপাল,	দিকপাল,	
difinision,	ডিফিনিশন,	ডেফিনেশন,	
beshirbhaagei,	বেশীরভাগেই,	বেশিরভাগেই,	
rajshri,	রাজশ্রী,	রাজশ্রী,	
nagorikke,	নাগরিককে,	নাগরিককে,	
flux,	ফ্লাক্স,	ফ্লাস্ক,	
maailkhanek,	মাইলখানেক,	মাইলখানেক,	
lutharen,	লুথারেন,	লুথেরান,	
nimitte,	নিমিত্তে,	নিমিত্তে,	
dhhaloor,	ঢালোর,	ঢালুর,	
bonorajite,	বনরাজিতে,	বনরাজিতে,	
bitertrate,	বিতারট্রাতে,	বাইটারট্রেট,	
sangbadmadhyome,	সংবাদমধ্যমে,	সংবাদমাধ্যমে,	
steeit,	স্টিট,	স্টেইট,	
holdim,	হোল্ডিং,	হোল্ডিং,	
prangulo,	প্রাণগুলো,	প্রানগুলো,	
ucchosito,	উচ্চসিত,	উচ্ছসিত,	
siropa,	সিরোপা,	শিরোপা,	
udbhaboney,	উদ্ভাবনে,	উদ্ভাবনে,	
abhidhaanick,	অভিধানিক,	অভিধানিক,	
shroddhabihin,	শ্রদ্ধাবিহীন,	শ্রদ্ধাবিহীন,	
ponera,	পনেরা,	পনের,	
bbiswasho,	বিবিস্বাসহ,	বিশ্বাসও,	
ebhara,	এভারা,	এভার,	
torutoler,	তরুতলের,	তরুতলের,	
jonoikaa,	জনৈকা,	জনৈকা,	
licenshe,	লাইসেন্স,	লাইসেন্স,	
ujbekistaner,	উজ্বেকিস্তানের,	উজবেকিস্তানের,	
zeebonto,	জীবন্ত,	জীবন্ত,	
shikh,	শিখ,	শিখ,	
phutanta,	ফুটান্টা,	ফুটন্ত,	
shektore,	শেক্তরে,	সেক্টরে,	
lyaanding,	ল্যান্ডিং,	ল্যান্ডিং,	
tatey,	তাতে,	তাতে,	
shasheja,	শাসেজা,	সসেজ,	
bajhyo,	বাঝ্য,	বাহ্য,	
nosihote,	নসীহতে,	নসিহতে,	
moushum,	মৌশুম,	মৌসুম,	
gaaddafee,	গাড়দাফী,	গাদ্দাফী,	
rajtantro,	রাজতন্ত্র,	রাজতন্ত্র,	
chorban,	চোরবান,	চর্বন,	
naazee,	নাজি,	নাত্সি,	
gabhaaskar,	গভাবকরের,	গাভাস্কার,	
fand,	ফ্যান্ড,	ফান্ড,	
sangbadmadhyamgulote,	সংবাদমাধ্যমগুলোতে,	সংবাদমাধ্যমগুলোতে,	
gajano,	গজনো,	গজানো,	
gonohotyakey,	গণহত্যাকে,	গণহত্যাকে,	
bhorkendra,	ভোরকেন্দ্রের,	ভরকেন্দ্র,	
dakteekiter,	ডাক্তিটিকের,	ডাকটিকিটের,	
byatari,	ব্যাটারি,	ব্যাটারী,	
domonmulok,	দমনমূলক,	দমনমূলক,	
drishyogulotey,	দৃশ্যগুলোতে,	দৃশ্যগুলোতে,	
forma,	ফোর্মা,	ফর্মা,	
daltagi,	ডালতাগী,	দলত্যাগী,	
hosney,	হোসনে,	হোসনে,	
bhujangta,	ভুজাঙ্গা,	ভুজঙ্গটা,	
groundta,	গ্রুন্ডটা,	গ্রাউন্ডটা,	
pravura,	প্রভুরা,	প্রভুরা,	
amar,	আমার,	আমর,	
aamor,	আমর,	আমর,	
songkolonti,	সংকল্নটি,	সংকলনটি,	
horeepur,	হরিপুর,	হরিপুর,	
avinetar,	অভিনেতার,	অভিনেতার,	
soceitytey,	সোকেটিতে,	সোসাইটিতে,	
cocaine,	কোকেইন,	কোকেইন,	
roopdaan,	রূপডান,	রুপদান,	
promodwara,	প্রমোদ্বারা,	প্রমদ্বারা,	
seoul,	সিওল,	সোল,	
poriharsoho,	পরিহারসহ,	পরিহারসহ,	
shekarmani,	শেকরনমি,	শেকরমানি,	
syfy,	সিফি,	সাইফাই,	
cholochchitratike,	চলচ্চিত্রাটিকে,	চলচ্চিত্রটিকে,	
foolkopi,	ফুলকোপি,	ফুলকপি,	
abhidhaaneeck,	অভিধানেকিক,	অভিধানিক,	
liedtke,	লিডডটকে,	লইডটক,	
surakarder,	সুরকরদের,	সুরকারদের,	
brindabane,	বৃন্দাবনে,	বৃন্দাবনে,	
geographics,	জিওগ্রাফিক্স,	জিওগ্রাফিকস,	
antennal,	অ্যান্টেনা,	অ্যান্টেনাল,	
heze,	হেজে,	হেজ,	
seekkharthirao,	সিক্ষার্থীরাও,	শিক্ষার্থীরাও,	
hitokor,	হিতোকোর,	হিতকর,	
teksuser,	টেকসুসের,	টেক্সাসের,	
dakten,	ডাকতেন,	ডাকতেন,	
gaphiloti,	গফফিলটি,	গাফিলতি,	
karaponner,	কারাপন্নের,	কারাপণ্যের,	
cheekitsar,	চিকিৎসার,	চিকিত্সার,	
glanio,	গ্লানিও,	গ্লানিও,	
pohnpeic,	পোভনেপিক,	ফোনপেইক,	
fishing,	ফিশিং,	ফিসিং,	
ragei,	রাগেই,	রাগেই,	
golimodhye,	গোিমধ্যে,	গলিমধ্যে,	
bikretaara,	বিক্রেতারা,	বিক্রেতারা,	
yuro,	যুরো,	ইউরো,	
kani,	কানি,	কানি,	
asaciates,	অ্যাসাইটেস,	এসোসিয়েটস,	
duryogamoyee,	দুর্যোগময়ী,	দুর্যোগময়ী,	
fotanor,	ফোটানোর,	ফোটানোর,	
mile,	মিলে,	মিলে,	
rajdhani,	রাজধানী,	রাজধানি,	
bhabaaponno,	ভাবাপন্ন,	ভাবাপন্ন,	
supreetira,	সুপ্রীটিরা,	সুপ্রীতিরা,	
streegon,	স্ত্রীগন,	স্ত্রীগণ,	
avidur,	আভিদুর,	আভিদুর,	
directorete,	ডিরেক্টরেত,	ডিরেক্টরেট,	
themekey,	থেমেকে,	থিমকে,	
plusey,	প্লুসে,	প্লাসে,	
shakara,	সাকারা,	সাকার,	
jolrong,	জলরোং,	জলরঙ,	
balithubar,	বলিঠুবার,	বালিথুবার,	
elakaate,	এলাকাতে,	এলাকাতে,	
uindoos,	উইন্দুসহ,	উইন্ডোস,	
muchlima,	মুছলিমা,	মুছলিমা,	
phokser,	ফকসের,	ফক্সের,	
hoteltite,	হোটেলটিতে,	হোটেলটিতে,	
potka,	পোটকা,	পটকা,	
nagorikota,	নাগরিকোটা,	নাগরিকতা,	
kurdider,	কুরদিদের,	কুর্দিদের,	
lahano,	লাহানো,	লাহানো,	
iqbalke,	ইকবালকে,	ইকবালকে,	
pader,	পাড়ার,	প্যাডের,	
relance,	রিল্যান্স,	রিলায়েন্স,	
danaqana,	দনকানা,	ডানকান,	
panchashjon,	পঞ্চাশ্যন,	পঞ্চাশজন,	
jhamala,	ঝামালা,	ঝামালা,	
monchosthol,	মঞ্চস্থল,	মঞ্চস্থল,	
musalmanderke,	মুসলমানদেরকে,	মুসলমানদেরকে,	
dharmee,	ধর্মী,	ধর্মী,	
paste,	পাস্তে,	পেষ্ট,	
amiretus,	আমিরেতাস,	এমিরেটাস,	
dera,	দেরা,	ডেরা,	
langhangulir,	লঙ্ঘনগুলির,	লঙ্ঘনগুলির,	
norpholk,	নরফফক,	নরফোক,	
mookhomaundoler,	মুখোমাউন্ডের,	মুখমণ্ডলের,	
helloin,	হেলোই়ান,	হ্যালোইন,	
goonoman,	গুণমান,	গুণমান,	
hajirhat,	হাজিরহাট,	হাজিরহাট,	
shoodhooi,	সূধুই,	শুধুই,	
paikgachha,	পাইকগাছা,	পাইকগাছা,	
chahidapotrer,	চাহিদাপত্রের,	চাহিদাপত্রের,	
jokkher,	যক্ষের,	যক্ষের,	
chaloke,	চালকে,	চালকে,	
utpatti,	উৎপত্তি,	উতপত্তি,	
annorup,	অন্নরূপ,	অন্যরূপ,	
agaldar,	আগালদার,	আগলদার,	
mahibur,	মহিবুরের,	মহিবুর,	
tukrote,	তুকরোতে,	টুকরোতে,	
sportstar,	স্পোর্টস্টার,	স্পোর্টসস্টার,	
aarmstrong,	আর্মস্ট্রং,	আর্মস্ট্রং,	
seguloi,	সেগুলোই,	সেগুলোই,	
saver,	সভভার,	সেভার,	
bojhe,	বোঝে,	বোঝে,	
tanu,	তানু,	তনু,	
riazuddin,	রিয়াজউদ্দিন,	রিয়াজউদ্দীন,	
oitijhyotike,	ঐতিহ্যটিকে,	ঐতিহ্যটিকে,	
mulyayonsapekkhe,	মূল্যয়সন্পাচশেষে,	মূল্যায়নসাপেক্ষে,	
maudelgulo,	মড়েলগুলো,	মডেলগুলো,	
achintopurer,	অচিন্তপুরের,	অচিন্তপুরের,	
mentither,	মেন্টিথের,	মেনটিথের,	
uparjoner,	উপার্যনের,	উপার্জনের,	
jomjamat,	জমজামাত,	জমজমাট,	
macbeth,	ম্যাকবেট,	ম্যাকবেথ,	
varote,	ভারতে,	ভারতে,	
noditir,	নদটিটির,	নদীটির,	
maryir,	মায়রীর,	ম্যারির,	
brixfield,	ব্রিক্সফিল্ড,	ব্রিক্সফিল্ড,	
aakkas,	আক্কাস,	আককাস,	
korimpur,	করিমপুর,	করিমপুর,	
spredshiit,	স্প্রেডশিট,	স্প্রেডশীট,	
mononiitoder,	মনোনিতৎদের,	মনোনীতদের,	
nothivukta,	নথিভুক্ত,	নথিভুক্ত,	
samanyai,	সামন্যই,	সামান্যই,	
neemeette,	নিমিত্তে,	নিমিত্তে,	
azin,	আজিন,	আজিন,	
chintakarma,	চিন্তাকর্মা,	চিন্তাকর্ম,	
meropenemer,	মেরোমেপেনের,	মেরোপেনেমের,	
aarik,	আরিক,	আরিক,	
masjidtir,	মসজিদটির,	মসজিদটির,	
grambaasheeo,	গ্রামবাশেও,	গ্রামবাসীও,	
prokalpagulo,	প্রকলাপগুলো,	প্রকল্পগুলো,	
disni,	দিসনি,	ডিজনী,	
chouhate,	চৌহাতে,	চৌহাটে,	
osomorthito,	অসমর্থিত,	অসমর্থিত,	
samaptir,	সমাপ্তির,	সমাপ্তির,	
futonta,	ফুটন্টা,	ফুটন্ত,	
parikha,	পারিখা,	পরিখার,	
baipash,	বাইপাশ,	বাইপাস,	
gandogol,	গণ্ডোগোল,	গন্ডগোল,	
joisttho,	জৈস্থ্ব,	জ্যৈষ্ঠ,	
shikare,	শিকরে,	শিকারে,	
projanankal,	প্রজানন্কল,	প্রজননকাল,	
tuni,	তুনি,	টুনি,	
aswasteekor,	অস্বাস্তিকর,	অস্বস্তিকর,	
deraa,	দিরা,	ডেরা,	
ramonar,	রামনার,	রমনার,	
daakticketer,	ড্যাকটিকেটের,	ডাকটিকিটের,	
cantan,	কান্তান,	ক্যান্টন,	
bangalore,	বাঙ্গোলরে,	ব্যাঙ্গালুরে,	
neermol,	নার্মল,	নির্মল,	
kaalki,	কালকি,	কালকি,	
gaziipur,	গাজিিপুর,	গাজীপুর,	
shikara,	শিকারা,	শিকার,	
abikaul,	আবিকুল,	অবিকল,	
parijaner,	পরিজনের,	পরিজনের,	
laaishheshh,	লাইশেষ,	লাইসেন্স,	
seramiks,	সেরামিক্স,	সিরামিকস,	
nakkal,	নাককল,	নক্কল,	
mele,	মেল,	মাইল,	
parabortee,	পারববর্তী,	পরর্বতী,	
windos,	উইন্ডোস,	উইন্ডোস,	
breqathru,	ব্রেকর্থু,	ব্রেকথ্রু,	
azimpur,	আজিমপুর,	আজিমপুর,	
uddhritir,	উদ্ধৃতির,	উদ্ধৃতির,	
dhani,	ধানি,	ধানি,	
ganokantha,	গণকন্ঠ,	গণকণ্ঠ,	
pratista,	প্রতিস্তা,	প্রতিষ্টা,	
hevy,	হেভি,	হেভি,	
pabo,	পাবো,	পাব,	
salafeta,	সালাফেতা,	সালফেট,	
oncholsomuho,	অঞ্চলসমূহ,	অঞ্চলসমূহ,	
madhobi,	মাধবী,	মাধবী,	
elakatike,	এলাকাটিকে,	এলাকাটিকে,	
romjaner,	রোমজনের,	রমযানের,	
magar,	মাগার,	মাগার,	
rajtantra,	রাজতন্ত্র,	রাজতন্ত্র,	
swairacharibirodhi,	স্বৈরেবারিরোোধি,	স্বৈরাচারীবিরোধী,	
video,	ভিদেও,	ভিডিয়োও,	
gorjon,	গর্জন,	গর্জন,	
soinyo,	সৈন্য,	সৈন্য,	
akhandata,	অখণ্ডতা,	অখণ্ডতা,	
tawnship,	তেনশশিপ,	টাউনশিপ,	
shomser,	শমসের,	সমশের,	
nirmalata,	নির্মালতা,	নির্মলতা,	
bhromoner,	ভ্রমণের,	ভ্রমণের,	
raia,	রাইয়া,	রায়,	
unchiyechilo,	উঁচিয়েছিলো,	উঁচিয়েছিল,	
shatokeo,	শতকেও,	শতকেও,	
nodnodeer,	নদন্দীর,	নদনদীর,	
ohalyar,	ওহারয়ার,	অহল্যার,	
nischoy,	নিশ্চই,	নিশ্চয়,	
elakaatite,	এলাকাটিতে,	এলাকাটিকে,	
sohojlovyotar,	সহজল্বতারার,	সহজলভ্যতার,	
sakshatkarer,	সাকষাৎকারের,	সাক্ষাৎকারের,	
shift,	শিফ,	শিফট,	
abdi,	আবদি,	অব্দি,	
vejjanno,	ভেজ্যান্ন,	ভেজানো,	
beatleser,	বিটলাসের,	বিটলসের,	
ganaporibahaner,	গণপরিবহণের,	গণপরিবহনের,	
ukeliptash,	ইউকেলিপ্টশ,	ইউক্যালিপ্টাস,	
koruna,	কোরুনা,	করুণা,	
cinematographar,	সিনেমাটাগ্রাফার,	সিনেমাটোগ্রাফার,	
vince,	ভিইন্স,	ভিন্স,	
marmader,	মারমাদের,	মারমাদের,	
gate,	গেট,	গ্যেটে,	
suchonakal,	সূচনাকাল,	সূচনাকাল,	
nimnosakkharkari,	নিম্নকাশকারকারী,	নিম্নস্বাক্ষরকারী,	
gandhikey,	গান্ধিকে,	গান্ধীকে,	
welcome,	ওয়েলকমে,	ওয়েলকাম,	
bagicha,	বাগিচা,	বাগিচা,	
superheroo,	সুপারহিরো,	সুপারহিরো,	
rahshahi,	রাহশাহী,	রাহশাহী,	
madrasi,	মাদ্রাসি,	মাদ্রাজি,	
rajbandir,	রাজবন্দির,	রাজবন্দীর,	
hugheke,	হুঝেকে,	হিউজকে,	
phormat,	ফোর্মাট,	ফরম্যাট,	
mugdha,	মুগধা,	মুগ্ধ,	
ooipoka,	উইপকা,	উইপোকা,	
jesh,	জেশ,	জেস,	
vromonkaley,	ভ্রমণকালে,	ভ্রমণকালে,	
proshtutkarok,	প্রশ্তুত্বকরা,	প্রস্তুতকারক,	
pushtee,	পুষ্টি,	পুষ্টি,	
nilfamarir,	নীলফামারির,	নীলফামারীর,	
vogno,	ভোগনো,	ভগ্ন,	
shikkhartheerao,	শিক্ষার্থীরাও,	শিক্ষার্থীরাও,	
jotharthovabey,	যথার্থভাবে,	যথার্থভাবে,	
khaschandpur,	খাসচাঁদপুর,	খাসচাঁদপুর,	
sambhabonao,	সম্ভাবনাও,	সম্ভবনাও,	
average,	এভারেজ,	এভারেজ,	
shaater,	সাতের,	শ্যুটার,	
panchbar,	পাঁচবার,	পাঁচবার,	
chhedon,	ছেদন,	ছেদন,	
laishensh,	লৈশেন,	লাইসেন্স,	
lendl,	লেন্ডল,	লেন্ডল,	
wedanta,	ওয়েদান্ত,	বেদান্ত,	
sanghatakder,	সংহতকদের,	সংঘটকদের,	
degreeo,	ডিগ্রিও,	ডিগ্রিও,	
prosadhaner,	প্রসাধনের,	প্রসাধনের,	
faltu,	ফল্টু,	ফালতু,	
jounotar,	যৌনতার,	যৌনতার,	
shrichaitanyadev,	শ্রীচৈতন্যদবব,	শ্রীচৈতন্যদেব,	
sthapanar,	স্থাপনার,	স্থাপনার,	
sectore,	সেক্টরে,	সেক্টরে,	
mailkhanek,	মেইলখানেক,	মাইলখানেক,	
vaibon,	ভাইবন,	ভাইবোন,	
miraclee,	মিরাকলি,	মিরাকেল,	
temanti,	টেমানটি,	তেমনটি,	
nirgaman,	নির্গমন,	নির্গমন,	
basturoi,	বাস্তুরই,	বস্তুরই,	
drissoke,	দ্রিসোকে,	দৃশ্যকে,	
pyore,	পিয়ারে,	পিওর,	
protectionism,	প্রটেকশনিজম,	প্রোটেকশনিজম,	
chirkoot,	চিরকুট,	চিরকুট,	
nowel,	নোলল,	নভেল,	
chat,	চাট,	চ্যাট,	
ogovir,	অগভীর,	অগভীর,	
habshi,	হাবশি,	হাবশী,	
qaferderkey,	কাফারদেরকে,	কাফেরদেরকে,	
prottokkhovabe,	প্রত্যক্ষভাবে,	প্রত্যক্ষভাবে,	
neelfamarir,	নেলফামারির,	নীলফামারীর,	
chalachchitroke,	চলচ্চিত্রকে,	চলচ্চিত্রকে,	
badhamuktovabe,	বাধাসুক্তভাবে,	বাধামুক্তভাবে,	
podarthobidder,	পদার্থবিদদের,	পদার্থবিদদের,	
kloud,	ক্লোউড,	ক্লাউড,	
swajan,	স্বজন,	স্বজন,	
grambaashio,	গ্রামবাশিও,	গ্রামবাসীও,	
nirbaho,	নির্বাহও,	নির্বাহ,	
dakope,	ডাকোপ,	দাকোপ,	
rajyotiro,	রাজ্যটিরও,	রাজ্যটিরও,	
onurbar,	অনুর্বার,	অনুর্বর,	
shitei,	শিটেই,	শীতেই,	
shaahaabiike,	সাহাববিকে,	সাহাবীকে,	
orbeet,	অরবিট,	অরবিট,	
abanishankar,	অবনীশকঙ্কর,	অবনিশংকর,	
ghumachchila,	ঘুমাচ্ছিলা,	ঘুমাচ্ছিল,	
salmaner,	সালমানের,	সালমানের,	
chaiten,	চাইতেন,	চাইতেন,	
ekoirokom,	একৌরলকম,	একইরকম,	
bandi,	বান্দি,	বন্দী,	
oitijjha,	ঐতিহ্যা,	ঐতিহ্য,	
dharabahiktite,	ধারাবাহিকটিতে,	ধারাবাহিকটিতে,	
rockibul,	রককাবুল,	রকিবুল,	
bondishalatei,	বন্দিশালাতেই,	বন্দিশালাতেই,	
karecho,	কারেছো,	করেছ,	
porobortii,	পরবর্তী,	পরর্বতী,	
ajibooner,	আজিবুনের,	আজীবনের,	
krema,	ক্রেমা,	ক্রাইম,	
stona,	স্তোনা,	স্টোন,	
kogake,	কোগাকে,	কোগাকে,	
favorite,	ফ্যাভরিতে,	ফেভারিট,	
uddhritto,	উদ্ধৃত্ব,	উদ্ধৃত,	
prothar,	প্রথার,	প্রথার,	
onucheeder,	অনুচীদের,	অনুচ্ছেদের,	
sooya,	সুয়া,	সোয়া,	
dadapur,	দাদাপুর,	দাদাপুর,	
uporoshtho,	উপরস্থ,	উপরস্থ,	
shandra,	শান্দ্রার,	শান্দ্রার,	
provritike,	প্রভৃতিকে,	প্রভৃতিকে,	
futote,	ফুটোতে,	ফুটোতে,	
lakshmir,	লক্ষ্মীর,	লক্ষ্মীর,	
toxoid,	টক্সাইড,	টক্সয়েড,	
eura,	ইউরা,	ইউরো,	
akheli,	আখেলি,	আখেলী,	
jaruri,	জারুরি,	জরূরী,	
juakhelar,	জুয়াখেলার,	জুয়াখেলার,	
rashedul,	রাশেদুল,	রাশিদুল,	
huqa,	হুকা,	হুক,	
batikromshalee,	বাতিক্রমশালে,	ব্যতিক্রমধর্মী,	
jeshtha,	যেশ্ঠা,	জ্যেষ্ঠা,	
laaisens,	লাইসেন্স,	লাইসেন্স,	
romantik,	রোমান্তিক,	রোমান্টিক,	
bandhubhaabaapanna,	বন্ধুভবাবন্ন,	বন্ধুভাবাপন্ন,	
phutbolarder,	ফুটবলারদের,	ফুটবলারদের,	
sambatsarkal,	সম্ববস্করকল,	সম্বৎসরকাল,	
basab,	বাসব,	বাসাব,	
maarmaader,	মারমাদের,	মারমাদের,	
prithibir,	পৃথিবীর,	পৃথবীর,	
ramzaner,	রামজনের,	রমযানের,	
dombhoke,	দম্ভকে,	দম্ভকে,	
nodiitei,	নদীতেই,	নদীতেই,	
mojdur,	মজদুর,	মজদুর,	
scholarsip,	স্কলারসিপ,	স্কলারশিপ,	
samanwitovabe,	সমন্বতিভাবে,	সমন্বিতভাবে,	
show,	শোভ,	শো,	
bhabanir,	ভবানীর,	ভবানীর,	
romnar,	রোমনার,	রমনার,	
diibug,	দিববুগ,	ডিবাগ,	
nagorikkey,	নাগরিককে,	নাগরিককে,	
gonjona,	গঞ্জনা,	গঞ্জনা,	
headquartus,	হেডকিউর্টাস,	হেডকোয়ার্টাস,	
shamshernagar,	শমশেরনগর,	শমশেরনগর,	
thabai,	থাবাই,	থাবাই,	
cheentaikaree,	চিন্তাইকারি,	ছিনতাইকারী,	
magical,	ম্যাজিক্যাল,	ম্যাজিকাল,	
doorotomo,	দূরতম,	দূরতম,	
touraat,	তৌরাত,	তওরাত,	
emiratas,	এমিরেটাস,	এমিরেটাস,	
seebiai,	সেবিয়াই,	সিবিআই,	
siddhanto,	সিদ্ধান্ত,	সিদ্ধান্তও,	
edipass,	এডিপ্সাস,	ইডিপাস,	
ekirokom,	একিরকম,	একইরকম,	
dalee,	ডালী,	ডালে,	
chiraharit,	চিরাহারিত,	চিরহরিৎ,	
ankanshilpe,	অঙ্কনশিল্পে,	অঙ্কনশিল্পে,	
pratisthanik,	প্রতিস্থানিক,	প্রাতিষ্ঠানিক,	
oichchheek,	ঐচ্চিক,	ঐচ্ছিক,	
toroonraa,	তরণরা,	তরুণরা,	
bonnypran,	বন্ন্প্রাণ,	বন্যপ্রাণ,	
deputy,	ডিপুটি,	ডেপুটি,	
barder,	বার্ডার,	বার্ডের,	
prashikkhane,	প্রাশিক্ষণে,	প্রশিক্ষণে,	
kadam,	কাদম,	কদম,	
dhos,	ধ্যস,	ধস,	
jibonnogor,	জীবননগর,	জীবননগর,	
euqalyptus,	ইউক্লাইপ্টাস,	ইউক্যালিপ্টাস,	
bifol,	বিফল,	বিফল,	
dapadpi,	দাপাপ্পি,	দাপাদপি,	
rudrasagar,	রুদ্রসাগর,	রুদ্রসাগরের,	
jansa,	জানসা,	জন্স,	
upbasher,	উপবাশের,	উপবাসের,	
podotyagsongkranto,	পদত্যাসংক্রান্ত,	পদত্যাগসংক্রান্ত,	
shresthoshcho,	শ্রেষ্ঠস্চ,	শ্রেষ্ঠশ্চ,	
armori,	আর্মোরি,	আরমোরি,	
jens,	জেন্স,	জিন্স,	
augustine,	আগাস্টিন,	অগাস্টিন,	
aziboner,	আজিবোনের,	আজীবনের,	
bijito,	বিজিত,	বিজিত,	
ganesh,	গেনশ,	গণেশ,	
hoteltee,	হোটেলটি,	হোটেলটি,	
sumi,	সুমি,	সুমি,	
simantarkkhibahinir,	সীমান্তকৃষ্ণবিনীর,	সীমান্তরক্ষীবাহিনীর,	
kei,	সেই,	কেই,	
oblivion,	অব্লিহন,	অবলিভিয়ন,	
sikkhokder,	শিক্ষকদের,	শিক্ষকদের,	
grauth,	গ্রাথ,	গ্রোথ,	
nothibhukta,	নথিভুক্ত,	নথিভুক্ত,	
sawam,	সামাম,	সাওম,	
sharthe,	শার্থে,	স্বার্থে,	
kraanti,	ক্রান্টি,	ক্রান্তি,	
bethikata,	বেথিকাটা,	বেঠিকতা,	
contemporary,	কনটারমপপারি,	কন্টেম্পোরারি,	
dimbacriti,	ডিম্বাক্রিটি,	ডিম্বাকৃতি,	
daap,	ডাপ,	ড্যাপ,	
rajnaiteek,	রাজনৈতিক,	রাজনৈতীক,	
jor,	জোর,	জ্বর,	
kanshat,	কানশাট,	কানসাট,	
klaud,	ক্লাউড,	ক্লাউড,	
bosoben,	বসবেন,	বসবেন,	
rakhete,	রাখেতে,	রাখেতে,	
gotirodh,	গতিরোধ,	গতিরোধ,	
pratijogira,	প্রতিযোগীরা,	প্রতিযোগীরা,	
hazat,	হাজাত,	হজত,	
hypar,	হাইপার,	হাইপার,	
chikitshar,	চিকিৎসার,	চিকিত্সার,	
planeti,	প্লানেটি,	প্লেনটি,	
directarate,	ডিরেক্টরেট,	ডিরেক্টরেট,	
chalachchitroi,	চলচ্চিত্রই,	চলচ্চিত্রই,	
samajikatar,	সমাজিকতার,	সামাজিকতার,	
palestine,	ফ্যালেস্টাইন,	প্যালেস্টাইনে,	
bhramapraban,	ভ্রমাপ্রবণ,	ভ্রমপ্রবণ,	
eekbalke,	একবালকে,	ইকবালকে,	
shasonamoleri,	শাসনামলেরই,	শাসনামলেরই,	
hamburgey,	হামবুর্গে,	হামবুর্গে,	
esasiyetasa,	এসাসিয়াতেস,	এসোসিয়েটস,	
gandhike,	গান্ধিকে,	গান্ধীকে,	
aakkaash,	অক্কাশ,	আককাস,	
ingreziteo,	ইংরেজিতেও,	ইংরেজিতেও,	
bangulzai,	বাঙুুলজায়ী,	বঙ্গুলিজাই,	
dajhyo,	দা্্য,	দাহ্য,	
antorvuktimulak,	আন্তর্ভতিমূলক,	অন্তর্ভুক্তিমূলক,	
perry,	পেরি,	পেরি,	
kutubuddinke,	কুটুবুদ্দিনকে,	কুতুবুদ্দিনকে,	
bhikkharthe,	ভিক্ষার্থে,	ভিক্ষার্থে,	
dephinishion,	ডিফিনিসহন,	ডেফিনেশন,	
conflikt,	কনফ্লিক্ট,	কনফ্লিক্ট,	
proshadhoner,	প্রসাধনের,	প্রসাধনের,	
mukhomandoler,	মুখমন্ডলের,	মুখমণ্ডলের,	
bbiseshyer,	বিবিশিষ্যের,	বিশেষ্যের,	
deefinition,	ডিফিনিশন,	ডেফিনেশন,	
sinakey,	সিনাকে,	সিনাকে,	
niphelheim,	নিফেলিওমি,	নিফেলহেইম,	
durtomo,	দুর্তমো,	দূরতম,	
krisenta,	ক্রিসেন্টা,	ক্রিসেন্ট,	
simaa,	সিমা,	সীমা,	
hetimganje,	হেটিমগঞ্জে,	হেতিমগঞ্জে,	
bonsho,	বন্স,	বংশ,	
purple,	পার্পল,	পার্পেল,	
uposhthit,	উপশ্থিত,	উপস্থিত,	
venuser,	ভেনাসের,	ভেনাসের,	
metropalitana,	মেট্রোপলিটান,	মেট্রোপলিটন,	
lagchhe,	লাছছে,	লাগছে,	
kagbeni,	কাগবেনি,	কাগবেনি,	
summer,	সাম্মার,	সামার,	
cholochchitrake,	চলচ্চিত্রাকে,	চলচ্চিত্রকে,	
heelser,	হেলসের,	হিলসের,	
nabotom,	নেবোটম,	নবতম,	
protijogiitamulok,	প্রতিযোগিতামূলক,	প্রতিযোগীতামূলক,	
bhittitei,	ভিত্তিতেই,	ভিত্তিতেই,	
shainyader,	শৈন্যদের,	সৈন্যদের,	
nathivookteer,	নাথিভজ্তির,	নথিভুক্তির,	
nuhas,	নুহাস,	নুহাশ,	
janar,	জানার,	জানার,	
shikshakbrinda,	শিক্ষাকবৃন্দা,	শিক্ষকবৃন্দ,	
fongli,	ফংলি,	ফংলি,	
tateo,	তাতেও,	তাতেও,	
dharmantor,	ধর্মন্তর,	ধর্মান্তর,	
prakar,	প্রকার,	প্রকার,	
chilahaati,	চিলাহাটি,	চিলাহাটি,	
mesenjarer,	মেসেনজাতের,	মেসেঞ্জারের,	
gabinius,	গ্যাবিনিয়াস,	গাবিনিআস,	
bijepi,	বিজেপি,	বিজেপি,	
munot,	মুনোত,	মুনোট,	
onshogrohoner,	অংশগ্রহণের,	অংশগ্রহনের,	
baarnish,	বার্নিশ,	বার্নিশ,	
niketon,	নিকেতন,	নিকেতন,	
bhoutikeshu,	ভৌতিকেষু,	ভৌতিকেষু,	
orgho,	অর্ঘো,	অর্ঘ্য,	
kalakushalir,	কালকুশলীর,	কলাকুশলীর,	
chetanagato,	চেতনাগত,	চেতনাগত,	
rubala,	রুবালা,	রুবল,	
omanisa,	অমানিসা,	অমানিশা,	
sushposhtolikhito,	সুষ্পষ্টিলখোত,	সুষ্পষ্টলিখিত,	
foreks,	ফোরেক্স,	ফরেক্স,	
nirbachakder,	নির্বাচকদের,	নির্বাচকদের,	
agomone,	আগমনে,	আগমনে,	
cholechi,	চলেছি,	চলেছি,	
shuchonakal,	শুচনাকাল,	সূচনাকাল,	
shrimoti,	শ্রীমটি,	শ্রীমতি,	
karlei,	করলেই,	করলেই,	
biplobi,	বিপ্লবি,	বিপ্লবী,	
modhumotii,	মধুমতিই,	মধুমতী,	
nutoner,	নিউনোর,	নূতনের,	
songrahak,	সংগ্রহক,	সংগ্রাহক,	
khappar,	খপ্পার,	খপ্পর,	
vagini,	ভাগিনি,	ভগিনী,	
deil,	ডেল,	ডেইল,	
shumo,	শুমো,	সুমো,	
udbodhani,	উদ্বধানী,	উদ্বোধনী,	
bahati,	বাহাটি,	বাহাতি,	
reejideencee,	রিজডডিয়েন্স,	রেসিডেন্স,	
laesensh,	লাসেনশ,	লাইসেন্স,	
bosturoi,	বস্তুরই,	বস্তুরই,	
narsinghomgulor,	নার্সিংহগুলোর,	নার্সিংহোমগুলোর,	
sanaktokaran,	সনক্তকরণ,	সনাক্তকরণ,	
capsul,	ক্যাপসুল,	ক্যাপসুল,	
somratra,	সম্রাট্রা,	সম্রাটরা,	
sanstha,	সান্স্থ,	সংস্থা,	
niutrino,	নিউট্রিনো,	নিউট্রিনো,	
auttacharer,	অট্টাচারের,	অত্যাচারের,	
suhayeler,	সুহায়েলের,	সুহায়েলের,	
ganoporibahon,	গণপরিবহণ,	গণপরিবহন,	
marathi,	মারাঠি,	মরাঠি,	
chhadite,	ছাড়িতে,	ছড়িতে,	
hozot,	হজত,	হজত,	
mangoleek,	মঙ্গলইিক,	মাঙ্গলিক,	
tachnach,	তাচনাচ,	তছনছ,	
oyebjin,	ওয়েবজিন,	ওয়েবজিন,	
hijrite,	হিজরিতে,	হিজরীতে,	
sursur,	সুরসুর,	সুরসুর,	
cinemapremider,	সিনেমাপ্রেমীদের,	সিনেমাপ্রেমীদের,	
rushod,	রুশোদ,	রুশদ,	
sabrakamer,	সব্রকামের,	সবরকমের,	
nothibhukteer,	নথিভুক্তির,	নথিভুক্তির,	
eshiyetika,	এসিয়েতিকা,	এশিয়াটিক,	
cholocchitrer,	চলচ্চিত্রের,	চলচ্চিত্রের,	
nopdnodir,	নপ্দনদির,	নদনদীর,	
opohoron,	অপহরণ,	অপহরন,	
bachai,	বাছাই,	বাছাই,	
khabarsoho,	খাবারসহ,	খাবারসহ,	
vobobibhuti,	ভববভভিতু,	ভববিভূতি,	
giitikobitar,	গীতিকটিবার,	গীতিকবিতার,	
sahozlabhbhatar,	সহযোলভভভাতার,	সহজলভ্যতার,	
qyantana,	ক্যান্টান,	ক্যান্টন,	
jahangirbad,	জাহাঙ্গীরবাদ,	জাহাঙ্গীরবাদ,	
fansi,	ফ্যান্সি,	ফাঁসী,	
caramiks,	ক্যারামিকস,	সিরামিকস,	
shef,	শেফ,	শেফ,	
temone,	টেমোন,	তেমনই,	
afzol,	আফজল,	আফজল,	
peeth,	পিথ,	পীঠ,	
modhyekar,	মধ্যেকার,	মধ্যেকার,	
uqeliptas,	ইউকেলিপ্টাস,	ইউক্যালিপ্টাস,	
ekhate,	এখাতে,	একহাতে,	
pichte,	পিচতে,	পিছতে,	
everestey,	এভারেস্টে,	এভারেস্টে,	
accountdharira,	একাউন্টোরোরীরা,	একাউন্টধারীরা,	
ashirbadatri,	আশীর্বযাত্রী,	আশীর্বাদাত্রী,	
satarkokari,	সতর্ককারী,	সতর্ককারী,	
pretty,	প্রেটি,	প্রিটি,	
pratijogitamulak,	প্রতিযোগিতামূলক,	প্রতিযোগীতামূলক,	
nagorikderkey,	নাগরিকদেরকে,	নাগরিকদেরকে,	
aniyantrita,	অনিয়ন্ত্রিত,	অনিয়ন্ত্রিত,	
kantajir,	কান্াজির,	কান্তজির,	
jotinkey,	জতিনকে,	যতীনকে,	
taims,	টেইমস,	টাইমস্,	
lettar,	লেট্টার,	লেটার,	
ernad,	এরনাদ,	এরনাড,	
pack,	প্যাক,	প্ল্যাক,	
vedanta,	ভেদন্ত,	বেদান্ত,	
chikitsar,	চিকিৎসার,	চিকিত্সার,	
ched,	চেদ,	ছেদ,	
samley,	সামলে,	সামলে,	
avetar,	আভেতার,	অবতার,	
pujito,	পুজিত,	পুজিত,	
prothati,	প্রথাটি,	প্রথাটি,	
nottee,	নটটি,	নোটটি,	
promothesh,	প্রমোথেস,	প্রমথেশ,	
mexicoteo,	মেক্সিকোেও,	মেক্সিকোতেও,	
ahmed,	আহমেদ,	আহামদ,	
seniar,	সেনিয়ার,	সিনিয়র,	
transformaarer,	ট্রান্সফোরমারের,	ট্রান্সফরমারের,	
nirbahi,	নির্বাহী,	নির্বাহি,	
dweepgoolotey,	দ্বীপগুলোতে,	দ্বীপগুলোতে,	
dhanak,	ধনক,	ধানক,	
bhebechili,	ভেবেছিলি,	ভেবেছিলি,	
sukumaree,	সুকুমারে,	সুকুমারী,	
rokkhonabekkhoner,	রক্ষণাগেষ্ঠনের,	রক্ষণাবেক্ষণের,	
suparharo,	সুপারহারো,	সুপারহিরো,	
pisach,	পিসাচ,	পিশাচ,	
arifin,	আরিফিন,	আরিফিন,	
judge,	জুদগে,	জাজ,	
shaddhi,	শাদ্ধি,	সাধ্বী,	
chirantan,	চিরন্তন,	চিরন্তন,	
jocqey,	জকে,	জকি,	
adwanced,	অ্যাডব্যান্ডেড,	অ্যাডভান্সড,	
saria,	সারিয়া,	সরিয়া,	
rushad,	রুশাদ,	রুশদ,	
shamuker,	শামুকের,	শামুকের,	
crucer,	ক্রুসের,	ক্রুশের,	
hafej,	হাফেজ,	হাফেয,	
ghamta,	ঘামটা,	ঘোমটা,	
dala,	দালা,	দলা,	
saras,	সারাস,	সরস,	
bisheshya,	বিশেষ্য,	বিশেষ্য,	
peethey,	পিথে,	পীঠে,	
hundai,	হুন্ডাই,	হুন্দাই,	
juboksoho,	যুবকসহ,	যুবকসহ,	
ghoor,	ঘুর,	ঘুর,	
wagadada,	ওয়াগাদাদা,	বাগদাদ,	
sahocorje,	সহকর্যে,	সাহচর্যে,	
bishwasho,	বিশ্বাসও,	বিশ্বাসও,	
zerusaleme,	জেরুসালেমে,	জেরুসালেমে,	
mukherjee,	মুখেরজি,	মুখার্জী,	
sima,	সিমা,	সীমা,	
kichutei,	কিছুতেই,	কিছুতেই,	
ul,	উলএল,	উল,	
giitikobita,	গীতিকতিবা,	গীতিকবিতা,	
sarjur,	সারজুর,	সরযূর,	
nazranar,	নাজরানার,	নাজরানার,	
seekkhaou,	সেক্ষাও,	শিক্ষাও,	
bhaandar,	ভান্ডার,	ভাণ্ডার,	
pachak,	পাচাক,	পাচক,	
flexta,	ফ্লেক্সটা,	ফ্লেক্সটা,	
peterke,	পেটারকে,	পিটারকে,	
ghotol,	ঘটল,	ঘটল,	
torunderke,	তরুণ্দারকে,	তরুণদেরকে,	
rajan,	রাজান,	রাজন,	
pathanatak,	পাঠানাটক,	পথনাটক,	
bhromonkaale,	ভ্রমণকালে,	ভ্রমণকালে,	
sarbhare,	সার্ভারে,	সার্ভারে,	
aashtikotaa,	আষ্টিকোৎ,	আস্তিকতা,	
nadnadeer,	নদ্নাদির,	নদনদীর,	
kadakhonchar,	কাদাখোঁচার,	কাদাখোঁচার,	
deqe,	ডিকে,	ডেকে,	
machsoho,	মাচসহ,	মাছসহ,	
sachetonvabe,	সচেতনভাবে,	সচেতনভাবে,	
agomonke,	আগমনকে,	আগমনকে,	
nachiketa,	নচিকেতা,	নচিকেতা,	
ragee,	রাগী,	রাগী,	
swasthohinotay,	স্বাস্থ্যহীনতায়,	স্বাস্থ্যহীনতায়,	
bohudeen,	বহুদিন,	বহুদিন,	
barack,	ব্রাক,	বারাক,	
probondhobhittik,	প্রবন্ধোভিত্তিক,	প্রবন্ধভিত্তিক,	
hol,	হোল,	হোল,	
murad,	মুরাদ,	মুরাদ,	
pratisthasaho,	প্রতিষ্ঠাসহ,	প্রতিষ্ঠাসহ,	
taunasipa,	তওনাসিপা,	টাউনশিপ,	
pyaleshtainer,	প্লালশ্টাইনের,	প্যালেস্টাইনের,	
crashlands,	ক্র্শানল্যান্ডস,	ক্র্যাশল্যান্ডস,	
ajeeboner,	আজেবনের,	আজীবনের,	
bhuushito,	ভৌষিত,	ভূষিত,	
temonbhabe,	তেমনভাবে,	তেমনভাবে,	
markeetim,	মার্কিটিম,	মার্কেটিং,	
baganoto,	বাগানোতো,	বাগানত,	
chargar,	চারগর,	চার্জার,	
koyeeri,	কয়েরি,	কোয়েরি,	
krush,	ক্রুশ,	ক্রুশ,	
byabaharkareer,	ব্যবহারকারীর,	ব্যবহারকারীর,	
bondi,	বন্দি,	বন্দী,	
meghacchonno,	মেঘাচ্ছন্ন,	মেঘাচ্ছন্ন,	
bikargrasta,	বিকারগ্রস্ত,	বিকারগ্রস্ত,	
sollallhu,	সোল্লালহুু,	সল্লাল্লাহু,	
waal,	ওয়াল,	উল,	
shommoteer,	সম্মতির,	সম্মতির,	
hughes,	হুঘেস,	হিউজেস,	
valobasen,	ভালোবাসেন,	ভালোবাসেন,	
venice,	ভেনিস,	ভেনিস,	
codeti,	কোটেটি,	কোডটি,	
shilpikuler,	শিল্পিকুলের,	শিল্পীকুলের,	
bishnu,	বিষ্ণু,	বিষ্ণু,	
taatey,	তাতে,	তাতে,	
muradkey,	মুরাদকে,	মুরাদকে,	
minilosar,	মিনিলোসার,	মিনিলোসার,	
vugorvey,	ভুগরভে,	ভূগর্ভে,	
baasaate,	বাসাতে,	বাসাতে,	
lirikti,	লিরিকটি,	লিরিকটি,	
vaticaner,	ভ্যাটিকানের,	ভ্যাটিকানের,	
bairer,	বেইরের,	বাইরের,	
madraser,	মাদ্রাসের,	মাদ্রাজের,	
ispredsiit,	আসপ্রেসডিপিট,	স্প্রেডশীট,	
sausagee,	সৌসাগী,	সসেজ,	
atak,	আটাক,	আটক,	
noitikota,	নৈতিকতা,	নৈতিকতা,	
khudhartara,	ক্ষুধারতা,	ক্ষুধার্তরা,	
khaaneker,	খানেকের,	খানেকের,	
alonkaran,	আলনকরণ,	অলঙ্করণ,	
lendol,	লেন্ডোল,	লেন্ডল,	
neerbahe,	নির্বাহে,	নির্বাহে,	
as,	এস,	অস,	
uponeeshod,	উপনেশদ,	উপনিষদ,	
chikittsar,	চিকিত্তাসের,	চিকিত্সার,	
chakurijibirao,	চাকুরিজীবিরাও,	চাকুরীজীবীরাও,	
eporzonto,	এপরজন্ত,	এপর্যন্ত,	
modelkey,	মডেলকে,	মডেলকে,	
scuvi,	স্কেভি,	স্কুভি,	
bihar,	বিহার,	বিহার,	
vittio,	ভিত্তিও,	ভিত্তিও,	
tahalo,	তাহালো,	তাহলো,	
brittakarey,	বৃত্তকারী,	বৃত্তাকারে,	
rudiger,	রুদিগের,	রুদিগের,	
bajpa,	বাজপা,	বাজপা,	
nirmolota,	নির্মোততা,	নির্মলতা,	
mosharroph,	মশাররোফ,	মশাররফ,	
saralya,	সরল্যা,	সারল্য,	
aachhis,	আছিস,	আছিস,	
byabosthar,	ব্যবস্থার,	ব্যাবস্থার,	
madeling,	ম্যাডেলিং,	মডেলিং,	
dorun,	দোরুন,	দরুণ,	
nirbachokder,	নির্বাচকদের,	নির্বাচকদের,	
pathkrom,	পাথক্রম,	পাঠক্রম,	
fokskon,	ফক্সন,	ফক্সকন,	
manjushri,	মঞ্জুশ্রী,	মঞ্জুশ্রী,	
stanahenja,	স্তানহেঙ্জা,	স্টোনহেঞ্জ,	
kharar,	খারার,	খরার,	
duuma,	দুমোমা,	দুমা,	
taufiq,	তওফিক,	তৌফিক,	
shamshere,	শামশেরে,	শমসের,	
wishnu,	উইস্ু,	বিষ্ণু,	
jipiusamriddha,	জিপিদুসমৃদ্ধ,	জিপিউসমৃদ্ধ,	
katiusha,	কাটিটোশা,	কাতিউশা,	
moreecha,	মরিচা,	মরিচা,	
ameettrakkhor,	অমিত্তরক্ষর,	অমিত্রাক্ষর,	
kayartara,	কায়ারটারা,	কোয়ার্টার,	
zonsa,	জোন্সা,	জোন্স,	
jacksonke,	জ্যাকসনকে,	জ্যাকসনকে,	
saarbhaarti,	সারভভর্তি,	সার্ভারটি,	
ganochien,	গণোচ্যেন,	গণচীন,	
youth,	উ্ত,	ইয়ুথ,	
impaction,	ইম্প্যাকশন,	ইমপ্যাকশন,	
keyu,	কেই,	কেউ,	
bisheshshyo,	বিশেষ্য,	বিশেষ্য,	
maaktoome,	ম্যাটটাম,	মাকতুম,	
borendroke,	বরেন্দ্রকে,	বরেন্দ্রকে,	
ranangane,	রণাঙ্গনে,	রণাঙ্গনে,	
biplabeer,	বিপ্লবীর,	বিপ্লবীর,	
debete,	দেবেতে,	ডিবেট,	
cooda,	কুড,	কোডা,	
jatata,	জাতাতা,	যতোটা,	
ostheesandhi,	অস্থিসন্ধি,	অস্থিসন্ধি,	
setike,	সেতিকে,	সেটিকে,	
munsi,	মুন্সি,	মুন্সী,	
bhutbhut,	ভূটভূত,	ভুটভুট,	
maritimer,	মেরিটিইমের,	মেরিটাইমের,	
saom,	সায়ম,	সাওম,	
harza,	হারজা,	হার্জ,	
mukhoshdharir,	মুখোষধারীর,	মুখোশধারীর,	
marry,	মাযারির,	ম্যারি,	
arthonitite,	অর্থনীতিতে,	অর্থনীতিতে,	
shringgo,	শৃঙ্গ,	শৃঙ্গ,	
milekhaanek,	মিলেখানেক,	মাইলখানেক,	
panchasjan,	পঞ্চাসজন,	পঞ্চাশজন,	
shhashtra,	শাস্ত্রা,	শাস্ত্র,	
kurdira,	কুর্দিরা,	কুর্দিরা,	
gonona,	গণনা,	গননা,	
mahafezkhanar,	মহাগেকতনার,	মহাফেজখানার,	
pouchute,	পৌছুতে,	পৌঁছুতে,	
kaamij,	কামিজ,	কামিজ,	
orthanitir,	অর্থানীটির,	অর্থনীতির,	
chalachchitra,	চলচ্চিত্র,	চলচ্চিত্র,	
medilek,	মেডিলেক,	মেডিলেক,	
bandhan,	বান্ধন,	বাঁধন,	
tigmanshu,	টিগমানশু,	তিগ্মাংশু,	
probeshkari,	প্রবেশকারী,	প্রবেশকারী,	
sthapanagulo,	স্থাপানগুলো,	স্থাপনাগুলো,	
serveray,	সারভারে,	সার্ভারে,	
seshardhe,	শেশার্ধে,	শেষার্ধে,	
hakone,	হাকোনে,	হাকোনে,	
ceramicer,	সেরামিসের,	সিরামিকের,	
arasie,	আরসসি,	আরসিএ,	
probhur,	প্রভুর,	প্রভুর,	
vault,	ভেল্ট,	ভল্ট,	
manush,	মানুশ,	মানুষ,	
nisshongotake,	নিঃসংগতকা,	নিঃসঙ্গতাকে,	
vesselli,	ভেসেলি,	ভেসেলি,	
scholarship,	স্কলারশিপ,	স্কলারশিপ,	
dijmarescu,	ডিজমার্েকস,	দিজমার্সাকু,	
brail,	ব্রাইল,	ব্রেইল,	
itostatah,	ইতস্তটা,	ইতস্ততঃ,	
kyatagorir,	ক্যাটাগরির,	ক্যাটাগরির,	
madhuri,	মধুরি,	মাধুরী,	
gronthao,	গ্রন্থাও,	গ্রন্থও,	
kathghera,	কাঠঘেরা,	কাঠঘেরা,	
uporzon,	উপরজন,	উপার্জন,	
sangitanusthane,	সঙ্গীতানুষ্ঠানে,	সঙ্গীতানুষ্ঠানে,	
ponchaasjon,	পঞ্চাকন,	পঞ্চাশজন,	
daebug,	দাবগগ,	ডিবাগ,	
vool,	ভোল,	উল,	
awrbit,	এবর্বিট,	অরবিট,	
saoum,	সাওয়াম,	সাওম,	
bbiswashke,	বিবিস্বাসকে,	বিশ্বাসকে,	
abhirupbabuke,	অভিরূপবাবুকে,	অভিরূপবাবুকে,	
oncoltike,	অনক্লটিকে,	অঞ্চলটিকে,	
koro,	কোরো,	করো,	
korley,	করলে,	করলে,	
lutherana,	লুথেরানা,	লুথেরান,	
atibiplabi,	আতিবিপ্লবী,	অতিবিপ্লবি,	
doorotaumo,	দূরতামু,	দূরতম,	
amarjito,	অমরজিত,	অমার্জিত,	
weenis,	ভিনিস,	ভেনিস,	
vange,	ভাঙ্গে,	ভাঙ্গে,	
saazano,	সাজানো,	সাজানো,	
deares,	ডিয়ারেস,	ডিআরএস,	
teamothy,	টিমোথি,	টিমোথি,	
borlen,	বরলেন,	বরলেন,	
thandabhabe,	থান্ডাওবাবে,	ঠাণ্ডাভাবে,	
chaalkee,	চালকে,	চালকে,	
gaichey,	গাইছে,	গাইছে,	
kalirkhal,	কালীরখাল,	কালিরখাল,	
bondhukey,	বন্ধুকে,	বন্ধুকে,	
johor,	জহর,	জহর,	
sayatana,	সায়াতানা,	শয়তান,	
detik,	ডেটিক,	দেতিক,	
gingbhalobasen,	জিংভালোবালেস,	গিংভালোবাসেন,	
providere,	প্রভিদেরে,	প্রভাইডারে,	
keyboarder,	কেইবোর্ডের,	কীবোর্ডের,	
yak,	যাক,	ইয়াক,	
backflipe,	ব্যাকফিলিপ,	ব্যাকফ্লিপে,	
bboponer,	ব্বপনের,	বপনের,	
pnouchute,	পৌঁছুতে,	পৌঁছুতে,	
chongar,	চঙ্গার,	চোঙ্গার,	
jotota,	যত্তা,	যতোটা,	
orhan,	ওরহান,	ওরহান,	
difinisian,	ডিফিনিসিয়ান,	ডেফিনেশন,	
dharabahikotitey,	ধারাবাহিকতিতে,	ধারাবাহিকটিতে,	
gasthi,	গাষ্ঠি,	গোষ্ঠী,	
biprodas,	বিপ্রদাস,	বিপ্রদাস,	
shekender,	সেকেন্ডের,	সেকেন্ডের,	
joki,	জোক,	জকি,	
juktorastrer,	যুক্তরাস্ত্রের,	যুক্তরাষ্ট্রের,	
stana,	স্তানা,	স্টোন,	
forex,	ফোরেক্স,	ফরেক্স,	
oedipus,	ওডেপাস,	ইডিপাস,	
utsahi,	উৎসাহি,	উৎসাহী,	
dharavahiker,	ধারাভাহীকের,	ধারাবাহিকের,	
abdoone,	আবদুনে,	আবদুন,	
foxcon,	ফক্সকন,	ফক্সকন,	
upobasher,	উপবাশের,	উপবাসের,	
freelancerra,	ফ্রীল্যান্সরা,	ফ্রিল্যান্সাররা,	
akkhunno,	অক্ষুন্ন,	অক্ষুণ্ণ,	
parinati,	পরিণাটি,	পরিণতি,	
hugeke,	হুগেকে,	হিউজকে,	
songbadmadhyame,	সংবাদমাধ্যমে,	সংবাদমাধ্যমে,	
drabyatah,	দ্রব্যতঃ,	দ্রব্যতঃ,	
madhabike,	মাধবীকে,	মাধবীকে,	
ralf,	রাল্ফ,	রালফ,	
ramachandranke,	রামচন্দ্রকে,	রামাচন্দ্রনকে,	
goora,	গুরা,	গোর,	
sharansthal,	শারাস্থল,	শরণস্থল,	
daqop,	ডাকোপ,	দাকোপ,	
balaruma,	বালারুমা,	বলরুম,	
atmobonchito,	আত্মবনচিত,	আত্মবঞ্চিত,	
kod,	কোদ,	কোড,	
suraaropeeto,	সুরাওরপিত,	সুরারোপিত,	
soomitrar,	সুমিত্রার,	সুমিত্রার,	
geja,	গেজা,	গেজ,	
jhalkanite,	ঝালকানিতে,	ঝলকানীতে,	
taigara,	তাইগারা,	টাইগার,	
karmasampadon,	কর্মসম্পান,	কর্মসম্পাদন,	
teoner,	টেওনার,	টিওনার,	
himchi,	হিমচি,	হিমচি,	
shekarone,	শেকারণে,	সেকারণে,	
sikkhakromer,	শিক্ষাক্রমের,	শিক্ষাক্রমের,	
militarir,	মিলিতারির,	মিলিটারির,	
qonfliqt,	কনফ্লিক্ট,	কনফ্লিক্ট,	
chaudhurio,	চৌধুরিও,	চৌধুরীও,	
ruby,	রুবি,	রুবী,	
prosadhoner,	প্রসাধনের,	প্রসাধনের,	
konistho,	কনিষ্ঠ,	কনিষ্ঠ,	
anubhutimalar,	অনুভূতিমালার,	অনুভূতিমালার,	
kirke,	কিরকে,	কিরকে,	
bongshokey,	বংশকে,	বংশকে,	
dhojovongo,	ধ্ববনঙ্গ,	ধ্বজভঙ্গ,	
phund,	ফান্ড,	ফান্ড,	
rilayensha,	রিলয়েন্স,	রিলায়েন্স,	
bishaashke,	বিশাশকে,	বিশ্বাসকে,	
ramnathbabur,	রামনাথবাবুর,	রামনাথবাবুর,	
mataram,	মাতারাম,	মাতরম,	
ardasha,	আর্দাশা,	আর্দশ,	
kash,	কাশ,	কাস,	
ashok,	আশক,	আশোক,	
taronee,	তরণী,	তরণী,	
lyaataa,	লেটা,	ল্যাটা,	
purborekorde,	পূর্বরেকরদে,	পূর্বরেকর্ডে,	
rachanakal,	রচনাকাল,	রচনাকাল,	
directorate,	ডিরেক্টরেট,	ডিরেক্টরেট,	
shcholastic,	স্কলাস্টিক,	স্কলাস্টিক,	
cuti,	কুউটি,	কিউটি,	
saqara,	সাকারা,	সাকার,	
semai,	সেমাই,	সেমাই,	
nirvaha,	নির্ভাহা,	নির্বাহ,	
obosan,	অবসান,	অবসান,	
elakaasoho,	এলাকাসহ,	এলাকাসহ,	
saarbharti,	সারভবর্তী,	সার্ভারটি,	
konflict,	কনফ্লিক্ট,	কনফ্লিক্ট,	
sheekar,	শিকার,	শিকার,	
ritesh,	রিটেশ,	রিতেশ,	
sampadon,	সামপাদন,	সম্পাদন,	
gobeshana,	গবেষণা,	গবেষনা,	
nichupattir,	নিচুপত্তির,	নিচুপট্টির,	
biphal,	বিপাল,	বিফল,	
dibya,	দিব্যা,	দিব্যা,	
krishibigyani,	কৃষিবিজ্ঞানী,	কৃষিবিজ্ঞানী,	
plainey,	প্লেইন,	প্লেনে,	
panda,	পাণ্ডা,	পান্ডে,	
daqten,	ডাতেন,	ডাকতেন,	
amanisha,	আমানিসা,	অমানিশা,	
shithilata,	শীথিলতা,	শিথিলতা,	
muhaiminer,	মুহাইমিনের,	মুহাইমিনের,	
bachhaikrito,	বাছাইকৃত,	বাছাইকৃত,	
dai,	দাই,	ডে,	
chhooti,	ছুটি,	ছুটি,	
brekethru,	ব্রেকটর্,	ব্রেকথ্রু,	
phutonta,	ফুটন্টা,	ফুটন্ত,	
muradke,	মুরাদকে,	মুরাদকে,	
messengerer,	মেসেনগারের,	মেসেঞ্জারের,	
khudrokar,	ক্ষুদ্রকার,	ক্ষুদ্রকার,	
bojhaao,	বঝাওা,	বোঝাও,	
phising,	ফিসিং,	ফিসিং,	
protul,	প্রতুল,	প্রতুল,	
manatmulak,	মনতমলূলক,	মানতমূলক,	
anhu,	আন্হু,	আনহু,	
mastarsa,	মাস্তারসা,	মাস্টার্স,	
municipal,	মুনিকিপাল,	মিউনিসিপ্যাল,	
nobotom,	নবটম,	নবতম,	
debholopar,	দেবলোপার,	ডেভলপার,	
naraphoka,	নারাফোকা,	নরফোক,	
ajuhath,	অজুহা,	অজুহাত,	
bonvumi,	বনভুমি,	বনভূমি,	
veenis,	ভিনিস,	ভেনিস,	
kaloniir,	কালোনির,	কালনীর,	
breel,	ব্রিল,	ব্রিল,	
ingrejra,	ইংরেজরা,	ইংরেজরা,	
camerapersoner,	ক্যামেরাপারসনের,	ক্যামেরাপার্সনের,	
premo,	প্রেমো,	প্রিমো,	
shabkam,	শামকাম,	শবকাম,	
aireshe,	আইরেশে,	আইরেসে,	
chandrima,	চন্দ্রিমা,	চন্দ্রিমা,	
marketin,	মার্কেটিন,	মার্কেটিং,	
bm,	বিএমএম,	বিএম,	
jani,	জানি,	জনি,	
suraaropito,	সুরারোপিত,	সুরারোপিত,	
refleks,	রিফ্লেক্স,	রিফ্লেক্স,	
lutheerana,	লুথিরানা,	লুথেরান,	
kajangale,	কাজঙ্গলে,	কজঙ্গলে,	
pujit,	পুজিত,	পুজিত,	
proshtotto,	প্রশ্তত্ব,	প্রস্ত্তত,	
bodhirota,	বধিরতা,	বধিরতা,	
horipur,	হরিপুরের,	হরিপুর,	
sanghitar,	সংহীতার,	সংহিতার,	
dinara,	দিনারা,	ডিনার,	
aporishodhito,	অপরিধোধিত,	অপরিশোধিত,	
ranangone,	রণাঙ্গনে,	রণাঙ্গনে,	
udyem,	উদ্যেম,	উদ্যেম,	
commissionvogider,	কমিশনভোবিদের,	কমিশনভোগীদের,	
langhaner,	লঙ্ঘনের,	লংঘনের,	
chhooteete,	ছুটিতে,	ছুটিতে,	
purushika,	পুরুষিকা,	পুরুষিকা,	
nutan,	নুতান,	নূতন,	
otyacharer,	অত্যাচারের,	অত্যাচারের,	
becha,	বেচা,	বেচা,	
poorohitra,	পুরহিত্রা,	পুরোহিতরা,	
nathivookto,	নাথিভোক্ত,	নথিভুক্ত,	
patjata,	পাতজাতা,	পাটজাত,	
samyuktha,	সম্যুক্ষ,	সামিউক্তা,	
nartana,	নরতানা,	নর্টন,	
sarollo,	সারললো,	সারল্য,	
assexe,	এ্েক্সে,	অ্যাসেক্সে,	
chalochchitrei,	চালচচিত্রেই,	চলচ্চিত্রেই,	
gurmukh,	গুরমুখ,	গুরমুখ,	
mitrer,	মিত্রের,	মিত্রের,	
folleni,	ফলেনি,	ফলেনি,	
agomoney,	আগমনে,	আগমনে,	
hingsar,	হিংসার,	হিংসার,	
arashie,	আরাশি,	আরসিএ,	
kakhnoba,	কাখনাবা,	কখনওবা,	
janghu,	জংঘু,	জঙ্ঘু,	
addata,	আদ্তাটা,	আড্ডাটা,	
chheher,	ছেহের,	ছেহের,	
gej,	লেজ,	গেজ,	
joubankal,	যৌবনকাল,	যৌবনকাল,	
nirarthak,	নিরর্থথক,	নিরর্থক,	
nirabota,	নিরাবতা,	নিরবতা,	
encidablu,	এনসিডিবললা,	এনসিডাব্লু,	
oswastikor,	অস্বাস্তিকর,	অস্বস্তিকর,	
kk,	কেক,	কেকে,	
choopi,	চুপি,	চুপি,	
soundorjotakei,	সৌন্দর্যতাকেই,	সৌন্দর্যটাকেই,	
jamjomat,	জমজোমত,	জমজমাট,	
jamarate,	জামারাতে,	জামারাতে,	
moonshi,	মনোশি,	মুন্সি,	
khonjena,	খোঁজেনা,	খোঁজেনা,	
ooporoshtho,	অপরস্থ,	উপরস্থ,	
ooipokar,	উইপকার,	উইপোকার,	
byatikrami,	ব্যতিক্রমি,	ব্যতিক্রমী,	
innahu,	ইন্নাহু,	ইন্নাহু,	
nabbata,	নব্বতা,	নাব্যতা,	
modelgulo,	মডেলগুলো,	মডেলগুলো,	
sthaponagulor,	স্থাপনাগুলোর,	স্থাপনাগুলোর,	
eenameela,	ইনামেলা,	এনামেল,	
olympicer,	অলিম্পিসের,	অলিম্পিকের,	
thare,	তারে,	থরে,	
jeebnagore,	জীবনাগরে,	জীবননগর,	
aairish,	আইরিশ,	আইরিস,	
protijogii,	প্রতিযোগী,	প্রতিযোগী,	
ateetkale,	অতীতকালে,	অতীতকালে,	
siddhantoo,	সিদ্ধান্ত,	সিদ্ধান্তও,	
otyacharito,	অত্যাচারিত,	অত্যাচারিত,	
kraim,	ক্রাইম,	ক্রাইম,	
obosorer,	অবসরের,	অবসরের,	
laga,	লাগা,	লগ,	
durgatsob,	দুর্গাৎসব,	দুর্গোৎসব,	
odeb,	ওদেব,	ওদেব,	
manir,	মানির,	মনির,	
vobani,	ভবানী,	ভবানী,	
jitpur,	জিটপুর,	জিতপুরের,	
remakri,	রিমাকরি,	রেমাক্রী,	
uttor,	উত্তর,	উওর,	
abodamaner,	অবদামানের,	অবদমনের,	
porbotmala,	পর্বতমালা,	পর্বতমালা,	
korimer,	করিমের,	করিমের,	
shikkhadikkhay,	শিক্ষাদিক্ষায়,	শিক্ষাদিক্ষায়,	
uporitale,	উপরিতালে,	উপরিতলে,	
utsahamulak,	উৎসাহূলক,	উৎসাহমূলক,	
smarak,	স্মররক,	স্মারক,	
vodqa,	ভডকা,	ভদকা,	
veemsen,	ভিমসেন,	ভীমসেন,	
asamanyo,	অসামন্য,	অসামান্য,	
sponsorshipe,	স্পন্শরশিপে,	স্পন্সরশীপে,	
turisht,	টুরিশ্টস,	টুরিস্ট,	
tyapa,	ত্য়াপা,	ট্যাপ,	
ceramicsh,	সেরামিকশ,	সিরামিকস,	
vitti,	ভিত্তি,	ভিত্তিই,	
shardotsobei,	সার্দস্বেই,	শারদোৎসবেই,	
qarpeta,	কারপেটা,	কার্পেট,	
bangobandhu,	বঙ্গবন্ধু,	বঙ্গবন্ধু,	
mayily,	মেইলি,	মাইলি,	
chitlar,	চিতলার,	চিতলার,	
dakkhinkare,	দক্ষিণকারে,	দক্ষিণকরে,	
osamanno,	ওসামান্য,	অসামান্য,	
unitgulo,	ইউনিটগুলো,	ইউনিটগুলো,	
varma,	ভার্মা,	ভার্মা,	
swastir,	স্বস্তির,	স্বস্তির,	
shubhag,	শুভাগ,	শুভাগ,	
pooshti,	পুষ্টি,	পুষ্টি,	
minishtarer,	মিনিশ্টারের,	মিনিস্টারের,	
armeenian,	আরমমিনিয়ান,	আর্মেনিয়ান,	
byaptikaler,	ব্যাপ্তিকালের,	ব্যাপ্তিকালের,	
ganjana,	গঞ্জনা,	গঞ্জনা,	
aflatoxin,	আফলাট্ক্সিন,	আ্যফ্ল্যাটক্সিন,	
besooro,	বেসুরো,	বেসুর,	
mukhyo,	মুখ্য,	মুখ্য,	
graambaaseeo,	গ্রামবাসেও,	গ্রামবাসীও,	
longhan,	লোনঘান,	লংঘন,	
sten,	স্টেন,	স্টেন,	
suraropito,	সুরারোপিত,	সুরারোপিত,	
govindarajan,	গোবিন্দরানন,	গোবিন্দরাজন,	
eesosiyeetasa,	ইসোিয়াজিস্ট,	এসোসিয়েটস,	
lendal,	লেন্দাল,	লেন্ডল,	
jerusalema,	জেরুসালেমা,	জেরুসালেম,	
munjur,	মুঞ্জুর,	মুনজুর,	
bishwaashshke,	বিশ্বশসকে,	বিশ্বাসকে,	
huka,	হুকা,	হুক,	
pyor,	পিয়ার,	পিওর,	
laishensha,	লৈশেশ্,	লাইসেন্স,	
laaisheesh,	লাইশেষ,	লাইসেন্স,	
fiksing,	ফিক্সিং,	ফিক্সিং,	
sookumari,	শুকুমারি,	সুকুমারী,	
bane,	ব্যানে,	বনে,	
raagei,	রাগেই,	রাগেই,	
bondhuvabaponyo,	বন্ধুবাবপন্য,	বন্ধুভাবাপন্ন,	
manushgulor,	মানুষগুলোর,	মানুষগুলোর,	
somabeshti,	সোবাবশটি,	সমাবেশটি,	
shudden,	শুদ্যেন,	সাডেন,	
brake,	ব্রেক,	ব্রেক,	
ayantarqatiqa,	অ্যান্টারকটিকা,	অ্যান্টার্কটিকা,	
akhhunno,	আখুন্ন,	অক্ষুণ্ণ,	
nagorikra,	নাগরিকরা,	নাগরিকেরা,	
fastag,	ফাস্তাগ,	ফ্যাসট্যাগ,	
sangram,	সংগ্রাম,	সঙ্গ্রাম,	
dembakreeti,	দেম্বকরিটি,	ডিম্বাকৃতি,	
plate,	প্লাটে,	প্লেট,	
venus,	ভেনাস,	ভেনাস,	
bagdad,	বাগদাদ,	বাগদাদে,	
bizito,	বিজিত,	বিজিত,	
whole,	ওোলে,	হোল,	
azaan,	অজান,	আজান,	
neemeetto,	নেমিত্ত,	নিমিত্ত,	
bornanukrome,	বর্ণানুক্রমে,	বর্নানুক্রমে,	
baugey,	বাউগে,	বাগে,	
spreedashita,	স্প্রীড়শিত,	স্প্রেডশীট,	
korle,	করলে,	করলে,	
shilver,	শিলভের,	সিলভার,	
spashtotai,	স্পষ্টতাই,	স্পষ্টতই,	
byabaharkarike,	ব্যবহারকারীকে,	ব্যবহারকারীকে,	
drissotir,	দৃষ্টইর,	দৃশ্যটির,	
daaradaa,	দারাদা,	দারদা,	
adbhanced,	অ্যাডভান্ডেড,	অ্যাডভান্সড,	
moresbai,	মোরেসবাই,	মোরেসবাই,	
shringa,	শ্রীংগা,	শৃঙ্গ,	
plaiin,	প্লেইন,	প্লেন,	
chhatrodiger,	ছাত্রদিগের,	ছাত্রদিগের,	
lyataa,	ল্যাটা,	ল্যাটা,	
sommoteer,	সম্মতির,	সম্মতির,	
jyesthaa,	জ্যেষ্ঠা,	জ্যেষ্ঠা,	
abti,	আবতি,	আবতি,	
yucalyptus,	যুকালিপ্টাস,	ইউক্যালিপ্টাস,	
naneer,	নানীর,	নানীর,	
atmabishvashi,	আত্মািশবাসী,	আত্মবিশ্বাসী,	
joumana,	যৌমানা,	জুমানা,	
sarajibonbyapi,	সারাজীবন্যবাপী,	সারাজীবনব্যাপী,	
shangkalonti,	সংকললন্তি,	সংকলনটি,	
phakay,	ফোকায়,	ফাকে,	
kkomandar,	ক্মনন্দর,	কমাণ্ডার,	
tecnokret,	টেকনক্রেট,	টেকনোক্র্যাট,	
nirapattamulok,	নিরাপত্তামূলক,	নিরাপত্তামূলক,	
parisankhanbid,	পরিসংখনবিদ,	পরিসংখ্যানবিদ,	
angsogrohone,	অংশগ্রহণে,	অংশগ্রহনের,	
rohosyo,	রহস্য,	রহস্য,	
aaeerese,	আইরেসে,	আইরেসে,	
dayitta,	দায়িত্ব,	দায়িত্ব,	
somraatder,	সম্রাটদের,	সম্রাটদের,	
bhowanipur,	ভোমানিপুর,	ভবানীপুর,	
kalnir,	কালনির,	কালনীর,	
manober,	মনোবের,	মানবের,	
nabatamo,	নবতামো,	নবতম,	
katbe,	কাটবে,	কাটবে,	
elakatay,	এলাকাতা,	এলাকাতে,	
matthews,	ম্যাথভিস,	ম্যাথিউস,	
with,	উইথ,	ভিত,	
bhenicer,	ভেনিসের,	ভেনিসের,	
felto,	ফেলটো,	ফেলত,	
pacchi,	পাচ্ছি,	পাচ্ছি,	
bufer,	বুফার,	বাফার,	
moshahidur,	মোশাহীদুর,	মোশাহিদুর,	
ghoorchen,	ঘুরছেন,	ঘুরেছেন,	
sotorkobhabey,	সতর্ষভাবে,	সতর্কভাবে,	
nagarikera,	নাগারিকেরা,	নাগরিকেরা,	
jakatke,	জাকাতকে,	যাকাতকে,	
songasthatike,	সংস্থাটিকে,	সংস্থাটিকে,	
madaspushto,	মাদাপুষ্ট,	মদদপুষ্ট,	
prakalpagulor,	প্রকল্পগুলোর,	প্রকল্পগুলোর,	
babare,	বাবারে,	বাবারে,	
shuri,	শুরি,	সুরি,	
gyada,	জ্ঞাদা,	গ্যাদা,	
taxikeo,	ট্যাক্সিকেও,	ট্যাক্সিকেও,	
chasee,	চাসি,	চেস,	
highcommissionay,	হাইকম্মিশনস,	হাইকমিশনে,	
unchuporjayer,	উঁচুপর্যায়ের,	উঁচুপর্যায়ের,	
bbiswashi,	বিবিস্বাসী,	বিশ্বাসই,	
fooloo,	ফুলো,	পোলো,	
bossoben,	বসবেন,	বসবেন,	
mandanda,	মন্দনদা,	মানদণ্ড,	
transform,	ট্রান্সফর্ম,	ট্রান্সফর্ম,	
gejetade,	গেজেটাদে,	গেজেটেড,	
tolemy,	টোলেমি,	টলেমির,	
khoka,	খোকা,	খোকা,	
fulkapi,	ফুলকাপি,	ফুলকপি,	
bike,	বিকে,	বাইক,	
dibet,	দিবেত,	ডিবেট,	
satarkabhabey,	সতর্কভাবে,	সতর্কভাবে,	
shalook,	শালুক,	শালুক,	
chikitsanirbhar,	চিকিৎসানির্ভর,	চিকিৎসানির্ভর,	
choson,	চোষন,	চোষণ,	
taposgoner,	তাপসগণের,	তাপসগণের,	
kormyi,	কর্মই,	কর্মই,	
chandil,	চান্ডিল,	চান্ডিল,	
siddhante,	সিদ্ধান্তে,	সিদ্ধান্তে,	
kalki,	কালকি,	কালকি,	
hosto,	হোস্তো,	হস্ত,	
ispredseet,	ইস্প্রেসেপি,	স্প্রেডশীট,	
kaande,	কান্ডে,	কাণ্ডে,	
soommo,	সমমও,	সুমো,	
basaake,	বাসাকে,	বাসাকে,	
sathik,	সাথিক,	সঠিক,	
chrystal,	ক্রিস্টাল,	ক্রাইস্টাল,	
shhepha,	সেফা,	শেফ,	
attacharito,	অত্তচারিত,	অত্যাচারিত,	
kuldip,	কুলদীপ,	কুলদীপ,	
abosare,	অবসারে,	অবসরে,	
mitrota,	মিত্রটা,	মিত্রতা,	
digreeke,	দিগ্রিইকে,	ডিগ্রিকে,	
soorsa,	সুরসা,	সোর্স,	
kormopontha,	কর্মপন্থা,	কর্মপন্থা,	
freekeh,	ফ্রিকেহ,	ফ্রিকেহ,	
dhangsantup,	ধ্বংসন্তুপ,	ধ্বংসন্তুপ,	
mangolic,	ম্যানগোলিক,	মাঙ্গলিক,	
dienes,	দিয়েনস,	ডিএনএস,	
akhandota,	অখণ্ডতা,	অখণ্ডতা,	
bujhtepari,	বুঝতেপারি,	বুঝতেপারি,	
uponeesoder,	উপনেসীদের,	উপনিষদের,	
palashir,	পলাশির,	পলাশীর,	
korush,	করুশ,	ক্রুশ,	
bokahoke,	বোকাহোকে,	বকাহকে,	
inapharameshana,	ইনফফরেমশন,	ইনফরমেশন,	
sanaktokaron,	সনাক্তকরণ,	সনাক্তকরণ,	
gronthoti,	গ্রন্থটি,	গ্রন্থটি,	
deebug,	দীবুগ,	ডিবাগ,	
meshenjar,	মেশেনজারের,	মেসেঞ্জার,	
firalem,	ফিরালেম,	ফিরালেম,	
pharn,	ফরণ,	ফার্ন,	
kiibord,	কিইব্রড,	কীবোর্ড,	
holding,	হোলিডং,	হোল্ডিং,	
bishshaasho,	বিশ্বাসও,	বিশ্বাসও,	
jhijhi,	ঝিঝি,	ঝিঝি,	
chalochchitreei,	চালচচিত্রীই,	চলচ্চিত্রেই,	
codee,	কডডি,	কোডে,	
cholchhee,	চলছি,	চলছে,	
chalachchitrei,	চলচ্চিত্রেই,	চলচ্চিত্রেই,	
kathmandu,	কাঠমণ্ডু,	কাঠমান্ডু,	
hosne,	হোসেন,	হোসনে,	
lat,	লটি,	লাট,	
mohajot,	মহাজত,	মহাজোট,	
lambi,	লাম্বি,	লম্বি,	
eduardo,	এডুর্যাডো,	এডুয়ার্দো,	
cxt,	সিসিটিএি,	সিএক্সটি,	
sompadonkaree,	সম্পাদনকারী,	সম্পাদনকারী,	
kuhelika,	কুহেলিকা,	কুহেলিকা,	
starker,	স্টার্কার,	স্টার্কের,	
blogarra,	ব্লগাররা,	ব্লগাররা,	
baipass,	বাইপাস,	বাইপাস,	
hunine,	হুনিনে,	হুনাইন,	
byaktikegreptar,	ব্যক্তিকেলপ্রাপ্তর,	ব্যক্তিকেগ্রেপ্তার,	
reshmirekha,	রেশ্মিরেখা,	রেশমীরেখা,	
jatinke,	জাতিনকে,	যতীনকে,	
hijri,	হিজরি,	হিজরী,	
palteche,	পালতেছে,	পাল্টেছে,	
niropekkho,	নিরপেক্ষ,	নিরপেক্ষ,	
bhyaatikaner,	ভ্যাটিকানের,	ভ্যাটিকানের,	
dola,	দোলা,	দলা,	
koreempoor,	করিমপুর,	করিমপুর,	
aalkaatra,	আলকাত্রা,	আলকাতরা,	
poriskoron,	পরিস্করণ,	পরিষ্করণ,	
perri,	পেরী,	পেরি,	
nederlande,	নেডারল্যান্ডে,	নেদারল্যান্ডে,	
deeares,	ডিয়ারস্,	ডিআরএস,	
taap,	তাপ,	ট্যাপ,	
nachar,	নাচর,	নাচার,	
bisnoo,	বিসনও,	বিষ্ণু,	
fatakesto,	ফাটাকেস্ত,	ফাটাকেষ্ট,	
jerusaleme,	জেরুসালেমে,	জেরুসালেমে,	
capshule,	ক্যাপশুলে,	ক্যাপসুল,	
popke,	পপকে,	পোপকে,	
ebham,	ইভাম,	ইভিএম,	
chhootochhuti,	ছুটোছুটি,	ছুটোছুটি,	
sexperter,	সেক্সপার্টের,	সেক্সপার্টের,	
asthishondhi,	অস্থিসন্ধি,	অস্থিসন্ধি,	
hoonayin,	হুনায়িন,	হুনাইন,	
seeramiks,	সারামিক্স,	সিরামিকস,	
puding,	পুড়িং,	পুডিং,	
zohns,	জোন্স,	জন্স,	
graambaashio,	গ্রামবাশীও,	গ্রামবাসীও,	
nazad,	নাজাদ,	নাজাদ,	
cholochchitra,	চলচ্চিত্র,	চলচ্চিত্র,	
dii,	দি,	দিই,	
tukroke,	তুকরোকে,	টুকরোকে,	
registaner,	রেজিস্টানের,	রেগিস্তানের,	
shipley,	শিপলি,	শিপলে,	
kaathhmaandute,	কাঠমান্ডুতে,	কাঠমান্ডুতে,	
choudhursoho,	চৌধুরসহ,	চৌধুরসহ,	
hood,	হোড,	হুড,	
nichols,	নিকোলস,	নিকলস,	
jhimochchilo,	ঝুমঝ্ছিলো,	ঝিমোচ্ছিলো,	
protizogii,	প্রতিযোগী,	প্রতিযোগী,	
keuoi,	কেওই,	কেউই,	
delibhara,	দেলিভারা,	ডেলিভার,	
audiotike,	অডিওটিকে,	অডিওটিকে,	
ishter,	ইস্টার,	ইস্টের,	
atighataner,	অতিঘাটনের,	অতিঘটনের,	
blacker,	ব্ল্যাকের,	ব্ল্যাকের,	
stander,	স্ট্যান্ডের,	স্ট্যাণ্ডের,	
biplabee,	বিপ্লবী,	বিপ্লবী,	
telakucha,	তেলাকুচা,	তেলাকুচা,	
vishnuu,	বিষ্ণু,	বিষ্ণু,	
cheento,	চিন্তো,	চিনতো,	
gobeshakgon,	গবেষকগণ,	গবেষকগণ,	
carzar,	কার্জার,	চার্জার,	
plato,	প্লাটো,	প্লেটো,	
daaoon,	দাওন,	ডাউন,	
shector,	সেক্টর,	সেক্টর,	
mandape,	মণ্ডপে,	মন্ডপে,	
daacktickete,	ড্যাককেটিকে,	ডাকটিকিটে,	
poketchorder,	পকেটচরদের,	পকেটচরদের,	
shchalastik,	সূলকাস্তিক,	স্কলাস্টিক,	
bhandar,	ভান্ডার,	ভাণ্ডার,	
kode,	কোড়ে,	কোড,	
amarika,	আমারিকা,	আমেরিকা,	
janosamaj,	জনসমাজ,	জনসমাজ,	
moomtaj,	মুমতাজ,	মুমতাজ,	
jaanachhe,	যানাচ্ছে,	জানাচ্ছে,	
sikkhagata,	শিক্ষাগতা,	শিক্ষাগত,	
ghamtaa,	ঘামটা,	ঘোমটা,	
sadadyarao,	সদাদ্যরাও,	সদদ্যরাও,	
korijachilen,	করিযাছিলেন,	করিযাছিলেন,	
samle,	সামলে,	সামলে,	
bibhinno,	বিভিন্ন,	বিভন্ন,	
armshtrong,	আর্মস্ট্রং,	আর্মস্ট্রং,	
toki,	তোক,	তকি,	
udbodhaney,	উদ্বধানে,	উদ্বোধনে,	
rashider,	রশিদের,	রশিদের,	
carloos,	কারলোস,	কার্লোস,	
milekhanek,	মিলেখানেক,	মাইলখানেক,	
tecno,	টেকনো,	টেকনো,	
asabhya,	অসভ্য,	অসভ্য,	
chhutochhuti,	ছুটোছুটি,	ছুটোছুটি,	
harja,	হারজা,	হার্জ,	
samratder,	সম্রাতদের,	সম্রাটদের,	
ship,	শিপ,	শিপ,	
birishiritey,	বীরিশিরিতে,	বিরিশিরিতে,	
poripakey,	পরিপাকে,	পরিপাকে,	
fuss,	ফুস,	ফাস,	
mosjidsoho,	মসজিদসহ,	মসজিদসহ,	
bonnopran,	বন্যপ্রাণ,	বন্যপ্রাণ,	
protizogiita,	প্রতিযোগীতা,	প্রতিযোগীতা,	
ashankai,	আশানকাই,	আশঙ্কাই,	
lavta,	লাভতা,	লাভটা,	
konruup,	কোনরুপ,	কোনরূপ,	
gajetted,	গ্যাজেট্ডে,	গেজেটেড,	
sector,	সেক্টর,	সেক্টর,	
daltyagi,	দল্তজীগী,	দলত্যাগী,	
pravritir,	প্রভৃতির,	প্রভৃতির,	
kramp,	ক্রাম্প,	ক্র্যাম্প,	
dipgulote,	দিপগুলোতে,	দ্বীপগুলোতে,	
hajeerhatt,	হাজীরহাট,	হাজিরহাট,	
bujhechhila,	বুঝেছিল,	বুঝেছিল,	
balakarak,	বালাকারক,	বলকারক,	
engreziteo,	এংরেজিতেও,	ইংরেজিতেও,	
postar,	পোস্টার,	পোস্টের,	
scholastik,	স্কলাস্তিক,	স্কলাস্টিক,	
ghomtaa,	ঘোমটা,	ঘোমটা,	
booksar,	বুকসার,	বুক্সার,	
siit,	সিট,	শীত,	
distibutor,	ডিস্টিবুটর,	ডিস্টিবিউটারের,	
chalochchitrogulor,	চলচ্চিত্রগুলোর,	চলচ্চিত্রগুলোর,	
bsnleu,	বিএসএনএিউউ,	বিএসএনএলইইউ,	
israelbahini,	ইসরায়বিলিহানী,	ইস্রায়েলবাহিনী,	
kormobuddhite,	কর্মবুদ্ধিতে,	কর্মবুদ্ধিতে,	
grushko,	গ্রুশকো,	গ্রুশকো,	
hights,	হাইটস,	হাইটস,	
jyaqasana,	জ্যাকাসন,	জ্যাকসন,	
bonobhumi,	বনভূমি,	বনভূমি,	
pyetarna,	পিটারটা,	প্যাটার্ন,	
kanasharabheshhana,	কনশারেশনভনা,	কনসারভেশন,	
ostad,	ওস্তাদ,	ওস্তাদ,	
jeher,	জেহের,	জেহের,	
adhunikkaley,	আধুনিককালে,	আধুনিককালে,	
prabhritite,	প্রভৃতিতে,	প্রভৃতিতে,	
ekatitto,	একাতিত্ব,	একাতিত্ব,	
nirbahey,	নির্বাহে,	নির্বাহে,	
baharamporer,	বাহারামপুরের,	বহরমপুরের,	
rinattak,	ঋণত্বক,	ঋনাত্মক,	
leaders,	লিডার্স,	লিডার্স,	
harishankar,	হরিশনকর,	হরিশংকর,	
adhunikkale,	আধুনিককালে,	আধুনিককালে,	
kinenni,	কিনেননি,	কিনেননি,	
bisnukey,	বিষ্ণুকে,	বিষ্ণুকে,	
deepan,	দীপান,	দীপন,	
raghubar,	রঘুবার,	রঘুবীর,	
anandamahale,	আনন্দমহলে,	আনন্দমহলে,	
mohajote,	মহাজতে,	মহাজোট,	
kaleo,	কালেও,	কালেও,	
besirbhaagi,	বেসীরভাগী,	বেশিরভাগই,	
abheedhaaneeck,	অভিধানেক,	অভিধানিক,	
karim,	কারিম,	করিম,	
deefinishion,	ডেফিনিশন,	ডেফিনেশন,	
lubitz,	লুবিৎজ,	লুবিৎজ,	
sachetanvabe,	সচেতনভাবে,	সচেতনভাবে,	
dhonni,	ধোনি,	ধন্যি,	
emerjency,	এমেরজেন্সি,	এমার্জেন্সি,	
peri,	পেরি,	পেরি,	
baibosthar,	বাইবস্থার,	ব্যবস্থার,	
drishyogulote,	দৃশ্যগুলোতে,	দৃশ্যগুলোতে,	
bossonte,	বসন্তে,	বসন্তে,	
kachhakaachhi,	কচচাাছি,	কাছাকাছি,	
bbosonto,	ব্বসন্ত,	বসন্ত,	
shasonkarta,	শাসনকর্তা,	শাসনকর্তা,	
byabaharkariderke,	ব্যবহারকারীদেরকে,	ব্যবহারকারীদেরকে,	
konar,	কোনার,	কণার,	
saraiki,	সরাইকি,	সরাইকি,	
manjushree,	মঞ্জুশ্রী,	মঞ্জুশ্রী,	
dekhso,	দেখসো,	দেখসো,	
probolshoktio,	প্রবলক্ষিতই,	প্রবলশক্তিও,	
anichchi,	অনিচ্ছি,	আনিচ্ছি,	
metropolitan,	মেট্রোপলিটান,	মেট্রোপলিটন,	
kareer,	কারির,	কারীর,	
soommita,	সমমিটা,	সুমিতা,	
bhittow,	ভিট্টও,	ভিত্তিও,	
quota,	কুওটা,	কোটা,	
bhramarotsab,	ভ্রমণর্ষব,	ভ্রমরোৎসব,	
turky,	টার্কি,	তুর্কি,	
jiland,	জিলান্দ,	জিল্যান্ড,	
dianes,	ডায়েনাস,	ডিএনএস,	
sangkalanti,	সংকল্নটি,	সংকলনটি,	
shakar,	শকর,	সকার,	
shahabike,	সাহাবীকে,	সাহাবীকে,	
byaboharkarir,	ব্যবহারকারীর,	ব্যবহারকারীর,	
meloonborroner,	মেলুনবর্ণের,	মেলবোর্নের,	
plator,	প্ল্যাটর,	প্লেটোর,	
dada,	দাদা,	দাদা,	
shasyadi,	শস্যাদি,	শস্যাদি,	
registrikrito,	রেজিস্ট্রিকৃত,	রেজিস্ট্রীকৃত,	
swadesh,	স্বদেশ,	স্বদেশ,	
dibi,	দিবি,	দিবি,	
mochlekha,	মোললেখা,	মোছলেখা,	
parswer,	পারস্বের,	পার্শ্বের,	
zerusalemer,	জেরুসালেমের,	জেরুজালেমের,	
shukrabab,	শুক্রবাব,	শুক্রবাব,	
rilayensa,	রিলায়েন্স,	রিলায়েন্স,	
nirmankarmisaha,	নির্মাণকর্মীসহ,	নির্মাণকর্মীসহ,	
jathartho,	যথার্থ,	যথার্থ,	
serup,	সেরুপ,	সেরূপ,	
naubom,	নৌবম,	নবম,	
laaishenshh,	লাইশেনশ,	লাইসেন্স,	
eigulor,	এইগুলোর,	এইগুলোর,	
karmojog,	কারমযোগ,	কর্মযোগ,	
nyeta,	ন্যেট,	ম্যাট,	
titarer,	তিতারের,	তিতারের,	
gopalrao,	গোপালরাও,	গোপালরাও,	
jamanataswarup,	জমনাতস্বরূপ,	জামানতস্বরূপ,	
baait,	বাইট,	বাইট,	
chatrorai,	ছাত্রাই,	ছাত্ররাই,	
phuda,	ফুড়া,	ফুড,	
dekaner,	দেকানের,	দেকানের,	
shoori,	শূরী,	সুরি,	
ganonanatto,	গণনান্ত্ব,	গণনাট্য,	
sombhobonaao,	সম্ভবনাও,	সম্ভবনাও,	
angshogrohon,	অংশগ্রহণ,	অংশগ্রহন,	
gannaprakasham,	গান্নাপ্রকাশম,	গন্নাপ্রকাশম,	
times,	টাইমস,	টাইমস্,	
lopjonito,	লোপজনিত,	লোপজনিত,	
musalmani,	মুসলমানি,	মুসলমানই,	
saseza,	সাসেজা,	সসেজ,	
jewellery,	জিউলেরলি,	জুয়েলারির,	
booroon,	বুরুন,	বোরন,	
durgotsab,	দুর্গোৎসব,	দুর্গোৎসব,	
slatgulor,	স্ল্যাটগুলোর,	স্ল্যাটগুলোর,	
uponishad,	উপনিশাদ,	উপনিষদ,	
jumlalancer,	জুমলালেন্সের,	জুমলাল্যান্সার,	
sanaktakaran,	সনক্তকরণ,	সনাক্তকরণ,	
bonvumitey,	বনভুমিতে,	বনভূমিতে,	
bupher,	বুফার,	বাফার,	
gobeshokgon,	গবেষকগণ,	গবেষকগণ,	
baju,	বাজু,	বাজু,	
porishongkhanbid,	পরিশংখনবিদ্বি,	পরিসংখ্যানবিদ,	
gunje,	গুঞ্জে,	গুঁজে,	
michir,	মিছির,	মিচির,	
shilpojaat,	শিল্পজাত,	শিল্পজাত,	
toching,	টচিং,	টোচিং,	
asiatic,	এসিয়াটিক,	এশিয়াটিক,	
mase,	মাসে,	মাসে,	
uddhrito,	উদ্ধৃত,	উদ্ধৃত,	
protijogitamulok,	প্রতিযোগিতামূলক,	প্রতিযোগীতামূলক,	
bhenus,	ভেনাস,	ভেনাস,	
seqtara,	সেক্তারা,	সেক্টর,	
madhuree,	মধুরে,	মাধুরী,	
lesense,	লেসেন্স,	লাইসেন্স,	
moshjidke,	মোশজিদকে,	মসজিদকে,	
bhittimul,	ভিত্তিমূল,	ভিত্তিমূল,	
badaghat,	বাদাঘাট,	বাদাঘাট,	
chenza,	চেঞ্জা,	চেঞ্জ,	
aholyar,	অহলয়ার,	অহল্যার,	
gaje,	গাজে,	গেজ,	
pratishthanik,	প্রতিষ্ঠানিক,	প্রাতিষ্ঠানিক,	
pachattar,	পাচত্তর,	পাচাত্তার,	
distance,	ডিসট্যান্সে,	ডিসট্যান্স,	
elakatite,	এলাকাটিতে,	এলাকাটিকে,	
damakalkarmirao,	দমকলকর্মীরাও,	দমকলকর্মীরাও,	
eokee,	ইওকি,	এওকি,	
baarbadoj,	বার্বাদজ,	বার্বাডোজ,	
shucharita,	শুচরিতা,	সুচরিতা,	
andamana,	আন্দামানা,	আন্দামান,	
basaalt,	বাসালট,	ব্যাসল্ট,	
bikromei,	বিক্রমেই,	বিক্রমেই,	
moddhyoshtho,	মধ্যশ্থ্য,	মধ্যস্থ,	
qor,	কোর,	কর,	
rajtantrey,	রাজতন্ত্রে,	রাজতন্ত্রে,	
obhijojan,	অভিজোজন,	অভিযোজন,	
abheedhaneek,	অভিধানকি,	অভিধানিক,	
bbiswash,	বিবিস্বাশ,	বিশ্বাস,	
ahong,	আহং,	অহং,	
beila,	বেইলা,	বেইলা,	
nodiiteyi,	নদীয়েই,	নদীতেই,	
reliance,	রিলিয়েন্সি,	রিলায়েন্স,	
vvimsenn,	ভিভিমসেন,	ভীমসেন,	
informetion,	ইনফর্মেশন,	ইনফরমেশন,	
votar,	ভোটার,	ভোটার,	
gronther,	গ্রন্থের,	গ্রন্থের,	
venisey,	ভেনিসে,	ভেনিসে,	
kantojir,	কান্তজীর,	কান্তজির,	
jontropatigulite,	যন্ত্রপৈতিগুলিতে,	যন্ত্রপাতিগুলিতে,	
mousumeo,	মৌসুমোও,	মৌসুমেও,	
parkasa,	পারকাশা,	পার্কস,	
shatan,	শাতান,	শয়তান,	
yura,	জুরা,	ইউরো,	
masjidsaha,	মাসদিকসহ,	মসজিদসহ,	
phiksim,	ফিকসিম,	ফিক্সিং,	
boiragirhat,	বৈরাগীর্থাট,	বৈরাগিরহাট,	
kinsha,	কিনশা,	কিংস,	
daakten,	ডাকতেন,	ডাকতেন,	
bajite,	বাজিতে,	বাজিতে,	
expreshshion,	এক্সপ্রেশন,	এক্সপ্রেশন,	
grambasheeo,	গ্রামবাশেও,	গ্রামবাসীও,	
dipke,	দিপকে,	দ্বীপকে,	
kommandar,	কম্মান্ডর,	কমাণ্ডার,	
liceensee,	লাইসনিস,	লাইসেন্স,	
shikhra,	শিখরা,	শিখরা,	
nehle,	নেহলে,	নেহলে,	
militarite,	মিলিটারিতে,	মিলিটারিতে,	
dharavassokar,	ধারাভাস্ককর,	ধারাভাষ্যকার,	
chopol,	চপল,	চপল,	
chalchhe,	চালচে,	চলছে,	
teennis,	টেনিস,	টেনিস,	
byboshthar,	বিবস্থার,	ব্যাবস্থার,	
loombinee,	লুমবিনি,	লুম্বিনী,	
kaaferder,	কাফারদের,	কাফেরদের,	
mumtazer,	মুমতাজের,	মুমতাজের,	
bunot,	বুনোত,	বুনট,	
magrey,	ম্যাগরে,	ম্যাগ্রে,	
osommotite,	অসমোটিতে,	অসম্মতি,	
bhiktara,	ভিক্তারা,	ভিক্টর,	
patrol,	পাত্রোল,	পেট্রোল,	
orthanitike,	অর্থনীতিকে,	অর্থনীতিকে,	
bheenisa,	ভিনিসা,	ভেনিস,	
motke,	মটকে,	মতকে,	
jounatar,	যৌনতার,	যৌনতার,	
byaboharkariyi,	ব্যবহারকারিয়,	ব্যবহারকারীই,	
dei,	দেই,	দিই,	
munim,	মুনিম,	মুনিম,	
sudrishya,	সুদৃশ্যা,	সুদৃশ্য,	
supparak,	সুপ্রাকা,	সুপ্পারক,	
digree,	দিগ্রি,	ডিগ্রি,	
recondishon,	রেকন্ডিশন,	রিকন্ডিশন,	
fostar,	ফোস্টার,	ফস্টার,	
duio,	দুইও,	দুইও,	
jyaqa,	জ্যাক,	জ্যাক,	
mohammadi,	মোহাম্মাদি,	মুহাম্মদী,	
desiseyer,	ডিসিয়ের,	ডিজিজের,	
tunaita,	তুনাইটা,	টুনাইট,	
gajiipur,	গাজিপুর,	গাজীপুর,	
bohoodin,	বহুদিন,	বহুদিন,	
jubokti,	যুবক্তি,	যুবকটি,	
jonesh,	জোেেশ,	জোন্স,	
porizoner,	পরিজনের,	পরিজনের,	
toroonra,	তরণণোা,	তরুণরা,	
dhadhiye,	ধাধিয়ে,	ধাধিয়ে,	
asbab,	আসবাব,	আসবাব,	
hoil,	হইল,	হইল,	
gasthii,	গাষ্ঠিই,	গোষ্ঠীই,	
diniphition,	ডিনিফিশন,	ডেফিনেশন,	
teenisa,	তিনিসা,	টেনিস,	
segulo,	সেগুলো,	সেগুলো,	
romancha,	রোমাঞ্চা,	রোমাঞ্চ,	
brittakar,	বৃত্তকার,	বৃত্তাকার,	
spredsheet,	স্প্রেডশিট,	স্প্রেডশীট,	
sharifpur,	শরিফপুর,	শরিফপুর,	
dhangsachchi,	ধ্বংশচ্চি,	ধ্বংসাচ্ছি,	
patigoniter,	পাতিগণিতের,	পাটিগণিতের,	
boshoborti,	বশবর্তী,	বশবর্তী,	
zerusalem,	জেরুসালেম,	জেরুজালেম,	
bibader,	বিবাদের,	বিবাদের,	
chapchap,	চ্যাপচাপ,	চাপচাপ,	
wodka,	ওয়াডকা,	ভদকা,	
shikhaboudi,	শিখাবৌদি,	শিখাবৌদি,	
prasadhoner,	প্রাসাধনের,	প্রসাধনের,	
gandharir,	গান্ধারীর,	গান্ধারীর,	
dhalur,	ধালুর,	ঢালুর,	
gafeeloti,	গাফেলটি,	গাফিলতি,	
fake,	ফাকে,	ফাকে,	
mah,	মাহ,	মাহে,	
juktorashtreo,	যুক্তরাস্ত্রেও,	যুক্তরাষ্ট্রেও,	
sangharshik,	সংঘর্ষিক,	সাংঘর্ষিক,	
ansareer,	আনসারির,	আনসারীর,	
durgatsabe,	দুর্গাৎসবে,	দুর্গোৎসবে,	
internship,	ইন্টারনিশপ,	ইন্টার্নশিপ,	
kaatbey,	কাতবে,	কাটবে,	
prasadhani,	প্রসাধানি,	প্রসাধনী,	
akai,	আকাই,	একাই,	
sangaskritipreme,	সংস্কৃতির্রীমে,	সংস্কৃতিপ্রেমে,	
tukrowti,	টুকরোউটি,	টুকরোটি,	
byabaharkaree,	ব্যবহারকারী,	ব্যবহারকারী,	
asovarno,	অসোভার্নো,	অসবর্ণ,	
chemjong,	চেমজং,	চেমজং,	
balatarin,	বালাটারিন,	বালাতারিয়ান,	
kingsh,	কিংশ,	কিংস,	
agamane,	আগামানে,	আগমনে,	
arekdol,	আরেকদল,	আরেকদল,	
lyandim,	ল্যান্ডিম,	ল্যান্ডিং,	
superheiroo,	সুপারহিওরো,	সুপারহিরো,	
gronthowo,	গ্রন্থ্য,	গ্রন্থও,	
jandrel,	জান্দ্রেল,	জাঁদরেল,	
vins,	ভিন্স,	ভিন্স,	
taalaal,	তালাল,	তালাল,	
khoakshir,	খোয়াক্ষির,	খোয়াক্ষীর,	
lisense,	লাইসেন্স,	লাইসেন্স,	
dupleks,	ডুপ্লেক্স,	ডুপ্লে,	
aashanka,	আশানকা,	আশংকা,	
malinga,	মালিঙ্গা,	মালিংগা,	
tarkareer,	তারকারীর,	তরকারীর,	
gavaskar,	গাভাস্কার,	গাভাস্কার,	
bhardwaj,	ভর্দব্যাজ,	ভরদ্বাজ,	
bhabarlaler,	ভাবারলালের,	ভবরলালের,	
notikotar,	নতীকতার,	নৈতিকতার,	
shite,	শিতে,	শীতে,	
fastara,	ফাস্তারা,	ফস্টার,	
shapad,	শাপাদ,	শ্বাপদ,	
soori,	সুরী,	সুরি,	
epiela,	এপিলে,	আইপিএল,	
maila,	মাইলা,	মাইল,	
tiunara,	তিউনারা,	টিউনার,	
muradpur,	মুরাদপুরের,	মুরাদপুর,	
duiekdiner,	দুইজদিনের,	দুইএকদিনের,	
omeettrakkhor,	অমিত্ররক্ষর,	অমিত্রাক্ষর,	
parther,	পার্থের,	পার্থের,	
dharmadasbabu,	ধর্মদাসবাবু,	ধর্মদাসবাবু,	
chirontan,	চিরন্তন,	চিরন্তন,	
myathiou,	ম্যাথিও,	ম্যাথিউ,	
aembed,	আেম্বেড,	এম্বেড,	
enginiiring,	ইঞ্জিনিয়িরিং,	ইঞ্জিনিয়ারিং,	
rakkhanbhag,	রক্ষণভাগ,	রক্ষণভাগ,	
hisabagyan,	হিসাবাগ্যান,	হিসাবজ্ঞান,	
deliver,	ডেলিভার,	ডেলিভার,	
dhhaabi,	ঢাবি,	ঢাবি,	
sthapanatir,	স্থাপনাটির,	স্থাপনাটির,	
salmanul,	সালমানুল,	সালমানুল,	
boudhher,	বৌধের,	বৌদ্ধের,	
sithilotar,	সীথিলতার,	শিথিলতার,	
nariider,	নারীদের,	নারীদের,	
hizrite,	হিজরিতে,	হিজরীতে,	
chhutee,	ছুটে,	ছুটি,	
rinobodh,	রিনবোধ,	ঋণবোধ,	
madhobeer,	মাধবীর,	মাধবীর,	
mercedes,	মার্সেডেস,	মার্সেডেস,	
jati,	জাতি,	যাতি,	
habol,	হাবল,	হাবোল,	
samajikotar,	সামাজিকতার,	সামাজিকতার,	
pragreesa,	প্রোগ্রিসা,	প্রগ্রেস,	
dalip,	দলিপ,	দালিপ,	
ghoomachhilo,	ঘুমাচিছোল,	ঘুমাচ্ছিল,	
booponer,	বুপনের,	বপনের,	
shikshagata,	শিক্ষাগতা,	শিক্ষাগত,	
nirikhe,	নিরিখে,	নিরিখ,	
feroza,	ফেরোজা,	ফিরোজা,	
milea,	মিলেয়া,	মাইলে,	
karima,	কারিমা,	করিম,	
torkarite,	তর্কারিতে,	তরকারিতে,	
doloo,	দলো,	ডলু,	
palkee,	পালকে,	পাল্কি,	
bardhitansh,	বার্থিতানশ,	বর্ধিতাংশ,	
meridiane,	মেরিডিয়ানে,	মেরিডিয়ানে,	
sookkho,	সূক্ষ,	সুক্ষ্ম,	
nilkuthir,	নীলকুঠির,	নীলকুঠির,	
sutir,	সুতির,	সুতির,	
bhabanipur,	ভবানীপুর,	ভবানীপুর,	
bhogiroth,	ভগিরোথ,	ভগীরথ,	
konoroop,	কোনরূপ,	কোনরূপ,	
bikargrosto,	বিকারগ্রস্ত,	বিকারগ্রস্ত,	
deciliter,	ডেকিলিটের,	ডেসিলিটার,	
akkelpure,	আক্কেলপুরে,	আক্কেলপুরে,	
deenesh,	দীনেশ,	দীনেশ,	
jatinkey,	জাতিনকে,	যতীনকে,	
mukhomandaley,	মুখমন্ডলে,	মুখমণ্ডলে,	
koota,	কোটা,	কোটা,	
salsa,	সালসা,	সালসা,	
natshi,	নাতশি,	নাত্সি,	
chalai,	চালাই,	চালাবে,	
aprasangikbhabei,	অপ্রসাংকিকভাবেই,	অপ্রাসঙ্গিকভাবেই,	
black,	ব্ল্যাক,	ব্ল্যাক,	
monir,	মনির,	মনির,	
kobulennechha,	কবুলেন্নেচ্ছা,	কবুলেন্নেছা,	
rahimed,	রহিমেদ,	রহিমেদ,	
shrabostee,	শ্রাবস্তে,	শ্রাবস্তী,	
hert,	হের্ট,	হার্ট,	
debdebie,	দেবদেবী,	দেবদেবী,	
hooldim,	হুল্ডিং,	হোল্ডিং,	
parishram,	পরিশ্রম,	পরিশ্রম,	
shilpajata,	শিল্পজাতা,	শিল্পজাত,	
anchalo,	আঞ্চলো,	অঞ্চলও,	
dhache,	ধাচে,	ধাঁচে,	
ghenshei,	ঘেনশেই,	ঘেঁষেই,	
sheepha,	শিং,	শেফ,	
horiddare,	হরিদ্দারে,	হরিদ্বারে,	
punosthaner,	পুনস্থানের,	পুনঃস্থানের,	
tapdei,	তাপদেই,	তাপড়েই,	
america,	আমেরিকা,	আমেরিকা,	
jini,	জিনি,	যিনি,	
naabbota,	নাব্যটা,	নাব্যতা,	
pothnirdeshona,	পথিন্দ্রনশন,	পথনির্দেশনা,	
deelibhara,	দেলিভারা,	ডেলিভার,	
palbongsher,	পালবংশের,	পালবংশের,	
shahjapur,	শাহজাপুর,	শাহজাপুর,	
oisamoyer,	ঐশাময়ের,	ঐসময়ের,	
uindos,	উইন্দোস,	উইন্ডোস,	
female,	ফেমালে,	ফিমেল,	
dijijer,	দিজিজের,	ডিজিজের,	
uzobekeestaan,	উজবেক্তেতান,	উজবেকিস্তান,	
dharavahikbhabe,	ধারাভাহিকভাবে,	ধারাবাহিকভাবে,	
falasrutite,	ফালাসরুটিতে,	ফলশ্রুতিতে,	
tomader,	তোমাদের,	তোমাদের,	
dobhaar,	ডভার,	ডোভার,	
jaadrel,	যাদলের,	জাঁদরেল,	
naazi,	নাজি,	নাত্সি,	
dolphiny,	ডলফিনি,	ডলফিনি,	
indrani,	ইন্দ্রানী,	ইন্দ্রাণী,	
taunsheep,	তওঁশিপ,	টাউনশিপ,	
houzgulite,	হাউগগুলিতে,	হাউজগুলিতে,	
vaider,	ভাইদের,	ভাইদের,	
trutimatra,	ত্রুতিমাত্র,	ত্রুটিমাত্র,	
station,	স্টেশন,	ষ্টেশন,	
chaka,	চাকা,	চাকা,	
trenda,	ট্রেন্ড,	ট্রেন্ড,	
upbrazillian,	উপব্রাজ্লানিয়ান,	আপব্রাজিলিয়ান,	
biswashi,	বিশ্বাশী,	বিশ্বাসই,	
sadeena,	সাদিনা,	সাডেন,	
oshtader,	অষ্টাদের,	ওস্তাদের,	
sokkhomotabriddhi,	সক্ষমাবৃদ্ধিত,	সক্ষমতাবৃদ্ধি,	
choshon,	চোষন,	চোষণ,	
uddharkarmirai,	উদ্ধারকর্মীরাই,	উদ্ধারকর্মীরাই,	
fakhrul,	ফখরুল,	ফাখরুল,	
swadhinotatukui,	স্বাধীনতাটুকুই,	স্বাধীনতাটুকুই,	
nirmankaaj,	নির্মাণকাজ,	নির্মাণকাজ,	
chalachchitrotike,	চলচ্চিত্রটিকে,	চলচ্চিত্রটিকে,	
jolrang,	জোলরাং,	জলরঙ,	
parisankhanvid,	পরিসংখুনবিদ,	পরিসংখ্যানবিদ,	
eucalyptus,	ইউক্যালেসটাস,	ইউক্যালিপ্টাস,	
noteti,	নোটেটি,	নোটটি,	
nikela,	নিকেলা,	নিকেল,	
teta,	তেত,	টেটা,	
swartho,	স্বার্থ,	স্বার্থ,	
kaash,	কাশ,	কাস,	
kyathlik,	ক্যাথলিক,	ক্যাথলিক,	
goshthiti,	গোষ্ঠিটি,	গোষ্ঠীটি,	
deputee,	ডিপুটে,	ডেপুটি,	
kortam,	কোরতাম,	করতাম,	
durlabhatwang,	দুর্লভপত্বং,	দুর্লভত্বং,	
pranidero,	প্রাণীদেরও,	প্রানীদেরও,	
heart,	হের্ট,	হার্ট,	
protishtan,	প্রতিষ্টান,	প্রতিষ্টান,	
poddhotitei,	পদ্ধটিতেই,	পদ্ধতিতেই,	
vaabnake,	ভাবনাকে,	ভাবনাকে,	
sharif,	শরিফ,	শরিফ,	
poste,	পোস্টে,	পোষ্টে,	
townshhip,	তোউনশিপ,	টাউনশিপ,	
machgulo,	মাছগুলো,	মাছগুলো,	
battery,	ব্যাটারী,	ব্যাটারী,	
patengar,	পাটেঙ্গার,	পতেঙ্গার,	
chhuteer,	ছুটের,	ছুটির,	
ateetkaale,	অতীতকালে,	অতীতকালে,	
chotogolper,	চটগল্লের,	ছোটগল্পের,	
aranyani,	অরণ্যনি,	অরণ্যানী,	
shommotite,	সম্মতিতে,	সম্মতিতে,	
songkulan,	সংকুলন,	সংকুলান,	
lagche,	লাগছে,	লাগছে,	
habathu,	হাবাথু,	হাবাথু,	
armashtram,	আর্মাষ্ট্রম,	আর্মস্ট্রং,	
siddhanter,	সিদ্ধান্তের,	সিদ্ধান্তের,	
nick,	নিক,	নিক্,	
chakrapani,	চক্রপণি,	চক্রপানী,	
roopmatro,	রূপমাত্র,	রূপমাত্র,	
sweety,	স্বিটি,	সুইটি,	
harbare,	হারবারে,	হারবারে,	
shajano,	শাজনো,	সাজানো,	
shniper,	স্নিপের,	স্নাইপার,	
bidghootey,	বিধ্যটে,	বিদঘুটে,	
dipti,	দীপটি,	ডেপুটি,	
sumita,	সুমিতা,	সুমিতা,	
kalkarkhana,	কলকারখানা,	কলকারখানা,	
haripur,	হারিপুরের,	হরিপুর,	
kalenga,	কালেঙ্গা,	কালেঙ্গা,	
dhanyi,	ধননি,	ধন্যি,	
toufik,	তৌফিক,	তৌফিক,	
jonmobhumitir,	জন্মভূমিটির,	জন্মভূমিটির,	
laaz,	লজজ,	লাজ,	
megacaldera,	মেগাকালদেরা,	মেগাক্যাল্ডেরা,	
megh,	মেঘ,	মেঘ,	
indro,	ইন্দ্রো,	ইন্দ্র,	
shpredshiit,	স্প্রেডশিটি,	স্প্রেডশীট,	
arthonitir,	অর্থনীতির,	অর্থনীতির,	
kyatgarite,	ক্যাটগারিতে,	ক্যাটগারিতে,	
alexanderke,	আলেক্সান্দারকে,	আলেকজান্ডারকে,	
bodhirta,	বোধিরটা,	বধিরতা,	
samashtike,	সমষ্টিকে,	সমষ্টিকে,	
sobche,	সবচে,	সবচে,	
totokhon,	ততক্ষণ,	ততক্ষন,	
tiger,	টিগার,	টাইগার,	
mukhomandal,	মুখোমন্ডল,	মুখমণ্ডল,	
sikarer,	সিকারের,	শিকারের,	
direqtareta,	ডিরেক্টরেট,	ডিরেক্টরেট,	
gondogol,	গণ্ডগোল,	গন্ডগোল,	
indra,	ইন্দ্রা,	ইন্দ্র,	
thaanobhi,	থানোভি,	থানভী,	
homeser,	হোমেসের,	হোমসের,	
blasterke,	ব্লাস্টারকে,	ব্লাস্টারকে,	
ghumunoi,	ঘুমুনোই,	ঘুমুনোই,	
panchadadu,	পঞ্চদদপু,	পঞ্চাদাদু,	
furio,	ফুরিও,	ফুরিও,	
amor,	আমর,	আমর,	
karmake,	কারমেক,	কর্মকে,	
armeeniyana,	আর্মিনিয়নন,	আর্মেনিয়ান,	
railliner,	রেলিলেনের,	রেললাইনের,	
nirikho,	নিরিখ্য,	নিরিখ,	
anchalgoolir,	আঞ্চলগুলির,	অঞ্চলগুলির,	
sarboshokteeman,	সর্বোক্তিমণান,	সর্বশক্তিমান,	
definition,	ডিফিনিশন,	ডেফিনেশন,	
byathapather,	ব্যথাপথের,	ব্যথাপথের,	
ssahocorze,	সহোকর্জে,	সাহচর্যে,	
anutpadanshil,	অনুতপপদাশশীল,	অনুৎপাদনশীল,	
hariken,	হরিকেন,	হ্যারিকেন,	
osthishondhi,	অস্থিসন্ধি,	অস্থিসন্ধি,	
pingna,	পিংনা,	পিংনা,	
bidyadanke,	বিদ্যাকানকে,	বিদ্যাদানকে,	
janoganonar,	জনগণনানার,	জনগণনার,	
manushera,	মানুশেরা,	মানুষেরা,	
somonnitobhabe,	সমন্ন্তিভাবে,	সমন্বিতভাবে,	
ronangane,	রোনাঙ্গনে,	রণাঙ্গনে,	
songkoloney,	সংকলনে,	সংকলনে,	
jahara,	জাহারা,	যাহরা,	
talaal,	তালাল,	তালাল,	
ashanka,	আশানকা,	আশংকা,	
pinglateo,	পিংলাতেও,	পিংলাতেও,	
bisheshyo,	বিশেষ্য,	বিশেষ্য,	
ashociatesh,	আশোকিয়েটোস,	এসোসিয়েটস,	
granthatyke,	গ্র্যানথ্যাটিকে,	গ্রন্থটিকে,	
kazianis,	কাজিয়ানিস,	কাজানিস,	
graambaaseeder,	গ্রামবাসীদের,	গ্রামবাসীদের,	
beetloser,	বিটলোসের,	বিটলসের,	
antorvukta,	অন্তর্ভূক্ত,	অন্তর্ভুক্ত,	
jalbe,	জলবে,	জ্বলবে,	
srabosty,	স্রাবস্টি,	শ্রাবস্তী,	
arthurer,	অর্থুরের,	আর্থারের,	
transhapharma,	ট্রান্সপোর্মা,	ট্রান্সফর্ম,	
matis,	মেটিস,	ম্যাটিস,	
bhabotarini,	ভাবতারিণী,	ভবতারিণী,	
photanor,	ফোটানোর,	ফোটানোর,	
ministara,	মিনিস্তারা,	মিনিস্টার,	
jibanto,	জীবন্ত,	জীবন্ত,	
shatoke,	শতকে,	শতকে,	
deejeejer,	দিজিজের,	ডিজিজের,	
satarkabhabe,	সতর্কভাবে,	সতর্কভাবে,	
nodimatrik,	নোীমাত্রিক,	নদীমাতৃক,	
selim,	সেলিম,	সেলিম,	
ekok,	একক,	একক,	
khude,	খুদ়ে,	ক্ষুদে,	
monjurul,	মঞ্জুরুল,	মনজুরুল,	
bharotchilo,	ভারতচিল,	ভারতছিল,	
deh,	দেহ,	দেহ্,	
kadapaker,	কাড়াপাকের,	কড়াপাকের,	
logotype,	লোগোটাইপ,	লোগোটাইপ,	
chaudhurider,	চৌধুরীদের,	চৌধুরীদের,	
doltyagi,	দলত্যাগী,	দলত্যাগী,	
hoondayi,	হুন্ডায়ি,	হুন্দাই,	
jhumjhumita,	ঝুমঝুমিটা,	ঝুমঝুমিটা,	
jeebonnogor,	জীবনগর,	জীবননগর,	
khilaphat,	খিলাফাত,	খিলাফত,	
chhayi,	ছাইি,	ছাই,	
nirobota,	নিরবতা,	নিরবতা,	
taholo,	তাহলো,	তাহলো,	
khuliechilam,	খুলিয়েছিলাম,	খুলিয়েছিলাম,	
sahittekder,	সাহিত্যকের,	সাহিত্যেকদের,	
haitasha,	হাইতাশা,	হাইটস,	
geejeeteeda,	গীজিতদা,	গেজেটেড,	
chai,	চাই,	ছাই,	
bibechyo,	বিবেচ্য,	বিবেচ্য,	
browser,	ব্রোভার,	ব্রাউজার,	
notti,	নটটি,	নোটটি,	
mandondo,	মানদন্ড,	মানদণ্ড,	
srichoitonnodeb,	শ্রীচৈতন্যদেব,	শ্রীচৈতন্যদেব,	
tricksguli,	ট্রিকস্গুললি,	ট্রিকসগুলি,	
mulvitti,	মুলভিত্তি,	মূলভিত্তি,	
chire,	চিরে,	চিরে,	
hastantar,	হস্তান্তর,	হস্তান্তর,	
nadike,	নাদিকে,	নদীকে,	
akkaas,	অক্কাস,	আককাস,	
eshtoniya,	এষ্টনীয়,	এস্তোনিয়া,	
schilling,	স্লিলিং,	শিলিং,	
autopromotioner,	অটোপ্রুমশনের,	অটোপ্রমোশনের,	
jaistho,	যয়স্থ,	জ্যৈষ্ঠ,	
logic,	লজিক,	লজিক,	
jemy,	জেমি,	জেমি,	
bulano,	বুলানো,	বুলান,	
rakkhandurga,	রক্ষণদূর্গ,	রক্ষণদুর্গ,	
hondooras,	হন্ডারোস,	হন্ডুরাস,	
daktickete,	ডাক্িিকেট,	ডাকটিকিটে,	
tahorir,	তাহরীর,	তাহরীর,	
suri,	সুরি,	সুরি,	
sobrakamer,	সব্রাকমের,	সবরকমের,	
amittrakkhor,	আমিত্তরক্ষর,	অমিত্রাক্ষর,	
inphormeshon,	ইনফোর্েশন,	ইনফরমেশন,	
baikalyo,	বৈকল্য,	বৈকল্য,	
jonee,	জনি,	জনি,	
poddhotiteyi,	পদ্ধটিটেই,	পদ্ধতিতেই,	
prakalpoguli,	প্রকল্পগুলি,	প্রকল্পগুলি,	
bangladesh,	বাংলাদেশ,	বঙ্গালাদেস,	
tonoo,	টোনো,	তনু,	
vetrillocuism,	ভেট্রিলচকাসিজম,	ভেট্রিলোকুইজম,	
jegulur,	যেগুলুর,	যেগুলুর,	
abdan,	আবদান,	আব্দান,	
harysoner,	হার্সনোর,	হ্যারিসনের,	
karpeter,	কারপেটের,	কার্পেটের,	
ongkush,	অংকুশ,	অংকুশ,	
torabganj,	তরাবগঞ্জ,	তোরাবগঞ্জ,	
laps,	ল্যাপস,	ল্যাপস,	
dinar,	দিনার,	ডিনার,	
ddheela,	ঢেলা,	ঢিলা,	
sarbhaarti,	সর্ভরটি,	সার্ভারটি,	
keu,	কেউ,	কেউ,	
aakaabar,	আকাবার,	আকাবার,	
chhuteete,	ছুটেতে,	ছুটিতে,	
thechar,	থেচার,	থ্যাচার,	
sedikei,	সেদিকেই,	সেদিকেই,	
dorgaaho,	দরগাগাহো,	দরগাহ,	
niroja,	নিরোজা,	নিরোজা,	
heerani,	হিরানী,	হিরানি,	
monzooshree,	মঞ্জর্ষী,	মঞ্জুশ্রী,	
lagto,	লাগতো,	লাগতো,	
antorbhuktimulak,	আন্তর্ভুক্তিকগুলো,	অন্তর্ভুক্তিমূলক,	
ramolino,	রামোলিনো,	রামোলিনো,	
dabliudabliui,	ডাব্লিউডিপিলিউল,	ডাব্লিউডাব্লিউই,	
sikara,	সিকারা,	শিকার,	
nirbaaho,	নির্বাহ,	নির্বাহ,	
shangsthaner,	সাংস্থানের,	সংস্থানের,	
kuthibarike,	কুঠিবারীকে,	কুঠিবাড়ীকে,	
kamla,	কামলায়,	কামলা,	
salchak,	সালচক,	সালচাক,	
kormokarer,	কর্মকারের,	কর্মকারের,	
grootha,	গ্রুথা,	গ্রোথ,	
siqh,	সিখ,	শিখ,	
baibasthaar,	বৈবস্থার,	ব্যবস্থার,	
ayumi,	আয়ুমী,	আয়ুমি,	
vittiteo,	ভিত্তিতেও,	ভিত্তিতেও,	
addhattikotar,	আধ্ধাত্মিকতার,	আধ্যাত্মিকতার,	
elgoridom,	এলগোরিডম,	এলগরিদম,	
songasthatir,	সংস্থাটটির,	সংস্থাটির,	
ukeliptas,	ইউকেলিপ্টাস,	ইউক্যালিপ্টাস,	
pyatarne,	প্যাটর্নে,	প্যাটার্নে,	
taufik,	তওফিক,	তৌফিক,	
tinage,	তিনাগে,	টিনেজ,	
ovarview,	ওভারভিউ,	ওভারভিউ,	
antarbhutto,	অন্তর্ভূত্ত,	অন্তর্ভুক্ত,	
edmeeral,	এডমিরাল,	এডমিরাল,	
rakhtokkharoner,	রথকতকারণের,	রক্তক্ষরণের,	
laiseensim,	লাইসিনিজম,	লাইসেন্সিং,	
ghumacchilo,	ঘুমাচ্ছিলো,	ঘুমাচ্ছিল,	
edaningkale,	এদানিকলালে,	ইদানীংকালে,	
morathee,	মরাঠাই,	মরাঠি,	
tokeo,	টোকেও,	টোকেও,	
sangbadmadhyame,	সংবাদমধধ্যমে,	সংবাদমাধ্যমে,	
militaryr,	মিলিটারির,	মিলিটারির,	
valobase,	ভালোবাসে,	ভালোবাসে,	
somraat,	সম্রাট,	সম্রাট,	
bage,	বাগে,	বাগে,	
orthoneeti,	অর্থনীতি,	অর্থনীতির,	
elaakate,	এলাকাতে,	এলাকাতে,	
marketing,	মার্কেটিং,	মার্কেটিং,	
grambaasi,	গ্রামবাসী,	গ্রামবাসী,	
senabahinio,	সেনাবাহিনীও,	সেনাবাহিনীও,	
kaia,	কাইয়া,	কায়া,	
baibosthaar,	বৈবস্থার,	ব্যবস্থার,	
niurolaji,	নিউরোলাজি,	নিউরোলজি,	
chalochchitraeeo,	চালচচিত্রীয়েও,	চলচ্চিত্রেও,	
akmato,	আকমাতো,	একমত,	
shtona,	স্তোনা,	স্টোন,	
laishenshim,	লাইশেনশিম,	লাইসেন্সিং,	
boikolyo,	বৈকল্য,	বৈকল্য,	
rupantarer,	রুপান্তরের,	রুপান্তরের,	
neshnos,	নেশনোস,	নেশনস,	
oncholgulir,	অঞ্চলগুলির,	অঞ্চলগুলির,	
mmadhukkori,	মমমধুককরি,	মাধুকরী,	
binakar,	বিনাকার,	বিনাকার,	
treend,	ট্রিন্ড,	ট্রেন্ড,	
parka,	পারকা,	পার্ক,	
chhadura,	ছদুরা,	ছাদুরা,	
kichudinpar,	কিছুদিন্পার,	কিছুদিনপর,	
change,	চাঙ্গে,	চেঞ্জ,	
reflex,	রিফ্লেক্স,	রিফ্লেক্স,	
biswashi,	বিশ্বাশী,	বিশ্বাসী,	
prime,	প্রাইম,	প্রাইম,	
umedpoor,	উমেদপুর,	উমেদপুর,	
madhoori,	মধুরি,	মাধুরী,	
pratisthanikvabe,	প্রতিস্থানিকভাবে,	প্রাতিষ্ঠানিকভাবে,	
lotharan,	লোথারান,	লুথেরান,	
middleton,	মিডলটেন,	মিডলটন,	
tigre,	তিগ্রে,	টাইগার,	
shringey,	শ্রিংয়ে,	শৃঙ্গে,	
site,	সিতে,	সিটে,	
upobaasee,	উপবাসী,	উপবাসী,	
baman,	বামান,	বামন,	
muktilav,	মুক্তিলাভ,	মুক্তিলাভ,	
shtonehenge,	স্তনেহেঙ্গে,	স্টোনহেঞ্জ,	
sorting,	সর্টিং,	সর্টিং,	
tongaa,	টঙ্গা,	টোঙ্গা,	
uchchotara,	উচ্চতারা,	উচ্চতর,	
chalochchitro,	চালচচিত্র,	চলচ্চিত্র,	
beem,	বিম,	বিম,	
yukeliptash,	যুকেলিপ্তশ,	ইউক্যালিপ্টাস,	
bondiira,	বন্দীরা,	বন্দীরা,	
kanthar,	কান্থার,	কাঁথার,	
peengna,	পিংংা,	পিংনা,	
dagmukta,	দাগমুক্ত,	দাগমুক্ত,	
prokolpow,	প্রকল্প,	প্রকল্পও,	
bisshaskey,	বিশ্বাসকে,	বিশ্বাসকে,	
udor,	উদর,	উদর,	
jomoker,	জমকের,	জমকের,	
sayanaida,	সায়নাইড,	সায়ানাইড,	
veniser,	ভেনিসের,	ভেনিসের,	
ardasho,	আর্দাশো,	আর্দশ,	
wictor,	উইক্টর,	ভিক্টর,	
graambasio,	গ্রামবাসিও,	গ্রামবাসীও,	
saifai,	সাইফাই,	সাইফাই,	
poscater,	পশ্কটের,	পশ্চাতের,	
soleel,	সোলেল,	সলিল,	
abheedhanic,	অভিধানিক,	অভিধানিক,	
utotoro,	উততর,	উততর,	
mohit,	মোহিত,	মুহিত,	
andra,	আন্দ্রা,	আন্ড্রা,	
alpakichudin,	অল্পকিউচ্দিন,	অল্পকিছুদিন,	
terlarang,	টেরলারং,	তেরলারং,	
prokolpogulor,	প্রকল্পগুলোর,	প্রকল্পগুলোর,	
janamukhi,	জনমুখী,	জনমুখী,	
nathivukteer,	নাথিভুক্তির,	নথিভুক্তির,	
neutrinoo,	নিউট্রিনো,	নিউট্রিনো,	
narbur,	নারবুর,	নরবুর,	
wilderske,	উইল্ডার্সকে,	উইল্ডার্সকে,	
engrezder,	এংরেজদের,	ইংরেজদের,	
shilbar,	শিলবার,	সিলভার,	
manbe,	মানবে,	মানবে,	
japanostho,	জাপানস্থ,	জাপানস্থ,	
degree,	ডিগ্রি,	ডিগ্রি,	
avisongson,	আভিসংসন,	অভিশংসন,	
hitlere,	হিটলারে,	হিটলারে,	
milton,	মিলনন,	মিলটন,	
salphat,	সালফাত,	সালফেট,	
showtey,	শোপটি,	শোতে,	
kanshater,	কানশাটের,	কানসাটের,	
teemothi,	তিমোঠি,	টিমোথি,	
bhenise,	ভেনিস,	ভেনিসে,	
ramantic,	রামান্টিক,	রোমান্টিক,	
nothibhukto,	নথিভুক্ত,	নথিভুক্ত,	
bhaibon,	ভাইবন,	ভাইবোন,	
plate,	প্লাটে,	প্লেটে,	
choudhurike,	চৌধুরীকে,	চৌধুরীকে,	
sumitrar,	সুমিত্রার,	সুমিত্রার,	
mette,	মেটে,	ম্যাট,	
sahooseekotar,	সভসিকতার,	সাহসিকতার,	
murader,	মুরাদের,	মুরাদের,	
rifleksa,	রিফলেক্সা,	রিফ্লেক্স,	
grooth,	গুরুথ,	গ্রোথ,	
rajashri,	রাজাশরী,	রাজশ্রী,	
bishashke,	বিশাষকে,	বিশ্বাসকে,	
dantahin,	দন্তাহীন,	দন্তহীন,	
beekaargrasta,	বিকারগ্রস্ত,	বিকারগ্রস্ত,	
ancholsaha,	অঞ্চলসহ,	অঞ্চলসহ,	
bishshasho,	বিশ্বাসও,	বিশ্বাসও,	
pothon,	পথন,	পঠন,	
jwar,	জ্বার,	জ্বর,	
engrejer,	এংরেজের,	ইংরেজের,	
dipon,	দীপন,	দীপন,	
ganosochetonota,	গণসচেতনতা,	গণসচেতনতা,	
adhyatmik,	আধ্যাত্মিক,	আধ্যাত্মিক,	
vabook,	ভাবুক,	ভাবুক,	
licencer,	লাইসেন্সের,	লাইসেন্সের,	
emarjensi,	এমারজেন্সি,	এমার্জেন্সি,	
bongsho,	বংশ,	বংশ,	
brindaboney,	বৃন্দাবনে,	বৃন্দাবনে,	
habsi,	হাবসি,	হাবশী,	
khamotagulor,	ক্ষমতাগুলোর,	ক্ষমতাগুলোর,	
poripaker,	পরিপাকের,	পরিপাকের,	
zubokder,	যুবকদের,	যুবকদের,	
adorso,	আদরস,	আর্দশ,	
thailand,	থেযালন্ড,	থাইল্যান্ড,	
manushsoho,	মানুসসহ,	মানুষসহ,	
esprito,	এসপ্রিত,	এস্পিরিটো,	
bhabaponno,	ভাবপন্ন,	ভাবাপন্ন,	
concerter,	কনসার্টার,	কানসাটের,	
boikalyo,	বৈকাল্য,	বৈকল্য,	
duburir,	ডুবুরির,	ডুবুরির,	
aairees,	এইয়ারস,	আইরিস,	
gaj,	গ্যাজ,	গেজ,	
shishupalgarh,	শিশুপলগরর,	শিশুপালগড়ে,	
sahajlabhbhotar,	সহজলভভভতার,	সহজলভ্যতার,	
ganohotyake,	গণহত্যাকে,	গণহত্যাকে,	
poste,	পোস্টে,	পোস্টে,	
ghoshanapatratio,	ঘোষণাপত্রটিও,	ঘোষণাপত্রটিও,	
eexpreession,	ইক্সপেরসন,	এক্সপ্রেশন,	
tistar,	তিস্তার,	তিস্তার,	
sbaajan,	স্বজন,	স্বজন,	
samaveshke,	সমাভেষকে,	সমাবেশকে,	
bagdadii,	বাগদাদী,	বাগদাদী,	
ekoghore,	একঘরে,	একঘরে,	
durbhagya,	দুর্ভাগ্য,	দূর্ভাগ্য,	
lishenshe,	লিসেন্স,	লাইসেন্স,	
prothakey,	প্রথাকে,	প্রথাকে,	
turbiner,	টারবিনের,	টারবাইনের,	
zoubankal,	যৌবনকাল,	যৌবনকাল,	
pratool,	প্রোতুল,	প্রতুল,	
senabahineekey,	সেনাবাহিনীকে,	সেনাবাহিনীকে,	
jerusalemer,	জেরুসালেমের,	জেরুজালেমের,	
godabari,	গোদাবারী,	গোদাবরী,	
mugdal,	মুগদাল,	মুগডাল,	
musallati,	মুসল্লাটি,	মুসল্লাটি,	
dhandu,	ধন্দু,	ধন্দু,	
prachirer,	প্রাচীরের,	প্রাচিরের,	
kormoi,	কর্মই,	কর্মই,	
welaqama,	ওয়েলাকামা,	ওয়েলকাম,	
kumbhalnar,	কুম্ভললনার,	কুম্ভালনার,	
transapharma,	ট্রান্সপোর্মা,	ট্রান্সফর্ম,	
metrikoleshana,	মেট্রিকোলেশন,	মেট্রিকোলেশন,	
orbi,	ওরবি,	ওরবি,	
bipradas,	বিপ্রদাস,	বিপ্রদাস,	
edseler,	এডসেলের,	এডসেলের,	
mumtaj,	মুমতাজ,	মুমতাজ,	
query,	কেয়েরি,	কোয়েরি,	
jarmaniteo,	জারমানিতেও,	জার্মানিতেও,	
evereste,	এভারেস্টে,	এভারেস্টে,	
idyi,	আইডিআইআই,	আইডিই,	
guzober,	গুজোবের,	গুজবের,	
residensa,	রেসিডেনসস,	রেসিডেন্স,	
kormokarke,	কর্মকারকে,	কর্মকারকে,	
rohasyati,	রোহস্যটি,	রহস্যটি,	
abhijitda,	অভিজিতদা,	অভিজিতদা,	
plasse,	প্লাসে,	প্লাসে,	
icelands,	আইসেল্যান্ডস,	আইসল্যান্ডসহ,	
sorano,	সোরাণো,	সরানো,	
pharmesigulote,	ফার্মেসিগুলোতে,	ফার্মেসীগুলোতে,	
associatis,	অ্যাসোসিটিয়টস,	এসোসিয়েটস,	
parikhar,	পারিখার,	পরিখার,	
gemske,	গেমস্কে,	জেমসকে,	
mukhmondole,	মুখমন্ডলে,	মুখমণ্ডলে,	
pare,	প্যার,	পাড়ে,	
monohputo,	মনোহপুত,	মনঃপুত,	
saabyastha,	সাব্যস্থ,	সাব্যস্থ,	
chintamani,	চিন্তামানি,	চিন্তামনি,	
mumtajer,	মুমতজার,	মুমতাজের,	
horash,	হোরাশ,	হোরাস,	
mathieu,	মাথিউ,	ম্যাথিউ,	
bhimsenkei,	ভীমসেনকেই,	ভীমসেনকেই,	
philipiner,	ফিলিপিনের,	ফিলিপাইনের,	
prokolpogulikei,	প্রকল্পগুলিকেই,	প্রকল্পগুলিকেই,	
comoros,	কমোরোস,	কোমোরোস,	
ingrezeeteo,	ইংরেজটিতেও,	ইংরেজিতেও,	
meghachchanno,	মেঘচ্ছান্ন,	মেঘাচ্ছন্ন,	
akten,	আকতেন,	অকটেন,	
brahmanera,	ব্রাহ্মণেরা,	ব্রাহ্মণেরা,	
ashamarthita,	আশামার্থিত,	অসমর্থিত,	
asociatis,	অ্োসাই়েটিস,	এসোসিয়েটস,	
flirt,	ফ্লার্ট,	ফ্লার্ট,	
planea,	প্ল্যানেল,	প্লেনে,	
qulim,	কুলিম,	কুলিং,	
dhaleshwari,	ধলেশ্বরী,	ধলেশ্বরী,	
bolvodro,	বলভদ্র,	বলভদ্র,	
kampita,	কাম্পিটা,	কম্পিত,	
oncoleo,	অঙ্কলেও,	অঞ্চলেও,	
dhyanastha,	ধ্যানস্থ,	ধ্যানস্থ,	
turista,	তুরিস্তা,	টুরিস্ট,	
bohorompurer,	বহরমপুরের,	বহরমপুরের,	
shloker,	শ্লোকের,	শ্লোকের,	
pathanirdeshona,	পাথানির্দেশন,	পথনির্দেশনা,	
myari,	ম্যারি,	ম্যারি,	
daaun,	ডাউন,	ডাউন,	
plack,	প্ল্যাক,	প্ল্যাক,	
shoreefer,	শরীফের,	শরিফের,	
shikshakbrindo,	শিক্ষাকবৃন্দ,	শিক্ষকবৃন্দ,	
maner,	মনের,	মানে,	
foks,	ফক্স,	ফক্স,	
heteler,	হেতেলের,	হেটেলের,	
jhanjra,	ঝাঁজরা,	ঝাঁজরা,	
jund,	জান্ড,	জুন্দ,	
tennys,	টেনিস,	টেনিস,	
rohosyoti,	রহস্যটি,	রহস্যটি,	
komanera,	কোমানেরা,	কমানেরা,	
sonaktokaran,	সনাক্তকরণ,	সনাক্তকরণ,	
deool,	ডেওল,	দেউল,	
mausumeo,	মৌসুমেও,	মৌসুমেও,	
provur,	প্রভুর,	প্রভুর,	
batom,	ব্যাটম,	বাটম,	
afrazuler,	আফরাজুলের,	আফরাজুলের,	
shektor,	শেক্তর,	সেক্টর,	
lutharan,	লুথারান,	লুথেরান,	
swostir,	স্বস্তির,	স্বস্তির,	
akkheperi,	আক্ষেপেরই,	আক্ষেপেরই,	
tookror,	টুকরর,	টুকরোর,	
parqa,	পারকা,	পার্ক,	
gujab,	গুজাব,	গুজব,	
horidbar,	হরিদবার,	হরিদ্বার,	
koordider,	কোর্দিদের,	কুর্দিদের,	
niknayman,	নিকনম্যান,	নিকনেইমান,	
kings,	কিংস,	কিংস,	
aagera,	আগেরা,	আগোরা,	
ganaparibahan,	গণপরিবহণ,	গণপরিবহন,	
assaciates,	অ্যাসাইজিটিসহ,	এসোসিয়েটস,	
laesens,	লেসেন্স,	লাইসেন্স,	
bosben,	বসবেন,	বসবেন,	
oncholshomuh,	অঞ্চলসমূহ,	অঞ্চলসমূহ,	
mekapgulo,	মেকাপগুলো,	মেকআপগুলো,	
sangkoolan,	সংকুলন,	সংকুলান,	
bosontoke,	বসন্তকে,	বসন্তকে,	
sylvi,	সিগভি,	সিলভি,	
pracharanamulak,	প্রচারণামূলক,	প্রচারণামূলক,	
bodhukeo,	বধুকেও,	বধুকেও,	
chowdhurir,	চৌষুধির,	চৌধুরীর,	
kolkarkhana,	কলকারখানা,	কলকারখানা,	
gaddaphii,	গাড়ডাফি,	গাদ্দাফী,	
alkatra,	আলকাত্রা,	আলকাতরা,	
baffer,	ব্যাফার,	বাফার,	
treebhuj,	ত্রিভুজ,	ত্রিভূজ,	
mankisundar,	মানকিসুন্দার,	মানকিসুন্দর,	
porirshoder,	পরির্শদের,	পরির্ষদের,	
chinito,	চিনিতো,	চিনতো,	
janagononar,	জনগণনার,	জনগণনার,	
bhugol,	ভূগোল,	ভূগোল,	
songbadmadhyomer,	সংবাদমাধ্যমের,	সংবাদমাধ্যমের,	
srivatsalakshanang,	শ্রীবৎসকললসংং,	শ্রীবৎসলক্ষণং,	
rata,	রাতা,	রত,	
jamkaalo,	জাককালো,	জমকালো,	
elaakati,	এলাকাটি,	এলাকাটি,	
scorey,	স্করে,	স্কোরে,	
cbi,	সিবিআই,	সিবিআই,	
matt,	মাট্ট,	ম্যাট,	
karmoi,	কার্মোই,	কর্মই,	
bitlaser,	বিটলাসের,	বিটলসের,	
remacri,	রিমাক্রি,	রেমাক্রী,	
eukalyptus,	ইউক্লালপাস্টস,	ইউক্যালিপ্টাস,	
disposes,	ডিস্পসেস,	ডিসপোজেস,	
dhauto,	ধাতো,	ধৌত,	
tantubayer,	তাঁতুবায়ের,	তন্তুবায়ের,	
cs,	সিএসএস,	সিএস,	
safin,	সাফিন,	সাফিন,	
brojomohun,	ব্রজমোহন,	ব্রোজোমোহন,	
enamela,	এনামেলা,	এনামেল,	
uthaney,	উঠানে,	উঠানে,	
proteemake,	প্রতিমাকে,	প্রতিমাকে,	
sahapathike,	সহপতঠীকে,	সহপাঠীকে,	
vugoley,	ভুগলে,	ভূগোলে,	
aviyojan,	অভিযোজন,	অভিযোজন,	
shnaipara,	শ্নাইপরা,	স্নাইপার,	
aatmobishwasi,	আট্মবিশ্বাসী,	আত্মবিশ্বাসী,	
batistambhatike,	বাতিস্তম্ভাটিকে,	বাতিস্তম্ভটিকে,	
elakai,	এলাকাই,	এলাকাই,	
salapheeta,	সালফফিতে,	সালফেট,	
kaansaat,	কানসাত,	কানসাট,	
landey,	ল্যান্ডে,	ল্যান্ডে,	
byan,	ব্যান,	ব্যাং,	
debeting,	ডেবেটিং,	ডিবেটিং,	
garora,	গারোরা,	গারোরা,	
zozyota,	যোজ্যতা,	যোজ্যতা,	
shoreefpur,	শরীফপুর,	শরিফপুর,	
dankaan,	ডানকান,	ডানকান,	
atwobishvashi,	আত্ববিচ্যাসী,	আত্মবিশ্বাসী,	
spancer,	স্প্যান্সের,	স্পেন্সার,	
kushumba,	কুশুম্বা,	কুশুম্বা,	
annanere,	অন্নানেরে,	অন্যানেরে,	
bishasey,	বিষাসে,	বিশ্বাসে,	
yatharthabhabe,	যথর্থভাবে,	যথার্থভাবে,	
literacy,	লিটারেকি,	লিটারেসি,	
vogiroth,	ভগিরোথ,	ভগীরথ,	
sures,	সুরেস,	সুরেশ,	
toptoshele,	তপ্তশেলে,	তপ্তশেলে,	
oikhan,	ঐখান,	ঐখান,	
bhaisaho,	ভাইসহ,	ভাইসহ,	
ghotleo,	ঘোটলেও,	ঘটলেও,	
manab,	মানব,	মানব,	
shunani,	শুনানি,	শুনানী,	
madrasa,	মাদ্রাসা,	মাদ্রাসা,	
sahojlovyotar,	সহযোলনুত্তার,	সহজলভ্যতার,	
polashir,	পলাশির,	পলাশীর,	
gaandaas,	গান্দাস,	জ্ঞানদাস,	
muhuriganj,	মুহুরীগঞ্জ,	মুহুরীগঞ্জ,	
satarkatar,	সতর্কতার,	সতর্কতার,	
faaj,	ফজজ,	ফাজ,	
spredasita,	স্প্রেডাসিটা,	স্প্রেডশীট,	
alpa,	আল্পা,	অল্প,	
mumtaz,	মুমতাজ,	মুমতাজ,	
haris,	হারিস,	হ্যারিস,	
collaborators,	কলাবরেটর,	কলাবরেটরস,	
rajotwo,	রাজত্ব,	রাজত্ব,	
elbamtite,	এলবাটিিতে,	এলবামটিতে,	
jansha,	জাশশা,	জন্স,	
prapokkey,	প্রাপককে,	প্রাপককে,	
korimkey,	করিমকে,	করিমকে,	
soundarja,	সৌন্দর্য্য,	সৌর্ন্দয্য,	
bibecchyo,	বিবেচ্যও,	বিবেচ্য,	
bhagno,	ভাগনো,	ভগ্ন,	
purbancoler,	পূর্বাঙ্কলের,	পূর্বাঞ্চলের,	
caroline,	ক্যারোলিন,	ক্যরোলিন,	
cathalic,	ক্যাথালিক,	ক্যাথলিক,	
jamjamat,	জমজামাত,	জমজমাট,	
dhila,	ধিলা,	ঢিলা,	
baire,	বেইরে,	বাইরে,	
kokeyin,	কোকেইন,	কোকেইন,	
kaalaam,	কালাম,	কালাম,	
lettere,	লেটারে,	লেটারে,	
debdebier,	দেবদেবীর,	দেবদেবীর,	
deaubande,	ডিউব্যান্ডে,	দেওবন্দে,	
teliha,	তেলিহা,	তেলিহা,	
barrageke,	বারাগেজকে,	ব্যারেজকে,	
anchalgulir,	আঞ্চলগুলির,	অঞ্চলগুলির,	
siddhantei,	সিদ্ধানেতেই,	সিদ্ধান্তেই,	
hydrological,	হাইড্রোলজিক্যাল,	হাইড্রোলজিক্যাল,	
protisthar,	প্রতিষ্ঠার,	প্রতিষ্ঠার,	
edaning,	এডানিং,	ইদানিং,	
gandhiio,	গান্ধিও,	গান্ধীও,	
boudher,	বৌধের,	বৌদ্ধের,	
sarboporee,	সর্বপরে,	সর্বোপরী,	
shangsthatikey,	সাংস্থাটিকে,	সংস্থাটিকে,	
daktikit,	ডাক্তিটি,	ডাকটিকিট,	
senior,	সেনিওর,	সিনিয়র,	
shatodha,	শাতোধা,	শতধা,	
khagen,	খাগেন,	খগেন,	
braqe,	ব্রেক,	ব্রেক,	
nothiboddho,	নথিবদ্ধ,	নথিবদ্ধ,	
shikkharthirao,	শিক্ষার্থীরাও,	শিক্ষার্থীরাও,	
kkhur,	খুর,	ক্ষুর,	
bhabatarini,	ভবতারিণী,	ভবতারিণী,	
kada,	কড়া,	কোডা,	
artherer,	অর্থেরের,	আর্থারের,	
graambaasheeo,	গ্রামবাশেও,	গ্রামবাসীও,	
calabe,	চালাবে,	চালাবে,	
aatto,	আট্টও,	আত্ম,	
confliqt,	কনফ্লিক্ট,	কনফ্লিক্ট,	
kailashrao,	কৈলাশরাও,	কৈলাশরাও,	
amiya,	অমিয়া,	অমিয়,	
jamaanor,	জামানোর,	জমানোর,	
somoodrotote,	সমুদ্রততে,	সমুদ্রতটে,	
hari,	হারি,	হরি,	
bastubad,	বস্তুবাদ,	বস্তুবাদ,	
kiandi,	কিয়ান্ডি,	ক্যান্ডি,	
chhanada,	ছানাদা,	ছানাদা,	
marpit,	মারপিট,	মারপিট,	
nathivukta,	নাথিভুক্ত,	নথিভুক্ত,	
uthhaane,	উঠানে,	উঠানে,	
grontho,	গ্রন্থ,	গ্রন্থ,	
emarjenshi,	এমারজেনশি,	এমার্জেন্সি,	
keui,	কেউই,	কেউই,	
baarnis,	বার্নিস,	বার্নিশ,	
abheedhanik,	অভিধানিক,	অভিধানিক,	
doobate,	দুবাতে,	ডুবাতে,	
dhormoprobortokder,	ধর্মপ্রবর্তকদের,	ধর্মপ্রবর্তকদের,	
hosbaleke,	হোসবালেকে,	হোসবালেকে,	
protinito,	প্রতিনিত,	প্রতিনিত,	
gamdan,	গামদান,	গামদান,	
maudelder,	মাউডলেদের,	মডেলদের,	
dheke,	ধেকে,	ঢেকে,	
suhasini,	সুহাসিনি,	সুহাসিনী,	
sontoshpur,	সন্তোশপুর,	সন্তোষপুর,	
ipl,	আইপিএল,	আইপিএল,	
vabnakey,	ভাবনাকে,	ভাবনাকে,	
palta,	পালটা,	পালটা,	
mirina,	মিরিনা,	মিরিনা,	
haridware,	হরিদ্বারে,	হরিদ্বারে,	
anusvara,	অনুস্বরা,	অনুস্বার,	
shikshagato,	শিক্ষাগত,	শিক্ষাগত,	
hurricane,	হুরিকরন,	হ্যারিকেন,	
wrighter,	হ্রিথটার,	রাইটের,	
atmiyasulabh,	আত্মীয়সসলভ,	আত্মীয়সুলভ,	
sossar,	সোশার,	সকার,	
gabeshonar,	গবেষনার,	গবেষনার,	
rajnikant,	রাজনীকান্ত,	রাজনীকান্ত,	
aalaa,	আলা,	আলা,	
kinto,	কিন্তো,	কিনত,	
landin,	ল্যান্ডিন,	ল্যান্ডিং,	
hukar,	হুকার,	হুকার,	
bodhir,	বোধির,	বধির,	
satarkakari,	সতর্ককারী,	সতর্ককারী,	
rabo,	রাবো,	রব,	
foloshrutite,	ফলশরুটিতে,	ফলশ্রুতিতে,	
kanasarabhesana,	কনসারেশন,	কনসারভেশন,	
bolbo,	বলবো,	বলবো,	
said,	সায়দ,	সাইদ,	
gatibege,	গাটিবেগে,	গতিবেগে,	
udvabani,	উদ্ভাবনী,	উদ্ভাবনী,	
sorsa,	সোর্সা,	সোর্স,	
sikarder,	সিকারদের,	শিকারদের,	
bondira,	বন্দিরা,	বন্দীরা,	
robot,	রোবোট,	রোবোট,	
nischitvabe,	নিশ্চিতভাবে,	নিশ্চিতভাবে,	
bowie,	বইভি,	বওই,	
bandhano,	বানধানো,	বাঁধানো,	
kekru,	কেকরু,	কেকরু,	
nepchooner,	নেপচুনের,	নেপচুনের,	
nibobondhonkrito,	নিববন্ধনকৃত,	নিববন্ধনকৃত,	
siddharther,	সিদ্ধার্থের,	সিদ্ধার্থের,	
rokibul,	রোকুবুল,	রকিবুল,	
bidhirnityang,	বিধির্নিত্যাং,	বিধির্নিত্যং,	
yuroo,	যুরো,	ইউরো,	
gaichhe,	গাইছে,	গাইছে,	
gandhiir,	গান্ধীর,	গান্ধীর,	
upobaashee,	উপবাশে,	উপবাসী,	
bonbhumi,	বনভূমি,	বনভূমি,	
anyarup,	অন্যরূপ,	অন্যরূপ,	
chereche,	চেরেছে,	ছেড়েছে,	
tennis,	টেনিস,	টেনিস,	
oitijhya,	ঐতিহ্যা,	ঐতিহ্য,	
danata,	দননাটা,	ডোনাট,	
arg,	আরগজ,	আর্গ,	
eporjonto,	এপর্জন্ত,	এপর্যন্ত,	
gonesher,	গনেশের,	গণেশের,	
byaboharkari,	ব্যবহারকারী,	ব্যবহারকারী,	
mukhomandaler,	মুখোমন্ডলের,	মুখমণ্ডলের,	
pariyech,	পারিয়েছ,	পরিয়েছ,	
gandhariir,	গান্ধারীর,	গান্ধারীর,	
