chirkut,	চিরকুট,	চিরকুট,	
kuldip,	কুলদীপ,	কুলদীপ,	
mookhomandoler,	মুখমন্ডলের,	মুখমণ্ডলের,	
ekok,	একো,	একক,	
degree,	ডিগ্রী,	ডিগ্রি,	
doobate,	দুবাতে,	ডুবাতে,	
overholing,	ওভারহোলিং,	ওভারহোলিং,	
byaboharkarike,	ব্যবহারকারীকে,	ব্যবহারকারীকে,	
jonoshongjog,	জনশংযোগ,	জনসংযোগ,	
redcrosser,	রেডক্রসের,	রেডক্রসের,	
deilee,	ডাইলল,	ডেইলি,	
liedtke,	লিডটকে,	লইডটক,	
baju,	বাজু,	বাজু,	
chhuteete,	ছুটিতে,	ছুটিতে,	
bipradas,	বিপ্রদাস,	বিপ্রদাস,	
scuvi,	স্কাভি,	স্কুভি,	
militarite,	মিলিটারিতে,	মিলিটারিতে,	
chhon,	ছন,	ছোঁ,	
vromonkaley,	ভ্রমণকালে,	ভ্রমণকালে,	
parkasa,	পারকাসা,	পার্কস,	
bagicha,	বাগিচা,	বাগিচা,	
themekey,	থেমেকে,	থিমকে,	
nanabornobishishto,	নানাবন্ষিবিশ্ষ,	নানাবর্ণবিশিষ্ট,	
rajtontro,	রাজতন্ত্র,	রাজতন্ত্র,	
auttacharer,	অত্মাচারের,	অত্যাচারের,	
postar,	পোস্টার,	পোস্টের,	
hadisti,	হাদিস্তি,	হাদিসটি,	
chakti,	চাকতি,	চাকতি,	
jerushalema,	জেরুশামেলা,	জেরুসালেম,	
narishwar,	নারীশ্বর,	নারীশ্বরের,	
jyaqasana,	জ্যাকসন,	জ্যাকসন,	
mahibur,	মাহিবুর,	মহিবুর,	
saatzoner,	সাতজনের,	সাতজনের,	
cholochchitro,	চলচ্চিত্র,	চলচ্চিত্র,	
shloker,	শ্লোকের,	শ্লোকের,	
soheensotar,	সহিনসতার,	সহিংসতার,	
madelim,	মাডেলিম,	মডেলিং,	
siddhantei,	সিদ্ধান্তেই,	সিদ্ধান্তেই,	
chaalkee,	চালকী,	চালকে,	
esasiyetasa,	এসাসিয়েসাস,	এসোসিয়েটস,	
chaiten,	চাইতেন,	চাইতেন,	
probhur,	প্রভুর,	প্রভুর,	
playtey,	প্লেইট,	প্লেটে,	
chirontan,	চিরন্তান,	চিরন্তন,	
plack,	প্ল্যাক,	প্ল্যাক,	
bhardwaj,	ভার্দ্বাজ,	ভরদ্বাজ,	
venush,	ভেনুশ,	ভেনাস,	
ancholgoolir,	অঞ্চলগুলির,	অঞ্চলগুলির,	
gazetted,	গেজেটেড,	গেজেটেড,	
sossar,	সোসার,	সকার,	
kuresher,	কুরেশের,	কুরেশের,	
rca,	আরএসসা,	আরসিএ,	
neermol,	নির্মোল,	নির্মল,	
folleni,	ফলেনি,	ফলেনি,	
onucheeder,	অনুচিদের,	অনুচ্ছেদের,	
nirvaha,	নির্বাহ,	নির্বাহ,	
shiter,	শীতের,	শীতের,	
bishwaashshke,	বিশ্বাসককে,	বিশ্বাসকে,	
adhunikkale,	আধুনিককালে,	আধুনিককালে,	
thare,	থারে,	থরে,	
horash,	হরাশ,	হোরাস,	
rakkhandurga,	রক্ষণদুর্গ,	রক্ষণদুর্গ,	
koordira,	কূর্দিরা,	কুর্দিরা,	
segulo,	সেগুলো,	সেগুলো,	
ghamta,	ঘামটা,	ঘোমটা,	
taufiq,	তাফিক,	তৌফিক,	
prakare,	প্রকারে,	প্রকারে,	
xpose,	ক্পোস,	এক্সপোজ,	
teemothi,	তীমোথি,	টিমোথি,	
sutir,	সুতির,	সুতির,	
nazad,	নাজাদ,	নজদ,	
anisa,	আনিসা,	আনিস,	
messengerer,	মেসেঞ্জারের,	মেসেঞ্জারের,	
bandhubhaabaapanna,	বন্ধুভাবন্পনা,	বন্ধুভাবাপন্ন,	
moshahidur,	মোশাহিদুর,	মোশাহিদুর,	
comoros,	কমোরোস,	কোমোরোস,	
elaakaati,	এলাকাটি,	এলাকাটি,	
pabo,	পাবো,	পাব,	
kotibondhe,	কতিবন্ধে,	কটিবন্ধে,	
malinga,	মালিঙ্গা,	মালিংগা,	
dhwajbhango,	ধ্বাজভঙ্গ,	ধ্বজভঙ্গ,	
smarok,	স্মরুক,	স্মারক,	
tarunra,	তরুনরা,	তরুণরা,	
osamarik,	ওসামারিক,	অসামরিক,	
pray,	প্রাই,	প্রায়,	
muradpur,	মুরাদপুর,	মুরাদপুর,	
female,	ফেমালে,	ফিমেল,	
byabaharkareederke,	ব্যবহারকারীদেরকে,	ব্যবহারকারীদেরকে,	
hetimganje,	হেতিমঞ্জগে,	হেতিমগঞ্জে,	
difinishian,	ডিফিনিশীয়,	ডেফিনেশন,	
ukeliptash,	উকেলেপ্তাশ,	ইউক্যালিপ্টাস,	
fuss,	ফাস,	ফাস,	
hakone,	হাকনে,	হাকোনে,	
oncolsoho,	অন্কলসহ,	অঞ্চলসহ,	
meropenemer,	মেরোপেনেমের,	মেরোপেনেমের,	
dip,	ডিপ,	দীপ,	
fibergulote,	ফাইবারগুলোতে,	ফাইবারগুলোতে,	
gronthowo,	গ্রন্থও,	গ্রন্থও,	
shikkharrthirao,	শিক্ষার্থীরাও,	শিক্ষার্থীরাও,	
arg,	আর্গ,	আর্গ,	
nischitvabe,	নিশ্চিতভাবে,	নিশ্চিতভাবে,	
rushad,	রুশাদ,	রুশদ,	
commissionvogider,	কমিসনিভগদের,	কমিশনভোগীদের,	
jonomukhi,	জনমুখি,	জনমুখী,	
balakarak,	বালাকারক,	বলকারক,	
bahati,	বাহাতি,	বাহাতি,	
rahshahi,	রাহশাহী,	রাহশাহী,	
bowie,	বউই,	বওই,	
paner,	পানের,	পানের,	
anubhutimalar,	অনুভূতিমালার,	অনুভূতিমালার,	
shekarone,	শেকারনে,	সেকারণে,	
giitikobitar,	গীতিকবিতার,	গীতিকবিতার,	
fulkapi,	ফুলকাপি,	ফুলকপি,	
disposes,	ডিসপোসেস,	ডিসপোজেস,	
poripake,	পরিপাকে,	পরিপাকে,	
jini,	জিনি,	যিনি,	
sarsa,	সারসা,	সোর্স,	
nogore,	নগরে,	নগরে,	
jakso,	জাকসো,	যক্ষ,	
nothibhukta,	নথিভুক্ত,	নথিভুক্ত,	
blacker,	ব্ল্যাকার,	ব্ল্যাকের,	
manushe,	মানুষে,	মানুষে,	
nirmol,	নির্মোল,	নির্মল,	
sthapanagulo,	স্থাপনগুলো,	স্থাপনাগুলো,	
chalachchitrotike,	চালাচ্ছিত্রীকে,	চলচ্চিত্রটিকে,	
victor,	ভিক্টর,	ভিক্টর,	
ghumachche,	ঘুমাচ্ছে,	ঘুমাচ্ছে,	
land,	ল্যান্ড,	ল্যান্ড,	
emiratas,	এমিরতাস,	এমিরেটাস,	
prakalpatike,	প্রকল্পতিকে,	প্রকল্পটিকে,	
samajikotar,	সমাজিকতার,	সামাজিকতার,	
vetrillocuism,	ভেট্রোইলিইকুমম,	ভেট্রিলোকুইজম,	
maner,	মানের,	মানে,	
akkhunno,	অক্ষুণ্য,	অক্ষুণ্ণ,	
besirbhaagi,	বেসিরভাগী,	বেশিরভাগই,	
dharavassokar,	ধারাবাসকার,	ধারাভাষ্যকার,	
churger,	চার্গের,	চার্জের,	
baganoto,	বাগানোট,	বাগানত,	
abhidhaaner,	অভিধানের,	অভিধানের,	
crashlands,	ক্রালশ্যান্ডস,	ক্র্যাশল্যান্ডস,	
karore,	কারোর,	কারোর,	
korley,	করলে,	করলে,	
ovidhaner,	অভিধানের,	অভিধানের,	
ceramicsh,	সেরামিক্স,	সিরামিকস,	
byan,	ব্যান,	ব্যাং,	
ghoshito,	ঘোষিত,	ঘোষিত,	
dembakreeti,	দেমব্রকিতি,	ডিম্বাকৃতি,	
porishongkhanbid,	পরিশংখ্যানবিদ,	পরিসংখ্যানবিদ,	
sallallahu,	সাল্লাল্লাহু,	সল্লাল্লাহু,	
shubhag,	শুভাগ,	শুভাগ,	
bhabaaponno,	ভবপন্ন,	ভাবাপন্ন,	
sanghar,	সাংহর,	সংহার,	
swadhinotatukui,	স্বাধীনতাটুকুই,	স্বাধীনতাটুকুই,	
vittio,	ভিত্তিও,	ভিত্তিও,	
freekeh,	ফ্রিকেহ,	ফ্রিকেহ,	
elakaai,	এলাকাই,	এলাকাই,	
manush,	মানুশ,	মানুষ,	
taderek,	তাদেরকে,	তাদেরেক,	
review,	রেভিভ,	রিভিউও,	
scorey,	স্কোর,	স্কোরে,	
madhnagar,	মধনগর,	মাধনগরের,	
salmaner,	সালমানের,	সালমানের,	
tokeo,	টকেও,	টোকেও,	
bisshas,	বিশ্বাস,	বিশ্বাস,	
shiropar,	শিরোপার,	শিরোপার,	
scholastik,	স্কোলস্তিক,	স্কলাস্টিক,	
assaciates,	অ্যাসোটিয়েটস,	এসোসিয়েটস,	
bharotiyotar,	ভারতীয়তার,	ভারতীয়তার,	
porinoti,	পরিণতি,	পরিণতি,	
dala,	দালা,	দলা,	
paolasthi,	পাওলাস্থি,	পাওলাসথি,	
lyataa,	ল্যাট,	ল্যাটা,	
ganosochetonota,	গণসচেতনতা,	গণসচেতনতা,	
vugorvey,	ভুগর্ভে,	ভূগর্ভে,	
vabaponno,	ভাবপন্ন,	ভাবাপন্ন,	
bishesyo,	বিশেষ্য,	বিশেষ্য,	
pronoti,	প্রণতি,	প্রণতি,	
oitijhya,	ঐতিহ্যা,	ঐতিহ্য,	
bonorajite,	বনরাজিতে,	বনরাজিতে,	
airish,	আইরিশ,	আইরিস,	
mele,	মেলে,	মাইল,	
chikitshar,	চিকিৎসার,	চিকিত্সার,	
andon,	আন্দন,	আন্দোন,	
mimgulor,	মিমগুলোর,	মিমগুলোর,	
amburi,	আম্বুরী,	আম্বুরি,	
laesensh,	লেশেন্স,	লাইসেন্স,	
juboke,	যুবকে,	যুবকে,	
adhunikkaley,	আধুনিককালে,	আধুনিককালে,	
monzushree,	মন্জুর্রী,	মঞ্জুশ্রী,	
moonshi,	মোনশি,	মুন্সি,	
emerjency,	এমেরজেন্সি,	এমার্জেন্সি,	
byaboharkareer,	ব্যবহারকারীর,	ব্যবহারকারীর,	
artore,	আর্টোর,	আর্টরে,	
godabari,	গোদাবারী,	গোদাবরী,	
longhan,	লোংহান,	লংঘন,	
okritokarjo,	অকৃতকার্য,	অকৃতকার্য,	
agamane,	আগমানে,	আগমনে,	
protyokkhovabey,	প্রত্যক্ষভাবে,	প্রত্যক্ষভাবে,	
gajiipur,	গাজীপুর,	গাজীপুর,	
karmake,	কারমাকে,	কর্মকে,	
elaakati,	এলাকাটি,	এলাকাটি,	
dacope,	ড্যাকোপ,	দাকোপ,	
satjaner,	সাতজানের,	সাতজনের,	
daayitto,	দায়িত্ব,	দায়িত্ব,	
toptoshele,	টপ্তশেলে,	তপ্তশেলে,	
bibecchyo,	বিবেচ্য,	বিবেচ্য,	
mousumeo,	মৌসুমেও,	মৌসুমেও,	
saramukhe,	সররামুখে,	সারামুখে,	
avinetar,	আভিনেতার,	অভিনেতার,	
byaboharkarir,	ব্যবহারকারীর,	ব্যবহারকারীর,	
oncholtee,	অন্চলটি,	অঞ্চলটি,	
shudden,	শুদ্দেন,	সাডেন,	
bedey,	বেদে,	বেদে,	
bhabatarini,	ভবতারিণী,	ভবতারিণী,	
sinakey,	সিনাকে,	সিনাকে,	
shchalastik,	স্ছালস্তিক,	স্কলাস্টিক,	
oojbekistan,	ওয়েবেকসিতান,	উজবেকিস্তান,	
gosthike,	গোষ্ঠিকে,	গোষ্ঠীকে,	
srivatsalakshanang,	শ্রীভততলক্ষং,	শ্রীবৎসলক্ষণং,	
deenes,	ডিনেস,	দীনেশ,	
nutaner,	নুটানের,	নূতনের,	
teter,	তেটের,	টেটের,	
khelechen,	খেলেছেন,	খেলেছেন,	
salafeta,	সালাফেটা,	সালফেট,	
jolrong,	জলরং,	জলরঙ,	
bidhirnityang,	বিধির্িত্যং,	বিধির্নিত্যং,	
sanaktakaran,	সংকক্তরণ,	সনাক্তকরণ,	
pouchute,	পৌছুতে,	পৌঁছুতে,	
dhanyi,	ধননই,	ধন্যি,	
abheedhanik,	অভিধানিক,	অভিধানিক,	
pitiler,	পিতিলের,	পিটিলের,	
kade,	কাদ,	কোড,	
magrey,	ম্যাগরি,	ম্যাগ্রে,	
podotyagsongkranto,	পদত্যাগসংক্রান্ত,	পদত্যাগসংক্রান্ত,	
shikh,	শিখ,	শিখ,	
sangbadmadhyomgulote,	সংবাদমাধ্যমগুলোতে,	সংবাদমাধ্যমগুলোতে,	
lebina,	লেবিনা,	লেবিনা,	
bbiswash,	বিব্শ্বাস,	বিশ্বাস,	
simantarkkhibahinir,	সীমন্তরখাবিহীনীর,	সীমান্তরক্ষীবাহিনীর,	
chalochchitraeeo,	চালোচিক্ত্রীও,	চলচ্চিত্রেও,	
sahajlabhbhotar,	সহজ্বলভতার,	সহজলভ্যতার,	
ghamtaa,	ঘামটা,	ঘোমটা,	
karadandey,	কারাদান্দে,	কারাদণ্ডে,	
fongli,	ফোংলি,	ফংলি,	
qredita,	ক্রেডিটা,	ক্রেডিট,	
america,	আমেরিকা,	আমেরিকা,	
ji,	জি,	জি,	
jonoikaa,	জনকা,	জনৈকা,	
dobhaar,	ডোভার,	ডোভার,	
fishing,	ফিশিং,	ফিসিং,	
laga,	লাগা,	লগ,	
delibhara,	দেলিভারা,	ডেলিভার,	
ovidhanik,	অভিধানিক,	অভিধানিক,	
daaktikit,	ডাক্তিকিট,	ডাকটিকিট,	
bhaandar,	ভান্দার,	ভাণ্ডার,	
faskari,	ফাসকারি,	ফাঁসকারী,	
obharbhiu,	ওভারভিউ,	ওভারভিউ,	
bayii,	বাই,	বাঈ,	
bhumija,	ভূমিজা,	ভূমিজ,	
nyeta,	নযইট,	ম্যাট,	
nirikho,	নিরিখো,	নিরিখ,	
iling,	ইলিং,	ইলিং,	
grambaaseeder,	গ্রামবাসীদের,	গ্রামবাসীদের,	
bane,	বানে,	বনে,	
samajeek,	সামাজিক,	সামাজিক,	
bhogiroth,	ভোগিরথ,	ভগীরথ,	
shoori,	শুরী,	সুরি,	
shasyadi,	শাস্যাদি,	শস্যাদি,	
vogiroth,	ভোগিরোথ,	ভগীরথ,	
manushsoho,	মানুষহ,	মানুষসহ,	
laaz,	লাযাজ,	লাজ,	
nichupattir,	নিচুপত্তির,	নিচুপট্টির,	
nationalser,	নাটিনসালসের,	ন্যাশনালসের,	
noiteekotar,	নৈতিকতার,	নৈতিকতার,	
alaoler,	আলাওলের,	আলাওলের,	
dibate,	দিবাতে,	ডিবেট,	
bunot,	বুনট,	বুনট,	
jor,	জোর,	জ্বর,	
taap,	টাপ,	ট্যাপ,	
danaqana,	ডানাকা,	ডানকান,	
choudry,	চৌড্রি,	চৌধুরী,	
rajnikant,	রাজনীকান্ত,	রাজনীকান্ত,	
karecho,	করেছো,	করেছ,	
elakatike,	এলাকাটিকে,	এলাকাটিকে,	
panthar,	পানথার,	পন্থার,	
satan,	সাতান,	শয়তান,	
soundorjotakei,	সৌন্দর্যতাকেই,	সৌন্দর্যটাকেই,	
dakope,	ডাকোপ,	দাকোপ,	
dorgah,	দরগাহ,	দরগাহ,	
hooldim,	হুল্ডিম,	হোল্ডিং,	
damakalkarmirao,	দামকলরকর্মীরাও,	দমকলকর্মীরাও,	
porirshoder,	পরিষ্দদের,	পরির্ষদের,	
kaande,	কান্দে,	কাণ্ডে,	
dorneca,	ডর্নেকা,	ডরনেকা,	
daktikit,	ডাক্তিকিত,	ডাকটিকিট,	
nothivookta,	নথিভুক্ত,	নথিভুক্ত,	
shabkam,	শাবকম,	শবকাম,	
sheetke,	শীতকে,	শীতকে,	
rakkhanvag,	রক্ষণবাগ,	রক্ষণভাগ,	
protijogiider,	প্রতিযোগীদের,	প্রতিযোগীদের,	
bodhirta,	বোধির্তা,	বধিরতা,	
survative,	সার্ভাটিভ,	সারভেটিভ,	
rena,	রেনা,	রেনো,	
chrystal,	ক্রিস্টাল,	ক্রাইস্টাল,	
bulichev,	বুলিচেভ,	বুলিচেভ,	
afzol,	আফজল,	আফজল,	
gurmukh,	গুরমুখ,	গুরমুখ,	
ghotol,	ঘটল,	ঘটল,	
rachanakal,	রচনাকাল,	রচনাকাল,	
saqara,	সাকারা,	সকার,	
dekhso,	দেখসো,	দেখসো,	
sangaskritipreme,	সংস্কৃতিপ্রেমে,	সংস্কৃতিপ্রেমে,	
bojhey,	বোঝে,	বোঝে,	
phartha,	ফার্থ,	ফার্থ,	
bitertrate,	বিটারট্রেট,	বাইটারট্রেট,	
tigmanshu,	তিগমাংশু,	তিগ্মাংশু,	
yuro,	যুরো,	ইউরো,	
domonmulok,	দোনমূলক,	দমনমূলক,	
blacq,	ব্ল্যাক,	ব্ল্যাক,	
chalochchitrei,	চালক্ছিত্রেই,	চলচ্চিত্রেই,	
sheepha,	শিফা,	শেফ,	
vabnakey,	ভবনাকে,	ভাবনাকে,	
kaathhmaandute,	কাঠমান্দুতে,	কাঠমান্ডুতে,	
swairacharibirodhi,	স্বৈরাচিরবিরোধী,	স্বৈরাচারীবিরোধী,	
senabahineekey,	সেনাবাহিনীকে,	সেনাবাহিনীকে,	
miraclee,	মিরাকলি,	মিরাকেল,	
karmosansthan,	কার্মসনস্থান,	কর্মসংস্থান,	
dhormokorme,	ধর্মকর্মে,	ধর্মকর্মে,	
shajano,	শাজানো,	সাজানো,	
manohputa,	মনোহপুতা,	মনঃপুত,	
karmoi,	করমোই,	কর্মই,	
taroni,	তারোনি,	তরণী,	
gudamjat,	গুডামজাত,	গুদামজাত,	
raiialati,	রাইয়ালিতি,	রয়্যালটি,	
pratijogira,	প্রাতিযোগীরা,	প্রতিযোগীরা,	
nick,	নিক,	নিক্,	
kraim,	ক্রাইম,	ক্রাইম,	
grambasheeo,	গ্রামবাশীও,	গ্রামবাসীও,	
amittrakkhor,	অমিত্রাক্ষর,	অমিত্রাক্ষর,	
gandhiio,	গানধীও,	গান্ধীও,	
hariken,	হরিকেন,	হ্যারিকেন,	
torkareer,	তরকারীর,	তরকারীর,	
digree,	ডিগরি,	ডিগ্রি,	
ganochin,	গণচিন,	গণচীন,	
bodhir,	বোধির,	বধির,	
konistho,	কনিষ্ঠ,	কনিষ্ঠ,	
lyaataa,	ল্যাট,	ল্যাটা,	
chetanagoto,	চেতানগত,	চেতনাগত,	
bujhechhila,	বুঝেছিল,	বুঝেছিল,	
chirkoot,	চিরকুট,	চিরকুট,	
residence,	রেসিডেন্স,	রেসিডেন্স,	
gondogol,	গণ্ডগল,	গন্ডগোল,	
bojhe,	বোঝে,	বোঝে,	
machhti,	মাছটি,	মাছটি,	
besur,	বেসুর,	বেসুর,	
hepatitis,	হেপাটাইটিস,	হেপাটাইটিস,	
hosney,	হোসনে,	হোসনে,	
mekapgulo,	মেকপপুলো,	মেকআপগুলো,	
vagni,	ভাগনি,	ভগ্নী,	
marpit,	মারপিট,	মারপিট,	
ingrezeeteo,	ইংরেজিতেও,	ইংরেজিতেও,	
taronee,	তরণী,	তরণী,	
shahjapur,	শাহজাপুর,	শাহজাপুর,	
kash,	কাশ,	কাস,	
domone,	ডমনে,	দমনে,	
shilpikuler,	শিল্পিকুলের,	শিল্পীকুলের,	
sahapathike,	সহপাঠিকে,	সহপাঠীকে,	
madhoboir,	মাধবরর,	মাধবীর,	
sollallhu,	সোল্লাহু,	সল্লাল্লাহু,	
sbaajan,	স্বাজন,	স্বজন,	
durgatsabe,	দুর্গতসসেবে,	দুর্গোৎসবে,	
moomtaj,	মমতাজ,	মুমতাজ,	
uddhritto,	উদ্ধৃত্ব,	উদ্ধৃত,	
achintopurer,	অচিন্তপুরের,	অচিন্তপুরের,	
bishshasho,	বিশ্বাস,	বিশ্বাসও,	
suhasini,	সুহাসিনি,	সুহাসিনী,	
said,	সাইদ,	সাইদ,	
abdoone,	আবদুনে,	আবদুন,	
hitokor,	হীতকর,	হিতকর,	
chorchita,	চর্চিত,	চর্চিত,	
bolvodro,	বলভদ্র,	বলভদ্র,	
khalidke,	খালিদকে,	খালিদকে,	
kaley,	কালে,	কালে,	
vandar,	ভান্দার,	ভাণ্ডার,	
rajtontre,	রাজতন্ত্রে,	রাজতন্ত্রে,	
saurce,	সার্স,	সোর্স,	
dhangsantup,	ধ্বংসত্তুপ,	ধ্বংসন্তুপ,	
existing,	এক্সিস্টিং,	এক্সিসটিং,	
modelkey,	মডেলকে,	মডেলকে,	
ashankai,	আশাঙকাই,	আশঙ্কাই,	
shaahaabiike,	শাহাবিজকে,	সাহাবীকে,	
torkarir,	তরকারীর,	তরকারীর,	
bikromei,	বিক্রমেই,	বিক্রমেই,	
rakhete,	রাখেতে,	রাখেতে,	
kinto,	কিন্ত,	কিনত,	
hock,	হক,	হুক,	
beatleser,	বিটলেসের,	বিটলসের,	
gannaprakasham,	গন্পপ্রকাশম,	গন্নাপ্রকাশম,	
meloonborroner,	মেলনপোবর্নের,	মেলবোর্নের,	
krechi,	ক্রেচি,	করেছি,	
bii,	বিই,	বি,	
caramiks,	ক্যারামিকস,	সিরামিকস,	
karmokarke,	কর্মকারকে,	কর্মকারকে,	
aaeerese,	এয়ারিস,	আইরেসে,	
purple,	পারপেল,	পার্পেল,	
biplobi,	বিপ্লবি,	বিপ্লবী,	
mohajote,	মহাযতে,	মহাজোট,	
chakrapani,	চক্রপাণী,	চক্রপানী,	
shommoteer,	সম্মতির,	সম্মতির,	
shniper,	শ্নীপের,	স্নাইপার,	
zoubankal,	যৌবনকাল,	যৌবনকাল,	
prashikkhane,	প্রশিক্ষণে,	প্রশিক্ষণে,	
hupile,	হুপিলে,	হুপিলে,	
ateetkale,	আতিৎকালে,	অতীতকালে,	
deil,	দেল,	ডেইল,	
somsher,	সমশের,	সমশের,	
aaziz,	আজিজ,	আজিজ,	
shasankarta,	শশসংকর্তা,	শাসনকর্তা,	
sexperter,	সেক্সপার্টের,	সেক্সপার্টের,	
kkhur,	কুঁর,	ক্ষুর,	
stoic,	স্টোঅক,	স্টোয়িক,	
quartar,	কোয়ার্তার,	কোয়ার্টার,	
falak,	ফালাক,	ফলক,	
internship,	ইন্টার্নশিপ,	ইন্টার্নশিপ,	
bolbo,	বলবো,	বলবো,	
akkaas,	আক্কাস,	আককাস,	
alexanderke,	অলেক্সাযান্ডারকে,	আলেকজান্ডারকে,	
sahachke,	সাহাচকে,	সাহাচকে,	
vool,	ভুল,	উল,	
ray,	রায়,	রায়,	
uparzoner,	উপারজনের,	উপার্জনের,	
maritimer,	মারিটিমের,	মেরিটাইমের,	
durbhagya,	দুর্ভাগ্য,	দূর্ভাগ্য,	
anchalo,	আঞ্চালো,	অঞ্চলও,	
jahara,	জাহারা,	যাহরা,	
kosambir,	কোসাম্বীর,	কোসাম্বীর,	
dhila,	ধিল,	ঢিলা,	
sheets,	সিটস,	শীটস,	
binee,	বিনী,	বেনি,	
ooipoka,	উপপকা,	উইপোকা,	
elakai,	এলাকাই,	এলাকাই,	
akreetokarjo,	আক্রিতকার্য,	অকৃতকার্য,	
debholopar,	ডেভোলাপার,	ডেভলপার,	
kanshater,	কাঁশাের,	কানসাটের,	
chhanada,	ছানাদা,	ছানাদা,	
maila,	মাইলা,	মাইল,	
shift,	শিফট,	শিফট,	
tarkale,	তারকালে,	তারকালে,	
treebhuj,	ত্রিভূজ,	ত্রিভূজ,	
byaboharkariyi,	ব্যবহারকারীই,	ব্যবহারকারীই,	
oblivion,	অব্লিভিও,	অবলিভিয়ন,	
harbore,	হারবরে,	হারবারে,	
shasonamoleri,	শাসনামলেরই,	শাসনামলেরই,	
kalkarkhana,	কালকারখানা,	কলকারখানা,	
jacksoner,	জ্যাকসনের,	জ্যাকসনের,	
prajanankal,	প্রজানকাল,	প্রজননকাল,	
kathmandu,	কাঠমন্দু,	কাঠমান্ডু,	
shilpajata,	শিল্পজাতা,	শিল্পজাত,	
masjidsaha,	মসজিদসহ,	মসজিদসহ,	
bibhinno,	বিভিন্ন,	বিভন্ন,	
prime,	প্রাইম,	প্রাইম,	
philipiner,	ফিলিপিনের,	ফিলিপাইনের,	
chhedon,	ছেডন,	ছেদন,	
keu,	কেউ,	কেউ,	
uchchotara,	উচ্চতারা,	উচ্চতর,	
hitlere,	হিটলারে,	হিটলারে,	
sethai,	সেথাই,	সেথাই,	
gazeetteed,	গেজিটিদ,	গেজেটেড,	
sarollo,	সরোলো,	সারল্য,	
agaldar,	আগোলদার,	আগলদার,	
konnoder,	কণ্যদের,	কন্যদের,	
bhugol,	ভুগোল,	ভূগোল,	
contemporary,	কন্টেমপররি,	কন্টেম্পোরারি,	
nowel,	নোয়েল,	নভেল,	
echhti,	এছটি,	এছটি,	
mookhomaundoler,	মৌখমান্দুলের,	মুখমণ্ডলের,	
jaanachhe,	জানাছে,	জানাচ্ছে,	
seqtara,	সেক্তারা,	সেক্টর,	
windos,	উইন্ডস,	উইন্ডোস,	
sobrakomer,	সব্রাকমের,	সবরকমের,	
bonke,	বনকে,	বনকে,	
aatto,	অ্যাটো,	আত্ম,	
nothivukta,	নথিভুক্ত,	নথিভুক্ত,	
dola,	ডোলা,	দলা,	
vangley,	ভ্যাঙ্গল,	ভাঙলে,	
mayily,	মেয়ি,	মাইলি,	
jansa,	জানসা,	জন্স,	
maailey,	মাইলে,	মাইলে,	
directorete,	ডিরেক্টরেট,	ডিরেক্টরেট,	
adhyatmik,	অধ্যাতিমক,	আধ্যাত্মিক,	
tata,	তাতা,	তাতা,	
gara,	গারা,	গোর,	
futote,	ফুটোতে,	ফুটোতে,	
orthonitir,	অর্থনীতির,	অর্থনীতির,	
soundarja,	সৌন্দর্যা,	সৌর্ন্দয্য,	
choshon,	চশষ,	চোষণ,	
bibader,	বিবাদের,	বিবাদের,	
generalissimo,	জেনারেলিসমম,	জেনারেলিসিমো,	
panda,	পাণ্ডা,	পান্ডে,	
naitikatavodh,	নৈতিকতাভোধ,	নৈতিকতাবোধ,	
aabarte,	আবার্তে,	আবর্তে,	
cholochchitraeeo,	চলচ্চিত্রীও,	চলচ্চিত্রেও,	
purborekorde,	পূর্বপরকদে,	পূর্বরেকর্ডে,	
aachhis,	আছিস,	আছিস,	
alkatra,	আলকাত্র,	আলকাতরা,	
baaiq,	বাইক,	বাইক,	
elgoridom,	এলজোরিডম,	এলগরিদম,	
pluck,	প্লাক,	প্ল্যাক,	
prokolpotike,	প্রকল্পতিকে,	প্রকল্পটিকে,	
fitarsaho,	ফিতারসহ,	ফিতরসহ,	
chouhate,	চৌহাতে,	চৌহাটে,	
bojhao,	বোঝাও,	বোঝাও,	
daaoon,	দাওন,	ডাউন,	
foolkopi,	ফুলকোপি,	ফুলকপি,	
makame,	মাকামে,	মাকামে,	
bim,	বিম,	বিম,	
naagaalyand,	নাগল্যান্ড,	নাগাল্যান্ড,	
protistha,	প্রতিষ্ঠা,	প্রতিষ্টা,	
humner,	হামনার,	হামনার,	
shaater,	সাটের,	শ্যুটার,	
moushum,	মৌশুম,	মৌসুম,	
amudey,	অমুদে,	আমুদে,	
masjidsaho,	মাসিদসহ,	মসজিদসহ,	
bayshorkarikarone,	বয়শরাককরণকরণে,	বেসরকারিকরণ,	
obhaarbhiu,	ওভারভিউ,	ওভারভিউ,	
abhidhaner,	অভিধানের,	অভিধানের,	
bonsho,	বনশ,	বংশ,	
rohasyati,	রহাস্যাটি,	রহস্যটি,	
ghumacchilo,	ঘুমাচ্ছিল,	ঘুমাচ্ছিল,	
arasie,	আর্সি,	আরসিএ,	
adbhanced,	অ্যাডভান্ডেড,	অ্যাডভান্সড,	
granada,	গ্রানাডা,	গ্র্যানাডা,	
gobeshakgon,	গবেষকগণ,	গবেষকগণ,	
nazad,	নাজাদ,	নাজাদ,	
reshidensha,	রেশিডেন্স,	রেসিডেন্স,	
heepatitis,	হেপাটিটিস,	হেপাটাইটিস,	
maudelgulo,	মাউদেলগুলো,	মডেলগুলো,	
eesa,	ইসিএ,	আইএএস,	
prosadhoni,	প্রসাধনী,	প্রসাধনী,	
rajashri,	রাজশ্রী,	রাজশ্রী,	
aakik,	আকিক,	আকিক,	
jeshh,	যেশ,	জেস,	
planeti,	প্লেনেটি,	প্লেনটি,	
kumbhalnar,	কুম্ভালনার,	কুম্ভালনার,	
dhormoprobortokder,	ধর্মপ্রবর্তকর্দের,	ধর্মপ্রবর্তকদের,	
kaaferder,	কাফেরদের,	কাফেরদের,	
majdur,	মাজদুর,	মজদুর,	
bolatkar,	বোলাতকর,	বলাৎকার,	
michhilti,	মিছিলটি,	মিছিলটি,	
purbancoler,	পূর্বানকোলের,	পূর্বাঞ্চলের,	
sangitanusthane,	সঙ্গীতানুষ্ঠানে,	সঙ্গীতানুষ্ঠানে,	
pyaleshtainer,	প্যালেশটাইনের,	প্যালেস্টাইনের,	
bahubar,	বহুবার,	বহুবার,	
neshnos,	নেশনস,	নেশনস,	
supreetira,	সুপ্রিতীরা,	সুপ্রীতিরা,	
borendroke,	বরেন্দ্রকে,	বরেন্দ্রকে,	
deaubande,	ডিউব্যান্ডে,	দেওবন্দে,	
bikretaara,	বিক্রেটরা,	বিক্রেতারা,	
heze,	হেজেজ,	হেজ,	
halding,	হালডিং,	হোল্ডিং,	
johny,	জননী,	জনি,	
tukroke,	তুকরোকে,	টুকরোকে,	
aembed,	আইম্বেড,	এম্বেড,	
pingna,	পিংনা,	পিংনা,	
ghenshei,	ঘেনশেই,	ঘেঁষেই,	
popaike,	পোপাইকে,	পপাইকে,	
bamon,	বামন,	বামন,	
cloudbook,	ক্লাডবুক,	ক্লাউডবুক,	
gunje,	গুঞ্জে,	গুঁজে,	
bbiswashke,	বিশ্বিশকে,	বিশ্বাসকে,	
sumeeta,	সুমিত,	সুমিতা,	
nibirbhabe,	নিবীরভাবে,	নিবিরভাবে,	
romancha,	রোমাঞ্চা,	রোমাঞ্চ,	
monchostho,	মন্চস্থ,	মঞ্চস্থ,	
bhimsen,	ভীমসেন,	ভীমসেন,	
oncholke,	অন্চলকে,	অঞ্চলকে,	
kidambi,	কিদম্বী,	কিদম্বি,	
pakhtunistan,	পাখতুনিস্তান,	পাখতুনিস্তান,	
baire,	বাইরে,	বাইরে,	
bhenise,	ভেনাইজ,	ভেনিসে,	
drishyogulote,	দৃশ্যগুলোতে,	দৃশ্যগুলোতে,	
padee,	পাড়ি,	পাড়ে,	
ghotolen,	ঘটলেন,	ঘটলেন,	
mitroder,	মিত্রোদের,	মিত্রদের,	
shikshakrom,	শিকশাক্রম,	শিক্ষাক্রম,	
akmato,	আকমাতো,	একমত,	
shatodha,	শতধা,	শতধা,	
kormobuddhite,	কর্মবুদ্ধিতে,	কর্মবুদ্ধিতে,	
chal,	চাল,	চাল,	
utsahi,	উৎসাহী,	উৎসাহী,	
chakradhare,	চক্রধরে,	চক্রধরে,	
meridiane,	মেরিডিয়ান,	মেরিডিয়ানে,	
cholochchitrake,	চলচ্চিত্রাকে,	চলচ্চিত্রকে,	
motabolombira,	মতাবলম্বীরা,	মতাবলম্বীরা,	
kourabe,	কৌরবে,	কৌরবে,	
oedipus,	ওডিপাস,	ইডিপাস,	
shiqara,	শিকার,	শিকার,	
shtonehenge,	ষ্টোনেজ্জে,	স্টোনহেঞ্জ,	
bujhtepari,	বুঝতেপারি,	বুঝতেপারি,	
phuda,	ফুড়া,	ফুড,	
bikretara,	বিক্রেতরা,	বিক্রেতারা,	
muchi,	মুচি,	মুচি,	
ssahocorze,	সাযাকোর্ডে,	সাহচর্যে,	
kk,	কেকে,	কেকে,	
chadake,	চাদাকে,	চড়াকে,	
ponthaar,	পন্থার,	পন্থার,	
zerusaleme,	জেরুসালেম,	জেরুসালেমে,	
vange,	ভাঙ্গে,	ভাঙ্গে,	
deliver,	ডেলিভার,	ডেলিভার,	
homsher,	হোমশের,	হোমসের,	
rohosyo,	রহস্য,	রহস্য,	
rejidens,	রেজিডেন্স,	রেসিডেন্স,	
munot,	মুনোট,	মুনোট,	
teentir,	তেনটির,	তিনটির,	
bhaangchur,	ভাংচুর,	ভাংচুর,	
oncholeo,	অনচলেও,	অঞ্চলেও,	
ghumachchila,	ঘুমাচ্ছিলা,	ঘুমাচ্ছিল,	
kazianis,	কাজিয়ানিস,	কাজানিস,	
turisht,	টুরিস্ট,	টুরিস্ট,	
shansthagulo,	শান্তাহগুলো,	সংস্থাগুলো,	
parkin,	পারকিন,	পার্কিং,	
kraanti,	ক্রান্তি,	ক্রান্তি,	
swostir,	স্বস্তির,	স্বস্তির,	
shten,	স্তেন,	স্টেন,	
rojapalaner,	রোজাপালনের,	রোজাপালনের,	
nischitobhabe,	নিশ্চিতভাবে,	নিশ্চিতভাবে,	
venice,	ভেনিস,	ভেনিস,	
aashanka,	আশাঙ্কা,	আশংকা,	
avidur,	আভিদুর,	আভিদুর,	
biprodas,	বিপ্রদাস,	বিপ্রদাস,	
mausumer,	মৌসুমের,	মৌসুমের,	
jacksonke,	জ্যাকসনকে,	জ্যাকসনকে,	
maarmaader,	মারমাদের,	মারমাদের,	
obhijojan,	অভিযোজন,	অভিযোজন,	
ganaparibahan,	গণপরিবান,	গণপরিবহন,	
elbamtite,	এলবামটিতে,	এলবামটিতে,	
nirbaahe,	নির্বাহে,	নির্বাহে,	
kormyi,	কর্মই,	কর্মই,	
mashtarsha,	মাস্টর্শ,	মাস্টার্স,	
seekkhokbrindo,	শীক্ষকবৃন্দ,	শিক্ষকবৃন্দ,	
krema,	ক্রেম,	ক্রাইম,	
bhujangta,	ভুজংটা,	ভুজঙ্গটা,	
udbodhani,	উদ্বোধানি,	উদ্বোধনী,	
sumi,	সুমি,	সুমি,	
deep,	ডিপ,	দীপ,	
marmaraa,	মারমারা,	মারমারা,	
emarjensi,	এমারজেন্সি,	এমার্জেন্সি,	
nirmolota,	নির্মলতা,	নির্মলতা,	
taler,	তালের,	তালের,	
kalakushalir,	কাাকুশলীর,	কলাকুশলীর,	
chalachchitrei,	চলাচিত্রেই,	চলচ্চিত্রেই,	
chai,	চাই,	ছাই,	
kaloniir,	কালনীর,	কালনীর,	
mmehonoti,	মমমনোটি,	মেহনতি,	
choddo,	চোড্ডো,	চোদ্দো,	
protijogitamulok,	প্রতিযোগিতামূলক,	প্রতিযোগীতামূলক,	
indrakanan,	ইন্দ্রকনন,	ইন্দ্রকানন,	
anagarikra,	অনাগরিকরা,	অনাগরিকরা,	
aamontrito,	আমন্ত্রিত,	আমন্ত্রিত,	
ashirbadatri,	আশীর্বাদাত্রী,	আশীর্বাদাত্রী,	
shootar,	শুতার,	শ্যুটার,	
samashtike,	সমষ্টিকে,	সমষ্টিকে,	
pakistanira,	পাকিস্তানিরা,	পাকিস্তানীরা,	
dufresne,	ডুফ্রেসনে,	ডুফরেস্ন,	
shasonkarta,	শাসনকর্তা,	শাসনকর্তা,	
dhalur,	ধালুর,	ঢালুর,	
darji,	দার্জি,	দরজি,	
postac,	পোস্টাক,	পোস্টকে,	
kanasarabheeshana,	কানারাভেশন,	কনসারভেশন,	
licensedhari,	লাইসেন্সাধীরই,	লাইসেন্সধারী,	
laatimer,	লাতিমের,	লাটিমের,	
bhalobasar,	ভালোবাসার,	ভালোবাসার,	
choudhurike,	চৌধুরিকে,	চৌধুরীকে,	
udbhaboni,	উদ্ভাবনী,	উদ্ভাবনী,	
chilahaati,	চিলাহাটি,	চিলাহাটি,	
maunchostho,	মৌনচস্থ,	মঞ্চস্থ,	
lungiti,	লুঙ্গিটি,	লুঙ্গিটি,	
duiekdiner,	দুইএকদিনের,	দুইএকদিনের,	
jewellery,	জিয়েলারি,	জুয়েলারির,	
popke,	পোককে,	পোপকে,	
satyaky,	সত্যাকি,	সাত্যকি,	
prokolpogulor,	প্রকল্পগুলোর,	প্রকল্পগুলোর,	
booponer,	বুপনের,	বপনের,	
saamaanya,	সামান্যা,	সামান্য,	
parishram,	পরিশরাম,	পরিশ্রম,	
parshwer,	পারশ্বের,	পার্শ্বের,	
boiragirhat,	বৈরাগীরহাট,	বৈরাগিরহাট,	
monzeele,	মনজজিলে,	মঞ্জিলে,	
graambaashee,	গ্রামবাশী,	গ্রামবাসী,	
saoum,	সাউউম,	সাওম,	
dakkhinkare,	দক্ষিণকারে,	দক্ষিণকরে,	
sithilotar,	সিথিলতার,	শিথিলতার,	
photanor,	ফোটানোর,	ফোটানোর,	
batistambhatike,	বাতিস্তামভাটিকে,	বাতিস্তম্ভটিকে,	
ashonkai,	আশঙ্কাই,	আশঙ্কাই,	
transformaarer,	ট্রান্সফররমারের,	ট্রান্সফরমারের,	
niurolaji,	নিউরলাজি,	নিউরোলজি,	
doorotomo,	দূরতম,	দূরতম,	
europia,	ইউরোপিয়া,	ইউরোপিয়া,	
audioguloke,	অডিওগুলোকে,	অডিওগুলোকে,	
carbus,	কার্বুস,	কারবাস,	
utotoro,	উততর,	উততর,	
uposhthit,	উপস্থিত,	উপস্থিত,	
sponsorshipe,	স্পন্্ষিপে,	স্পন্সরশীপে,	
riazuddin,	রিয়াজুদ্দিন,	রিয়াজউদ্দীন,	
bongshokey,	বংশকে,	বংশকে,	
maaktoome,	ম্যাক্টম,	মাকতুম,	
jomjamat,	জমজামাত,	জমজমাট,	
punosthaner,	পুনস্থানের,	পুনঃস্থানের,	
mumtazer,	মুমতাজার,	মুমতাজের,	
nek,	নেক,	নেক,	
treend,	ট্রিন্ড,	ট্রেন্ড,	
jyesttha,	জেয়েষ্ঠ,	জ্যেষ্ঠা,	
pleta,	প্লেটা,	প্লেটো,	
logic,	লজিক,	লজিক,	
palbongsher,	পালবংশের,	পালবংশের,	
sohojlovyotar,	সহজল্যভাতার,	সহজলভ্যতার,	
beshakbar,	বেশকবার,	বেশকবার,	
judge,	জুডগে,	জাজ,	
rayyaleti,	রায়়ায়েলটি,	রয়্যালটি,	
ajijer,	অজিজের,	আজিজের,	
daktickete,	ডাক্টিকেটে,	ডাকটিকিটে,	
firalem,	ফিরালেম,	ফিরালেম,	
dharavahik,	ধারাবাহিক,	ধারাবাহিক,	
prapokkey,	প্রাপককে,	প্রাপককে,	
bhittitei,	ভিত্তিতেই,	ভিত্তিতেই,	
avetar,	আভেতার,	অবতার,	
armeenian,	আর্মিনীয়,	আর্মেনিয়ান,	
morathee,	মরাথি,	মরাঠি,	
masto,	মাস্তো,	মাস্ত,	
byabaharkariderke,	ব্যবহারকারীদেরকে,	ব্যবহারকারীদেরকে,	
tennys,	টেনিস,	টেনিস,	
oitijjo,	ঐতিঞ্য,	ঐতিহ্য,	
ongshogrohoner,	অংশগ্রহণের,	অংশগ্রহনের,	
nabayug,	নবায়ুগ,	নবযুগ,	
sommotitey,	সম্মতিতে,	সম্মতিতে,	
qor,	কোর,	কর,	
choudhursoho,	চৌধুরসহ,	চৌধুরসহ,	
jamarate,	জামারাতে,	জামারাতে,	
setike,	সেটিকে,	সেটিকে,	
gujab,	গুজাব,	গুজব,	
zubokra,	যুবকরা,	যুবকরা,	
fanse,	ফ্যান্সে,	ফাঁসে,	
toufik,	তৌফিক,	তৌফিক,	
harasta,	হারস্টা,	হারাস্তা,	
cheentaikaree,	চেন্তাইকারী,	ছিনতাইকারী,	
ateetkaale,	আতিৎকালে,	অতীতকালে,	
chalochchitro,	চালক্চিত্র,	চলচ্চিত্র,	
cholchhee,	চলছি,	চলছে,	
asamanyo,	অসামান্য,	অসামান্য,	
drishyogulotey,	দৃশ্যগুলোতে,	দৃশ্যগুলোতে,	
marketin,	মার্কেটিন,	মার্কেটিং,	
ayantarqatiqa,	অয়ন্টরটকক,	অ্যান্টার্কটিকা,	
chahidapotrer,	চাহিদাপত্রের,	চাহিদাপত্রের,	
licencer,	লাইসেন্সার,	লাইসেন্সের,	
khanabale,	খানাবালে,	খানাবলে,	
kakhnoba,	কাখনবা,	কখনওবা,	
townshhip,	টুনশিপ,	টাউনশিপ,	
krisenter,	ক্রিসেন্টের,	ক্রিসেন্টের,	
heerani,	হিরানী,	হিরানি,	
evereste,	ইভারেস্টে,	এভারেস্টে,	
satarkabhabey,	সতর্কভাবে,	সতর্কভাবে,	
huka,	হুকা,	হুক,	
spredasita,	স্প্রেডাসিট,	স্প্রেডশীট,	
dokanei,	দোকাই,	দোকানেই,	
dighol,	দিঘল,	দীঘল,	
dinar,	দিনার,	ডিনার,	
qaro,	কারো,	কারো,	
bangalore,	বাঙ্গালোর,	ব্যাঙ্গালুরে,	
shomser,	শমসের,	সমশের,	
janghu,	জংহু,	জঙ্ঘু,	
jackey,	জ্যাকে,	জকি,	
mukhobondho,	মুখবন্ধ,	মুখবন্ধ,	
arashie,	আরাশী,	আরসিএ,	
gonona,	গনোনা,	গননা,	
pisach,	পিসাচ,	পিশাচ,	
vvimsenn,	ভিভসসেন,	ভীমসেন,	
sursur,	সুরসুর,	সুরসুর,	
mah,	মাহ,	মাহে,	
alankorana,	অলঙ্করণা,	অলঙ্করণ,	
sithilota,	সিথিলতা,	শিথিলতা,	
naazi,	নাজি,	নাত্সি,	
saria,	সরিয়া,	সরিয়া,	
bashoborty,	বাশবর্তী,	বশবর্তী,	
oisamoyer,	ঐসময়ের,	ঐসময়ের,	
patjata,	পাটজাতা,	পাটজাত,	
aosafur,	আসোফুর,	আওশাফুর,	
shilver,	শিল্ভের,	সিলভার,	
grootha,	গ্রুথা,	গ্রোথ,	
nimitte,	নিমিত্বে,	নিমিত্তে,	
shuchonakal,	শুচনাকাল,	সূচনাকাল,	
grushko,	গ্রুশকো,	গ্রুশকো,	
jerusaleme,	জেরুসালেমে,	জেরুসালেমে,	
uponishad,	উপনিশাদ,	উপনিষদ,	
vortuki,	ভর্তুকি,	ভর্তুকি,	
harris,	হ্যারিস,	হ্যারিস,	
habshi,	হাবশি,	হাবশী,	
tenishe,	তেনিশে,	টেনিসে,	
bonvumitey,	বনভূমিতে,	বনভূমিতে,	
hames,	হ্যামেস,	হোমস,	
jwar,	জ্বর,	জ্বর,	
plusey,	প্লাসে,	প্লাসে,	
gazipur,	গাজীপুর,	গাজিপুর,	
rahi,	রহী,	রাহী,	
neck,	নেক,	নেক,	
dipti,	দীপটি,	ডেপুটি,	
shucharita,	শুচারিত,	সুচরিতা,	
jhonkar,	ঝোঁকার,	ঝঙ্কার,	
niropekkho,	নিরপপক্ষ,	নিরপেক্ষ,	
armeeniyana,	আর্মিনীয়,	আর্মেনিয়ান,	
ponchasjon,	পঞ্চাসন,	পঞ্চাশজন,	
oncoltike,	অন্কলটিকে,	অঞ্চলটিকে,	
bhutbhut,	ভূৎভূত,	ভুটভুট,	
samaveshke,	সমাভশেকে,	সমাবেশকে,	
suraaropeeto,	সুরারোপিত,	সুরারোপিত,	
khalidkay,	খালিদকায়,	খালিদকে,	
jamjamat,	জামজামাত,	জমজমাট,	
prasadhani,	প্রসাধনী,	প্রসাধনী,	
magical,	ম্যাজিকাল,	ম্যাজিকাল,	
asovya,	অসোভ্য,	অসভ্য,	
sangkalanti,	সংকলনন্তি,	সংকলনটি,	
maail,	মাইল,	মাইল,	
osommotite,	অসম্ততিতে,	অসম্মতি,	
sikkhakromer,	শিক্ষাক্রমের,	শিক্ষাক্রমের,	
eupheike,	উইফেইকে,	ইউফেইকে,	
carlosh,	কার্লোশ,	কার্লোস,	
hizriite,	হিজরাইতে,	হিজরীতে,	
saralya,	সরল্য,	সারল্য,	
sures,	সুরেস,	সুরেশ,	
providere,	প্রভিদেরে,	প্রভাইডারে,	
boiporiityen,	বৈপরিত্যেন,	বৈপরীত্যেন,	
cholochchitrer,	চলচ্চিত্রের,	চলচ্চিত্রের,	
chenza,	চেঞ্জা,	চেঞ্জ,	
ghotaibe,	ঘোটাইবে,	ঘটাইবে,	
zeland,	জেলান্দ,	জিল্যান্ড,	
tiuning,	টিউনিং,	টিউনিং,	
osthisondhi,	অস্থিসন্ধি,	অস্থিসন্ধি,	
amanisa,	আমানিসা,	অমানিশা,	
gitikobita,	গীতুকবিতা,	গীতিকবিতা,	
nishad,	নিশাদ,	নিষাদ,	
leaders,	লিডার্স,	লিডার্স,	
yatharthabhabe,	যথথর্থভাবে,	যথার্থভাবে,	
hastamathun,	হস্তমথথুন,	হস্তমথুন,	
ostad,	ওস্তাদ,	ওস্তাদ,	
shoodhooi,	শুধুই,	শুধুই,	
kheshar,	খেশার,	খেশার,	
protiakromonei,	প্রতিয়াক্রমনেই,	প্রতিআক্রমণেই,	
murader,	মুরাদের,	মুরাদের,	
brail,	ব্রেইল,	ব্রেইল,	
jothartho,	যথার্থ,	যথার্থ,	
diibug,	দিবুগ,	ডিবাগ,	
shringgo,	শ্রিংগো,	শৃঙ্গ,	
rajbandir,	রাজবন্দির,	রাজবন্দীর,	
suparahiro,	সুপারাহিরও,	সুপারহিরো,	
shipley,	শিপলে,	শিপলে,	
upbrazillian,	আপব্রিজিলিয়ান,	আপব্রাজিলিয়ান,	
kirti,	কীর্তি,	কীর্তি,	
ghumunoi,	ঘুমুনোই,	ঘুমুনোই,	
ghomtaa,	ঘোমটা,	ঘোমটা,	
gandhike,	গাঁধীকে,	গান্ধীকে,	
pet,	পেট,	পেত,	
laesens,	লেসেন্স,	লাইসেন্স,	
shresthoshcho,	শ্রেষ্টশ্চ,	শ্রেষ্ঠশ্চ,	
ganesh,	গণেশ,	গণেশ,	
qara,	কারা,	কর,	
thechar,	থেচার,	থ্যাচার,	
mosjidsoho,	মসজিদসহ,	মসজিদসহ,	
deeares,	ডিয়ারস,	ডিআরএস,	
bijito,	বিজিত,	বিজিত,	
nutoner,	নুটনের,	নূতনের,	
rohasyer,	রহস্যের,	রহস্যের,	
queri,	কুয়েরি,	কোয়েরি,	
wrighter,	অই্টার,	রাইটের,	
diiptii,	দীপ্তই,	ডেপুটি,	
audiotike,	অডিওটিকে,	অডিওটিকে,	
mekon,	মেকন,	মেকং,	
komanera,	কমনেরা,	কমানেরা,	
angkita,	অংকিতা,	অঙ্কিতা,	
buddhitii,	বুদ্ধিতই,	বুদ্ধিটিই,	
onshogrohoner,	অংশগ্রহণের,	অংশগ্রহনের,	
samratder,	সম্রাদদের,	সম্রাটদের,	
umb,	ইউএমবি,	ইউএমবি,	
sarder,	সার্দের,	সরদার,	
shahoshikatar,	শাহশিকতার,	সাহসিকতার,	
karmakarke,	কর্মকারকে,	কর্মকারকে,	
grahoksebai,	গ্রাহকসেবাই,	গ্রাহকসেবায়,	
rashider,	রাশিদের,	রশিদের,	
dinifitian,	ডানিফিইন,	ডেফিনেশন,	
difinision,	ডিফিনিসন,	ডেফিনেশন,	
chhutee,	ছুতি,	ছুটি,	
provur,	প্রভুর,	প্রভুর,	
maley,	মালে,	মালে,	
toxoid,	টক্সোইড,	টক্সয়েড,	
dosha,	দোশা,	দোসা,	
gaaddafee,	গ্যাড্ডাফি,	গাদ্দাফী,	
bike,	বিকে,	বাইক,	
nanir,	নানির,	নানীর,	
shatokeo,	শতকেও,	শতকেও,	
dweepgoolotey,	দ্বীপগুলোতে,	দ্বীপগুলোতে,	
hijritey,	হিজরিতে,	হিজরীতে,	
khonjena,	খোঁজেনা,	খোঁজেনা,	
sachetanvabe,	সচেতনভাবে,	সচেতনভাবে,	
atorkitey,	আতরকীতে,	অতর্কিতে,	
nagorikra,	নাগরিকরা,	নাগরিকেরা,	
muchlima,	মুছলিমা,	মুছলিমা,	
ujbekistaner,	উজবেকিস্তানের,	উজবেকিস্তানের,	
starker,	স্টার্কার,	স্টার্কের,	
conservetion,	কনভার্েশন,	কনসারভেশন,	
pratijogider,	প্রাতিযোগীদের,	প্রতিযোগীদের,	
musabbirul,	মুসাব্বিরুল,	মুসাব্বিরুল,	
olympicer,	অলিমপিসের,	অলিম্পিকের,	
mausumeo,	মৌসুমেও,	মৌসুমেও,	
kaleo,	কালেও,	কালেও,	
taateo,	তাতেও,	তাতেও,	
neerbahi,	নির্বাহী,	নির্বাহি,	
pharn,	ফার্ন,	ফার্ন,	
chemjong,	চেমজং,	চেমজং,	
jomoker,	জমকের,	জমকের,	
elakatite,	এলাকাটিতে,	এলাকাটিকে,	
shamijir,	শামীজির,	স্বামীজীর,	
garora,	গারোরা,	গারোরা,	
nirgomon,	নির্মমন,	নির্গমন,	
paikgachha,	পাইকগাছা,	পাইকগাছা,	
dolphiny,	ডলফিনি,	ডলফিনি,	
volapuk,	ভোলাপুক,	ভোলাপুক,	
aieesha,	আইসা,	আইএএস,	
rasunkunchi,	রসুনকুষ্চি,	রসুনকুঁচি,	
simaa,	সিমা,	সীমা,	
footbalarer,	ফুটবালারের,	ফুটবলারের,	
edseler,	এডসেলের,	এডসেলের,	
chhuteer,	ছুটির,	ছুটির,	
sahozlabhbhatar,	সহজল্লভভতার,	সহজলভ্যতার,	
pushtee,	পুষ্ট,	পুষ্টি,	
nothivukto,	নথিভুক্ত,	নথিভুক্ত,	
chhaikalo,	ছাইকালো,	ছাইকালো,	
bhogni,	ভগ্নী,	ভগ্নী,	
soolke,	সুলকে,	শুল্কে,	
shcholastic,	স্লোস্ট্রিক,	স্কলাস্টিক,	
pare,	পারে,	পাড়ে,	
nirmankaaj,	নির্মানকাজ,	নির্মাণকাজ,	
niropekshtar,	নিরপপেক্ষটার,	নিরপেক্ষতার,	
khargosher,	খরগোষের,	খরগোসের,	
pujit,	পুজিত,	পুজিত,	
chargar,	চারগর,	চার্জার,	
dhonni,	ধন্নি,	ধন্যি,	
becha,	বেচা,	বেচা,	
hari,	হারি,	হরি,	
furio,	ফুরিও,	ফুরিও,	
mail,	মাইল,	মাইল,	
suparichiti,	সুপরিচিতি,	সুপরিচিতি,	
taatey,	তাতে,	তাতে,	
elaaka,	এলাকা,	এলাকা,	
prothati,	প্রথাটি,	প্রথাটি,	
habsi,	হাবসি,	হাবশী,	
debdebyr,	ডেবদিবর,	দেবদেবীর,	
seekkhaou,	শীক্ষাও,	শিক্ষাও,	
abosare,	অবসারে,	অবসরে,	
chetanagato,	চেতনাগত,	চেতনাগত,	
madrasake,	মাদ্রাসাকে,	মাদ্রাসাকে,	
nisshongotake,	নিঃশংগতাকে,	নিঃসঙ্গতাকে,	
korimpur,	করিমপুর,	করিমপুর,	
uindoos,	ইইন্ডুস,	উইন্ডোস,	
futonta,	ফুতনটা,	ফুটন্ত,	
basakey,	বাসাকে,	বাসাকে,	
chinto,	চিন্ত,	চিনতো,	
jumlalancer,	জুমলাযান্সের,	জুমলাল্যান্সার,	
gaichhe,	গাইছে,	গাইছে,	
laishenshim,	লাইশেনশিম,	লাইসেন্সিং,	
venus,	ভেনুস,	ভেনাস,	
bonnopran,	বন্যপ্রাণ,	বন্যপ্রাণ,	
akai,	আকাই,	একাই,	
pujito,	পুজিত,	পুজিত,	
mythological,	মাথলজিকাল,	মাইথলজিকাল,	
humira,	হুমিরা,	হুমিরা,	
stonehenje,	স্টোনহজন্জে,	স্টোনহেঞ্জ,	
poripakey,	পরিপাকে,	পরিপাকে,	
madhobeer,	মাধবীর,	মাধবীর,	
borkhastokritora,	বরখাস্তকতরা,	বরখাস্তকৃতরা,	
nanilalke,	নানিলালকে,	ননীলালকে,	
sonaktokaran,	সোনাক্তকরণ,	সনাক্তকরণ,	
byabostho,	ব্যবস্থ,	ব্যাবস্থা,	
procharona,	প্রচারণা,	প্রচারণা,	
debete,	দেবেতে,	ডিবেট,	
ganakantha,	গণকন্ঠ,	গণকণ্ঠ,	
chongar,	চোঙ্গার,	চোঙ্গার,	
piulir,	পিউলির,	পিউলির,	
neerbahe,	নির্বাহে,	নির্বাহে,	
maadla,	মাদলা,	মাদলা,	
shakar,	শাকার,	সকার,	
braqe,	ব্রেক,	ব্রেক,	
nosihote,	নসিহতে,	নসিহতে,	
greenald,	গ্রানল্ড,	গ্রিনল্ড,	
gloria,	গ্লোরিয়া,	গ্লোরিয়া,	
vimsen,	ভিমসেন,	ভীমসেন,	
prithibir,	পৃথিবীর,	পৃথবীর,	
qaferderkey,	কাফেরদেরকে,	কাফেরদেরকে,	
morodeho,	মরদেহ,	মরদেহ,	
harbare,	হারবারে,	হারবারে,	
madhumati,	মধুমতি,	মধুমতী,	
ekekrokom,	একেক্রমক,	একেকরকম,	
horiddar,	হরিদ্দার,	হরিদ্বার,	
thailandsaho,	থাইলান্ডসহ,	থাইল্যান্ডসহ,	
baieq,	বাইয়েক,	বাইক,	
ekatto,	একাত্য,	একাত্ব,	
hukar,	হুকার,	হুকার,	
gronthao,	গ্রন্থাও,	গ্রন্থও,	
alpakichudin,	অল্পাচিদুদিন,	অল্পকিছুদিন,	
kram,	ক্রাম,	ক্রম,	
oncholshomuher,	অন্চলসমূহের,	অঞ্চলসমূহের,	
forma,	ফরমা,	ফর্মা,	
prodiiper,	প্রদীপের,	প্রদীপের,	
shikara,	শিকারা,	শিকার,	
khabarsoho,	খাবারসহ,	খাবারসহ,	
moshzidtike,	মশদিদটিকে,	মসজিদটিকে,	
paadee,	পাড়ি,	পাড়ে,	
jamkaalo,	জামকালো,	জমকালো,	
charban,	চারবান,	চর্বন,	
dubaate,	দুবাতে,	ডুবাতে,	
sombhobonao,	সম্ভবনাও,	সম্ভবনাও,	
tukroti,	তুকরোটি,	টুকরোটি,	
dhhaabi,	ঢাবী,	ঢাবি,	
foxer,	ফক্সার,	ফক্সের,	
jamseder,	জামসেদের,	জামসেদের,	
kinenni,	কিইনেনি,	কিনেননি,	
qraima,	ক্রাইম,	ক্রাইম,	
bishwasho,	বিশ্বস,	বিশ্বাসও,	
fastara,	ফাস্তারা,	ফস্টার,	
satarkakari,	সতর্ককারী,	সতর্ককারী,	
mesenjjar,	মেসেঞ্জজার,	মেসেঞ্জার,	
bhagnekeo,	ভাগনেকেও,	ভাগ্নেকেও,	
kamla,	কামলায়,	কামলা,	
laicenshe,	লাইচেন্সে,	লাইসেন্স,	
dheke,	ধেকে,	ঢেকে,	
satarkatar,	সতর্কতার,	সতর্কতার,	
dekaner,	দেকানের,	দেকানের,	
chotogolper,	চতগল্পের,	ছোটগল্পের,	
gotirodh,	গতিরোধ,	গতিরোধ,	
remission,	রেমিশন,	রিমিশন,	
fakhrul,	ফাখরুল,	ফাখরুল,	
fatakesto,	ফাটাকেস্ত,	ফাটাকেষ্ট,	
souripurang,	সৌরীপূরং,	সৌরিপুরং,	
gaandaas,	গান্ডাস,	জ্ঞানদাস,	
licencedhari,	লাইকেন্সাধারী,	লাইসেন্সধারী,	
shilpojaat,	শিল্পজাত,	শিল্পজাত,	
uddhrito,	উদ্ধৃত,	উদ্ধৃত,	
sommotite,	সম্মতিতে,	সম্মতিতে,	
gopalrao,	গোপলরাও,	গোপালরাও,	
adarsho,	আদারশ্ব,	আর্দশ,	
afrazuler,	আফরাজুলের,	আফরাজুলের,	
dadapur,	দাদাপুরের,	দাদাপুর,	
balatkar,	বালাতকার,	বলাৎকার,	
nirobota,	নিরবতা,	নিরবতা,	
vorkendra,	ভোরকেন্দ্র,	ভরকেন্দ্র,	
temanti,	তেমন্তি,	তেমনটি,	
dupleks,	ডাপ্লক্স,	ডুপ্লে,	
nimnosakkharkari,	নিম্নসাস্কারীরী,	নিম্নস্বাক্ষরকারী,	
udvaboney,	উদ্ভবনে,	উদ্ভাবনে,	
janosamaj,	জনসমাজ,	জনসমাজ,	
societytey,	সোসিয়েটিতে,	সোসাইটিতে,	
zerusalem,	জেরুসালেম,	জেরুজালেম,	
prothar,	প্রথার,	প্রথার,	
gavaskar,	গাভাসকার,	গাভাস্কার,	
rajyabhogi,	রাজ্যবোগী,	রাজ্যভোগী,	
muktilav,	মুক্তিলাভ,	মুক্তিলাভ,	
somosto,	সমস্ত,	সমস্ত,	
anektai,	অনেকটাই,	অনেকটাই,	
bosonte,	বসন্তে,	বসন্তে,	
pillai,	পিল্লাই,	পিল্লাই,	
huk,	হুক,	হুক,	
taxikeo,	ট্যাক্সিকেও,	ট্যাক্সিকেও,	
shangkalonti,	শংকলনটি,	সংকলনটি,	
ramchander,	রামচন্দের,	রামচন্দরের,	
vobobibhuti,	ভববিভূতি,	ভববিভূতি,	
boikalyo,	বৈকাল্য,	বৈকল্য,	
rakshanbhag,	রক্ষণবাগ,	রক্ষণভাগ,	
camerapersoner,	ক্যামেরাপরসনের,	ক্যামেরাপার্সনের,	
vodqa,	ভোডকা,	ভদকা,	
hurricane,	হারিকেন,	হ্যারিকেন,	
vobanipur,	ভবানীপুর,	ভবানীপুর,	
sommoteer,	সম্মতির,	সম্মতির,	
chinito,	চিনিত,	চিনতো,	
ghurte,	ঘুর্তে,	ঘুরতে,	
arthonitir,	অর্থনীতির,	অর্থনীতির,	
manjushri,	মন্জুর্রী,	মঞ্জুশ্রী,	
talgachh,	তালগাছ,	তালগাছ,	
besooro,	বেসোরো,	বেসুর,	
antorbhuktimulak,	অন্তর্ভূর্তিকূলক,	অন্তর্ভুক্তিমূলক,	
carzar,	কার্জার,	চার্জার,	
kanasharabheshhana,	কানারাশেষন,	কনসারভেশন,	
kiandi,	কিয়ান্দি,	ক্যান্ডি,	
katui,	কাতুই,	কাতুই,	
protinito,	প্রতিনিত,	প্রতিনিত,	
bee,	বিই,	বি,	
teksuser,	টেকসুসের,	টেক্সাসের,	
beekaargrasta,	বিকারগ্রস্ত,	বিকারগ্রস্ত,	
phiqsa,	ফিকস,	ফিক্স,	
turkyder,	টার্কিদের,	তুর্কিদের,	
spreadshiit,	স্প্রেডশিট,	স্প্রেডশীট,	
nibeditar,	নিবেদিতার,	নিবেদিতার,	
madhuree,	মধুরী,	মাধুরী,	
pulivendla,	পুলিভেন্ডলা,	পুলিভেন্ডলা,	
azimpur,	আজিমপুর,	আজিমপুর,	
dipke,	ডিপকে,	দ্বীপকে,	
parqa,	পারকা,	পার্ক,	
spreedashita,	স্প্রিডডাশিট,	স্প্রেডশীট,	
grooth,	গ্রুথ,	গ্রোথ,	
dokaangoolote,	দোকানগুলোতে,	দোকানগুলোতে,	
ancholsomuho,	আঞ্চলসমূহ,	অঞ্চলসমূহ,	
osoborno,	অসবর্ণ,	অসবর্ণ,	
ghatleo,	ঘাটলেও,	ঘটলেও,	
gandhariir,	গানধারীর,	গান্ধারীর,	
ramzaner,	রামজানের,	রমযানের,	
biphal,	বিফাল,	বিফল,	
foloshrutite,	ফলশ্রুটিতে,	ফলশ্রুতিতে,	
rananganey,	রণঙ্গনে,	রণাঙ্গনে,	
suiza,	সুইজা,	সুইজা,	
prothakey,	প্রথাকে,	প্রথাকে,	
senabahinio,	সেনাবাহিনিও,	সেনাবাহিনীও,	
sahooseekotar,	সাহুসকতার,	সাহসিকতার,	
panchbar,	পাঁচবার,	পাঁচবার,	
baibosthaar,	বাইবস্থার,	ব্যবস্থার,	
amarika,	আমারিকা,	আমেরিকা,	
indro,	ইন্দ্র,	ইন্দ্র,	
chiroharit,	চিরহহারিত,	চিরহরিৎ,	
dii,	ডিয়,	দিই,	
elakatir,	এলাকাটির,	এলাকাটির,	
neshnosh,	নেশনশোষ,	নেশনস,	
utpatti,	উৎপত্তি,	উতপত্তি,	
addabaj,	আদ্যাবাজ,	আড্ডাবাজ,	
vejjanno,	ভেজ্যান্য,	ভেজানো,	
gronther,	গ্রন্থের,	গ্রন্থের,	
nachar,	নাচার,	নাচার,	
kormokarke,	কর্মকারকে,	কর্মকারকে,	
talaa,	তালা,	তালা,	
pachchi,	পাচ্ছি,	পাচ্ছি,	
toroonraa,	তরূণরা,	তরুণরা,	
paste,	পাস্তে,	পেষ্ট,	
abhijitda,	অভিজিতদা,	অভিজিতদা,	
lakshmir,	লক্ষ্মীর,	লক্ষ্মীর,	
courtcaser,	কোর্টকাসের,	কোর্টকেসের,	
shektore,	শেক্তরে,	সেক্টরে,	
annanere,	অন্যানেরে,	অন্যানেরে,	
lopjonito,	লঞ্জনিত,	লোপজনিত,	
shchalastic,	স্কালাসটিক,	স্কলাস্টিক,	
kisti,	কিস্তি,	কিস্তি,	
labonaktatar,	লাবণাক্ততার,	লবণাক্ততার,	
towraat,	টুআরট,	তওরাত,	
hafsa,	হাফসা,	হাফসা,	
trutimatra,	ত্রুতিমাত্রা,	ত্রুটিমাত্র,	
daybhager,	দায়ভাগের,	দায়ভাগের,	
brixfield,	ব্রিক্সল্ড,	ব্রিক্সফিল্ড,	
sthaponagulo,	স্থাপনাগুলো,	স্থাপনাগুলো,	
borlen,	বোরলেন,	বরলেন,	
chat,	চাট,	চ্যাট,	
mukherjee,	মুখের্জী,	মুখার্জী,	
soomitrar,	সুমিত্রার,	সুমিত্রার,	
swarther,	স্বার্থের,	স্বার্থের,	
templet,	টেম্পলেট,	টেম্পলেট,	
eshtoniya,	এস্তনীয়া,	এস্তোনিয়া,	
steen,	স্তিন,	স্টেন,	
tecno,	টেকনো,	টেকনো,	
bisshasi,	বিশ্বাসী,	বিশ্বাসী,	
khaaneker,	খানেকের,	খানেকের,	
sofie,	সোফি,	সোফি,	
gafeeloti,	গাফলোটি,	গাফিলতি,	
bhoutikeshu,	ভৌতিকেষু,	ভৌতিকেষু,	
shnaipara,	স্নাইপার,	স্নাইপার,	
markeetim,	মার্কিটিম,	মার্কেটিং,	
sarajibonbyapi,	সারোজিন্ববাপী,	সারাজীবনব্যাপী,	
edic,	এডিক,	এডিক,	
arke,	আরকে,	আরকে,	
antorvuktimulak,	অ্যান্টররভ্মুমাক,	অন্তর্ভুক্তিমূলক,	
bhejaano,	ভেজানো,	ভেজানো,	
asommoti,	অসম্মতি,	অসম্মতি,	
klaud,	ক্লাউড,	ক্লাউড,	
bossoben,	বসবেন,	বসবেন,	
dhache,	ধাচে,	ধাঁচে,	
laaisensh,	লাইশেন্স,	লাইসেন্স,	
bhabanir,	ভাবানীর,	ভবানীর,	
ponchaashjon,	পঞ্চাশজন,	পঞ্চাশজন,	
shithilata,	শিথিলতা,	শিথিলতা,	
phox,	ফক্স,	ফক্স,	
firth,	ফিরথ,	ফার্থ,	
saifullahil,	সাইফুল্লাহীল,	সাইফুল্লাহিল,	
gaichey,	গাইছে,	গাইছে,	
shibraj,	শিবরাজ,	শিবরাজ,	
sangsakti,	সংসক্তি,	সংসক্তি,	
songasthatike,	সংস্থাটিকে,	সংস্থাটিকে,	
flirt,	ফ্লির্ট,	ফ্লার্ট,	
choopi,	চুপি,	চুপি,	
choson,	চসন,	চোষণ,	
mumtajer,	মুমতাজের,	মুমতাজের,	
asamonjasyopurno,	অসামঞ্জস্যস্পুণ,	অসামঞ্জস্যপূর্ণ,	
samley,	সামলে,	সামলে,	
chhootochhuti,	ছোটছুতি,	ছুটোছুটি,	
shourshe,	শৌরশ,	সোর্স,	
pharmesigulote,	ফার্মেসিগুলোতে,	ফার্মেসীগুলোতে,	
crime,	ক্রাইম,	ক্রাইম,	
graambaaseeder,	গ্রামসবাসীদের,	গ্রামবাসীদের,	
ujobekeestan,	উজবেকস্তান,	উজবেকিস্তান,	
rajyotiro,	রাজ্যতিরও,	রাজ্যটিরও,	
soleel,	সলিল,	সলিল,	
booroon,	বুরুন,	বোরন,	
mahbunur,	মাহবুনুর,	মাহবুনুর,	
planey,	প্ল্যানে,	প্লেনে,	
sanaktokaran,	সনক্্তকরণ,	সনাক্তকরণ,	
balaruma,	বালারুমা,	বলরুম,	
shhow,	ষৌ,	শো,	
bhebechili,	ভেবেছিলি,	ভেবেছিলি,	
durlabhatwang,	দুর্বভাত্বং,	দুর্লভত্বং,	
beshyasdone,	বেশ্যাসদনে,	বেশ্যাসদনে,	
songkoloney,	সংকলনে,	সংকলনে,	
alimpiqa,	আলিম্পিকা,	অলিম্পিক,	
mugdha,	মুগধা,	মুগ্ধ,	
eexpreession,	ইক্সপ্রিশন,	এক্সপ্রেশন,	
neemeetto,	নিমত্ব,	নিমিত্ত,	
phareeksa,	ফারিকসা,	ফরেক্স,	
brittakare,	বৃত্তকরে,	বৃত্তাকারে,	
shansthaner,	শান্সথানের,	সংস্থানের,	
dabliudabliui,	ডাবলিউদৌলবিউ,	ডাব্লিউডাব্লিউই,	
farid,	ফারিদ,	ফরিদ,	
sambhabonao,	সম্ভাবনাও,	সম্ভবনাও,	
teenisa,	তেনিসা,	টেনিস,	
title,	টিটল,	টাইটেল,	
lambaate,	ল্যাম্বাট,	লম্বাটে,	
rajotta,	রাজোত্ব,	রাজত্ব,	
ovarview,	ওভারভিভ,	ওভারভিউ,	
aalkaatra,	আলকাত্র,	আলকাতরা,	
acrolect,	অ্যাক্রোলিক্ট,	অ্যাক্রোলেক্ট,	
somonwitobhabey,	সমন্ভিতভাবে,	সমন্বিতভাবে,	
dhanak,	ধনক,	ধানক,	
uqeliptas,	উকেলিপ্টাস,	ইউক্যালিপ্টাস,	
shikshakbrinda,	শিকশকবৃন্দ,	শিক্ষকবৃন্দ,	
seeramiks,	সেরামিকস,	সিরামিকস,	
armshtronj,	আর্মস্ট্রন,	আর্মস্ট্রং,	
bhenasha,	ভেনাশা,	ভেনাস,	
gandharir,	গানধারীর,	গান্ধারীর,	
mukhyo,	মুখ্য,	মুখ্য,	
rajtantra,	রাজতন্ত্র,	রাজতন্ত্র,	
pretti,	প্রেটি,	প্রিটি,	
vaisoho,	ভাইসহ,	ভাইসহ,	
munshiji,	মুন্শিজি,	মুনশীজি,	
ashamorthito,	অশামর্থিত,	অসমর্থিত,	
koruna,	কোরুনা,	করুণা,	
deefinision,	ডিফিনিসন,	ডেফিনেশন,	
probeshan,	প্রবেশন,	প্রবেশন,	
huqa,	হুকা,	হুক,	
bibadey,	বিবাদে,	বিবাদে,	
pratisthasaho,	প্রাতিষ্ঠাস,	প্রতিষ্ঠাসহ,	
giitikobita,	গীতিকবিতা,	গীতিকবিতা,	
bodna,	বোদনা,	বদনা,	
akhandota,	আখণ্ডটা,	অখণ্ডতা,	
muradke,	মুরাদকে,	মুরাদকে,	
matorom,	মাতরম,	মাতরম,	
trabuco,	ট্রাবুকো,	ট্র্যাবুকো,	
obosan,	অবসান,	অবসান,	
khelaphate,	খেলাফেট,	খেলাফতে,	
michir,	মিছির,	মিচির,	
cloring,	ক্লোরিং,	ক্লোরিং,	
lirikti,	লিরিকটি,	লিরিকটি,	
siddhante,	সিদ্ধান্তে,	সিদ্ধান্তে,	
basturoi,	বস্তুরই,	বস্তুরই,	
stoonahenja,	স্টুনাহেঞ্জ,	স্টোনহেঞ্জ,	
shtona,	স্তোনা,	স্টোন,	
aasar,	আসোর,	আসর,	
larson,	লারসন,	লারসন,	
antercticker,	অ্যান্টার্টকেের,	অ্যান্টার্কটিকের,	
bhaibon,	ভাইবন,	ভাইবোন,	
edaning,	এদানিং,	ইদানিং,	
ashiatic,	অ্যাশিয়াটিক,	এশিয়াটিক,	
teliha,	তেলিহা,	তেলিহা,	
niroja,	নিরোজা,	নিরোজা,	
konorup,	কনোরূপ,	কোনরূপ,	
jamaanor,	জামানোর,	জমানোর,	
chaanoo,	চানু,	চানু,	
artilary,	আর্টিলারি,	আর্টিলারি,	
tep,	টিপ,	ট্যাপ,	
headquartus,	হেডকররাটাস,	হেডকোয়ার্টাস,	
kayartara,	কায়ারটারা,	কোয়ার্টার,	
highcommissionay,	হাইমসিনসায়ে,	হাইকমিশনে,	
aireshe,	আইরেশে,	আইরেসে,	
madhabike,	মাধবিকে,	মাধবীকে,	
puding,	পুডিং,	পুডিং,	
ansareer,	আনসরীর,	আনসারীর,	
byabaharkarike,	ব্যবহারকারীকে,	ব্যবহারকারীকে,	
jontrototto,	যন্ত্রতত্ব,	যন্ত্রতত্ত্ব,	
aaps,	এপিএস,	এএপিএস,	
byboshthar,	বিবশ্ঠার,	ব্যাবস্থার,	
hooq,	হুঁক,	হুক,	
cn,	সিএনএন,	সিএন,	
noteti,	নটেটি,	নোটটি,	
suporichita,	সুপরিচিতা,	সুপরিচিত,	
mangoleek,	মঙ্গলিক,	মাঙ্গলিক,	
tolemy,	টোলেমি,	টলেমির,	
ponero,	পনেরও,	পনের,	
mukhabandha,	মুখবন্ধ,	মুখবন্ধ,	
footballerra,	ফুটবললাররা,	ফুটবলাররা,	
gonohotyakey,	গণহজ্যাকে,	গণহত্যাকে,	
dipankar,	দীপাঙ্কর,	দিপঙ্কর,	
kaash,	কাশ,	কাস,	
kurdira,	কুর্দিরা,	কুর্দিরা,	
shikkhartheerao,	শিক্ষার্থীরাও,	শিক্ষার্থীরাও,	
kings,	কিংস,	কিংস,	
uthhaane,	উঠানে,	উঠানে,	
cholocchitrer,	চলচকিত্রের,	চলচ্চিত্রের,	
kale,	কালে,	কালে,	
bouddho,	বৌদ্ধ,	বৌদ্ধ,	
sqalastiqa,	স্কালাস্তি,	স্কলাস্টিক,	
plato,	প্ল্যাটো,	প্লেটো,	
parabortee,	পারাবোর্তী,	পরর্বতী,	
asif,	আসিএফ,	আসিফ,	
ganohotyake,	গণহত্যাকে,	গণহত্যাকে,	
baharamporer,	বাহারাম্পরের,	বহরমপুরের,	
uddhrita,	উদ্ধিতা,	উদ্ধৃত,	
hitaishi,	হিতাইশি,	হিতৈষী,	
firti,	ফিরটি,	ফিরতি,	
accountdharira,	অকৌউন্ধ্তরীরা,	একাউন্টধারীরা,	
shurugulo,	শুরুগুলো,	শুরুগুলো,	
amiretus,	আমিরেটাস,	এমিরেটাস,	
bo,	বো,	বু,	
drissogoolote,	ড্রিসগুলোতে,	দৃশ্যগুলোতে,	
naazee,	নাজী,	নাত্সি,	
durgotshob,	দুর্গতশব,	দুর্গোৎসব,	
kompeeto,	কম্পিতো,	কম্পিত,	
ameettrakkhor,	অমিত্রকর্ষর,	অমিত্রাক্ষর,	
graambasio,	গ্রামবাসিও,	গ্রামবাসীও,	
azijer,	আজিজের,	আজিজের,	
siddhanter,	সিদ্ধান্তের,	সিদ্ধান্তের,	
keui,	কেউ,	কেউই,	
kholdhular,	খোলধুলার,	খোলধূলার,	
jontrangshogulor,	যন্ত্রাংশগুলোর,	যন্ত্রাংশগুলোর,	
miley,	মিলে,	মিলে,	
deputi,	ডেপুটি,	ডেপুটি,	
shite,	শীতে,	শীতে,	
monchosthol,	মন্চস্থল,	মঞ্চস্থল,	
vabuk,	ভাবুক,	ভাবুক,	
benojir,	বেনোজির,	বেনজীর,	
torutoler,	তরুতলের,	তরুতলের,	
probeshkari,	প্রবেশকারী,	প্রবেশকারী,	
brekethru,	ব্রেকেথ্রু,	ব্রেকথ্রু,	
masjidke,	মাসজিদকে,	মসজিদকে,	
sabrakamer,	সাবরাকামের,	সবরকমের,	
barrageke,	বারাগেকে,	ব্যারেজকে,	
soommita,	সুম্মিতা,	সুমিতা,	
wedanta,	ওয়েদান্ত,	বেদান্ত,	
kutubuddinke,	কুতুবুদ্দিনকে,	কুতুবুদ্দিনকে,	
bondira,	বন্দীরা,	বন্দীরা,	
sharoker,	শারকের,	স্মারকের,	
aalkatraa,	আলকাত্রা,	আলকাতরা,	
turkeyder,	তুর্কিদের,	তুর্কিদের,	
louhojato,	লৌহজাত,	লৌহজাত,	
duburir,	ডুবুরির,	ডুবুরির,	
akatwa,	আকাত্ব,	একাত্ব,	
saainyo,	সাইন্য,	সৈন্য,	
hoteltite,	হোটেলটিতে,	হোটেলটিতে,	
bandhan,	বানধন,	বাঁধন,	
mutar,	মুতার,	মুতার,	
qarlosa,	কার্লোসা,	কার্লোস,	
atighataner,	অতিঘাটনের,	অতিঘটনের,	
babare,	বাবারে,	বাবারে,	
eeksapreeshana,	এক্সপ্রেশন,	এক্সপ্রেশন,	
ramonar,	রমনার,	রমনার,	
graambaashio,	গ্রামবাশিও,	গ্রামবাসীও,	
muhuriganj,	মুহুরীগঞ্জ,	মুহুরীগঞ্জ,	
protectionism,	প্রোটেকশনিম,	প্রোটেকশনিজম,	
dolu,	দলু,	ডলু,	
bonobhumi,	বনভূমি,	বনভূমি,	
balithubar,	বালিথুবার,	বালিথুবার,	
aprasangikbhabei,	অপ্রাসঙ্কিকভাবেই,	অপ্রাসঙ্গিকভাবেই,	
bhowanipur,	ভোবানিপুর,	ভবানীপুর,	
tophaat,	টোফাত,	তফাৎ,	
satarka,	সতর্কা,	সতর্ক,	
chintamani,	চিন্তামণি,	চিন্তামনি,	
nobotomo,	নবতম,	নবতম,	
songbadmadhyame,	সংবাদমাধ্যমে,	সংবাদমাধ্যমে,	
chhadite,	ছাদিতে,	ছড়িতে,	
dologuloo,	দলগুলো,	দলগুলোও,	
dimbacriti,	ডিম্বাক্রিটি,	ডিম্বাকৃতি,	
apad,	এপাদ,	আপদ,	
daakticketer,	ডাক্টিকেটের,	ডাকটিকিটের,	
manober,	মানবের,	মানবের,	
anhu,	আনহু,	আনহু,	
liceensee,	লাইসেন্স,	লাইসেন্স,	
niketaner,	নিকেতানের,	নিকেতনের,	
windows,	উইন্ডোস,	উইন্ডোস,	
drishi,	দৃশি,	দৃশ্যই,	
ahong,	আহং,	অহং,	
nisader,	নিসাদের,	নিষাদের,	
qarqa,	কারকা,	কার্ক,	
greep,	গ্রীপ,	গ্রিপ,	
fevarite,	ফেভারিতে,	ফেভারিট,	
euqalyptus,	ইউক্যালিপ্টাস,	ইউক্যালিপ্টাস,	
drissogulo,	দৃশসগুলো,	দৃশ্যগুলো,	
sikkhagata,	শিক্ষগত,	শিক্ষাগত,	
joki,	জোকি,	জকি,	
eekbalke,	ইকবালকে,	ইকবালকে,	
cs,	সিএসএস,	সিএস,	
wilderske,	উইলহার্সকে,	উইল্ডার্সকে,	
byatikrami,	ব্যতিক্রমী,	ব্যতিক্রমী,	
kokeyin,	কোকাইন,	কোকেইন,	
kortona,	কর্তনা,	করতনা,	
gaddaphii,	গাড়দাফিই,	গাদ্দাফী,	
shoriph,	শোরিফ,	শরিফ,	
sheshardhe,	শেষার্ধে,	শেষার্ধে,	
sahittopritite,	সাহিত্যপৃতিতে,	সাহিত্যপ্রীতিতে,	
raia,	রাইয়া,	রায়,	
munjur,	মুঞ্জুর,	মুনজুর,	
sthapona,	স্থাপনা,	স্থাপনা,	
kaalaam,	কালাম,	কালাম,	
anchalgulir,	অঞ্চলগুলির,	অঞ্চলগুলির,	
sedikei,	সেদিকেই,	সেদিকেই,	
shikshagata,	শিক্ষাগা,	শিক্ষাগত,	
totokson,	ততটকন,	ততক্ষন,	
shhepha,	সেফ,	শেফ,	
stagecraft,	স্টাগের্ক্ট,	স্টেজক্রাফট,	
beila,	বেইলা,	বেইলা,	
bhenkates,	ভেনকাটেস,	ভেঙ্কটেশ,	
akkelpure,	আক্কেলপুরে,	আক্কেলপুরে,	
zarniz,	জারনিজ,	জারনিজ,	
aniyantrita,	অনিয়ন্ত্রিত,	অনিয়ন্ত্রিত,	
jens,	জেনস,	জিন্স,	
juakhelar,	যুয়াখেলার,	জুয়াখেলার,	
horas,	হোরাস,	হোরাস,	
obdee,	অব্দী,	অব্দি,	
mercial,	মারসিয়াল,	মার্শিয়াল,	
bhaisaho,	ভাইসহ,	ভাইসহ,	
wagadada,	ওয়াগাদা,	বাগদাদ,	
shommotir,	সম্মটির,	সম্মতির,	
palkee,	পালকি,	পাল্কি,	
kushakhali,	কুশাখালী,	কুশাখালি,	
bifol,	বিফল,	বিফল,	
confliqt,	কনফ্লিক্ট,	কনফ্লিক্ট,	
chalachchitro,	চলচ্চিত্র,	চলচ্চিত্র,	
daaktikite,	দাক্তিকীতে,	ডাকটিকিটে,	
gaziipur,	গাজীপুর,	গাজীপুর,	
dhanche,	ধাচে,	ধাঁচে,	
laiseensee,	লাইসিন্স,	লাইসেন্স,	
poripaker,	পরিপাকের,	পরিপাকের,	
nischoy,	নিশ্চয়,	নিশ্চয়,	
somabeshti,	সমাবেষটি,	সমাবেশটি,	
krimlin,	ক্রিমিন,	ক্রিমলিন,	
agora,	আগোরা,	আগোরা,	
langhaner,	লংহানের,	লংঘনের,	
niketon,	নিকেটন,	নিকেতন,	
byaptikaler,	ব্যাপ্তিকালের,	ব্যাপ্তিকালের,	
bodhirota,	বধিরতা,	বধিরতা,	
roy,	রয়,	রায়,	
mandanda,	মনন্দন,	মানদণ্ড,	
utshahomulok,	উত্ষাহমূলক,	উৎসাহমূলক,	
eesosiyeetasa,	ইসসিয়াতাসা,	এসোসিয়েটস,	
registaner,	রেজিস্টানের,	রেগিস্তানের,	
mane,	মানে,	মানে,	
daaradaa,	দারাদা,	দারদা,	
narbur,	নরবুর,	নরবুর,	
hol,	হল,	হোল,	
ranangone,	রণনঙ্গনে,	রণাঙ্গনে,	
suiti,	সুইটি,	সুইটি,	
emarjenshi,	এমারজেন্সি,	এমার্জেন্সি,	
rajendracholer,	রাজেন্দ্রচলের,	রাজেন্দ্রচোলের,	
directarate,	ডারেক্টারেট,	ডিরেক্টরেট,	
orthobochorke,	অর্থবছরকে,	অর্থবছরকে,	
faaj,	ফাজ,	ফাজ,	
pragreesa,	প্রাগ্রেসা,	প্রগ্রেস,	
skolarsip,	স্কলারসিপ,	স্কলারশিপ,	
antarctika,	আন্টার্টকিকা,	অ্যান্টার্কটিকা,	
dada,	দাদা,	দাদা,	
lutheerana,	লুঠিরন,	লুথেরান,	
grontho,	গ্রন্থ,	গ্রন্থ,	
baibosthar,	বাইবস্থার,	ব্যবস্থার,	
hingsar,	হিংসার,	হিংসার,	
uponeeshod,	উপনীষদ,	উপনিষদ,	
oporishodhito,	অপরিষধিত,	অপরিশোধিত,	
bisheshshyo,	বিশেষ্য,	বিশেষ্য,	
attorkite,	অত্তরকিতে,	অতর্কিতে,	
tawnship,	টানশিপ,	টাউনশিপ,	
sorting,	সর্টিং,	সর্টিং,	
chereche,	চেরেছে,	ছেড়েছে,	
fooloo,	ফুলুও,	পোলো,	
lutharan,	লুথারান,	লুথেরান,	
bhittiti,	ভিত্তিটি,	ভিত্তিটি,	
detik,	ডেটিক,	দেতিক,	
mozdur,	মজদুর,	মজদুর,	
sangharshik,	সংঘর্ষিক,	সাংঘর্ষিক,	
tantubayer,	তানুতবায়ের,	তন্তুবায়ের,	
azin,	আজিন,	আজিন,	
tonoo,	টনু,	তনু,	
panchadadu,	পঞ্চদাদু,	পঞ্চাদাদু,	
chaudhurio,	চৌধুরিও,	চৌধুরীও,	
dharmee,	ধর্মী,	ধর্মী,	
ekghore,	একঘরে,	একঘরে,	
alraji,	আলরাজি,	আলরাজী,	
iub,	ইইবিএ,	আইইউবি,	
scholars,	স্কলারস,	স্কলার্স,	
bbiseshyer,	বেবশিশ্যের,	বিশেষ্যের,	
mukhomandoler,	মুখমণ্ডলের,	মুখমণ্ডলের,	
saver,	সাভার,	সেভার,	
salmanul,	সালমানুল,	সালমানুল,	
senior,	সেনিওর,	সিনিয়র,	
ayumi,	আয়ুমী,	আয়ুমি,	
sarbhaarti,	সর্ভারটি,	সার্ভারটি,	
bisnuke,	বিস্নুকে,	বিষ্ণুকে,	
godamjato,	গোদামজত,	গুদামজাত,	
khorsed,	খোরসেড,	খোরশেদ,	
premoronge,	প্রেমরণ্গে,	প্রেমরঙে,	
lyaandeeng,	ল্যাড্ডিং,	ল্যান্ডিং,	
dharmiyabhabei,	ধর্মীয়ভাবেই,	ধর্মীয়ভাবেই,	
hastantar,	হস্তনন্তর,	হস্তান্তর,	
milayatane,	মিলায়তনে,	মিলায়তনে,	
cuti,	কিটি,	কিউটি,	
canservatian,	ক্যান্সারভেটায়ান,	কনসারভেশন,	
khitkar,	খিটকার,	ক্ষিতকর,	
durgatsober,	দুর্গাৎসবের,	দুর্গোৎসবে,	
jotharthovabey,	যথর্থভাবে,	যথার্থভাবে,	
rastagulikeo,	রাস্তাগুলিকেও,	রাস্তাগুলিকেও,	
reflex,	রিফ্লেক্স,	রিফ্লেক্স,	
rotheen,	রথথিন,	রথীন,	
andamana,	আন্দামনা,	আন্দামান,	
dhojovongo,	ধোভভঙ্গ,	ধ্বজভঙ্গ,	
habathu,	হাবাথু,	হাবাথু,	
mithener,	মিঠেনের,	মিথেনের,	
noditir,	নদীটির,	নদীটির,	
porizoner,	পরিজনের,	পরিজনের,	
duhsthanostho,	দুঃস্থানস্থ,	দুঃস্থানস্থ,	
kanader,	কানাদের,	কণাদের,	
laaishheshh,	লাইশেষ,	লাইসেন্স,	
ekspression,	এক্সপ্রেশন,	এক্সপ্রেশন,	
janagononar,	জানাগোনার,	জনগণনার,	
carloos,	কারলুস,	কার্লোস,	
daaun,	দাউন,	ডাউন,	
drissotir,	দৃশসতির,	দৃশ্যটির,	
weelcomee,	ভইলকোম,	ওয়েলকাম,	
tanshree,	তা্শরী,	তানশ্রী,	
kaalengaa,	কালেঙ্গা,	কালেঙ্গা,	
madhobi,	মাধবি,	মাধবী,	
naper,	নেপার,	ন্যাপের,	
samanwitovabe,	সামন্তিভাবে,	সমন্বিতভাবে,	
oncholshomuh,	অন্চলসমূহ,	অঞ্চলসমূহ,	
sahab,	সাহাব,	সাহাব,	
brindabane,	বৃন্দবানে,	বৃন্দাবনে,	
krom,	ক্রম,	ক্রম,	
songasthatir,	সংস্থাটির,	সংস্থাটির,	
sambatsarkal,	সম্বৎসারকাল,	সম্বৎসরকাল,	
bulano,	বুলানো,	বুলান,	
dibug,	দিবুগ,	ডিবাগ,	
nibondhocheler,	নিবন্ধচলের,	নিবন্ধছেলের,	
qanasarabheshana,	কানারাভেশন,	কনসারভেশন,	
mulyayonsapekkhe,	মূল্যয়নসেবশ্নে,	মূল্যায়নসাপেক্ষে,	
sikkhokder,	শিক্ষকদের,	শিক্ষকদের,	
notikotar,	নটিকতার,	নৈতিকতার,	
smarak,	স্মরক,	স্মারক,	
aro,	আরো,	আরও,	
khalid,	খালিদ,	খালিদ,	
tachnach,	টাচনাচ,	তছনছ,	
kramp,	ক্রাম্প,	ক্র্যাম্প,	
shamshernagar,	শমশেরনগর,	শমশেরনগর,	
manbe,	মানবে,	মানবে,	
hepatetisa,	হেপোটেসাস,	হেপাটাইটিস,	
shotodha,	শতধা,	শতধা,	
khagen,	খাগেন,	খগেন,	
aashtikotaa,	আষ্টিকতা,	আস্তিকতা,	
kathmandute,	কাঠমান্ডুতে,	কাঠমান্ডুতে,	
bajpa,	বাজপা,	বাজপা,	
peeri,	পীরি,	পেরি,	
oncholsomuho,	অন্চলসমূহ,	অঞ্চলসমূহ,	
lisense,	লিসেন্সে,	লাইসেন্স,	
relance,	রিলান্স,	রিলায়েন্স,	
cinematographar,	সিনেমেটফোগ্রের,	সিনেমাটোগ্রাফার,	
nazranar,	নাজরানার,	নাজরানার,	
bhupal,	ভুপাল,	ভূপাল,	
shapad,	শাপদ,	শ্বাপদ,	
catholicbad,	ক্যাথোলিব্যাড,	ক্যাথলিকবাদ,	
brojomohun,	ব্রোজমুন,	ব্রোজোমোহন,	
beetloser,	বিটলসের,	বিটলসের,	
raagei,	রাগেই,	রাগেই,	
byaktikegreptar,	ব্যক্তিকেগপ্রতার,	ব্যক্তিকেগ্রেপ্তার,	
boshoborty,	বশবর্তী,	বশবর্তী,	
ernad,	এরনাদ,	এরনাড,	
swasthohinotay,	স্বাস্থ্যহীনতায়,	স্বাস্থ্যহীনতায়,	
atwabishvashi,	অত্ববিভাষী,	আত্মবিশ্বাসী,	
adorsho,	আদর্শ,	আর্দশ,	
koota,	কুতা,	কোটা,	
vaticaner,	ভ্যাটিকানের,	ভ্যাটিকানের,	
arsie,	আর্সি,	আরসিএ,	
syfy,	সিফি,	সাইফাই,	
parikha,	পারিখা,	পরিখার,	
panchasjan,	পাঁচসজন,	পঞ্চাশজন,	
prity,	প্রিটি,	প্রিটি,	
batsmanei,	ব্যাটসম্যানেই,	ব্যাটসম্যানই,	
ankanshilpe,	আঙ্কানশিল্পে,	অঙ্কনশিল্পে,	
dorgaaho,	দোরগহ,	দরগাহ,	
anusvara,	অনুসভারা,	অনুস্বার,	
valobase,	ভালোবাসে,	ভালোবাসে,	
vesselli,	ভেসেল্,	ভেসেলি,	
karlei,	কারলেই,	করলেই,	
nagorikderkey,	নাগরিকদেরকে,	নাগরিকদেরকে,	
ghoomachhilo,	ঘোমাছিল,	ঘুমাচ্ছিল,	
karadando,	কারাদান্ড,	কারাদণ্ড,	
amontronkarider,	আমন্ত্রনকারীদের,	আমন্ত্রণকারীদের,	
hilser,	হিলসার,	হিলসের,	
safin,	সাফিন,	সাফিন,	
okkhorke,	অক্ষরকে,	অক্ষরকে,	
chalachchitroke,	চালাচ্তিত্রকে,	চলচ্চিত্রকে,	
chakurijibirao,	চাকুরীজীবিরাও,	চাকুরীজীবীরাও,	
jhanjra,	ঝাঁজরা,	ঝাঁজরা,	
ajibon,	অজিবন,	আজীবন,	
udor,	উদর,	উদর,	
cheess,	চেস,	চেস,	
balokarak,	বালোকরক,	বলকারক,	
siramikasa,	সিরামিকাসা,	সিরামিকস,	
dibi,	দিবি,	দিবি,	
edmeeral,	এডমিরাল,	এডমিরাল,	
dhaleshwari,	ধলেশ্বরী,	ধলেশ্বরী,	
rajtantrey,	রাজতন্ত্রী,	রাজতন্ত্রে,	
qrisenta,	ক্রিসন্তা,	ক্রিসেন্ট,	
ragei,	রাগেই,	রাগেই,	
enamela,	এনামেলা,	এনামেল,	
ogovir,	অগোভির,	অগভীর,	
taunasipa,	তৌনসীপা,	টাউনশিপ,	
onupater,	অনুপাতের,	অনুপাতের,	
kinsa,	কিনসা,	কিংস,	
ronodeep,	রণদীপ,	রণদীপ,	
songkolonti,	সংকলণটি,	সংকলনটি,	
fansi,	ফানসি,	ফাঁসী,	
marry,	মারি,	ম্যারি,	
difinishion,	ডিফিনিশন,	ডেফিনেশন,	
suparharo,	সুপারহারো,	সুপারহিরো,	
oikhan,	ঐখান,	ঐখান,	
orbit,	অরবিত,	অরবিট,	
saom,	সাওশ,	সাওম,	
vince,	ভিন্স,	ভিন্স,	
ap,	এপিপি,	আপ,	
sportstar,	স্পোর্টস্টার,	স্পোর্টসস্টার,	
whole,	ভললে,	হোল,	
bhogno,	ভগ্ন,	ভগ্ন,	
eigulor,	এইগুলোর,	এইগুলোর,	
shainyader,	শৈন্যদের,	সৈন্যদের,	
armshtrong,	আর্মশ্ররং,	আর্মস্ট্রং,	
bisnoo,	বিস্নু,	বিষ্ণু,	
bhotomulyoke,	ভোটমূল্যকে,	ভোটমূল্যকে,	
reetesh,	রিতেশ,	রিতেশ,	
seekkharthirao,	শিক্ষার্থীরাও,	শিক্ষার্থীরাও,	
gaj,	গজ,	গেজ,	
sahittekder,	সাহিত্যকদের,	সাহিত্যেকদের,	
gyandas,	জ্ঞানদাস,	জ্ঞানদাস,	
moshjidke,	মসদিজকে,	মসজিদকে,	
tanu,	তানু,	তনু,	
nariderke,	নারীদেরকে,	নারীদেরকে,	
pravura,	প্রভুরা,	প্রভুরা,	
bopoon,	বপুন,	বপন,	
mastarsa,	মাস্টারসা,	মাস্টার্স,	
bikargrasta,	বিকারগ্রস্ত,	বিকারগ্রস্ত,	
pooshteer,	পুষ্টির,	পুষ্টির,	
bhenicer,	ভেনিসের,	ভেনিসের,	
laaisheesh,	লাইশেশ,	লাইসেন্স,	
myathiou,	ম্যাথিওউ,	ম্যাথিউ,	
prottokkhovabe,	প্রত্যক্ষভাবে,	প্রত্যক্ষভাবে,	
artherer,	আর্থেরের,	আর্থারের,	
fud,	ফুদ,	ফুড,	
salsa,	সালসা,	সালসা,	
jounotar,	যৌনতার,	যৌনতার,	
grambaseer,	গ্রামবাসীর,	গ্রামবাসীর,	
roktokhoron,	রক্তখরণ,	রক্তক্ষরণের,	
argho,	আরঘঘ,	অর্ঘ্য,	
sikkharthirao,	শিক্ষার্থীরাও,	শিক্ষার্থীরাও,	
talgach,	তালগাছ,	তালগাছ,	
dhanijomite,	ধানিজমিতে,	ধানিজমিতে,	
nirbahi,	নির্বাহী,	নির্বাহি,	
dorun,	দোরুন,	দরুণ,	
tookrote,	টুক্রোতে,	টুকরোতে,	
atarkitey,	আতারকিতে,	অতর্কিতে,	
prokolpow,	প্রকল্প,	প্রকল্পও,	
keuoi,	কেউই,	কেউই,	
yura,	যুরা,	ইউরো,	
hossne,	হসনে,	হোসনে,	
idipasha,	ইডিপাশা,	ইডিপাস,	
tahorir,	তাহরীর,	তাহরীর,	
chalochchitrogulor,	চালক্চিত্রগুলোর,	চলচ্চিত্রগুলোর,	
sumita,	সুমিতা,	সুমিতা,	
bhangle,	ভাঙ্গল,	ভাঙলে,	
kalki,	কালকি,	কালকি,	
parjotaker,	পার্যটাকের,	পর্যটকের,	
dharmadasbabu,	ধর্মদাসবাবু,	ধর্মদাসবাবু,	
haitasha,	হৈতাশা,	হাইটস,	
themeke,	থেমেকে,	থিমকে,	
gasthii,	গা্থথই,	গোষ্ঠীই,	
aatmobishwasi,	আত্মবিশ্বাসী,	আত্মবিশ্বাসী,	
kormopontha,	কর্মপন্থা,	কর্মপন্থা,	
gostigulo,	গোষ্টিগুলো,	গোষ্ঠীগুলো,	
milekhaanek,	মিলেখানাক,	মাইলখানেক,	
behrampurer,	বেহরামপুরের,	বহরমপুরের,	
remacry,	রিমেক্রি,	রেমাক্রী,	
porjotoker,	পর্যটকের,	পর্যটকের,	
drissoteer,	দৃষসিতের,	দৃশ্যটির,	
nachiketa,	নাচিকেতা,	নচিকেতা,	
dooburira,	দুবুরিরা,	ডুবুরিরা,	
fiksing,	ফিকসিং,	ফিক্সিং,	
lendal,	লেন্ডাল,	লেন্ডল,	
bornolikhon,	বর্ণলিখন,	বর্ণলিখন,	
bhenom,	ভেনম,	ভেনম,	
aviyojan,	অভিযোজন,	অভিযোজন,	
heteler,	হেটেলের,	হেটেলের,	
shardotsobei,	শার্দতসবেই,	শারদোৎসবেই,	
sangbadmadhyome,	সংবাদমাধ্যমে,	সংবাদমাধ্যমে,	
fasir,	ফাসির,	ফাসীর,	
janoganonar,	জনগোনার,	জনগণনার,	
dhyanastha,	ধ্যানস্থ,	ধ্যানস্থ,	
ramantika,	রামন্তিকা,	রোমান্টিক,	
sangbadmadhyamgulote,	সংবাদমাধ্যমগুলোতে,	সংবাদমাধ্যমগুলোতে,	
sainyader,	সৈন্যদের,	সৈন্যদের,	
madraser,	মাদ্রাসের,	মাদ্রাজের,	
duio,	দুও,	দুইও,	
mooney,	মুনে,	মুনে,	
direectoratee,	ডিরিকোটর্টো,	ডিরেক্টরেট,	
biswashi,	বিশ্বাসী,	বিশ্বাসী,	
abheedhaneek,	অভিধানীক,	অভিধানিক,	
ekbakke,	একবাককে,	একবাক্যে,	
byaboharkarie,	ব্যবহারকারী,	ব্যবহারকারীই,	
average,	এভারেজ,	এভারেজ,	
bhuushito,	ভূষিত,	ভূষিত,	
monroe,	মনরো,	মনেরোর,	
teenej,	তিনজেজ,	টিনেজ,	
golimodhye,	গলিমধ্যে,	গলিমধ্যে,	
bondi,	বন্দী,	বন্দী,	
kheylechen,	খেয়েছেন,	খেলেছেন,	
lyaanding,	লিডনিং,	ল্যান্ডিং,	
quary,	কোয়ারী,	কোয়েরি,	
kamti,	কামটি,	কমতি,	
kyatagorir,	ক্যাটাগরির,	ক্যাটাগরির,	
hydrological,	হাইড্রোলিকাল,	হাইড্রোলজিক্যাল,	
aamor,	আমোর,	আমর,	
nirikhe,	নিরিখে,	নিরিখ,	
aakaabaar,	আকাবার,	আকাবার,	
ganokantha,	গণকান্ঠ,	গণকণ্ঠ,	
saifai,	সাইফাই,	সাইফাই,	
phutbolarder,	ফুটবলরদের,	ফুটবলারদের,	
croak,	ক্রোয়াক,	ক্রোক,	
bharotchilo,	ভারতচিল,	ভারতছিল,	
kachhakaachhi,	কাছাছাছি,	কাছাকাছি,	
nartana,	নার্ান,	নর্টন,	
dephinishion,	ডেফিনিশন,	ডেফিনেশন,	
cathalic,	ক্যাথালিক,	ক্যাথলিক,	
monjooshree,	মন্যুশ্রী,	মঞ্জুশ্রী,	
vogno,	ভোগনো,	ভগ্ন,	
rokibul,	রকিবুল,	রকিবুল,	
irana,	ইরানা,	ইরান,	
aaireshe,	আইরেশে,	আইরেসে,	
jipiusamriddha,	জিপিউসামৃদ্ধ,	জিপিউসমৃদ্ধ,	
hozot,	হোজোট,	হজত,	
aasirbaad,	আসিরবাাদ,	আশির্বাদ,	
ongkush,	অংকুশ,	অংকুশ,	
onchalgulir,	অন্চালগুলির,	অঞ্চলগুলির,	
bade,	বাদে,	বাদে,	
shfingtar,	শ্ফিংটার,	স্ফিংটার,	
varma,	ভারমা,	ভার্মা,	
byabosthar,	ব্যবস্থার,	ব্যবস্থার,	
jeher,	জেহের,	জেহের,	
prosadhoner,	প্রসাধনের,	প্রসাধনের,	
kushumba,	কুশুম্বা,	কুশুম্বা,	
gobeshonar,	গবেষণার,	গবেষনার,	
ceramicer,	সেরামিকেসের,	সিরামিকের,	
gondhe,	গন্ধে,	গন্ধে,	
narsinghomgulor,	নার্সিংহমগুলোর,	নার্সিংহোমগুলোর,	
kleentoner,	ক্লিন্টনের,	ক্লিনটনের,	
rajtantro,	রাজতন্ত্র,	রাজতন্ত্র,	
poscime,	পস্চিম,	পশ্চিমে,	
beam,	বিএম,	বিম,	
mugdal,	মুগদল,	মুগডাল,	
dwipke,	দ্বীপকে,	দ্বীপকে,	
shikkharthirao,	শিক্ষার্থীরাও,	শিক্ষার্থীরাও,	
kottar,	কোত্তার,	কট্টর,	
deefinition,	ডিফিনেশন,	ডেফিনেশন,	
jotinkey,	জোিনকে,	যতীনকে,	
mukhamandoler,	মুখমন্ডলের,	মুখমণ্ডলের,	
arifin,	আরিফিন,	আরিফিন,	
favorite,	ফাভোরিতে,	ফেভারিট,	
dalip,	ডালিপ,	দালিপ,	
bahjya,	বাহজ্যা,	বাহ্য,	
ministara,	মিনিস্তার,	মিনিস্টার,	
temonbhabe,	তেমনভাবে,	তেমনভাবে,	
sompadon,	সম্পাদন,	সম্পাদন,	
mukhomandaley,	মুখমন্ডলে,	মুখমণ্ডলে,	
tahalo,	তাহালো,	তাহলো,	
paramartha,	পরমর্থ,	পরমার্থ,	
jandrel,	জান্দ্রেল,	জাঁদরেল,	
chhayi,	ছাই,	ছাই,	
mohammadi,	মোহমম্দি,	মুহাম্মদী,	
nilkuthir,	নীলকুঠির,	নীলকুঠির,	
masjidtir,	মসসিদটির,	মসজিদটির,	
mukharji,	মুখর্জী,	মুখার্জী,	
prosadhaner,	প্রসাধনের,	প্রসাধনের,	
shattoki,	শত্্কী,	সাত্যকি,	
swadesh,	স্বদেশ,	স্বদেশ,	
aarke,	আরকে,	আরকে,	
aagera,	আগেরা,	আগোরা,	
sontoshpur,	সন্তশ্পুর,	সন্তোষপুর,	
as,	আস,	অস,	
vushi,	ভুশি,	ভুষি,	
brookoleen,	ব্রুকলিন,	ব্রুকলিন,	
somoodrotote,	সমুদ্রততে,	সমুদ্রতটে,	
khuliechilam,	খুলিয়েছিলাম,	খুলিয়েছিলাম,	
uthe,	উঠে,	উঠে,	
kolkarkhana,	কোলকারখানা,	কলকারখানা,	
harbur,	হারবুর,	হারবার,	
sahojatprobritti,	সহজাত্রবৃত্তি,	সহজাতপ্রবৃত্তি,	
neemitte,	নিমিত্যে,	নিমিত্তে,	
pinglateo,	পিংলাতেও,	পিংলাতেও,	
joumana,	যৌমানা,	জুমানা,	
anyarup,	অন্যরূপ,	অন্যরূপ,	
koomarir,	কুমারীর,	কুমারীর,	
dienes,	ডায়েনেস,	ডিএনএস,	
meshmeshya,	মেশমেশ্য,	মেশহমেশহিইয়া,	
lidars,	লিডার্স,	লিডার্স,	
ovinetar,	অভিনেতার,	অভিনেতার,	
laishensh,	লাইেেশশ,	লাইসেন্স,	
bosoben,	বসবেন,	বসবেন,	
seo,	সিও,	সেও,	
korush,	কোরুশ,	ক্রুশ,	
prijon,	প্রিজন,	প্রিজন,	
ahalya,	আহল্যা,	অহল্যা,	
kabutorer,	কাবুটরের,	কবুতরের,	
dhadhiye,	ধাধিয়ে,	ধাধিয়ে,	
prakalpagulor,	প্রকলালগুলোর,	প্রকল্পগুলোর,	
metrikoleshana,	মেট্রিকোেেন,	মেট্রিকোলেশন,	
chalochchitreei,	চালক্ছিত্রী,	চলচ্চিত্রেই,	
bejiye,	বেজিয়ে,	বেজিয়ে,	
brittakarey,	বৃত্তকরে,	বৃত্তাকারে,	
teennis,	টেনিস,	টেনিস,	
pratiyogitar,	প্রাতিযোগিতার,	প্রতিযোগীতার,	
kichutei,	কিছুতেই,	কিছুতেই,	
aairees,	এইরিস,	আইরিস,	
icelands,	আইসেল্যান্ডস,	আইসল্যান্ডসহ,	
tecnokret,	টেকনোক্রেট,	টেকনোক্র্যাট,	
seniar,	সেনিয়ার,	সিনিয়র,	
bandi,	বন্দী,	বন্দী,	
abti,	আবটি,	আবতি,	
sikha,	সিখা,	শিখ,	
pratisthanikvabe,	প্রতিত্ঠানকভাবে,	প্রাতিষ্ঠানিকভাবে,	
ipl,	আইপিএল,	আইপিএল,	
bandra,	বনন্দ্রা,	বন্দীরা,	
dokan,	ডোকান,	দোকান,	
ashor,	আশর,	আসর,	
jibnagore,	জীবনাগরে,	জীবননগর,	
jitpur,	জিতপুর,	জিতপুরের,	
shorifer,	শোরিফার,	শরিফের,	
societykey,	সোকাইটকে,	সোসাইটিকে,	
abhidhaaneeck,	অভিধানিক,	অভিধানিক,	
prachirer,	প্রাচীরের,	প্রাচিরের,	
skolastik,	স্কোলস্তিক,	স্কলাস্টিক,	
jotsna,	জোসসনা,	জ্যোৎস্না,	
literacy,	লিটারেরাসি,	লিটারেসি,	
dantahin,	দন্তাহীন,	দন্তহীন,	
kada,	কাদা,	কোডা,	
karmazog,	কর্মযোগ,	কর্মযোগ,	
mandape,	মান্দাপে,	মন্ডপে,	
station,	স্টেযাশন,	ষ্টেশন,	
waal,	ওয়াল,	উল,	
alaol,	আলাওল,	আলাওল,	
associatis,	অ্যাসোসিয়েটিস,	এসোসিয়েটস,	
loombinee,	লুম্বিনি,	লুম্বিনী,	
khoka,	খোকা,	খোকা,	
bostubad,	বস্তুবাদ,	বস্তুবাদ,	
spredashiita,	স্প্রেডাডিশটা,	স্প্রেডশীট,	
eokee,	ইকু,	এওকি,	
shashtra,	শাস্ত্র,	শাস্ত্র,	
seshardhe,	শেষার্ধে,	শেষার্ধে,	
nakkal,	নক্কাল,	নক্কল,	
diznee,	ডিজনি,	ডিজনী,	
saras,	সারাস,	সরস,	
srisri,	শ্রীশরি,	শ্রীশ্রী,	
manabmaner,	মানবমনের,	মানবমনের,	
miraqela,	মিরাকেল,	মিরাকেল,	
otyacharer,	অত্যাচারের,	অত্যাচারের,	
ghoorchen,	ঘুরছেন,	ঘুরেছেন,	
ucchosito,	উচ্চসিত,	উচ্ছসিত,	
bhiktara,	ভিকটারা,	ভিক্টর,	
doorger,	ডুরগের,	দুর্গের,	
koyeeri,	কয়েরি,	কোয়েরি,	
barbadoj,	বারবাদোজ,	বার্বাডোজ,	
vaabnake,	ভাবনাকে,	ভাবনাকে,	
rabo,	রাবো,	রব,	
adhyatmikata,	অধ্যাতিমতা,	আধ্যাত্মিকতা,	
chandil,	চানদিল,	চান্ডিল,	
hijri,	হিজরি,	হিজরী,	
taigara,	তাইগারা,	টাইগার,	
turky,	টার্কি,	তুর্কি,	
chalochchitreer,	চালক্ছিত্রীর,	চলচ্চিত্রের,	
koreempoor,	করিমপুর,	করিমপুর,	
akheli,	আখেলি,	আখেলী,	
kortam,	করতাম,	করতাম,	
bidghootey,	বিদঘুতে,	বিদঘুটে,	
sohinsotar,	সহিনসাতর,	সহিংসতার,	
volivoler,	ভলিভোলের,	ভলিভলের,	
shunani,	শুনানি,	শুনানী,	
elakaatite,	এলাকাটিতে,	এলাকাটিকে,	
black,	ব্ল্যাক,	ব্ল্যাক,	
saazano,	সাজানো,	সাজানো,	
pranidero,	প্রাণীদেরও,	প্রানীদেরও,	
simons,	সিমন্স,	সিমন্স,	
pettern,	পেটার্ন,	প্যাটার্ন,	
chandrimaa,	চন্দ্রিমা,	চন্দ্রিমা,	
holding,	হলডিং,	হোল্ডিং,	
proteemar,	প্রতিমার,	প্রতিমার,	
abodamaner,	অবদামানের,	অবদমনের,	
concerter,	কনসার্টার,	কানসাটের,	
madhoori,	মধুরি,	মাধুরী,	
purbanchaler,	পূর্বাঞ্চলের,	পূর্বাঞ্চলের,	
obdi,	অব্দি,	অব্দি,	
welaqama,	ওয়লেকা,	ওয়েলকাম,	
asaktibandhan,	অসক্তাবিন্ধন,	আসক্তিবন্ধন,	
edaningkale,	এদানীংকালে,	ইদানীংকালে,	
codeti,	কোদেটি,	কোডটি,	
khudhartara,	ক্ষুধর্তরা,	ক্ষুধার্তরা,	
footbalarra,	ফুটবললরা,	ফুটবলাররা,	
bamni,	বামনি,	বামনী,	
faase,	ফাযাস,	ফাঁসে,	
bishshaasho,	বিশ্শাস,	বিশ্বাসও,	
navaratri,	নবরাত্রী,	নবরাত্রি,	
chalachchitroi,	চলচ্চিত্রই,	চলচ্চিত্রই,	
dhangsachchi,	ধ্বংসচ্চি,	ধ্বংসাচ্ছি,	
zerusalem,	জেরুসালেম,	জেরুসালেম,	
bosben,	বসবেন,	বসবেন,	
baarbadoj,	বারবাদজ,	বার্বাডোজ,	
taalaal,	তালাল,	তালাল,	
shikare,	শিকারে,	শিকারে,	
sampadon,	সম্পাদন,	সম্পাদন,	
akten,	আকতেন,	অকটেন,	
bhandar,	ভাণ্দার,	ভাণ্ডার,	
everage,	এভারেজ,	এভারেজ,	
chamski,	চামস্কি,	চমস্কি,	
unchiyechilo,	উঁচিয়েছিল,	উঁচিয়েছিল,	
pretty,	প্রেটি,	প্রিটি,	
bondhukey,	বন্ধুকে,	বন্ধুকে,	
atwobishvashi,	অত্ববিশাষী,	আত্মবিশ্বাসী,	
spashtotai,	স্পা্ততাই,	স্পষ্টতই,	
shikhra,	শিখরা,	শিখরা,	
pleto,	প্লেটো,	প্লেটো,	
antarbhutto,	অন্তর্ভূত্ব,	অন্তর্ভুক্ত,	
aakkaash,	আক্কাশ,	আককাস,	
mmadhukkori,	মমমধুকরি,	মাধুকরী,	
unitgulo,	ইউনিটগুলো,	ইউনিটগুলো,	
nodimaatrik,	নদীমাত্রিক,	নদীমাতৃক,	
kathghera,	কাঠঘেরা,	কাঠঘেরা,	
amanisha,	আমানিশা,	অমানিশা,	
taufik,	তাফিক,	তৌফিক,	
chakundite,	চাকুন্ডিতে,	চাকুন্দিতে,	
nirapattamulok,	নিরাপত্তমূলক,	নিরাপত্তামূলক,	
ikbaaler,	ইকবালের,	ইকবালের,	
abhidhaanick,	অভিধানিক্,	অভিধানিক,	
protijogiitamulok,	প্রতিযোগিতামূলক,	প্রতিযোগীতামূলক,	
hights,	হাইটস,	হাইটস,	
byathapather,	ব্যথাপথের,	ব্যথাপথের,	
shatan,	শতন,	শয়তান,	
punorabortonte,	পুনরাবরর্তে,	পুনরাবর্তন্তে,	
bohudeen,	বহুদীন,	বহুদিন,	
site,	সিইট,	সিটে,	
aamoode,	আমোড,	আমুদে,	
deebug,	দেবুগ,	ডিবাগ,	
babona,	বাবনা,	বাবনা,	
olympik,	অলিম্পিক,	অলিম্পিক,	
chalai,	চালাই,	চালাবে,	
debate,	দেবাতে,	ডিবেট,	
buth,	বুথ,	বুথ,	
show,	শৌ,	শো,	
agomoney,	আগমনে,	আগমনে,	
sheekar,	শীকার,	শিকার,	
ikboler,	ইকবোলের,	ইকবলের,	
helly,	হেলি,	হিলি,	
sokkhomotabriddhi,	সক্ষমাত্ববৃদ্ধি,	সক্ষমতাবৃদ্ধি,	
gandogol,	গণ্ডগোল,	গন্ডগোল,	
gobeshokgon,	গবেষকগণ,	গবেষকগণ,	
sarboshokteeman,	সর্বশক্তিমান,	সর্বশক্তিমান,	
jaatti,	যাটটি,	জাতটি,	
uthaney,	উঠানে,	উঠানে,	
chirantan,	চিরন্তন,	চিরন্তন,	
temonvabe,	তেমনভাবে,	তেমনভাবে,	
sombhobonaao,	সম্ভবনাও,	সম্ভবনাও,	
ruptan,	রূপতান,	রূপটান,	
shakara,	শাকারা,	সাকার,	
sonaicha,	সোনাইছা,	সোনাইচা,	
capsule,	ক্যাপসুলে,	ক্যাপ্সুল,	
saarbharti,	সার্ভরটি,	সার্ভারটি,	
toler,	টোলের,	তালের,	
asabhya,	অসভ্য,	অসভ্য,	
mohit,	মহহিত,	মুহিত,	
turbiner,	তুরবিনের,	টারবাইনের,	
brittakar,	বৃত্তকার,	বৃত্তাকার,	
koordider,	কূর্দিদের,	কুর্দিদের,	
vittimul,	ভিত্তিমূল,	ভিত্তিমূল,	
mag,	মাযাগ,	এমএজি,	
battery,	ব্যাটারি,	ব্যাটারী,	
eporzonto,	ইপর্জন্ত,	এপর্যন্ত,	
hondooras,	হন্দুরাস,	হন্ডুরাস,	
thabai,	থাবাই,	থাবাই,	
hafej,	হাফেজ,	হাফেয,	
shem,	শেম,	সেম,	
shringey,	শ্রিংগে,	শৃঙ্গে,	
istoone,	ইস্টুন,	স্টোন,	
maudelder,	মাডেলদের,	মডেলদের,	
setikey,	সেতিকে,	সেটিকে,	
dharabahikbhabe,	ধারাবাহিকভাবে,	ধারাবাহিকভাবে,	
corsin,	করসিন,	করসিন,	
elakatikay,	এলাকাতিকায়,	এলাকাটিকে,	
hattey,	হাত্যে,	হাঁটতে,	
gabhaskaar,	গাভসককার,	গাভাস্কার,	
patrol,	পাট্রল,	পেট্রোল,	
dhaanche,	ধাঁচে,	ধাঁচে,	
landin,	ল্যান্ডিন,	ল্যান্ডিং,	
elakaate,	এলাকাতে,	এলাকাতে,	
kuronir,	কুরনীর,	কুরনীর,	
poriskoron,	পরিস্করণ,	পরিষ্করণ,	
ingrejra,	ইংরেজরা,	ইংরেজরা,	
mekong,	মেকং,	মেকং,	
heawy,	হেভ,	হেভি,	
nagorikota,	নাগরিকোটা,	নাগরিকতা,	
shrichaitanyadev,	শ্রীচৈতন্যদদেব,	শ্রীচৈতন্যদেব,	
laat,	লাট,	লাট,	
samajikatar,	সমজাকিকতার,	সামাজিকতার,	
proshadhoner,	প্রশাধনের,	প্রসাধনের,	
seguloi,	সেগুলোই,	সেগুলোই,	
pleena,	প্লীন,	প্লেন,	
samaptir,	সমপপ্তির,	সমাপ্তির,	
faltu,	ফাল্টু,	ফালতু,	
grambaasheeo,	গ্রামবাশীও,	গ্রামবাসীও,	
drishyer,	দৃশ্যের,	দৃশ্যের,	
summer,	সামমার,	সামার,	
pinogbagke,	পিনোগবাগকে,	পিনগবাগকে,	
tokee,	টকক,	তকি,	
gaje,	গাজে,	গেজ,	
dharabahikvabe,	ধারাবাহিকভাবে,	ধারাবাহিকভাবে,	
horidbar,	হরিদবার,	হরিদ্বার,	
gujob,	গুজব,	গুজব,	
samratra,	সম্রাত্র,	সম্রাটরা,	
sayatana,	সায়তন,	শয়তান,	
samanyai,	সামান্যাই,	সামান্যই,	
onkush,	অঙ্কুশ,	অংকুশ,	
sachetonvabe,	সাচেতনভাবে,	সচেতনভাবে,	
motke,	মতকে,	মতকে,	
path,	পাথ,	পাথ,	
kani,	কাই,	কানি,	
jounatar,	যৌনাতার,	যৌনতার,	
cantan,	কান্টান,	ক্যান্টন,	
ritesh,	রিতেশ,	রিতেশ,	
shishu,	শিশু,	শিশু,	
dijijer,	দিজিজের,	ডিজিজের,	
cena,	সেএন,	সিনা,	
distance,	ডিসট্যান্স,	ডিসট্যান্স,	
spredashita,	স্প্রেডাডিশটা,	স্প্রেডশীট,	
urey,	ইরে,	ইউরি,	
proo,	প্রু,	প্রো,	
soomita,	সুমিতা,	সুমিতা,	
pachak,	পাচক,	পাচক,	
milton,	মিল্টন,	মিলটন,	
nili,	নীলী,	নিলি,	
danata,	দানাটা,	ডোনাট,	
bhorkendra,	ভোরকেন্দ্র,	ভরকেন্দ্র,	
oboshore,	অবশরে,	অবসরে,	
phiksim,	ফিকসিম,	ফিক্সিং,	
meshintao,	মেশিনটাও,	মেশিনটাও,	
ishtone,	ইশ্টন,	স্টোন,	
hansasya,	হংসস্য,	হংসস্য,	
baarnis,	বার্নিস,	বার্নিশ,	
deh,	দেহ,	দেহ্,	
sharansthal,	শারনস্থল,	শরণস্থল,	
somraatra,	সম্রাত্রা,	সম্রাটরা,	
zonsa,	জনসা,	জোন্স,	
bairer,	বৈরের,	বাইরের,	
otyacharito,	অত্যাচারিত,	অত্যাচারিত,	
shumo,	শুমো,	সুমো,	
joubankal,	যৌবনকাল,	যৌবনকাল,	
oitijhyotike,	ঐতিহ্যটিকে,	ঐতিহ্যটিকে,	
odeb,	ওদেব,	ওদেব,	
abikaul,	আবিকাউল,	অবিকল,	
machkabar,	মাচকাবার,	মাচকাবার,	
akhando,	আখণ্ড,	অখন্ড,	
udbhabaney,	উদ্ভানে,	উদ্ভাবনে,	
kodorer,	কদরের,	কদরের,	
rahimed,	রহিমদ,	রহিমেদ,	
habol,	হাবল,	হাবোল,	
hillse,	হিলসে,	হিলসে,	
antennal,	অ্যান্টেননাল,	অ্যান্টেনাল,	
chaka,	চাক,	চাকা,	
pathanatak,	পাঠনাটক,	পথনাটক,	
sushposhtolikhito,	সুস্পত্ষিগোিত,	সুষ্পষ্টলিখিত,	
ganoporibahon,	গণপরীবাহণ,	গণপরিবহন,	
lutharen,	লুথারেন,	লুথেরান,	
everestey,	ইভার্স্ট,	এভারেস্টে,	
geejeeteeda,	গিজেটিডা,	গেজেটেড,	
chanoo,	চানু,	চানু,	
torunra,	তরুনরা,	তরুণরা,	
duuma,	ডুউমা,	দুমা,	
duple,	ডাপল,	ডুপ্লে,	
sorsa,	সোরসা,	সোর্স,	
bastubad,	বস্তুবাদ,	বস্তুবাদ,	
murali,	মুরালি,	মুরলী,	
graambaasheeo,	গ্রামবাশীও,	গ্রামবাসীও,	
transform,	ট্রান্সফর্ম,	ট্রান্সফর্ম,	
iuro,	ইউরো,	ইউরো,	
kanasarabhesana,	কানারাভেশন,	কনসারভেশন,	
abdi,	আবদি,	অব্দি,	
titarer,	তিতারের,	তিতারের,	
biplabee,	বিপ্লাবে,	বিপ্লবী,	
mandarbani,	মন্দরবানী,	মন্দারবাণী,	
manatmulak,	মনতমূলক,	মানতমূলক,	
grauth,	গ্রাউথ,	গ্রোথ,	
telakucha,	তেলাকুচা,	তেলাকুচা,	
aholya,	আহল্যা,	অহল্যা,	
madhabi,	মাধাবী,	মাধবী,	
shikkhadikkhay,	শিক্ষাদিক্ষয়,	শিক্ষাদিক্ষায়,	
pachattar,	পাঁচত্র,	পাচাত্তার,	
kurdider,	কুর্দিদের,	কুর্দিদের,	
sucre,	সাকরে,	সাকার,	
qonflict,	কনফ্লিক্ট,	কনফ্লিক্ট,	
foreks,	ফরেকস,	ফরেক্স,	
panchashjon,	পঞ্চাশ্যন,	পঞ্চাশজন,	
joones,	জুনস,	জোন্স,	
dhhaloor,	ঢালুর,	ঢালুর,	
dhos,	ধুশ,	ধস,	
vault,	ভাউট,	ভল্ট,	
cheerontan,	চেরন্তন,	চিরন্তন,	
ajeem,	আজিম,	আজিম,	
pichte,	পিছতে,	পিছতে,	
bhromonkaale,	ভ্রমণকালে,	ভ্রমণকালে,	
mukhomondoler,	মুখমণ্ডলের,	মুখমণ্ডলের,	
shrimoti,	শ্রীতই,	শ্রীমতি,	
enginiiring,	ইঞ্জিনিরিং,	ইঞ্জিনিয়ারিং,	
aqram,	আকরাম,	আকরাম,	
hypar,	হাইপার,	হাইপার,	
vagini,	ভাগিনি,	ভগিনী,	
mailkhanek,	মাইলখানেক,	মাইলখানেক,	
bonshi,	বনশশী,	বংশী,	
nirvachokder,	নির্ভাচকদের,	নির্বাচকদের,	
liaodong,	লিয়াডং,	লিয়াওদং,	
ghaghat,	ঘাঘাট,	ঘাঘট,	
miitar,	মিটার,	মিত্র,	
sangkulaan,	সংকুলান,	সংকুলান,	
nirvachaker,	নির্ভাচকের,	নির্বাচকের,	
sobaiderke,	সোবাইদেরকে,	সবাইদেরকে,	
khudrokar,	ক্ষুদ্রকার,	ক্ষুদ্রকার,	
cinemapremider,	সিনেমপ্রেমীদের,	সিনেমাপ্রেমীদের,	
antarctica,	আন্টার্টকাক,	অ্যান্টার্কটিকার,	
forex,	ফরেক্স,	ফরেক্স,	
azaan,	আজান,	আজান,	
votarer,	ভটারের,	ভোটারের,	
plate,	প্লেট,	প্লেট,	
purohitra,	পুরোহিত্র,	পুরোহিতরা,	
prokar,	প্রকার,	প্রকার,	
porbotmala,	পর্বোতমালা,	পর্বতমালা,	
provritike,	প্রভৃতিকে,	প্রভৃতিকে,	
ceramiker,	সেরামিকের,	সিরামিকের,	
golghare,	গোলঘরে,	গোলঘরে,	
lajik,	লাজিক,	লজিক,	
deraa,	দেরা,	ডেরা,	
jonmobhumitir,	জন্মভূমিতির,	জন্মভূমিটির,	
turkii,	তুরকিই,	তুর্কি,	
dajhyo,	দাজ্য,	দাহ্য,	
sarboporee,	সার্বপরী,	সর্বোপরী,	
sanghatakder,	সংহতকদের,	সংঘটকদের,	
digri,	ডিগরি,	ডিগ্রি,	
venkates,	ভেঙ্কটেস,	ভেঙ্কটেশ,	
swatantrata,	স্বাতন্ত্রটা,	স্বতন্ত্রতা,	
kinsha,	কিনশা,	কিংস,	
asthishondhi,	অস্থিসন্ধি,	অস্থিসন্ধি,	
gorrer,	গোরের,	গোরের,	
aanaan,	আনান,	আনান,	
spenser,	স্পেন্সের,	স্পেন্সার,	
doneta,	ডোনেটা,	ডোনাট,	
asbab,	আসবাব,	আসবাব,	
nischitobhave,	নিশ্চিতভাবে,	নিশ্চিতভাবে,	
siropa,	সিরোপা,	শিরোপা,	
naabbota,	নাব্বতা,	নাব্যতা,	
bisnukey,	বিস্নুকে,	বিষ্ণুকে,	
jund,	জান্দ,	জুন্দ,	
scholarship,	স্কলারশিপ,	স্কলারশিপ,	
dai,	দাই,	দিই,	
bulan,	বুলান,	বুলান,	
shhashtra,	শাস্ত্র,	শাস্ত্র,	
carlos,	কার্লোস,	কার্লোস,	
phund,	ফুন্ড,	ফান্ড,	
naajii,	নাজি,	নাত্সি,	
mardud,	মার্দুদ,	মরদুদ,	
soommo,	সামমো,	সুমো,	
aairish,	আইরিশ,	আইরিস,	
serveray,	সার্ভারে,	সার্ভারে,	
semai,	সেমাই,	সেমাই,	
chintakarma,	চিন্তকর্ম,	চিন্তাকর্ম,	
adhyattikota,	অধ্যাত্মিকতা,	আধ্যাত্মিকতা,	
sukumaree,	সুকুমারী,	সুকুমারী,	
samle,	সামলে,	সামলে,	
aholyar,	আহল্যার,	অহল্যার,	
chalaabi,	চালাবি,	চালাবে,	
tookror,	টুকর,	টুকরোর,	
yaak,	য্যাক,	ইয়াক,	
gajano,	গাজানো,	গজানো,	
reliance,	রিলিয়ান্স,	রিলায়েন্স,	
peerry,	পিরি,	পেরি,	
soketgulor,	সোকেতগুলোর,	সকেটগুলোর,	
chaudhurider,	চৌধুরিদের,	চৌধুরীদের,	
munsi,	মুনসি,	মুন্সী,	
onchalti,	অন্চলটি,	অঞ্চলটি,	
majlishpur,	মালবিশপুর,	মজলিশপুর,	
niharkantibabu,	নীহারকান্তবাবু,	নিহারকান্তিবাবু,	
juktorastrer,	যুক্তরাস্ত্রের,	যুক্তরাষ্ট্রের,	
meloonborrone,	মেলনবোরর্ন,	মেলবোর্নে,	
debeting,	ডেবেটিং,	ডিবেটিং,	
hughkey,	হুঘকে,	হিউজকে,	
thakeni,	থাকেনি,	থাকেনি,	
tuleche,	তুলেছে,	তুলেছে,	
ganjana,	গঞ্জনা,	গঞ্জনা,	
thailandshoho,	থাইল্যান্ডসহ,	থাইল্যান্ডসহ,	
sahocorje,	সহকর্যে,	সাহচর্যে,	
dai,	দাই,	ডে,	
zaire,	জায়ার,	জাইরে,	
salapheeta,	সালাফাট,	সালফেট,	
yukeliptash,	যুকেলিপ্তাস,	ইউক্যালিপ্টাস,	
mulvitti,	মুলভিত্তি,	মূলভিত্তি,	
taranee,	তরনী,	তরণী,	
jyesthaa,	জ্যেষ্ঠা,	জ্যেষ্ঠা,	
horeepur,	হরিপুর,	হরিপুর,	
chaloke,	চালোকে,	চালকে,	
chorban,	চোরবান,	চর্বন,	
dankaan,	ডানকান,	ডানকান,	
ghuznavi,	ঘুজনবি,	গজনভি,	
mulor,	মুলোর,	মুলোর,	
madhukori,	মাধুকরি,	মাধুকরী,	
beshirbhaagei,	বেশীরভাগেই,	বেশিরভাগেই,	
chasee,	চাসী,	চেস,	
tukrote,	তুকরোতে,	টুকরোতে,	
atmobonchito,	আত্মবঞ্চিত,	আত্মবঞ্চিত,	
swastir,	স্বস্তির,	স্বস্তির,	
hertj,	হার্টজ,	হার্জ,	
jibonnogor,	জীবন্যগর,	জীবননগর,	
joisttho,	জৈস্ঠ,	জ্যৈষ্ঠ,	
tirmijii,	তীর্মিজি,	তিরমিজি,	
samajik,	সমাজিক,	সামাজিক,	
grambaasi,	গ্রামবাসী,	গ্রামবাসী,	
sanstha,	সন্্থ,	সংস্থা,	
mohajot,	মহাযত,	মহাজোট,	
paripakey,	পারিপাকে,	পরিপাকে,	
vishnuu,	বিষ্ণু,	বিষ্ণু,	
nirgoon,	নিরগুণ,	নির্গুণ,	
streegon,	স্ত্রীগণ,	স্ত্রীগণ,	
abosan,	অবসান,	অবসান,	
bagdad,	বাগদাদ,	বাগদাদে,	
madaspushto,	মাদাসুষ্ট,	মদদপুষ্ট,	
israelbahini,	ইস্রালেলিহিনী,	ইস্রায়েলবাহিনী,	
dhauto,	ধাউতো,	ধৌত,	
with,	উইথ,	ভিত,	
temone,	তেমনে,	তেমনই,	
karmojog,	কর্মযোগ,	কর্মযোগ,	
kobutorer,	কবুতরের,	কবুতরের,	
dianes,	ডিয়ানস,	ডিএনএস,	
palashir,	পালাশির,	পলাশীর,	
ronangane,	রোনাঙ্গানে,	রণাঙ্গনে,	
binakar,	বিনাকার,	বিনাকার,	
dharabahiktite,	ধারাবাহিকটিতে,	ধারাবাহিকটিতে,	
jorury,	জোরুরি,	জরূরী,	
somraat,	সম্রাত,	সম্রাট,	
spredshiit,	স্প্রেডশিট,	স্প্রেডশীট,	
naabyota,	নাব্যতা,	নাব্যতা,	
prangulo,	প্রাণগুলো,	প্রানগুলো,	
kormokarer,	কর্মকারের,	কর্মকারের,	
uponeesoder,	উপনিসদের,	উপনিষদের,	
romjaner,	রোমজানের,	রমযানের,	
rajnaiteek,	রাজনৈতিক,	রাজনৈতীক,	
nichols,	নিচোলস,	নিকলস,	
choritrotakeo,	চরিত্রতাকেও,	চরিত্রটাকেও,	
boikolyo,	বৈকল্য,	বৈকল্য,	
aalaa,	আলা,	আলা,	
gaphiloti,	গাফিলোি,	গাফিলতি,	
dakter,	ডাক্তার,	ডাকতের,	
ekshoti,	একশতি,	একশোটি,	
machsoho,	মাচসহ,	মাছসহ,	
matrirup,	মাতৃরূপ,	মাতৃরূপ,	
rahee,	রহে,	রাহি,	
chupani,	চুপানি,	চুপানি,	
grambaashi,	গ্রামবাশী,	গ্রামবাসী,	
daakteekite,	দাক্তিকিতে,	ডাকটিকিটে,	
antorvukta,	অন্তর্ভুক্ত,	অন্তর্ভুক্ত,	
moorali,	মূরালী,	মুরলী,	
sosoa,	সোসোয়া,	শশা,	
banglota,	বাংলোটা,	বাংলোটা,	
kantajir,	কন্টাজীর,	কান্তজির,	
anutpadanshil,	অনুৎপানদশীল,	অনুৎপাদনশীল,	
zerusalemer,	জেরুসালেমের,	জেরুজালেমের,	
olpo,	ওল্প,	অল্প,	
bondiira,	বন্ডিরা,	বন্দীরা,	
residensa,	রেসিডেন্স,	রেসিডেন্স,	
bufer,	বুফার,	বাফার,	
balabhadra,	বালাভডা,	বলভদ্র,	
bouddher,	বৌদ্ধের,	বৌদ্ধের,	
santoshpore,	সন্ততষ্পরে,	সন্তোষপুর,	
shukrabab,	শুক্রবাব,	শুক্রবাব,	
anchalgoolir,	অঞ্চলগুলির,	অঞ্চলগুলির,	
yathaarthabhaabe,	যথারাথভাবে,	যথার্থভাবে,	
karuna,	করুনা,	করুণা,	
durtomo,	দূর্তম,	দূরতম,	
sqolastiq,	স্কোলাট্ক,	স্কলাস্টিক,	
nuhas,	নুহাস,	নুহাশ,	
hugheke,	হুঘেকে,	হিউজকে,	
shit,	শিট,	শীত,	
militaryr,	মিলিটারির,	মিলিটারির,	
manushti,	মনুষ্টি,	মানুষটি,	
hijrite,	হিজরিতে,	হিজরীতে,	
cxt,	সিসিএসটি,	সিএক্সটি,	
chiraharit,	চিরাহরিত,	চিরহরিৎ,	
minilosar,	মিনিলোসার,	মিনিলোসার,	
nathivukteer,	নথিভুক্তির,	নথিভুক্তির,	
onurbar,	অনুরবার,	অনুর্বর,	
bajhyo,	বাঝ্য,	বাহ্য,	
alonkaran,	অলোকরণ,	অলঙ্করণ,	
touraat,	টুরাত,	তওরাত,	
mosharroph,	মশারোরওফ,	মশাররফ,	
tolemyr,	টলেমির,	টলেমির,	
rajpur,	রাজপুর,	রাজপুর,	
saraiki,	সারাইকি,	সরাইকি,	
thyachar,	থায়চর,	থ্যাচার,	
karima,	কারিমা,	করিম,	
chheher,	ছেহের,	ছেহের,	
saalsa,	সালসা,	সালসা,	
protishtan,	প্রতিষ্টান,	প্রতিষ্টান,	
bishaashke,	বিশাশকে,	বিশ্বাসকে,	
distibutor,	ডিস্টিবুটর,	ডিস্টিবিউটারের,	
kyathlik,	ক্যাথলিক,	ক্যাথলিক,	
ispredsheet,	ইস্প্রেডশিত,	স্প্রেডশীট,	
jubokti,	যুবকটি,	যুবকটি,	
peshto,	পেশতো,	পেষ্ট,	
dushtogone,	দুষ্টগণে,	দুষ্টগণে,	
krishibigyani,	কৃষিবিজ্ঞানী,	কৃষিবিজ্ঞানী,	
jeebanjapon,	জীবনজনপণ,	জীবনযাপন,	
dijmarescu,	ডিজমেরসস্ু,	দিজমার্সাকু,	
cocaine,	কোকাইন,	কোকেইন,	
dormetori,	দর্মেতরি,	ডরমিটরি,	
chet,	চেট,	চ্যাট,	
eporjonto,	এপরজন্ত,	এপর্যন্ত,	
sima,	সিমা,	সীমা,	
remakri,	রেমকররী,	রেমাক্রী,	
badargaji,	বদররগাজি,	বদরগাজী,	
shringa,	শ্রিঙ্গা,	শৃঙ্গ,	
asantosh,	আসন্তোষ,	অসন্তোষ,	
parq,	পার্ক,	পার্ক,	
natshi,	নাটশি,	নাত্সি,	
gamdan,	গামদান,	গামদান,	
baaik,	বাইক,	বাইক,	
hoonayin,	হুনায়িন,	হুনাইন,	
kode,	কোড,	কোড,	
monohputo,	মনোহপুত,	মনঃপুত,	
jatinkey,	জাতিনকে,	যতীনকে,	
indrani,	ইন্দ্রানী,	ইন্দ্রাণী,	
sarjur,	সারজুর,	সরযূর,	
phaltu,	ফাল্তু,	ফালতু,	
nutunotto,	নুতুনত্ব,	নতুনত্ব,	
rilayensha,	রিলায়েন্স,	রিলায়েন্স,	
platform,	প্ল্যাফ্রম,	প্লাটফর্ম,	
kaalki,	কালকি,	কালকি,	
nabyata,	নব্যতা,	নাব্যতা,	
bohudin,	বহুদিন,	বহুদিন,	
asovarno,	অসবর্ণ,	অসবর্ণ,	
indra,	ইন্দ্রা,	ইন্দ্র,	
plate,	প্লেট,	প্লেটে,	
sthapanatir,	স্থাপনাটির,	স্থাপনাটির,	
senabahinikey,	সেনাবাহিনীকে,	সেনাবাহিনীকে,	
madrasi,	মাদ্রাসি,	মাদ্রাজি,	
injiniyarim,	ইন্জিনিয়ারিম,	ইঞ্জিনিয়ারিং,	
neker,	নেকের,	নেকের,	
jakatke,	জাকাতকে,	যাকাতকে,	
mathieu,	মাঠিওই,	ম্যাথিউ,	
riphleksa,	রিফলকেস,	রিফ্লেক্স,	
taposgoner,	তাপসগণের,	তাপসগণের,	
boudhher,	বৌধের,	বৌদ্ধের,	
nirmalata,	নির্মলতা,	নির্মলতা,	
manir,	মানির,	মনির,	
pacbar,	পাঁচর,	পাঁচবার,	
anusthane,	অনুষ্ঠানে,	অনুষ্ঠানে,	
saseza,	সাসেজা,	সসেজ,	
dombhoke,	দম্ভকে,	দম্ভকে,	
hool,	হুল,	হুল,	
mitrer,	মিত্রের,	মিত্রের,	
panchashjan,	পঞ্চাশজন,	পঞ্চাশজন,	
rokkhonabekkhoner,	রক্ষণাবিক্ষণের,	রক্ষণাবেক্ষণের,	
jones,	জননস,	জোন্স,	
yanqee,	যাঙ্কী,	ইয়াংকি,	
deqe,	ডেকে,	ডেকে,	
akeeb,	আকিব,	আকিব,	
poriharsoho,	পরিহারসহ,	পরিহারসহ,	
kiibord,	কাইবোর্ড,	কীবোর্ড,	
veenis,	ভেইনিস,	ভেনিস,	
suri,	সুরী,	সুরি,	
murad,	মুরাদ,	মুরাদ,	
obosore,	অবসরে,	অবসরে,	
salphat,	সালফাত,	সালফেট,	
arthanitike,	অর্থনীতিকে,	অর্থনীতিকে,	
ruble,	রাবল,	রুবল,	
meghacchonno,	মেঘচচন্ন,	মেঘাচ্ছন্ন,	
palteche,	পালটেছে,	পাল্টেছে,	
militarir,	মিলিটারির,	মিলিটারির,	
tunaita,	টুনাইটা,	টুনাইট,	
uparjon,	উপারজন,	উপার্জন,	
mandope,	ম্যান্ডপে,	মন্ডপে,	
barder,	বার্দার,	বার্ডের,	
mulbhitti,	মূলভিত্তি,	মূলভিত্তি,	
ghoor,	ঘুর,	ঘুর,	
pratiyogita,	প্রয়িিগত,	প্রতিযোগীতা,	
snehban,	স্নেহবান,	স্নেহবান,	
tinhazar,	তিনহজার,	তিনহাজার,	
unchuporjayer,	উঁচুর্যপয়ারের,	উঁচুপর্যায়ের,	
ahmed,	আহমেদ,	আহামদ,	
dikpal,	ডিকপাল,	দিকপাল,	
shandra,	শন্দ্রা,	শান্দ্রার,	
kareer,	কারীর,	কারীর,	
breq,	ব্রেক,	ব্রেক,	
salchak,	সালচাক,	সালচাক,	
capsul,	ক্যাপসুল,	ক্যাপসুল,	
pratishthanik,	প্রতিষ্ঠানিক,	প্রাতিষ্ঠানিক,	
chopal,	চোপাল,	চপল,	
bhageri,	ভাগেরি,	ভাগেরই,	
khiladirao,	খিলাদিরাও,	খিলাড়িরাও,	
lesense,	লেসেন্সে,	লাইসেন্স,	
monzooshree,	মন্জশ্রী,	মঞ্জুশ্রী,	
poderthobid,	পদার্থবিদ,	পদার্থবিদ,	
bornanukrome,	বর্ণানুকর্মে,	বর্নানুক্রমে,	
graambasheeo,	গ্রামবাশীও,	গ্রামবাসীও,	
modhyekar,	মধ্যেকার,	মধ্যেকার,	
aakkas,	আক্কাস,	আককাস,	
pustir,	পুস্তির,	পুষ্টির,	
parqim,	পারকিম,	পার্কিং,	
aarik,	আরিক,	আরিক,	
rudiger,	রুদিগের,	রুদিগের,	
byepass,	ব্যাপেস,	বাইপাস,	
lendl,	লেন্ডল,	লেন্ডল,	
tikta,	টিকটা,	তিক্ত,	
elakayi,	এলাকায়ী,	এলাকাই,	
booksar,	বুকসার,	বুক্সার,	
aditisaha,	আদিতিসহ,	অদিতিসহ,	
magar,	মাগার,	মাগার,	
poroborti,	পরবর্তী,	পরর্বতী,	
angibhutovabe,	অঙ্গীভুতভাবে,	অঙ্গীভূতভাবে,	
farna,	ফারনা,	ফার্ন,	
raagee,	রাগি,	রাগী,	
jesh,	জেশ,	জেস,	
karaponner,	কারাপন্যের,	কারাপণ্যের,	
farhetin,	ফারহেটিন,	ফারহেতিন,	
toching,	টচিং,	টোচিং,	
daraider,	দারাইদের,	দরাইদের,	
chalochchitraeer,	চলচ্চিত্রীর,	চলচ্চিত্রের,	
shuri,	শুরী,	সুরি,	
sulfatee,	সালফাতি,	সালফেট,	
nagorikke,	নাগরিককে,	নাগরিককে,	
bhabanipur,	ভবানীপুর,	ভবানীপুর,	
chapchap,	চাপচাপ,	চাপচাপ,	
supplenza,	সাপলেনজা,	সাপলেঞ্জা,	
seoul,	সিউল,	সোল,	
sahinsatar,	সহীনসাতার,	সহিংসতার,	
ohalyar,	ওহাল্যার,	অহল্যার,	
russad,	রুসাদ,	রুশদ,	
inziniyarsa,	ইনজিনিয়ারসা,	ইঞ্জিনিয়ার্স,	
dewaben,	দেওয়াবেন,	দেওয়াবেন,	
mirakela,	মিরাকেলা,	মিরাকেল,	
stona,	স্তোনা,	স্টোন,	
siitei,	সিতেই,	শীতেই,	
nirbachakder,	নির্বাচকদের,	নির্বাচকদের,	
erokomer,	এরকমের,	এরকমের,	
dumaa,	ডুমা,	দুমা,	
chhutochhooti,	ছুটোচুটি,	ছুটোছুটি,	
tigre,	তিগরে,	টাইগার,	
nagorikkey,	নাগরিককে,	নাগরিককে,	
chikitsar,	চিকিৎসার,	চিকিত্সার,	
inapharameshana,	ইনফফরেশন,	ইনফরমেশন,	
notti,	নট্টি,	নোটটি,	
kathla,	কাঠলা,	কাঠলা,	
cooda,	কুডা,	কোডা,	
procharjontrogulo,	প্রচারজন্ত্রগুলো,	প্রচারযন্ত্রগুলো,	
kanthar,	কাঁথার,	কাঁথার,	
lavta,	লাভটা,	লাভটা,	
dharavahiker,	ধারাবাহিকের,	ধারাবাহিকের,	
remacri,	রিমাক্রি,	রেমাক্রী,	
juboksoho,	যুবকসহ,	যুবকসহ,	
shanno,	সান্ন,	সান্নো,	
dipgulote,	ডিপগুলোতে,	দ্বীপগুলোতে,	
catholicder,	ক্যাথললিকদের,	ক্যাথলিকদের,	
peterke,	পেটারকে,	পিটারকে,	
robot,	রোবোট,	রোবোট,	
bbosonto,	ব্বসন্ত,	বসন্ত,	
shalook,	শালুক,	শালুক,	
hojurer,	হজুরের,	হজুরের,	
bishasey,	বিশাসে,	বিশ্বাসে,	
shamshere,	শমশেরে,	শমসের,	
supparak,	সুপ্রারক,	সুপ্পারক,	
parka,	পারকা,	পার্ক,	
ghomta,	ঘোমটা,	ঘোমটা,	
ganoparibahaner,	গণপরিবাহনের,	গণপরিবহনের,	
pothnirdeshona,	পথনিরদদেশনা,	পথনির্দেশনা,	
raiji,	রাইজি,	রাইজি,	
baipash,	বাইপাশ,	বাইপাস,	
chhooti,	ছুটি,	ছুটি,	
roopmatro,	রূপমাত্র,	রূপমাত্র,	
konflict,	কনফ্লিক্ট,	কনফ্লিক্ট,	
mette,	মেটে,	ম্যাট,	
jonesh,	জনেষ,	জোন্স,	
fatakasto,	ফাতাকাস্ত,	ফাটাকেষ্ট,	
kandy,	কানদি,	ক্যান্ডি,	
chopol,	চোপ,	চপল,	
langhangulir,	লাঙ্ঘনগুলির,	লঙ্ঘনগুলির,	
chhotogolper,	ছোটগল্পের,	ছোটগল্পের,	
jamanataswarup,	জনমন্তস্বরূপ,	জামানতস্বরূপ,	
antarvuktimulak,	অন্তর্ভক্তিমূলক,	অন্তর্ভুক্তিমূলক,	
uporitale,	উপরিতালে,	উপরিতলে,	
bheenisa,	ভেনিস,	ভেনিস,	
shudhir,	শুধির,	শুধীর,	
durgotsabe,	দুর্গৎসাবে,	দুর্গোৎসবে,	
patengar,	পাটেঙ্গার,	পতেঙ্গার,	
santaa,	সান্তা,	সান্তা,	
torabganj,	তোরাবগঞ্জ,	তোরাবগঞ্জ,	
jeebonnogor,	জীবননগর,	জীবননগর,	
engrejra,	এংগ্রেজা,	ইংরেজরা,	
parswer,	পার্সওয়ের,	পার্শ্বের,	
societyke,	সোসাইটিকে,	সোসাইটিকে,	
blyaka,	ব্ল্যাক,	ব্ল্যাক,	
taitela,	তাইতেলা,	টাইটেল,	
attacharito,	অত্তাচরিত,	অত্যাচারিত,	
bhabarlaler,	ভবরলললের,	ভবরলালের,	
ved,	ভেদ,	বেদ,	
hizrite,	হিজরিতে,	হিজরীতে,	
jhalkanite,	ঝলকানিতে,	ঝলকানীতে,	
timathi,	তিমাথি,	টিমোথি,	
amarjito,	অমর্জিত,	অমার্জিত,	
shangkulaan,	শাংকুলান,	সংকুলান,	
metropolitan,	মেট্রোপলিটান,	মেট্রোপলিটন,	
nathivukta,	নথিভুক্ত,	নথিভুক্ত,	
sondhisthaponer,	সন্ধিস্থাপনের,	সন্ধিস্থাপনের,	
chikkingsasoho,	চিককিংসাসহ,	চিকিংসাসহ,	
satarkabhabe,	সতর্কভাবে,	সতর্কভাবে,	
baman,	বামান,	বামন,	
rezidence,	রেজিডেন্স,	রেসিডেন্স,	
shukraanoo,	শুকরাঁও,	শুক্রানু,	
dei,	দেই,	দিই,	
bagdadii,	বাগদাদী,	বাগদাদী,	
doula,	ডুলা,	দৌলা,	
zozyota,	জোজোটা,	যোজ্যতা,	
sharif,	শারিফ,	শরিফ,	
balatarin,	বালাতারিন,	বালাতারিয়ান,	
chalochchitraeei,	চালোচিত্রীরই,	চলচ্চিত্রেই,	
daebug,	দেইবুগ,	ডিবাগ,	
bizito,	বিজিত,	বিজিত,	
landing,	ল্যান্ডিং,	ল্যান্ডিং,	
kaale,	কালে,	কালে,	
pothon,	পঠন,	পঠন,	
hazat,	হাজাত,	হজত,	
brindaboney,	বৃন্দাবনে,	বৃন্দাবনে,	
deelibhara,	দীলিভরা,	ডেলিভার,	
pacchi,	পাচ্চি,	পাচ্ছি,	
heelser,	হীলসের,	হিলসের,	
jati,	জাতি,	যাতি,	
yuroo,	যুরু,	ইউরো,	
elakasoho,	এলাকাসহ,	এলাকাসহ,	
tukrowti,	টুক্রৌতি,	টুকরোটি,	
baugey,	বাউগে,	বাগে,	
jerusalema,	জেরুসালেমা,	জেরুসালেম,	
shrabostee,	শ্রাবস্তি,	শ্রাবস্তী,	
toki,	টোকি,	তকি,	
madeling,	ম্যাডেলিং,	মডেলিং,	
tomader,	তোমাদের,	তোমাদের,	
sausagee,	সৌসীগ,	সসেজ,	
zoojyota,	জোজ্যোতা,	যোজ্যতা,	
mulyabriddhikale,	মূল্যবৃদ্ধিকালে,	মূল্যবৃদ্ধিকালে,	
aswasteekor,	অস্বাস্তকর,	অস্বস্তিকর,	
ultrasonography,	আলটার্সগোপ্রাফিয়ার,	আলট্রাসনোগ্রাফিও,	
laiseensim,	লাইসনসন্ম,	লাইসেন্সিং,	
kaia,	কাইয়া,	কায়া,	
korimkey,	করিমকে,	করিমকে,	
eduardo,	এডুয়ারদো,	এডুয়ার্দো,	
sathik,	সাথিক,	সঠিক,	
dhandu,	ধান্দু,	ধন্দু,	
bishwaashshoi,	বিশ্বাসশই,	বিশ্বাসই,	
conflikt,	কনফ্লিক্ট,	কনফ্লিক্ট,	
alumni,	আলুমনি,	অ্যালমনি,	
lettar,	লেটাট,	লেটার,	
juddhahato,	যুদ্ধাহাত,	যুদ্ধাহত,	
rajnoitik,	রাজনৈতিক,	রাজনৈতীক,	
dishani,	দিশানি,	দিশানি,	
phokser,	ফোকসের,	ফক্সের,	
hindutirtha,	হিন্দুতির্থ,	হিন্দুতীর্থ,	
siddhantoo,	সিদ্ধান্ত,	সিদ্ধান্তও,	
krus,	ক্রুস,	ক্রুশ,	
korkotkraantee,	কর্কক্রান্ত,	কর্কটক্রান্তি,	
koyekbare,	কয়েকবারে,	কয়েকবারে,	
jani,	জানি,	জনি,	
atmira,	আত্মিরা,	আত্মীরা,	
bidyadanke,	বিদ্যাদানকে,	বিদ্যাদানকে,	
parijaner,	পারিজনের,	পরিজনের,	
ajeejer,	অজিজের,	আজিজের,	
brake,	ব্রাক,	ব্রেক,	
kanuner,	কানুনের,	কানুনের,	
beauby,	বিউবি,	বিউবি,	
siqh,	সিক,	শিখ,	
nirbaho,	নির্বাহ,	নির্বাহ,	
chuti,	চুতি,	ছুটি,	
chitronattakar,	চিত্রনাত্তকর,	চিত্রনাট্যকার,	
abeganuvutir,	আবেগানাভুতির,	আবেগানুভূতির,	
cheenja,	চেঞ্জা,	চেঞ্জ,	
uddharkarmirai,	উদ্ধরকর্মীরাই,	উদ্ধারকর্মীরাই,	
kyatgarite,	ক্যাটগরিতে,	ক্যাটগারিতে,	
abdan,	আবদান,	আব্দান,	
kayed,	কায়েদ,	কায়েদ,	
yucalyptus,	যুকালিপ্টাস,	ইউক্যালিপ্টাস,	
sookumari,	সুকুমারি,	সুকুমারী,	
udyem,	উদ্যেম,	উদ্যেম,	
mataram,	মাতারাম,	মাতরম,	
patochitra,	পাটচিত্র,	পটচিত্র,	
youth,	য়াথ,	ইয়ুথ,	
kul,	কুল,	কুল,	
nikote,	নিকোতে,	নিকটে,	
chokrantosoho,	চক্রান্তসহ,	চক্রান্তসহ,	
kharavel,	খারাভেল,	খারবেল,	
basermick,	ব্যাসেরিক,	বেসারমিক,	
bosantake,	বসন্তকে,	বসন্তকে,	
rayyalati,	রয়য়লতী,	রয়্যালটি,	
daltyagi,	দাল্টযাগী,	দলত্যাগী,	
bone,	বনে,	বনে,	
ghatiti,	ঘাটিটি,	ঘাঁটিটি,	
sobche,	সবচে,	সবচে,	
plak,	প্লাক,	প্ল্যাক,	
mukhoshdharir,	মুখোষধারীর,	মুখোশধারীর,	
roopdan,	রূপদান,	রুপদান,	
nirgaman,	নির্গামন,	নির্গমন,	
hisabagyan,	হিসাবাজ্ঞান,	হিসাবজ্ঞান,	
bishashke,	বিষাশকে,	বিশ্বাসকে,	
upobaashee,	উপবাশী,	উপবাসী,	
ekghare,	একঘরে,	একঘরে,	
ooipokar,	উপপকার,	উইপোকার,	
bishhnu,	বিষ্ণু,	বিষ্ণু,	
sudrishya,	সুদৃশ্য,	সুদৃশ্য,	
fokskon,	ফকসকন,	ফক্সকন,	
bohoodin,	বহুদিন,	বহুদিন,	
dakten,	ডাকতেন,	ডাকতেন,	
gej,	গেজ,	গেজ,	
sarbhare,	সারভারে,	সার্ভারে,	
mozdoor,	মজদুর,	মজদুর,	
billaho,	বিল্লাহ,	বিল্লাহ,	
projanankal,	প্রজাননাল,	প্রজননকাল,	
wictor,	উইস্টর,	ভিক্টর,	
encidablu,	এনসিডেবলবু,	এনসিডাব্লু,	
asiatic,	এসিয়াটিক,	এশিয়াটিক,	
chapal,	চাপাল,	চপল,	
nariderke,	নারীদেরকে,	নারিদেরকে,	
kei,	কেই,	কেই,	
thaanobhi,	থানোভি,	থানভী,	
zeeland,	জিল্যান্ড,	জিল্যান্ড,	
coons,	কাউনস,	কুনস,	
ajuhath,	অজুহাথ,	অজুহাত,	
angshogrohon,	অংশগ্রহণ,	অংশগ্রহন,	
francine,	ফ্রান্সাইন,	ফ্রান্সিন,	
matt,	ম্ট,	ম্যাট,	
pohnpeic,	পোহনেইক,	ফোনপেইক,	
sadeep,	সাদীপ,	সদীপ,	
lagche,	লাগছে,	লাগছে,	
doorotaumo,	দৌরোতাউমো,	দূরতম,	
bonnypran,	বনিপ্রাণ,	বন্যপ্রাণ,	
baasaate,	বাসাতে,	বাসাতে,	
oswastikor,	অস্বাস্তিকর,	অস্বস্তিকর,	
sadeena,	সাদিনা,	সাডেন,	
melbourner,	মেলবর্নের,	মেলবোর্নের,	
kagbeni,	কাগবেনি,	কাগবেনি,	
mahakabi,	মহাকাবী,	মহাকবি,	
meshenjar,	মেশেনজার,	মেসেঞ্জার,	
adhikartai,	অধিকর্তই,	অধিকর্তাই,	
shangsthatikey,	সংস্থাতিকে,	সংস্থাটিকে,	
fastag,	ফাস্টাযাগ,	ফ্যাসট্যাগ,	
graambasider,	গ্রাম্সবাসীদের,	গ্রামবাসীদের,	
palbongser,	পালবংসের,	পালবংশের,	
minishtarer,	মিনিষ্টারের,	মিনিস্টারের,	
vins,	ভাইন্স,	ভিন্স,	
nathivookto,	নাথিভুক্ত,	নথিভুক্ত,	
saarbhaarti,	সার্ভরটি,	সার্ভারটি,	
nabbata,	নব্বাটা,	নাব্যতা,	
naraphoka,	নারোফোকা,	নরফোক,	
shamuker,	শামুকের,	শামুকের,	
megacaldera,	মেগাকালদারা,	মেগাক্যাল্ডেরা,	
lambi,	লাম্বি,	লম্বি,	
change,	চাঙ্গে,	চেঞ্জ,	
somratra,	সম্রাত্রা,	সম্রাটরা,	
pnouchute,	পৌঁচুতে,	পৌঁছুতে,	
rajdhani,	রাজধানী,	রাজধানি,	
hundai,	হুন্ডাই,	হুন্দাই,	
milea,	মিলিয়া,	মাইলে,	
vitti,	ভিত্তি,	ভিত্তিই,	
nabatarange,	নবতরঙ্গে,	নবতরঙ্গে,	
bardhitansh,	বর্ধিতানশ,	বর্ধিতাংশ,	
nirdesika,	নির্দেসিকা,	নির্দেশিকা,	
songkulan,	সংকুলান,	সংকুলান,	
oindrila,	ঐন্দ্রিলা,	ঐন্দ্রিলা,	
naubom,	নাউব,	নবম,	
jonosomaj,	জনসমাজ,	জনসমাজ,	
chhatrodiger,	ছাত্রদিগের,	ছাত্রদিগের,	
sangosrobomukto,	সংস্রবমুক্ত,	সংস্রবমুক্ত,	
proshikkhane,	প্রশিক্ষাণে,	প্রশিক্ষণে,	
katiusha,	কাতিইশা,	কাতিউশা,	
krusher,	ক্রুষের,	ক্রুশের,	
ceramiksh,	সেরামিকস,	সিরামিকস,	
feemalee,	ফেমালী,	ফিমেল,	
deepan,	দীপান,	দীপন,	
manobikotao,	মানবিকতাও,	মানবিকতাও,	
karaa,	কারা,	কারো,	
eshtonia,	এষ্টনিয়া,	এস্তোনিয়া,	
mandondo,	মান্দন্ড,	মানদণ্ড,	
japanostho,	জাপানস্থ,	জাপানস্থ,	
sampadoner,	সম্পাদনের,	সম্পাদনের,	
ekoghore,	একঘরে,	একঘরে,	
khamotagulor,	ক্ষমতাগুলোর,	ক্ষমতাগুলোর,	
chhooteer,	ছুটির,	ছুটির,	
labonaaktotaar,	লাবণাক্ততার,	লবণাক্ততার,	
fising,	ফিসিং,	ফিসিং,	
renoo,	রেনু,	রেনো,	
alpa,	আলপা,	অল্প,	
patigoniter,	পাটিগনীতের,	পাটিগণিতের,	
jatata,	জাতাটা,	যতোটা,	
pooshti,	পুষ্টি,	পুষ্টি,	
rinattak,	ঋণতত্তক,	ঋনাত্মক,	
ekbai,	একবাই,	একবাই,	
dormitory,	ডর্মিটরি,	ডরমিটরি,	
hevy,	হেভি,	হেভি,	
darjiling,	দার্জিলিং,	দার্জিলিং,	
bohorompurer,	বহরমপুরের,	বহরমপুরের,	
elakatay,	এলাকাতায়,	এলাকাতে,	
edipass,	এডিপাস,	ইডিপাস,	
podarthobidder,	পদার্থবিদদের,	পদার্থবিদদের,	
husni,	হুসনি,	হুসনি,	
poste,	পোস্টে,	পোষ্টে,	
shikhaboudi,	শিখাবৌডি,	শিখাবৌদি,	
holuder,	হলুদের,	হলুদের,	
shector,	সেক্টর,	সেক্টর,	
bitlaser,	বিটলাসের,	বিটলসের,	
korle,	কোরলে,	করলে,	
pyore,	প্য়োর,	পিওর,	
phiksa,	ফিকসা,	ফিক্স,	
ganoporibahoner,	গণপরিবাহনের,	গণপরিবহনের,	
soceitytey,	সোসিটিতে,	সোসাইটিতে,	
arthonitite,	আর্থনীথিতে,	অর্থনীতিতে,	
transhapharma,	ট্রান্সফর্মা,	ট্রান্সফর্ম,	
scoore,	স্কোর,	স্কোর,	
phood,	ফুড,	ফুড,	
udvabani,	উদ্ববনী,	উদ্ভাবনী,	
cholochchitratike,	চলচ্চিত্রাটিকে,	চলচ্চিত্রটিকে,	
thaii,	থাই,	থাই,	
ansarir,	আনসারীর,	আনসারীর,	
teman,	তেমান,	তেমন,	
zommu,	জম্মু,	জম্মু,	
transapharma,	ট্রান্সফর্মা,	ট্রান্সফর্ম,	
batikromee,	বাতিক্রম,	ব্যতিক্রমী,	
devolapar,	দেবোলাপার,	ডেভলপার,	
protizogii,	প্রতিযোগী,	প্রতিযোগী,	
bhushito,	ভূষিত,	ভূষিত,	
fol,	ফোল,	ফল,	
iraner,	ইরানের,	ইরানের,	
ghetu,	ঘেটু,	ঘেটু,	
probhura,	প্রভুরা,	প্রভুরা,	
hosbaleke,	হোসবালেকে,	হোসবালেকে,	
uporitaley,	উপরিতালে,	উপরিতলে,	
nehle,	নেহলে,	নেহলে,	
bojata,	বোজাটা,	বোজাটা,	
songbadmadhyomer,	সংবাদমাধ্যমের,	সংবাদমাধ্যমের,	
laaishenshh,	লাইেশশ্শ,	লাইসেন্স,	
kalenga,	কালেঙ্গা,	কালেঙ্গা,	
shakankti,	শাকনকটি,	শকাঙ্কটি,	
hena,	হেনা,	হেনা,	
manushera,	মনুষেরা,	মানুষেরা,	
rubala,	রুবালা,	রুবল,	
ghotleo,	ঘোটলেও,	ঘটলেও,	
moreecha,	মরিচা,	মরিচা,	
karmasampadon,	কর্মসম্বদন,	কর্মসম্পাদন,	
bedantodhormo,	বেদান্তধর্ম,	বেদান্তধর্ম,	
barack,	ব্যারাক,	বারাক,	
danakana,	দানাকা,	ডানকান,	
engrezder,	এংগ্রেডের,	ইংরেজদের,	
abheedhaaneeck,	অভিধান্ক,	অভিধানিক,	
sharthe,	শার্থে,	স্বার্থে,	
shasankorta,	শাসনকর্তা,	শাসনকর্তা,	
siddharther,	সিদ্ধার্থের,	সিদ্ধার্থের,	
matthews,	ম্যাথভেস,	ম্যাথিউস,	
rakim,	রকিম,	রাকিম,	
teestar,	তেস্টার,	তিস্তার,	
udbodhaney,	উদ্বধধানে,	উদ্বোধনে,	
musalmani,	মুসলমনি,	মুসলমানই,	
shef,	শেফ,	শেফ,	
nadike,	নাদিকে,	নদীকে,	
kaathhaamaandu,	কথথমান্দু,	কাঠমান্ডু,	
bisheshyo,	বিশেষ্য,	বিশেষ্য,	
bhittimul,	ভিত্তিমূল,	ভিত্তিমূল,	
sawam,	সাভায়াম,	সাওম,	
biswashi,	বিশ্বাসী,	বিশ্বাসই,	
prrajanankaal,	প্রজাননাকল,	প্রজননকাল,	
juktarashtrasaha,	যুক্তরা্থসাহ,	যুক্তরাষ্ট্রসহ,	
ched,	চেদ,	ছেদ,	
oitijjha,	ঐতিহ্যা,	ঐতিহ্য,	
baikalyo,	বাইকাল্য,	বৈকল্য,	
safiha,	সাফিহা,	সাফিহা,	
rushod,	রুশোদ,	রুশদ,	
teoyana,	তেওয়ানা,	তাইওয়ান,	
slatgulor,	স্লুটগুলোর,	স্ল্যাটগুলোর,	
cholchhe,	চলছে,	চলছে,	
shommotite,	সম্মতিতে,	সম্মতিতে,	
kaferder,	কাফারদের,	কাফেরদের,	
alaul,	আলাউল,	আলাওল,	
krisenta,	কৃষেন্ট,	ক্রিসেন্ট,	
jokkher,	যক্ষের,	যক্ষের,	
nirgamon,	নির্গামন,	নির্গমন,	
omeettrakkhor,	অমীত্রক্ষর,	অমিত্রাক্ষর,	
akpashe,	আকপাশে,	একপাশে,	
duryogamoyee,	দুর্যোগায়ো,	দুর্যোগময়ী,	
protijogii,	প্রতিযোগী,	প্রতিযোগী,	
metropalitana,	মেট্রোপালিটন,	মেট্রোপলিটন,	
oiteejye,	ঐতিহ্যে,	ঐতিহ্যে,	
licenshe,	লাইসেন্সে,	লাইসেন্স,	
ghurechen,	ঘুরেছেন,	ঘুরেছেন,	
hisaber,	হিসাবের,	হিসাবের,	
siqhar,	সিখার,	শিকার,	
suhayeler,	সুহায়েলের,	সুহায়েলের,	
adorso,	আদরসস,	আর্দশ,	
ratishilatai,	রতিশীলতায়,	রতিশীলতায়,	
puroheetder,	পুরোহিতদের,	পুরোহিতদের,	
madhuri,	মাধুরি,	মাধুরী,	
torunderke,	তরুণদেরকে,	তরুণদেরকে,	
collaborators,	কলাবরেটর্স,	কলাবরেটরস,	
grotha,	গ্রথা,	গ্রোথ,	
muktijuddhojato,	মুক্তিযুদ্ধাত,	মুক্তিযুদ্ধজাত,	
bajite,	বাজিতে,	বাজিতে,	
jins,	জিনস,	জিন্স,	
ul,	ইউল,	উল,	
badaghat,	বাদাঘাট,	বাদাঘাট,	
prokolpogulikei,	প্রকল্পগুলিকেই,	প্রকল্পগুলিকেই,	
qirq,	কির্ক,	কার্ক,	
abhidhaanic,	অভিধানিক,	অভিধানিক,	
heavy,	হেভি,	হেভি,	
sompadonkaree,	সম্পাদকানী,	সম্পাদনকারী,	
aziboner,	আজিবনের,	আজীবনের,	
dipon,	ডিপন,	দীপন,	
sudrissho,	সুদৃশ্,	সুদৃশ্য,	
sheshdinti,	শেষদিনটি,	শেষদিনটি,	
noiteek,	নৈতিক,	নৈতিক,	
grambaashio,	গ্রামবাশিও,	গ্রামবাসীও,	
somraatder,	সমরাতদের,	সম্রাটদের,	
mangolic,	ম্যাঙ্গোলিক,	মাঙ্গলিক,	
ganonanatto,	গণনাত্ব,	গণনাট্য,	
dormroome,	ডরর্রুম,	ডর্মরুমে,	
musolmanera,	মুসলমানেরা,	মুসলমানেরা,	
eevil,	ইভিল,	ইভিল,	
shhikara,	সিকারা,	শিকার,	
bapio,	বাপিও,	বাপিও,	
digrir,	দিগ্রির,	ডিগ্রির,	
casper,	ক্যাসপার,	ক্যাসপার,	
oxfordey,	অক্সর্ডে,	অক্সফোর্ডে,	
proboleme,	প্রবলেম,	প্রবলেমে,	
bouddha,	বৌদ্ধ,	বৌদ্ধ,	
katbe,	কাতবে,	কাটবে,	
stanahenja,	স্তননানেঞ্জ,	স্টোনহেঞ্জ,	
uparjoner,	উপার্যনের,	উপার্জনের,	
chalachchitrer,	চলচ্চিত্রের,	চলচ্চিত্রের,	
konroop,	কণরূপ,	কোনরূপ,	
chowdhurir,	চৌধুরির,	চৌধুরীর,	
konar,	কোনার,	কণার,	
dalee,	ডায়ল,	ডালে,	
nirbachokder,	নির্বাচকদের,	নির্বাচকদের,	
kooshumba,	কুশুম্বা,	কুশুম্বা,	
purushika,	পুরুষিকা,	পুরুষিকা,	
neelkamal,	নীলকামাল,	নীলকমল,	
nutan,	নুতান,	নূতন,	
bojiye,	বজিয়ে,	বজিয়ে,	
vezano,	ভেজানো,	ভেজানো,	
kaferderke,	কাফেরদেরকে,	কাফেরদেরকে,	
deool,	দেওল,	দেউল,	
mast,	মাস্ট,	মাস্ত,	
saranor,	সারানোর,	সরানোর,	
bokahoke,	বোকাহকে,	বকাহকে,	
sanaktokaron,	সনাক্তকরণ,	সনাক্তকরণ,	
samoshtigato,	সমস্তিগত,	সমষ্টিগত,	
poribahokotto,	পরিবাহকত্য,	পরিবাহকত্ব,	
phutonta,	ফুটনটা,	ফুটন্ত,	
modelgulo,	মডেলগুলো,	মডেলগুলো,	
addhattikotar,	আদ্ধাত্মিকতার,	আধ্যাত্মিকতার,	
zeebonto,	জীবন্ত,	জীবন্ত,	
chandanara,	চান্দানারা,	চন্দনারা,	
swajan,	স্বজন,	স্বজন,	
anchalsaho,	আঞ্চলসহ,	অঞ্চলসহ,	
korimer,	করিমের,	করিমের,	
tateo,	তাতেও,	তাতেও,	
cheekitsar,	চিকিৎসার,	চিকিত্সার,	
jibanto,	জীবান্ত,	জীবন্ত,	
gorjon,	গর্জন,	গর্জন,	
matis,	মাটিস,	ম্যাটিস,	
bangobandhu,	বঙ্গবন্ধু,	বঙ্গবন্ধু,	
pader,	পাদের,	প্যাডের,	
ekjoge,	একযোগে,	একযোগে,	
beem,	বীম,	বিম,	
purohitder,	পুরোহিতদের,	পুরোহিতদের,	
shikkhakram,	শিক্ষাক্রম,	শিক্ষাক্রম,	
lendol,	লেন্ডল,	লেন্ডল,	
vobani,	ভবানি,	ভবানী,	
karim,	কারিম,	করিম,	
shasheja,	শাশেজা,	সসেজ,	
tochhnochh,	তোচনাচ,	তছনছ,	
angsogrohone,	অংশগ্রহণে,	অংশগ্রহনের,	
onker,	অঙ্কের,	ওঙ্কার,	
spredsheet,	স্প্রেডশিত,	স্প্রেডশীট,	
ramnathbabur,	রামনথবাবুর,	রামনাথবাবুর,	
jegulur,	জেগুলুর,	যেগুলুর,	
surakarder,	সুরকর্দের,	সুরকারদের,	
bairey,	বাইরে,	বাইরে,	
mahafezkhanar,	মহাফেজজানানার,	মহাফেজখানার,	
elaakaate,	এলাকাতে,	এলাকাতে,	
torikher,	তরিখের,	তরিখের,	
dobhara,	ডোভারা,	ডোভার,	
aporishodhito,	অপরিসধধিত,	অপরিশোধিত,	
bapokotor,	বাপকতর,	ব্যাপকতর,	
gatibege,	গাতিবেগে,	গতিবেগে,	
polashir,	পলাশির,	পলাশীর,	
probhuder,	প্রভুদের,	প্রভুদের,	
shikshakbrindo,	শিকশাকবৃন্দ,	শিক্ষকবৃন্দ,	
bhyatikaner,	ভ্যাটিকানের,	ভ্যাটিকানের,	
zubokder,	যুবকদের,	যুবকদের,	
mitro,	মিত্রো,	মিত্র,	
jaruri,	জারুরি,	জরূরী,	
chhuti,	ছুটি,	ছুটি,	
sorano,	সোরানো,	সরানো,	
nadnadeer,	নদনাদীর,	নদনদীর,	
mukhbondho,	মুখবন্ধ,	মুখবন্ধ,	
guha,	গুহা,	গোহ,	
fand,	ফাযান্ড,	ফান্ড,	
eenameela,	ইনমালা,	এনামেল,	
surke,	সুরকে,	সুরকে,	
bhabaponno,	ভাবপন্ন,	ভাবাপন্ন,	
biplabeer,	বিপ্লাবীর,	বিপ্লবীর,	
bhalobaas,	ভালোবাস,	ভালোবাসা,	
rakhtokkharoner,	রাক্ষকরষণের,	রক্তক্ষরণের,	
moresbai,	মোরেসবাই,	মোরেসবাই,	
kampita,	কম্পিতা,	কম্পিত,	
gonesher,	গণেশের,	গণেশের,	
saqara,	সাকারা,	সাকার,	
dhrubaker,	ধ্রুবাকের,	ধ্রুবকের,	
rata,	রাটা,	রত,	
ummool,	উম্মুল,	উম্মুল,	
myari,	ম্যারি,	ম্যারি,	
karam,	কারাম,	কেরাম,	
upbasher,	উপবাশের,	উপবাসের,	
mathews,	ম্যাথিভস,	ম্যাথিউস,	
wishnu,	উইশ্নু,	বিষ্ণু,	
restuarant,	রেস্টুরেয়ান্ট,	রেষ্টুরেন্ট,	
qyantana,	ক্যান্টন,	ক্যান্টন,	
monir,	মনির,	মনির,	
fostar,	ফোস্টার,	ফস্টার,	
mitrota,	মিত্রোটা,	মিত্রতা,	
mehsus,	মেহসাস,	মেহসুস,	
monjurul,	মন্জুরুল,	মনজুরুল,	
bharatey,	ভারাতে,	ভারতে,	
cheekitshar,	চিকিৎসার,	চিকিত্সার,	
mile,	মিল,	মিলে,	
calabe,	ক্যালাবে,	চালাবে,	
akhhunno,	আখুন্য,	অক্ষুণ্ণ,	
jalarong,	জালারং,	জলরঙ,	
rinobodh,	ঋণবোধ,	ঋণবোধ,	
haripur,	হরিপুর,	হরিপুর,	
jansha,	জনসা,	জন্স,	
yak,	যাক,	ইয়াক,	
byaboharkari,	ব্যবহারকারী,	ব্যবহারকারী,	
mujuru,	মুজুরু,	মুজুরু,	
gejeted,	গেজেটেড,	গেজেটেড,	
uter,	ইউটার,	উটের,	
rodney,	রোডে,	রেডনি,	
assexe,	অ্যাসেক্সে,	অ্যাসেক্সে,	
sthapanagulor,	স্থাপানগুলোর,	স্থাপনাগুলোর,	
turista,	তুরিস্তা,	টুরিস্ট,	
gate,	গাতে,	গ্যেটে,	
qonfliqt,	কনফ্লিক্ট,	কনফ্লিক্ট,	
si,	সিই,	এসআই,	
informetion,	ইনফরমেশন,	ইনফরমেশন,	
deares,	ডিয়ার্স,	ডিআরএস,	
creshcent,	ক্রেসেন্ট,	ক্রিসেন্ট,	
hosto,	হোস্ট,	হস্ত,	
jetam,	জেটাম,	যেতাম,	
haridware,	হরিদ্বারে,	হরিদ্বারে,	
protishta,	প্রতিষ্ট,	প্রতিষ্টা,	
lahano,	লাহানো,	লাহানো,	
bachai,	বাছাই,	বাছাই,	
bage,	বাগে,	বাগে,	
sazanor,	সাজানোর,	সাজানোর,	
groth,	গ্রথ,	গ্রোথ,	
bandhano,	বানধানো,	বাঁধানো,	
abhirupbabuke,	অভিরুপবাবুকে,	অভিরূপবাবুকে,	
sobrakamer,	সব্রকামের,	সবরকমের,	
ddheela,	ঢেল,	ঢিলা,	
akar,	আকার,	একার,	
thanvi,	থানভি,	থানভী,	
segular,	সেগুলার,	সেগুলোর,	
thandabhabe,	থাণ্ডাভাবে,	ঠাণ্ডাভাবে,	
highcomissione,	হাইমকিশনে,	হাইকমিশনে,	
enjineers,	এনজিনায়ারস,	ইঞ্জিনিয়ার্স,	
kuthibarike,	কুঠিবারীকে,	কুঠিবাড়ীকে,	
byatari,	ব্যাটারি,	ব্যাটারী,	
tinage,	তিনাগে,	টিনেজ,	
hoteltee,	হোটেলটি,	হোটেলটি,	
fanding,	ফান্ডিং,	ফান্ডিং,	
pratool,	প্রতূল,	প্রতুল,	
goolen,	গুলেন,	গুলেন,	
abhidhanick,	অভিধানিকক,	অভিধানিক,	
flux,	ফ্লাক্স,	ফ্লাস্ক,	
chatrorai,	চাত্রাাই,	ছাত্ররাই,	
jyaqa,	জ্যাক,	জ্যাক,	
goodamjato,	গুদামজত,	গুদামজাত,	
gandagol,	গান্ডাগোল,	গন্ডগোল,	
tetela,	তেতেলা,	টাইটেল,	
dharabahikotitey,	ধারাবাহিকীতে,	ধারাবাহিকটিতে,	
bokul,	বকুল,	বকুল,	
goora,	গুর,	গোর,	
suraropito,	সুরারোপিত,	সুরারোপিত,	
dakteekiter,	ডাক্তিকিতের,	ডাকটিকিটের,	
eura,	ইউরা,	ইউরো,	
noitik,	নৈটিক,	নৈতিক,	
bibechyo,	বিবেচ্য,	বিবেচ্য,	
pratista,	প্রতিস্ত,	প্রতিষ্টা,	
falasrutite,	ফলাস্রুটিতে,	ফলশ্রুতিতে,	
shuperheiro,	শুপারহিডিরো,	সুপারহিরো,	
bishnu,	বিষ্ণু,	বিষ্ণু,	
dokaangulotey,	দোকানগুলোতে,	দোকানগুলোতে,	
elakaasoho,	এলাকাসহ,	এলাকাসহ,	
ajuhat,	অজুহাত,	অজুহাত,	
inafarameshana,	ইনফররেশন,	ইনফরমেশন,	
chikitsanirbhar,	চিকিৎসানির্ভর,	চিকিৎসানির্ভর,	
heart,	হার্ট,	হার্ট,	
uttor,	উত্তর,	উওর,	
sohokari,	সোককারি,	সহকারী,	
maryir,	মারিয়ার,	ম্যারির,	
gabeshonar,	গবেশনার,	গবেষনার,	
sikarer,	সিকারের,	শিকারের,	
debdebie,	দেবদেবীয়,	দেবদেবী,	
kaansaat,	কানসা,	কানসাট,	
nabotom,	নবতো,	নবতম,	
priseflex,	প্রাইসফ্লেক্স,	প্রাইজফ্লেক্স,	
ekroop,	একরূপ,	একরূপ,	
shoreefer,	শরীফের,	শরিফের,	
kingsh,	কিংস,	কিংস,	
bisheshya,	বিশেষ্য,	বিশেষ্য,	
licensin,	লাইসেনসিন,	লাইসেন্সিং,	
shroddhabihin,	শ্রদ্ধাবিহীন,	শ্রদ্ধাবিহীন,	
showtey,	শুতে,	শোতে,	
chandrima,	চন্দ্রিমা,	চন্দ্রিমা,	
orthoneeti,	অর্থনীতি,	অর্থনীতির,	
phising,	ফিসিং,	ফিসিং,	
difinisian,	ডিফিনিসীয়,	ডেফিনেশন,	
reshmirekha,	রেশমিরেখা,	রেশমীরেখা,	
melborrone,	মেলবরোন,	মেলবোর্নে,	
bondhuvabaponyo,	বন্ধুবানপ্্য,	বন্ধুভাবাপন্ন,	
basab,	বাসাব,	বাসাব,	
brekthrough,	ব্রেক্টরাঘে,	ব্রেকথ্রু,	
rockibul,	রকিবুল,	রকিবুল,	
shikhbe,	শিখবে,	শিখবে,	
songasthaner,	সংস্থানের,	সংস্থানের,	
liseensee,	লিসিন্সি,	লাইসেন্স,	
elahabade,	এলাহাবাদে,	এলাহাবাদে,	
rubidium,	রুউডিডিয়াম,	রুবিডিয়াম,	
suparichito,	সুপারিছিত,	সুপরিচিত,	
institutione,	ইনস্টিউটিশনে,	ইনস্টিটিউশনে,	
sweety,	স্বিতি,	সুইটি,	
osamanno,	অসামান্য,	অসামান্য,	
varote,	ভারোতে,	ভারতে,	
prakalpoguli,	প্রকালগুলি,	প্রকল্পগুলি,	
lagchhe,	লাগছে,	লাগছে,	
teunar,	তেউনার,	টিউনার,	
dabarer,	দাবারের,	দাবারের,	
turbine,	তুরবিন,	টারবাইন,	
akhandata,	আখণ্ডতা,	অখণ্ডতা,	
torkarite,	তরকারিতে,	তরকারিতে,	
geographics,	জিওগ্রাফিক্স,	জিওগ্রাফিকস,	
ralf,	র্যালফ,	রালফ,	
patininda,	পাতিনিন্দা,	পতিনিন্দ,	
turkamena,	তুরকামেনা,	তুর্কমেন,	
ishahak,	ইশাহক,	ইসাহাক,	
tikto,	টিক্ত,	তিক্ত,	
soteciety,	সটেশিটি,	সোসাইটিতে,	
rahee,	রহে,	রাহী,	
hoondayi,	হুন্ডায়ী,	হুন্দাই,	
shahanara,	শাহানারা,	শাহানারা,	
bikargrosto,	বিকারগ্রস্ত,	বিকারগ্রস্ত,	
moushumei,	মৌশুমেই,	মৌসুমেই,	
poschime,	পশ্চিমে,	পশ্চিমে,	
khilaphat,	খিলাফাত,	খিলাফত,	
vugoley,	ভুগোলে,	ভূগোলে,	
khanonkaj,	খানকাজ,	খননকাজ,	
jolbe,	জলবে,	জ্বলবে,	
boner,	বনের,	বনের,	
perry,	পেরি,	পেরি,	
naneer,	নানীর,	নানীর,	
sobchey,	সবচে,	সবচে,	
nirbahe,	নির্বাহে,	নির্বাহে,	
suchonakal,	সূচনাকাল,	সূচনাকাল,	
aranyani,	অরণ্যনী,	অরণ্যানী,	
bipajjanak,	বিপজ্জনক,	বিপজ্জনক,	
kajangale,	কাজনগলে,	কজঙ্গলে,	
dubureer,	দুবুরির,	ডুবুরির,	
daqop,	ডাকোপ,	দাকোপ,	
goonoman,	গণোমান,	গুণমান,	
itostatah,	ইতসস্তাঃ,	ইতস্ততঃ,	
norfolk,	নরফলক,	নরফোক,	
mozlis,	মজলিস,	মজলিশ,	
gagee,	গাগী,	গেজ,	
konisttha,	কনিষ্ঠা,	কনিষ্ঠ,	
romantik,	রোমান্তিক,	রোমান্টিক,	
adwanced,	অ্যাডব্যান্ড,	অ্যাডভান্সড,	
basaalt,	বাসাল,	ব্যাসল্ট,	
durgotsab,	দুর্গোৎসব,	দুর্গোৎসব,	
bhikkharthe,	ভিক্ষার্থে,	ভিক্ষার্থে,	
jhumjhumita,	ঝুমঝুমিত,	ঝুমঝুমিটা,	
prosadhani,	প্রসাধনি,	প্রসাধনী,	
mochlekha,	মোললেখা,	মোছলেখা,	
noitikota,	নৈটিকতা,	নৈতিকতা,	
rudrasagar,	রুদ্রসাগর,	রুদ্রসাগরের,	
bbosben,	ব্বসবেন,	বসবেন,	
tennis,	টেনিস,	টেনিস,	
orunima,	ওরুনিমা,	অরুণিমা,	
bodhukeo,	বোধুকেও,	বধুকেও,	
ujobekeestaner,	উজবেক্তাসানের,	উজবেকিস্তানের,	
poriikkhateo,	পরীক্ষাতেও,	পরীক্ষাতেও,	
hajirhat,	হাজিরহাট,	হাজিরহাট,	
wodka,	ওড়কা,	ভদকা,	
mercedes,	মার্সডেস,	মার্সেডেস,	
deputee,	ডিপুতে,	ডেপুটি,	
ramachandranke,	রামানচ্রদনকে,	রামাচন্দ্রনকে,	
hariner,	হরিনের,	হরিণের,	
konagoolo,	কনাগুলো,	কণাগুলো,	
gandhikey,	গান্ধিকে,	গান্ধীকে,	
dayitta,	দায়িত্বা,	দায়িত্ব,	
jahangirbad,	জাহাঙ্গীরবাদ,	জাহাঙ্গীরবাদ,	
tottorat,	তত্তরা,	তওরাত,	
iksaprishana,	এক্সপ্রীষন,	এক্সপ্রেশন,	
canflikt,	ক্যানফ্লিক্ট,	কনফ্লিক্ট,	
video,	ভিডেও,	ভিডিয়োও,	
siddhantoke,	সিদ্ধান্তকে,	সিদ্ধান্তকে,	
protisthar,	প্রতিষ্ঠার,	প্রতিষ্ঠার,	
abheedhaaneek,	অভিধানক,	অভিধানিক,	
fake,	ফাকে,	ফাকে,	
dhaleshorii,	ধালেশরী,	ধলেশ্বরী,	
firozapure,	ফিরোজাপুরে,	ফিরোজাপুরে,	
gratha,	গ্রাথা,	গ্রোথ,	
expreshshion,	এক্সপ্রেশন,	এক্সপ্রেশন,	
ingreziteo,	ইংরেজিতেও,	ইংরেজিতেও,	
jolrang,	জলরাং,	জলরঙ,	
kindom,	কিন্দোম,	কিংডম,	
tiger,	টিজের,	টাইগার,	
senabahineeow,	সেনাবাহীনী,	সেনাবাহিনীও,	
jiland,	জিল্যান্ড,	জিল্যান্ড,	
mase,	ম্যাস,	মাসে,	
prabhritite,	প্রাৃতীতে,	প্রভৃতিতে,	
ganosachetanata,	গণসােনেতা,	গণসচেতনতা,	
sooya,	সোয়া,	সোয়া,	
scholastic,	স্কোলস্টিক,	স্কলাস্টিক,	
awrbit,	আব্রিত,	অরবিট,	
subader,	সুবাদের,	সুবাদে,	
mokhmoley,	মখমলে,	মখমলে,	
anichchi,	আনিচ্ছি,	আনিচ্ছি,	
hank,	হ্যাঙ্ক,	হাঙ্ক,	
byaktigotovabeo,	ব্যক্তিগতভাবেও,	ব্যাক্তিগতভাবেও,	
damodar,	দামোদার,	দামদর,	
sangkoolan,	সংকুলান,	সংকুলান,	
breakthrough,	ব্রেক্টরাঘে,	ব্রেকথ্রু,	
carlo,	কার্লো,	কার্লো,	
bishnoo,	বিষ্ণু,	বিষ্ণু,	
totokhon,	ততকখন,	ততক্ষন,	
tookrokey,	তুকরকে,	টুকরোকে,	
fatkabazare,	ফাটকাবাজারে,	ফাটকাবাজারে,	
jhimochchilo,	ঝিমচ্ছিল,	ঝিমোচ্ছিলো,	
toranganj,	তোরঙ্গঞ্জ,	তোরাবগঞ্জ,	
boshoborti,	বশবর্তী,	বশবর্তী,	
khude,	খুদ়ে,	ক্ষুদে,	
pyetarna,	প্য়াররা,	প্যাটার্ন,	
colgirl,	কলগির,	কলগার্ল,	
glanio,	গ্লানিও,	গ্লানিও,	
oichchheek,	ঐচ্ছিক,	ঐচ্ছিক,	
langhoner,	ল্যাংহনের,	লংঘনের,	
inphormeshon,	ইনফরোমেশন,	ইনফরমেশন,	
kkomandar,	কোকমান্দার,	কমাণ্ডার,	
uddhritir,	উদ্ধৃতির,	উদ্ধৃতির,	
maailkhanek,	মালখখানেক,	মাইলখানেক,	
khappar,	খাপ্পার,	খপ্পর,	
hul,	হুল,	হুল,	
dep,	ডিপ,	ডেপ,	
pravritir,	প্রভৃতির,	প্রভৃতির,	
zohns,	জনস,	জন্স,	
subade,	সুবাদে,	সুবাদে,	
palestine,	পেলেস্টিন,	প্যালেস্টাইনে,	
orbeet,	অরবিত,	অরবিট,	
manjushree,	মঞ্জুশ্রী,	মঞ্জুশ্রী,	
chhutochhuti,	ছুটোচুটি,	ছুটোছুটি,	
prasadhoner,	প্রাসাধনের,	প্রসাধনের,	
silabhara,	সিলাভারা,	সিলভার,	
hert,	হের্ট,	হার্ট,	
tatey,	তাতে,	তাতে,	
poddhotitei,	পদ্ধটিতেই,	পদ্ধতিতেই,	
bollov,	বলভভ,	বল্লভ,	
bbiswasho,	বিব্্বাসও,	বিশ্বাসও,	
batikromshalee,	বাতিকর্মশলী,	ব্যতিক্রমধর্মী,	
monur,	মনুর,	মনুর,	
tiunara,	টিউনার,	টিউনার,	
mukhomandaler,	মুখমন্ডলের,	মুখমণ্ডলের,	
mishal,	মিশাল,	মিশাল,	
deobonde,	দেওবন্ডে,	দেওবন্দে,	
jatotaa,	যাতোটা,	যতোটা,	
marmader,	মার্মাদের,	মারমাদের,	
manoharpur,	মনোহরপুর,	মনোহরপুর,	
norpholk,	নরফলক,	নরফোক,	
ase,	আসে,	আসে,	
plator,	প্ল্যাটর,	প্লেটোর,	
danab,	ডানাব,	দানব,	
houzgulite,	হাউজগুলিতে,	হাউজগুলিতে,	
soource,	সুয়ার্স,	সোর্স,	
sqirt,	স্কির্ট,	স্কার্ট,	
augustine,	অগাস্টিন,	অগাস্টিন,	
dera,	দেরা,	ডেরা,	
qulim,	কুলিম,	কুলিং,	
protijogi,	প্রতিযোগী,	প্রতিযোগী,	
romarder,	রোমার্ডের,	রোমারদের,	
zibonnogor,	জীবননগর,	জীবননগর,	
deputy,	ডিপিউটি,	ডেপুটি,	
kuhelika,	কুহেলিকা,	কুহেলিকা,	
kantojir,	কাঁটজজীর,	কান্তজির,	
upobasher,	উপবাশের,	উপবাসের,	
tigmanshu,	তিগমাংশু,	তিগমংশু,	
rajbandi,	রাজবন্দী,	রাজবন্দী,	
harysoner,	হ্যারিসনের,	হ্যারিসনের,	
jolaatonko,	জলাতনক,	জলাতঙ্ক,	
chhintayikari,	ছিন্তাইয়াকারী,	ছিনতাইকারী,	
bboponer,	ব্ববপনের,	বপনের,	
sthapanar,	স্থাপার,	স্থাপনার,	
vabook,	ভাবক,	ভাবুক,	
direqtareta,	দিরেকররতে,	ডিরেক্টরেট,	
niemond,	নিমন্ড,	নিমন্ড,	
kalnir,	কালনির,	কালনীর,	
nepchooner,	নেপচুনের,	নেপচুনের,	
kiuti,	কিউটি,	কিউটি,	
sift,	সিফট,	শিফট,	
scholarsip,	স্কলারসিপ,	স্কলারশিপ,	
tooku,	টুকু,	টুকু,	
sikkhakbrinda,	শিক্ষাকবৃন্দ,	শিক্ষকবৃন্দ,	
pratijogitamulak,	প্রাতিযোগিতামূলক,	প্রতিযোগীতামূলক,	
birishiritey,	বীরীশিতী,	বিরিশিরিতে,	
mukhomandal,	মুখমন্ডল,	মুখমণ্ডল,	
sanghitar,	সংহীতার,	সংহিতার,	
teoner,	তিওনের,	টিওনার,	
avisongson,	আভিভংসন,	অভিশংসন,	
sepha,	সেফ,	শেফ,	
katateo,	কাটাতেও,	কাটাতেও,	
blasterke,	ব্লাস্টারকে,	ব্লাস্টারকে,	
plainey,	প্লেন,	প্লেনে,	
muradkey,	মুরাদকে,	মুরাদকে,	
fasi,	ফাসি,	ফাঁসী,	
kobulennechha,	কবুলেন্ঞেছা,	কবুলেন্নেছা,	
harza,	হারজা,	হার্জ,	
raghubar,	রাঘুবার,	রঘুবীর,	
phutanta,	ফুটান্ত,	ফুটন্ত,	
bongsho,	বংশ,	বংশ,	
umedpoor,	উমেডপুর,	উমেদপুর,	
jhijhi,	ঝিঝি,	ঝিঝি,	
dokkhinangsho,	দক্ষিণাংশ্,	দক্ষিণাংশ,	
yaq,	যাক,	ইয়াক,	
amiya,	আমিয়া,	অমিয়,	
batikromi,	বাতিকরমী,	ব্যতিক্রমী,	
lutherana,	লুথেরানা,	লুথেরান,	
saabyastha,	সাব্যস্থ,	সাব্যস্থ,	
sotorkobhabey,	সতর্কভাবে,	সতর্কভাবে,	
kayech,	কায়েছ,	কায়েছ,	
orthanitike,	অর্থনীতিকে,	অর্থনীতিকে,	
daap,	ডাপ,	ড্যাপ,	
roopdaan,	রূপদান,	রুপদান,	
raunanganey,	রৌননঙ্গণে,	রণাঙ্গনে,	
bosontokke,	বসন্তককে,	বসন্তকে,	
bisshonath,	বিশ্ননাথ,	বিশ্বনাথ,	
omanisa,	ওমানিসা,	অমানিশা,	
deciliter,	ডেসালিটের,	ডেসিলিটার,	
sikara,	সিকারা,	শিকার,	
shahurgulor,	শাহুরগুলোর,	শহুরগুলোর,	
mitrata,	মিত্রাটা,	মিত্রতা,	
ghoomato,	ঘুমত,	ঘুমাতো,	
shingping,	শিংপিং,	শিংপিং,	
cheerokoomari,	চেরোকুমারী,	চিরকুমারী,	
jaanar,	জানার,	জানার,	
girilal,	গিরিলাল,	গিরিলাল,	
konoroop,	কনরূপ,	কোনরূপ,	
veniser,	ভেনিসের,	ভেনিসের,	
drissoke,	দৃষসকে,	দৃশ্যকে,	
dong,	ডং,	ডং,	
dhamshrenite,	ধামশ্রেণীতে,	ধামশ্রেণীতে,	
modyer,	মোদিরের,	মদ্যের,	
peengna,	পিংনা,	পিংনা,	
omarader,	ওমারাদের,	ওমারাদের,	
aizulke,	আইজুলকে,	আইজুলকে,	
kharar,	খার,	খরার,	
bite,	বিতে,	বাইট,	
bbiswashi,	ব্বীস্বাশী,	বিশ্বাসই,	
harja,	হার্জা,	হার্জ,	
chokhwala,	চোখবালা,	চোখওয়ালা,	
koro,	করো,	করো,	
gejetade,	গেজেটাদে,	গেজেটেড,	
nodimatrik,	নদীমাত্রিক,	নদীমাতৃক,	
phakay,	ফাকায়,	ফাকে,	
srabosty,	স্রাবস্টি,	শ্রাবস্তী,	
argead,	আর্িিড,	আর্জিদ,	
prachando,	প্রাচাঁডো,	প্রচণ্ড,	
chittronatyokar,	চিত্রনা্যকরার,	চিত্রনাট্যকার,	
upacharjo,	উপাচার্য,	উপাচার্য,	
uporitoler,	উপরিতলের,	উপরিতলের,	
abarte,	আবার্তে,	আবর্তে,	
suraaropito,	সুরারোপিত,	সুরারোপিত,	
sumoo,	সুমৌ,	সুমো,	
ciima,	সিইমা,	সীমা,	
nottee,	নট্,	নোটটি,	
poste,	পোস্টে,	পোস্টে,	
karecho,	করেছো,	করেছো,	
tricksguli,	ট্রিকসসগুলি,	ট্রিকসগুলি,	
prokalpagulo,	প্রকালপগুলো,	প্রকল্পগুলো,	
ragee,	রাগী,	রাগী,	
helloin,	হেল্যন,	হ্যালোইন,	
charukala,	চারুকা,	চারুকলা,	
idyi,	ইদি,	আইডিই,	
amar,	আমার,	আমর,	
nathivookteer,	নথিভকুক্তির,	নথিভুক্তির,	
siddhanto,	সিদ্ধান্ত,	সিদ্ধান্তও,	
mumtaj,	মুমতাজ,	মুমতাজ,	
kusumeshu,	কুসুমেশু,	কুসুমেষু,	
karir,	কারির,	কারীর,	
maradeha,	মারাহেহ,	মরদেহ,	
olympic,	অলিম্পিক,	অলিম্পিক,	
jhamala,	ঝামালা,	ঝামালা,	
dharmantor,	ধর্মন্তর,	ধর্মান্তর,	
dokaanei,	দোকানেই,	দোকানেই,	
neemeette,	নেমত্যে,	নিমিত্তে,	
bhoolapuka,	ভূলাপুকা,	ভোলাপুক,	
taunship,	টাউনশিপ,	টাউনশিপ,	
utpotti,	উৎপত্তি,	উতপত্তি,	
eoki,	ইকোি,	এওকি,	
kanshat,	কানশট,	কানসাট,	
votar,	ভোটার,	ভোটার,	
schilling,	সিকিলং,	শিলিং,	
kaatbey,	কাটবে,	কাটবে,	
dwibidho,	দ্বিবিধ,	দ্বিবিধ,	
siit,	সিইট,	শীত,	
disni,	ডিসনি,	ডিজনী,	
neutrinoo,	নিউট্রিনো,	নিউট্রিনো,	
ekhate,	এখাতে,	একহাতে,	
batom,	বাতোম,	বাটম,	
foxcon,	ফক্সকন,	ফক্সকন,	
jathartho,	যথার্থ,	যথার্থ,	
firozaa,	ফিরোজা,	ফিরোজা,	
steena,	স্তিনা,	স্টেন,	
hood,	হুড,	হুড,	
laagche,	লাগছে,	লাগছে,	
abheedhanic,	অভিফানিক,	অভিধানিক,	
welcome,	ওয়ালকোম,	ওয়েলকাম,	
medilek,	মেডিলেক,	মেডিলেক,	
parisankhanvid,	পরিসংখ্যান্ব,	পরিসংখ্যানবিদ,	
ebhara,	এভারা,	এভার,	
torabgonj,	তোরাবগঞ্জ,	তোরাবগঞ্জ,	
aajeej,	আজিজ,	আজিজ,	
groundta,	গ্রুন্ডটা,	গ্রাউন্ডটা,	
birmuktijoddhagan,	বীর্মুক্তিযোগ্ধধান,	বীরমুক্তিযোদ্ধাগণ,	
proteemake,	প্রতিমাকে,	প্রতিমাকে,	
jalbe,	জলবে,	জ্বলবে,	
sakshatkarer,	সাক্ষাৎকারের,	সাক্ষাৎকারের,	
korijachilen,	করিজাছিলেন,	করিযাছিলেন,	
makhno,	মাখনো,	মাখনো,	
pranibigyani,	প্রণীবিজ্ঞানী,	প্রাণীবিজ্ঞানী,	
lubitz,	লুবিৎজ,	লুবিৎজ,	
plaiin,	প্লেইন,	প্লেন,	
gyandaas,	জ্ঞানদাস,	জ্ঞানদাস,	
asamorik,	অসমারিক,	অসামরিক,	
shektor,	শেক্তর,	সেক্টর,	
superheroo,	সুপারহররু,	সুপারহিরো,	
amor,	আমরোর,	আমর,	
kuttake,	কুট্াকে,	কুত্তাকে,	
oyebjin,	ওয়েবজিন,	ওয়েবজিন,	
rakkhanbhag,	রক্ষণবভাগ,	রক্ষণভাগ,	
doloo,	দলও,	ডলু,	
rajshri,	রাজশ্রী,	রাজশ্রী,	
durgatsob,	দুর্গাৎসব,	দুর্গোৎসব,	
anchalei,	আঁচললেই,	অঞ্চলেই,	
srichoitonnodeb,	শ্রীচৈতন্যবদ,	শ্রীচৈতন্যদেব,	
ponera,	পনেরা,	পনের,	
mawdeel,	মাউদীল,	মডেল,	
sip,	সিপ,	শিপ,	
tapdei,	তাপদেই,	তাপড়েই,	
jerusalemer,	জেরুসালেমের,	জেরুজালেমের,	
dadar,	দাদার,	দাদার,	
skirt,	স্কির্ট,	স্কার্ট,	
pancbaar,	প্যান্সবার,	পাঁচবার,	
sinaake,	সিনাকে,	সিনাকে,	
modhumotii,	মধুমতিই,	মধুমতী,	
tintir,	তিনটির,	তিনটির,	
blogarra,	ব্লোগাররা,	ব্লগাররা,	
milekhanek,	মিলেখানেক,	মাইলখানেক,	
asovyo,	অসভ্য,	অসভ্য,	
shrabasti,	শ্রাবস্তি,	শ্রাবস্তী,	
nibobondhonkrito,	নিববন্ধনকৃত,	নিববন্ধনকৃত,	
ukeliptas,	উকেলিপ্টাস,	ইউক্যালিপ্টাস,	
daqten,	ডাকতেন,	ডাকতেন,	
teamothy,	টিমোথি,	টিমোথি,	
gandhiir,	গান্ধীর,	গান্ধীর,	
shudhui,	শুধুই,	শুধুই,	
chire,	চিরে,	চিরে,	
crucer,	ক্রুসার,	ক্রুশের,	
tyapa,	ত্যাপ,	ট্যাপ,	
deefinishion,	ডিফিনিশন,	ডেফিনেশন,	
horidwar,	হরিদ্বার,	হরিদ্বার,	
deejeejer,	দিজেজের,	ডিজিজের,	
veenish,	ভিনিশ,	ভেনিস,	
gaujano,	গৌজানো,	গজানো,	
armstronz,	আর্মস্ট্রন্জ,	আর্মস্ট্রং,	
shrabastee,	শ্রাবস্তি,	শ্রাবস্তী,	
spancer,	স্প্যান্সার,	স্পেন্সার,	
shekender,	শেকেন্দার,	সেকেন্ডের,	
bhandti,	ভাঁদটি,	ভাণ্ডটি,	
munim,	মুনিম,	মুনিম,	
jemy,	জেমি,	জেমি,	
times,	টাইমস,	টাইমস্,	
udbhaboney,	উদ্ভাবনে,	উদ্ভাবনে,	
lagto,	ল্যাগটো,	লাগতো,	
chalchhe,	চালছে,	চলছে,	
gajetted,	গেজেট্ড,	গেজেটেড,	
oxforde,	অক্সফো্ডে,	অক্সফোর্ডে,	
basaake,	বাসাকে,	বাসাকে,	
nirbahey,	নির্বাহে,	নির্বাহে,	
qaferder,	কাফারদের,	কাফেরদের,	
laaisens,	লাইসেন্স,	লাইসেন্স,	
ghotleyo,	ঘোটলেও,	ঘটলেও,	
nagorikra,	নাগরিকরা,	নাগরিকরা,	
cholochchitra,	চলচিত্র,	চলচ্চিত্র,	
janamukhi,	জনমুখী,	জনমুখী,	
rajan,	রজন,	রাজন,	
ghumachhe,	ঘুমাছে,	ঘুমাচ্ছে,	
dojo,	দজ,	ডোজো,	
middleton,	মিডলটন,	মিডলটন,	
jotota,	যততা,	যতোটা,	
pyor,	প্যার,	পিওর,	
rupantarer,	রূপান্তরের,	রুপান্তরের,	
mesenjarer,	মেসেঞ্জরের,	মেসেঞ্জারের,	
tongaa,	টংগা,	টোঙ্গা,	
felto,	ফেলটো,	ফেলত,	
pariyech,	পারিয়েছ,	পরিয়েছ,	
erajyobasi,	এরাজ্যবাসী,	এরাজ্যবাসী,	
haris,	হারিস,	হ্যারিস,	
suisharke,	সুইশারকে,	সুইশারকে,	
rachonakal,	রচনাকাল,	রচনাকাল,	
eucalyptus,	ইউক্যাপ্লাস,	ইউক্যালিপ্টাস,	
manab,	মানব,	মানব,	
awatar,	আওয়াতার,	অবতার,	
konruup,	কন্রুপ,	কোনরূপ,	
rubidiyaam,	রুবিদিয়াম,	রুবিডিয়াম,	
daltagi,	ডালতাগি,	দলত্যাগী,	
ponchashjon,	পঞ্চাশ্যন,	পঞ্চাশজন,	
dakshinangsho,	দাক্ষিণাংশ,	দক্ষিণাংশ,	
feroza,	ফেরোজা,	ফিরোজা,	
uindos,	উইন্ডস,	উইন্ডোস,	
bisshasyi,	বিশ্বস্যী,	বিশ্বাসই,	
madrasa,	মাদরাসা,	মাদ্রাসা,	
minister,	মিনিস্টার,	মিনিস্টার,	
joubanbatee,	যৌবনবতী,	যৌবনবতী,	
zesa,	জেস,	জেস,	
lobbytey,	লবিটে,	লবিতে,	
serology,	সেরোলজি,	সেরোলজি,	
erythrian,	এরিথরিয়ান,	এরিথ্রিয়ান,	
ardasho,	আর্দাশো,	আর্দশ,	
ekirokom,	একিরকম,	একইরকম,	
gasthi,	গাস্থি,	গোষ্ঠী,	
homeser,	হোমেসের,	হোমসের,	
bhagno,	ভাগনো,	ভগ্ন,	
mosjidtir,	মসজিদটির,	মসজিদটির,	
nagarikera,	নাগারিকেরা,	নাগরিকেরা,	
protizogiita,	প্রতিযোগিতা,	প্রতিযোগীতা,	
alsaar,	আলসার,	আলসার,	
kadam,	কাদম,	কদম,	
shho,	শো,	শো,	
primoo,	প্রীমৌ,	প্রিমো,	
sthitiko,	স্থিতিকো,	স্থিতিকো,	
akram,	আকরাম,	আকরাম,	
apolokbhabe,	আপলকভাবে,	অপলকভাবে,	
aansareer,	আনসরীর,	আনসারীর,	
bhabotarini,	ভবতারিণী,	ভবতারিণী,	
nothivuktir,	নথিভুক্তির,	নথিভুক্তির,	
perri,	পেরি,	পেরি,	
sangbadmadhyame,	সংবাদমাধ্যমে,	সংবাদমাধ্যমে,	
marodeho,	মারোহে,	মরদেহ,	
ekatitto,	একাতিত্ব,	একাতিত্ব,	
siraju,	সিরাজু,	সিরাজু,	
eukalyptus,	ইউক্যালিপ্টাস,	ইউক্যালিপ্টাস,	
chalachchitra,	চলচ্ছিত্র,	চলচ্চিত্র,	
bhyaatikaner,	ভ্যাটিকানের,	ভ্যাটিকানের,	
bhromoner,	ভ্রমণের,	ভ্রমণের,	
jeelyaand,	জিল্দান্দ,	জিল্যান্ড,	
mentither,	মেন্টিথের,	মেনটিথের,	
kalirkhal,	কালিরখাল,	কালিরখাল,	
gyada,	গ্যাড,	গ্যাদা,	
ramantic,	র্যামান্টিক,	রোমান্টিক,	
peri,	পেরি,	পেরি,	
ahalyar,	আহল্যার,	অহল্যার,	
addata,	আদ্ডাটা,	আড্ডাটা,	
alexandar,	আলেক্সান্ডার,	আলেকজান্ডার,	
makong,	মাকোং,	মেকং,	
superheiroo,	সুপারহিরৌও,	সুপারহিরো,	
qyapasula,	ক্যাপাসুলা,	ক্যাপসুল,	
oitijje,	ঐতিঞ্জে,	ঐতিহ্যে,	
vaibon,	ভাইবন,	ভাইবোন,	
pleeta,	প্লেটা,	প্লেট,	
ajeeboner,	অজিবনের,	আজীবনের,	
dalnata,	দালনাটা,	ডালনাটা,	
rupert,	রুপার্ট,	রুপার্ট,	
ostheesandhi,	অস্থিসন্ধি,	অস্থিসন্ধি,	
rekhapat,	রেখাপাট,	রেখাপাত,	
lampot,	লামপোট,	লম্পট,	
sharifpur,	শরিফপুর,	শরিফপুর,	
satarkokari,	সতর্ককারী,	সতর্ককারী,	
hyaloyin,	হালোয়িন,	হ্যালোইন,	
jocqey,	জকে,	জকি,	
elaakate,	এলাকাতে,	এলাকাতে,	
graminphonor,	গ্রামিনভনোর,	গ্রামীণফোনর,	
jothon,	যথন,	যথন,	
toufiq,	তৌফিক,	তৌফিক,	
firoze,	ফিরোজ,	ফিরোজ,	
macbeth,	মাযাকবেথ,	ম্যাকবেথ,	
patishapta,	পাটিশপ্ট,	পাটিসাপটা,	
rohinibabu,	রোহিনীবাবু,	রোহিনীবাবু,	
mojdur,	মজনদুর,	মজদুর,	
ivil,	ইভিল,	ইভিল,	
champa,	চম্পা,	চাঁপা,	
taims,	টেইমস,	টাইমস্,	
maladabha,	মালাদভভা,	মলদোভা,	
rohosyoti,	রহস্যটি,	রহস্যটি,	
capshule,	কাপশুলে,	ক্যাপসুল,	
eshiyetika,	এশিয়েতিকা,	এশিয়াটিক,	
byapoktor,	ব্যপক্তর,	ব্যাপকতর,	
windo,	উইন্ডো,	উইন্ডো,	
latsaheb,	লাটসাহেব,	লাটসাহেব,	
stana,	স্টানা,	স্টোন,	
daakten,	ডাকতেন,	ডাকতেন,	
jaunotar,	যৌনতার,	যৌনতার,	
bisshaskey,	বিশশাসকে,	বিশ্বাসকে,	
gore,	গোর,	গোর,	
gingbhalobasen,	গীংভালবাসেন,	গিংভালোবাসেন,	
durarohini,	দুরারোহিনী,	দুরারোহিণী,	
impaction,	ইম্প্যাকশন,	ইমপ্যাকশন,	
jonee,	জনী,	জনি,	
sahozlabhbhotar,	সহজলভাভতার,	সহজলভ্যতার,	
sthaponagulor,	স্থাপনাগুলোর,	স্থাপনাগুলোর,	
harishankar,	হরিশঙ্কর,	হরিশংকর,	
hajeerhatt,	হাজেরহাট,	হাজিরহাট,	
lyandim,	ল্যান্ডিং,	ল্যান্ডিং,	
anandamahale,	আনন্দমহলে,	আনন্দমহলে,	
corymb,	করিম্ব,	করিম,	
holdim,	হোল্ডিম,	হোল্ডিং,	
palta,	পালতা,	পালটা,	
dapadpi,	ডাপদপি,	দাপাদপি,	
shekarmani,	শেকরমানি,	শেকরমানি,	
registrikrito,	রেজিস্ট্রিকট,	রেজিস্ট্রীকৃত,	
municipal,	মুনিসিপাল,	মিউনিসিপ্যাল,	
logotype,	লোটোপাপ,	লোগোটাইপ,	
shpredshiit,	স্পের্ডশিট,	স্প্রেডশীট,	
ishton,	ইস্টন,	স্টোন,	
pathkrom,	পাঠকরম,	পাঠক্রম,	
masjidti,	মসসিদটি,	মসজিদটি,	
chaaktir,	চাকতির,	চাকতির,	
esoosiyetasa,	এসুয়েতিসা,	এসোসিয়েটস,	
shoreefpur,	শরীফপুর,	শরিফপুর,	
prasadhoni,	প্রাসধনী,	প্রসাধনী,	
utsahamulak,	উৎসহমূলক,	উৎসাহমূলক,	
motkey,	মতকে,	মতকে,	
kadakhonchar,	কাদাখোঁচর,	কাদাখোঁচার,	
ebham,	ইভাম,	ইভিএম,	
engreziteo,	এংরজিতেতেও,	ইংরেজিতেও,	
torunosomriddho,	তরুণসমৃদ্ধ,	তরুণসমৃদ্ধ,	
anyorup,	অন্যরূপ,	অন্যরূপ,	
sadadyarao,	সদদ্যরাও,	সদদ্যরাও,	
protul,	প্রতুল,	প্রতুল,	
veemsen,	ভিমসেন,	ভীমসেন,	
planea,	প্লেন,	প্লেনে,	
neerbachoker,	নির্বাচকের,	নির্বাচকের,	
akkheperi,	আক্ষেপেরী,	আক্ষেপেরই,	
nikela,	নিকেল,	নিকেল,	
breqathru,	ব্রেক্ঠারু,	ব্রেকথ্রু,	
pathanirdeshona,	পাঠনিরদেশন,	পথনির্দেশনা,	
bupher,	বুফার,	বাফার,	
bosturoi,	বস্তুরই,	বস্তুরই,	
railliner,	রেইলাইনের,	রেললাইনের,	
byke,	বিকে,	বাইক,	
gemske,	জেমসকে,	জেমসকে,	
baarnish,	বার্নিশ,	বার্নিশ,	
conflict,	কনফ্লিক্ট,	কনফ্লিক্ট,	
kanar,	কানার,	কণার,	
ala,	আলা,	আলা,	
jeten,	জেতেন,	জেতেন,	
chalake,	চালাকে,	চালকে,	
ship,	শিপ,	শিপ,	
keyboarder,	কেইবোর্ডের,	কীবোর্ডের,	
sbajan,	স্বজন,	স্বজন,	
prarthitao,	প্রার্থিতাও,	প্রার্থীতাও,	
ispredsiit,	ইস্প্রেডিটি,	স্প্রেডশীট,	
innahu,	ইন্হানু,	ইন্নাহু,	
dooburir,	দুবুরির,	ডুবুরির,	
chitlar,	চিতলার,	চিতলার,	
ddebet,	ডিডবেট,	ডিবেট,	
pharanyeta,	ফরণ্যেতা,	ফরম্যাট,	
autopromotioner,	অটোপ্রোশনের,	অটোপ্রমোশনের,	
peethey,	পিথে,	পীঠে,	
goshthiti,	গোষ্ঠিটি,	গোষ্ঠীটি,	
sqalarashipa,	স্কলাররিপা,	স্কলারশিপ,	
dinara,	দিনারা,	ডিনার,	
proshtutkarok,	প্রষ্টুতকারক,	প্রস্তুতকারক,	
megh,	মেঘ,	মেঘ,	
jinsa,	জিনসা,	জিন্স,	
sookkho,	সুক্ষ,	সুক্ষ্ম,	
manushgulor,	মানুষগুলোর,	মানুষগুলোর,	
noditei,	নদিতেই,	নদীতেই,	
hunine,	হুনিন,	হুনাইন,	
nederlande,	নেদারল্যান্ডে,	নেদারল্যান্ডে,	
khali,	খালি,	খালি,	
graambaaseeo,	গ্রামবাসীও,	গ্রামবাসীও,	
gananatyo,	গণনাত্য,	গণনাট্য,	
kartona,	কারতনা,	করতনা,	
nirabota,	নিরাবতা,	নিরবতা,	
agomone,	আগমনে,	আগমনে,	
rilayensa,	রিলায়েনসা,	রিলায়েন্স,	
kormoke,	করমকে,	কর্মকে,	
homshke,	হোমশকে,	হোমসকে,	
ashanka,	আশাঙ্কা,	আশংকা,	
valobasen,	ভালোবাসেন,	ভালোবাসেন,	
jommu,	জম্মু,	জম্মু,	
rakhtokkharone,	রাক্ষকক্ষরণে,	রক্তক্ষরণে,	
lishenshe,	লিশেনশে,	লাইসেন্স,	
reejideencee,	রিজিডিন্সে,	রেসিডেন্স,	
bhangchur,	ভাংচুর,	ভাংচুর,	
mach,	মাচ,	মাছ,	
dristiheen,	দৃষ্টিহীন,	দৃষ্টিহীন,	
ghatla,	ঘাটলা,	ঘটল,	
tyap,	ত্যাপ,	ট্যাপ,	
nirmankarmisaha,	নির্মকরণমীসহ,	নির্মাণকর্মীসহ,	
ponchaasjon,	পঞ্চাসজন,	পঞ্চাশজন,	
jaubankal,	যৌবনকাল,	যৌবনকাল,	
susamo,	সুসামো,	সুসম,	
pyatarne,	প্যাটার্নে,	প্যাটার্নে,	
nodiiteyi,	নদীতেই,	নদীতেই,	
emargency,	এমরগজেন্সী,	এমার্জেন্সি,	
geja,	গেজ,	গেজ,	
itastata,	ইটস্ততা,	ইতস্তত,	
dhyana,	ধ্যান,	ধ্যান,	
byomkes,	ব্যমোকেস,	ব্যোমকেশ,	
terlarang,	তেররাং,	তেরলারং,	
asaciates,	অ্যাসিয়েটেস,	এসোসিয়েটস,	
shilbar,	শিলবার,	সিলভার,	
definition,	ডিফিনিশন,	ডেফিনেশন,	
guzober,	গুজববের,	গুজবের,	
omkar,	ওমকার,	ওঙ্কার,	
gaddaafee,	গাদ্দাফি,	গাদ্দাফী,	
srk,	স্কেক,	শাহরুখ,	
uzobekeestaan,	উজোবেক্তসান,	উজবেকিস্তান,	
orbi,	অরবি,	ওরবি,	
lat,	ল্যাট,	লাট,	
atmabishvashi,	আত্মবিশভাষী,	আত্মবিশ্বাসী,	
himchi,	হিমচি,	হিমচি,	
bisheshshyer,	বিশেষ্যের,	বিশেষ্যের,	
chaudhuriyo,	চৌদুরীয়,	চৌধুরীও,	
iqbalke,	ইকবালকে,	ইকবালকে,	
jaaygata,	জায়গা,	জায়গাটা,	
rajbondir,	রাজবন্দির,	রাজবন্দীর,	
probhritike,	প্রভৃতিকে,	প্রভৃতিকে,	
sten,	স্টেন,	স্টেন,	
prokolpoti,	প্রকল্পটি,	প্রকল্পটি,	
khoor,	খুর,	ক্ষুর,	
refleks,	রেফলেক্স,	রিফ্লেক্স,	
machgulo,	মাছগুলো,	মাছগুলো,	
chhadura,	ছাদুরা,	ছাদুরা,	
dibya,	দিব্যা,	দিব্যা,	
parikhar,	পারিখার,	পরিখার,	
vushito,	ভুশিত,	ভূষিত,	
ekoirokom,	একৈরকম,	একইরকম,	
phormat,	ফোর্মাত,	ফরম্যাট,	
dajjha,	দাজ্ঝা,	দাহ্য,	
sausage,	সাওযাজে,	সসেজ,	
meghachchanno,	মেঘচ্ছান্ন,	মেঘাচ্ছন্ন,	
bhramapraban,	ভ্রমপ্রবণ,	ভ্রমপ্রবণ,	
marathi,	মারাথি,	মরাঠি,	
abanishankar,	অবনিশঙ্কর,	অবনিশংকর,	
naobihar,	নাওবিহার,	নৌবিহার,	
sayanaida,	সায়ানইদা,	সায়ানাইড,	
promodwara,	প্রমদ্বারা,	প্রমদ্বারা,	
narsaari,	নরসারী,	নার্সারি,	
ajij,	আজিজ,	আজিজ,	
laps,	লাপস,	ল্যাপস,	
oncoleo,	অঙ্কলেও,	অঞ্চলেও,	
bihar,	বিহার,	বিহার,	
gardeen,	গার্ডিন,	গার্ডেন,	
bethikata,	বেঠিকতা,	বেঠিকতা,	
jeshtha,	জেশথা,	জ্যেষ্ঠা,	
parther,	পার্থের,	পার্থের,	
standards,	স্ট্যান্ডার্ডসহ,	স্টান্ডার্ডস,	
armashtram,	আর্মস্ত্রম,	আর্মস্ট্রং,	
shangsthaner,	সাংস্থানের,	সংস্থানের,	
barnis,	বার্নিস,	বার্নিশ,	
neshadrabyer,	নেশাদ্রব্যের,	নেশাদ্রব্যের,	
taunsheep,	টাউনশীপ,	টাউনশিপ,	
ixprission,	এইপ্সপ্রশিন,	এক্সপ্রেশন,	
utkhaat,	উৎকাাত,	উত্খাত,	
poddhotiteyi,	পদ্ধতিতেই,	পদ্ধতিতেই,	
cholechi,	চলেছি,	চলেছি,	
recondishon,	রেকনডিশন,	রিকন্ডিশন,	
oncholgulir,	অনচলগুলির,	অঞ্চলগুলির,	
niknayman,	নিক্নয়মন,	নিকনেইমান,	
ancholsaha,	আঁচলোসহ,	অঞ্চলসহ,	
bhramarotsab,	ভ্রামোৎসব,	ভ্রমরোৎসব,	
ganochien,	গানিচোয়েন,	গণচীন,	
gobeshana,	গোবেনা,	গবেষনা,	
shatoke,	শতকে,	শতকে,	
bedanta,	বেদান্ত,	বেদান্ত,	
mukhmondole,	মুখমন্ডলে,	মুখমণ্ডলে,	
teemothy,	তেমোথি,	টিমোথি,	
horippur,	হরিপুর,	হরিপুর,	
maudelti,	মাদেলটি,	মডেলটি,	
sangasthagulo,	সংস্থাগুলো,	সংস্থাগুলো,	
ispreedshiit,	ইস্প্রিডিটি,	স্প্রেডশীট,	
musallati,	মুসল্লাতি,	মুসল্লাটি,	
mankisundar,	মান্িসুন্দর,	মানকিসুন্দর,	
edmiral,	ইদমিরাল,	এডমিরাল,	
philo,	ফিলো,	ফিলো,	
bondishalatei,	বন্দিশালাতেই,	বন্দিশালাতেই,	
flexta,	ফ্লেস্ট,	ফ্লেক্সটা,	
shrabosty,	শ্রাবসটি,	শ্রাবস্তী,	
shahabike,	শাহাবীকে,	সাহাবীকে,	
bharpur,	ভারপুর,	ভরপুর,	
obosorer,	অবসরের,	অবসরের,	
probondhobhittik,	প্রবন্ধভিত্তিক,	প্রবন্ধভিত্তিক,	
paroner,	পারণের,	পারণের,	
peeth,	পিঠ,	পীঠ,	
nathibhuktir,	নথিভুক্তির,	নথিভুক্তির,	
baibasthaar,	বাইবাস্থার,	ব্যবস্থার,	
seconder,	সেকন্ডের,	সেকেন্ডের,	
poorohitder,	পুরহিতদের,	পুরোহিতদের,	
cheef,	চিফ,	শেফ,	
shariba,	শারিবা,	শরিবা,	
talaal,	তালাল,	তালাল,	
rudroke,	রুদ্রকে,	রুদ্রকে,	
jamjomat,	জামজোমাট,	জমজমাট,	
achintyabhedaved,	অচিন্ত্যভাদেব,	অচিন্ত্যভেদাভেদ,	
kommandar,	কোমনন্দর,	কমাণ্ডার,	
akkharkey,	অক্ষরকে,	অক্ষরকে,	
kailashrao,	কৈলশ্ররও,	কৈলাশরাও,	
hosne,	হোসন,	হোসনে,	
orhan,	ওরহান,	ওরহান,	
bonvumi,	বনভুমী,	বনভূমি,	
postay,	পোস্টে,	পোস্টে,	
bachhaikrito,	বাছাইকৃত,	বাছাইকৃত,	
kirke,	কিরকে,	কিরকে,	
orgho,	ওরঘো,	অর্ঘ্য,	
gabinius,	গাবিনিয়াস,	গাবিনিআস,	
ekla,	একলা,	একলা,	
chhooteete,	ছোটতে,	ছুটিতে,	
janar,	জানার,	জানার,	
dhani,	ধাী,	ধানি,	
plasse,	প্লাস,	প্লাসে,	
ashok,	আশক,	আশোক,	
andra,	আন্দ্রা,	আন্ড্রা,	
krush,	ক্রুশ,	ক্রুশ,	
stander,	স্ট্যান্ডার,	স্ট্যাণ্ডের,	
annimated,	এ্যানিমেটেড,	এনিমেটেড,	
qlauda,	ক্লাউডা,	ক্লাউড,	
himsrot,	হিমস্রোত,	হিমস্রোত,	
dakticket,	ডাক্টিকেট,	ডাকটিকিট,	
mononiitoder,	মনোনীতদের,	মনোনীতদের,	
sangram,	সংগ্রাম,	সঙ্গ্রাম,	
atmiyasulabh,	আত্মীয়সুলভ,	আত্মীয়সুলভ,	
osomorthito,	অসমর্থিত,	অসমর্থিত,	
rijoor,	রিজুর,	রিজুর,	
bangulzai,	বানগুলজাই,	বঙ্গুলিজাই,	
nabatamo,	নবতামো,	নবতম,	
laishensha,	লাইেশশ্,	লাইসেন্স,	
kloud,	ক্লাউড,	ক্লাউড,	
potka,	পটকা,	পটকা,	
dito,	দিতো,	দিতো,	
janmat,	জন্মত,	জন্মাত,	
bolechile,	বলেছিলে,	বলেছিলে,	
byabosthar,	ব্যবস্থার,	ব্যাবস্থার,	
baffer,	ব্যাফার,	বাফার,	
bangladesh,	বাংলাদেশ,	বঙ্গালাদেস,	
johor,	জহর,	জহর,	
dholeshwari,	ধোলেশ্বরী,	ধলেশ্বরী,	
nobotom,	নবতম,	নবতম,	
aborto,	আবর্ত,	আবর্ত,	
jaistho,	যাইশ্থ,	জ্যৈষ্ঠ,	
kormoi,	কর্মই,	কর্মই,	
khuizza,	খুইজ্জা,	খুইজ্জা,	
arekdol,	আরেকডল,	আরেকদল,	
install,	ইনস্টাল,	ইন্সটল,	
vaider,	ভাইদের,	ভাইদের,	
charpanch,	চারপাঞ্চ,	চারপাঁচ,	
byabaharkaree,	ব্যবহারকারী,	ব্যবহারকারী,	
venisey,	ভেনিস,	ভেনিসে,	
ishter,	ইসততের,	ইস্টের,	
steeit,	স্তিত,	স্টেইট,	
parinati,	পরিণাটি,	পরিণতি,	
charger,	চার্গের,	চার্জার,	
paira,	পাইরা,	পাইরা,	
degreeo,	ডেগ্রিও,	ডিগ্রিও,	
donat,	ডোনাত,	ডোনাট,	
toroonra,	তরূণরা,	তরুণরা,	
nodnodeer,	নদনদীর,	নদনদীর,	
bosante,	বসন্তে,	বসন্তে,	
muhurtati,	মুহুরতাটি,	মুহুর্তটি,	
bosontoke,	বসন্তকে,	বসন্তকে,	
suchanakal,	সূচনকাল,	সূচনাকাল,	
lettere,	লেটার,	লেটারে,	
tintikey,	তিনটিকে,	তিনটিকে,	
notey,	নোটে,	নোটে,	
cbi,	সিবিআই,	সিবিআই,	
tuni,	তুনী,	টুনি,	
baet,	বেইট,	বাইট,	
ekbakye,	একবাক্যে,	একবাক্যে,	
fimela,	ফিমেলা,	ফিমেল,	
teta,	টেট,	টেটা,	
baipass,	বাইপাস,	বাইপাস,	
aarmstrong,	আর্মস্ট্রং,	আর্মস্ট্রং,	
atibiplabi,	আতিবিপ্লবী,	অতিবিপ্লবি,	
sardar,	সারদার,	সরদার,	
pradoshik,	প্রদদশিক,	প্রাদশিক,	
sumitrar,	সুমিত্রার,	সুমিত্রার,	
shulfate,	শুলফাতে,	সালফেট,	
chomski,	চমস্কি,	চমস্কি,	
besirvagei,	বেসিরভাগেই,	বেশিরভাগেই,	
romnar,	রোমনার,	রমনার,	
marri,	মারি,	ম্যারি,	
progresh,	প্রগ্রেশ,	প্রগ্রেস,	
juktorashtreo,	যুক্তরাশ্রেরও,	যুক্তরাষ্ট্রেও,	
chaalaabi,	চালাবি,	চালাবে,	
atak,	আটাক,	আটক,	
graambaaseer,	গ্রামবাসীর,	গ্রামবাসীর,	
cheento,	চেন্টো,	চিনতো,	
granthatyke,	গ্রানথাটিকে,	গ্রন্থটিকে,	
doltyagi,	দলত্যাগি,	দলত্যাগী,	
proshtotto,	প্রষ্টত্ব,	প্রস্ত্তত,	
somonnitobhabe,	সমন্নিতভাবে,	সমন্বিতভাবে,	
taholo,	তাহোলো,	তাহলো,	
esprito,	এসপ্রিত,	এস্পিরিটো,	
shlok,	শ্লোক,	শ্লোক,	
trenda,	ট্রেন্ড,	ট্রেন্ড,	
weenis,	উইনিস,	ভেনিস,	
promothesh,	প্রমতেশ,	প্রমথেশ,	
nothiboddho,	নথিবদ্ধ,	নথিবদ্ধ,	
nirbaaho,	নির্বাহ,	নির্বাহ,	
bossonte,	বসন্তে,	বসন্তে,	
lakkhero,	লক্ষেরও,	লক্ষেরও,	
choukato,	চৌকাতো,	চৌকাত,	
premo,	প্রেমো,	প্রিমো,	
mexicoteo,	মেক্সিকোতেও,	মেক্সিকোতেও,	
aflatoxin,	আফলাটক্সিন,	আ্যফ্ল্যাটক্সিন,	
poorohitra,	পুরহিত্র,	পুরোহিতরা,	
vittiteo,	ভিত্তিতেও,	ভিত্তিতেও,	
query,	কোয়েরি,	কোয়েরি,	
parisankhanbid,	পরিসংখ্যানিদ,	পরিসংখ্যানবিদ,	
pracharanamulak,	প্রচারণমূলক,	প্রচারণামূলক,	
digreeke,	ডিগ্রীকে,	ডিগ্রিকে,	
nodiitei,	নদীতেই,	নদীতেই,	
chyeta,	চ্যাট,	চ্যাট,	
byabaharkareer,	ব্যবহারকারীর,	ব্যবহারকারীর,	
ardasha,	আর্দাশা,	আর্দশ,	
taffsherer,	তাফশারের,	তাফসীরের,	
sector,	সেক্টর,	সেক্টর,	
uporoshtho,	উপরস্থ,	উপরস্থ,	
lotharan,	লোথারন,	লুথেরান,	
siima,	সিমা,	সীমা,	
ancholgoolote,	অঞ্চলগুলোতে,	অঞ্চলগুলোতে,	
baptics,	ব্যাপটিক্স,	ব্যাপটিকস,	
bhenus,	ভেনুস,	ভেনাস,	
hughes,	হুগেস,	হিউজেস,	
nariider,	নারীদের,	নারীদের,	
opohoron,	অপহরণ,	অপহরন,	
heena,	হীনা,	হেনা,	
myat,	মিট,	ম্যাট,	
nirarthak,	নিরার্থক,	নিরর্থক,	
bhittow,	ভিত্তূ,	ভিত্তিও,	
shikshagato,	শিক্ষাগত,	শিক্ষাগত,	
dharavahikbhabe,	ধারাবাহিকভাবে,	ধারাবাহিকভাবে,	
quata,	কোয়াটা,	কোটা,	
goteehin,	গতিহীন,	গতিহীন,	
oshtader,	অষ্টাদের,	ওস্তাদের,	
mmadhuri,	মমধুরী,	মাধুরী,	
durotamo,	দুরতম,	দূরতম,	
kadapaker,	কাড়াপাকের,	কড়াপাকের,	
pratisthanik,	প্রতিত্ঠানিক,	প্রাতিষ্ঠানিক,	
niutrino,	নাউট্রিনো,	নিউট্রিনো,	
ashociatesh,	অ্যাসোয়েটেস,	এসোসিয়েটস,	
soorsa,	সূর্স,	সোর্স,	
nopdnodir,	নপডনোডির,	নদনদীর,	
freelancerra,	ফ্রীল্যান্সরা,	ফ্রিল্যান্সাররা,	
timoothi,	তিমোথি,	টিমোথি,	
gabhaaskar,	গাভাস্কার,	গাভাস্কার,	
alpo,	অ্যালপো,	অল্প,	
ranangane,	রণনঙ্গনে,	রণাঙ্গনে,	
vedanta,	ভেদান্ত,	বেদান্ত,	
aakabar,	আকাবার,	আকাবার,	
upobashii,	উপবাশী,	উপবাসী,	
dovaar,	ডোভার,	ডোভার,	
bhimsenkei,	ভীমসেনকেই,	ভীমসেনকেই,	
karu,	কারু,	কারু,	
backflipe,	ব্যাকফ্লিপে,	ব্যাকফ্লিপে,	
landey,	ল্যান্ডে,	ল্যান্ডে,	
ghoshanapatratio,	ঘোষণাপত্রটিও,	ঘোষণাপত্রটিও,	
upobasee,	উপবাসে,	উপবাসী,	
deenesh,	দীনেশ,	দীনেশ,	
epiela,	এপিয়েল,	আইপিএল,	
ramolino,	রোমোলিনো,	রামোলিনো,	
musalmanderke,	মুসলমানদেরকে,	মুসলমানদেরকে,	
lokhindorer,	লখিন্ডরের,	লখিন্দরের,	
armori,	আরমোরি,	আরমোরি,	
tarkareer,	তরকারীর,	তরকারীর,	
bhadaka,	ভাড়াকা,	ভদকা,	
niphelheim,	নিফেলহাইম,	নিফেলহেইম,	
quota,	কুয়াতা,	কোটা,	
ancholtike,	আঞ্চলটিকে,	অঞ্চলটিকে,	
abadamoner,	আবাদামনের,	অবদমনের,	
kruser,	ক্রুসের,	ক্রুশের,	
bonbhumi,	বনভূমি,	বনভূমি,	
horiddare,	হরিদ্দারে,	হরিদ্বারে,	
guzon,	গুজন,	গুজব,	
kaamij,	কামিজ,	কামিজ,	
phonekari,	ফোনেকারি,	ফোনকারী,	
aakaabar,	আকাবার,	আকাবার,	
rashedul,	রশেদুল,	রাশিদুল,	
manibhaijaner,	মণিভাইজানের,	মণিভাইজানের,	
sadbi,	সাদবি,	সাধ্বী,	
arthurer,	অর্থুরের,	আর্থারের,	
elaakaa,	এলাকা,	এলাকা,	
directorate,	ডাইরেক্টরেট,	ডিরেক্টরেট,	
chilona,	চিলনা,	ছিলনা,	
dagmukta,	দাগমুক্ত,	দাগমুক্ত,	
breel,	ব্রিল,	ব্রিল,	
chhutir,	ছুটির,	ছুটির,	
drabyatah,	দ্রাব্যতঃঃ,	দ্রব্যতঃ,	
aansaareer,	আনসারীর,	আনসারীর,	
desiseyer,	দেসিসযয়ের,	ডিজিজের,	
bijepi,	বিজেপি,	বিজেপি,	
shringge,	শ্রিং,	শৃঙ্গে,	
baait,	বাইত,	বাইট,	
shitei,	শিতেই,	শীতেই,	
kod,	কোড,	কোড,	
poschimey,	পশ্চিমে,	পশ্চিমে,	
cholochchitrai,	চলচ্চিত্রায়,	চলচ্চিত্রই,	
sylvi,	সিলভি,	সিলভি,	
poscater,	পোস্কেটের,	পশ্চাতের,	
bojhaao,	বোঝাও,	বোঝাও,	
prarthonakokkher,	প্রার্থনাকক্ষের,	প্রার্থনাকক্ষের,	
probolshoktio,	প্রবলশক্তিও,	প্রবলশক্তিও,	
oxite,	অক্সিতে,	অক্সাইট,	
orrgho,	অর্ঘ,	অর্ঘ্য,	
upobaasee,	উপবাসে,	উপবাসী,	
keyu,	কেই,	কেউ,	
tasminer,	তাসমিনের,	তাসমিনের,	
fotanor,	ফতানোর,	ফোটানোর,	
thyachara,	থ্যাচার,	থ্যাচার,	
nothibhukto,	নথিভুক্ত,	নথিভুক্ত,	
caroline,	ক্যারোলিন,	ক্যরোলিন,	
harees,	হারিস,	হ্যারিস,	
nirikh,	নিরিখ,	নিরিখ,	
nojder,	নজদার,	নজদের,	
porobortii,	পরবর্তীই,	পরর্বতী,	
khaschandpur,	খশচন্দপুর,	খাসচাঁদপুর,	
ooporoshtho,	অপরস্থ,	উপরস্থ,	
saptahokal,	সপ্তাহোকাল,	সপ্তাহকাল,	
byomkesh,	ব্যমকিশেষ,	ব্যোমকেশ,	
shiulijhra,	শিউলিঝরা,	শিউলিঝরা,	
amorendro,	অমরণেন্দ্র,	অমরেন্দ্র,	
prakar,	প্রকর,	প্রকার,	
serup,	সেরূপ,	সেরূপ,	
graambasi,	গ্রামবাসী,	গ্রামবাসী,	
neelfamarir,	নীলফামারির,	নীলফামারীর,	
selim,	সেলিম,	সেলিম,	
annorup,	অন্ররূপ,	অন্যরূপ,	
sipa,	সিপা,	শিপ,	
irish,	ইরিশ,	আইরিস,	
jaandrel,	যাঁদ্রেল,	জাঁদরেল,	
tistar,	তিস্তার,	তিস্তার,	
shaddhi,	শাদ্ধি,	সাধ্বী,	
muhaiminer,	মুহাইমিনের,	মুহাইমিনের,	
chilahatee,	চিলাহাতে,	চিলাহাটি,	
sectore,	সেক্টরে,	সেক্টরে,	
bm,	বিএমএ,	বিএম,	
orthisoho,	অর্থিসহ,	অর্থিসহ,	
gotihin,	গতিহীন,	গতিহীন,	
abhiyojan,	অভিযোজন,	অভিযোজন,	
manob,	মানব,	মানব,	
orthanitir,	অর্থানীতির,	অর্থনীতির,	
ajibooner,	অজিবুনের,	আজীবনের,	
osthishondhi,	অস্থিনন্ধি,	অস্থিসন্ধি,	
hugeke,	হুয়েকে,	হিউজকে,	
nyata,	ন্যাট,	ম্যাট,	
agomonke,	আগমনকে,	আগমনকে,	
boudher,	বৌধের,	বৌদ্ধের,	
ghoomachhe,	ঘোমছে,	ঘুমাচ্ছে,	
sahojlovyotar,	সহজলোভ্যতার,	সহজলভ্যতার,	
seebiai,	সিবিয়াই,	সিবিআই,	
jarmaniteo,	জারানাতেও,	জার্মানিতেও,	
mukhya,	মুখ্যা,	মুখ্য,	
mojlish,	মজলিশ,	মজলিশ,	
mahasava,	মহাসভ,	মহাসভা,	
aziza,	আজিজা,	আজিজা,	
maktum,	মাক্তুম,	মাকতুম,	
chikittsar,	চিকিৎসার,	চিকিত্সার,	
infarmatian,	ইনফরমেেশায়ান,	ইনফরমেশন,	
marketing,	মার্কেটিং,	মার্কেটিং,	
kekru,	কেকরু,	কেকরু,	
browser,	ব্রাউসের,	ব্রাউজার,	
nomo,	নোমো,	নমো,	
paab,	পাব,	পাব,	
safiin,	সাফিন,	সাফিন,	
bosano,	বসানো,	বসানো,	
ruby,	রূবি,	রুবী,	
moddhyoshtho,	মধ্যস্থ,	মধ্যস্থ,	
kogake,	কোগাকে,	কোগাকে,	
evaner,	ইভানের,	ইভানের,	
nikate,	নিকাতে,	নিকটে,	
codee,	কোডি,	কোডে,	
govindarajan,	গোবিন্দরাজন,	গোবিন্দরাজন,	
rajotwo,	রাজত্ব,	রাজত্ব,	
soori,	সুরী,	সুরি,	
drissogulote,	দৃশসগুলোতে,	দৃশ্যগুলোতে,	
rifleksa,	রিফলেকসা,	রিফ্লেক্স,	
venuser,	ভেনুসের,	ভেনাসের,	
shomostigoto,	সমস্তিগত,	সমষ্টিগত,	
gonjona,	গনজনা,	গঞ্জনা,	
khoakshir,	খোয়াক্ষির,	খোয়াক্ষীর,	
samany,	সামানি,	সামান্য,	
jontropatigulite,	যন্ত্রপাতিগুলিতে,	যন্ত্রপাতিগুলিতে,	
bakhyateet,	বাখ্যাতিত,	ব্যাখ্যাতীত,	
sealvi,	সেলভি,	সিলভি,	
nothibhukteer,	নথিভুক্তির,	নথিভুক্তির,	
nirmolotaa,	নির্মলতা,	নির্মলতা,	
hoil,	হইল,	হইল,	
lekhaksattwar,	লেখকসত্ত্বর,	লেখকসত্ত্বার,	
soinyora,	সৈন্যরা,	সৈন্যরা,	
bipti,	বিপ্তি,	বিপ্তি,	
qarpeta,	কারপেটা,	কার্পেট,	
poketchorder,	পকেটচর্ডের,	পকেটচরদের,	
shkalarashhipa,	স্কারারশিপ,	স্কলারশিপ,	
sikarder,	সিকারদের,	শিকারদের,	
sikkharrtheerao,	শিক্ষার্থীরাও,	শিক্ষার্থীরাও,	
jatinke,	জাতিনকে,	যতীনকে,	
mumtaz,	মুমতাজ,	মুমতাজ,	
firoza,	ফিরোজা,	ফিরোজা,	
seramiks,	সেরামিক্স,	সিরামিকস,	
parking,	পারকিং,	পার্কিং,	
banshite,	বাঁশীতে,	বাঁশিতে,	
foks,	ফকস,	ফক্স,	
antarctica,	আন্টার্টকাক,	অ্যান্টার্কটিকা,	
pack,	পাক,	প্ল্যাক,	
debdebier,	দেবদেবিয়ের,	দেবদেবীর,	
ponjikar,	পন্জিকার,	পঞ্জিকার,	
modele,	মডেল,	মডেলে,	
ganaporibahaner,	গণপরিবহণের,	গণপরিবহনের,	
horipur,	হরিপুর,	হরিপুর,	
bsnleu,	বিএসএনএলএন,	বিএসএনএলইইউ,	
jeebnagore,	জীবনাগরে,	জীবননগর,	
dibet,	দিবেত,	ডিবেট,	
badhamuktovabe,	বাধাুক্তভাবে,	বাধামুক্তভাবে,	
oswasteekor,	অস্বাস্তকর,	অস্বস্তিকর,	
jaadrel,	যাদরেল,	জাঁদরেল,	
asociatis,	অ্যাসাইটিস,	এসোসিয়েটস,	
dara,	দারা,	দারা,	
kichudinpar,	কিছুদিনপার,	কিছুদিনপর,	
thailand,	থাইলান্ড,	থাইল্যান্ড,	
karpeter,	কারপেটের,	কার্পেটের,	
akpaase,	আকপাসে,	একপাশে,	
dreeshtiheen,	দৃষ্টিহীন,	দৃষ্টিহীন,	
shahidputra,	সহিদপুত্র,	শহীদপুত্র,	
chowdhuryke,	চৌধুরীকে,	চৌধুরীকে,	
ashamarthita,	অশমরর্থিত,	অসমর্থিত,	
brahmanera,	ব্রহ্মণেরা,	ব্রাহ্মণেরা,	
diniphition,	ডানিফিশন,	ডেফিনেশন,	
somoibo,	সময়ব,	সমৈব,	
vaphara,	ভাফারা,	বাফার,	
hamburgey,	হামবুর্গে,	হামবুর্গে,	
uporzon,	উপরজন,	উপার্জন,	
soinyo,	সৈন্য,	সৈন্য,	
daacktickete,	ড্যাকটিকেটে,	ডাকটিকিটে,	
mirina,	মিরেনা,	মিরিনা,	
nilfamarir,	নীলফামরির,	নীলফামারীর,	
protisthan,	প্রতিষ্ঠান,	প্রতিষ্টান,	
ispredseet,	ইস্প্রেডজিত,	স্প্রেডশীট,	
samyuktha,	সম্যুক্থ,	সামিউক্তা,	
engrejer,	এংগ্রেজের,	ইংরেজের,	
zakharovar,	যাখারোভার,	জাখারোভার,	
songrahak,	সংগ্রহক,	সংগ্রাহক,	
arshie,	আর্শি,	আরসিএ,	
swartho,	স্রার্থ,	স্বার্থ,	
gronthoti,	গ্রন্থটি,	গ্রন্থটি,	
protibedokrao,	প্রতিবেদকরাও,	প্রতিবেদকরাও,	
graambashee,	গ্রামবাশী,	গ্রামবাসী,	
shishupalgarh,	শিশুপললগর,	শিশুপালগড়ে,	
dwijenbabuder,	দ্বিজেনবাবুদের,	দ্বিজেনবাবুদের,	
