towraat,	তোরাট,	তওরাত,	
platform,	প্লাটফর্ম,	প্লাটফর্ম,	
diiptii,	দিপপিত,	ডেপুটি,	
syfy,	সিফি,	সাইফাই,	
anhu,	আনহু,	আনহু,	
byaboharkarir,	ব্যবহারকারীর,	ব্যবহারকারীর,	
black,	ব্ল্যাক,	ব্ল্যাক,	
ashiatic,	এ্যাসিয়াটিক,	এশিয়াটিক,	
bosano,	বসানো,	বসানো,	
doorotomo,	দররতম,	দূরতম,	
fising,	ফিসিং,	ফিসিং,	
ghumachchila,	ঘুমাচ্ছিলা,	ঘুমাচ্ছিল,	
daap,	ডাযাপ,	ড্যাপ,	
sangbadmadhyamgulote,	সংবাদমাধ্যমগুলোতে,	সংবাদমাধ্যমগুলোতে,	
anchalsaho,	আঞ্চলসাহ,	অঞ্চলসহ,	
torkarir,	তর্কারির,	তরকারীর,	
karmakarke,	কর্মকরকে,	কর্মকারকে,	
ghoor,	ঘোর,	ঘুর,	
samle,	সমলে,	সামলে,	
asiatic,	অ্যাসিয়াটিক,	এশিয়াটিক,	
bardhitansh,	বার্ধিতাশ,	বর্ধিতাংশ,	
nyeta,	নেততা,	ম্যাট,	
bhaibon,	ভাইবন,	ভাইবোন,	
rokkhonabekkhoner,	রক্ষণাবেষকনের,	রক্ষণাবেক্ষণের,	
rushad,	রুশাদ,	রুশদ,	
gaichey,	গাইছে,	গাইছে,	
foreks,	ফোরেকস,	ফরেক্স,	
grambaaseeder,	গ্রামবাসীদের,	গ্রামবাসীদের,	
bikretaara,	বিক্রেতারা,	বিক্রেতারা,	
bishnoo,	বিষ্ণু,	বিষ্ণু,	
grushko,	গ্রুশ্ক,	গ্রুশকো,	
suhayeler,	সুহায়েলের,	সুহায়েলের,	
rajshri,	রাজশ্রী,	রাজশ্রী,	
morodeho,	মরদেহো,	মরদেহ,	
haridware,	হরিদ্বরে,	হরিদ্বারে,	
biprodas,	বিপ্রদাস,	বিপ্রদাস,	
ganohotyake,	গণহত্যাকে,	গণহত্যাকে,	
khorsed,	খোরসেদ,	খোরশেদ,	
angshogrohon,	অংশগ্রহণ,	অংশগ্রহন,	
shipley,	শিপলে,	শিপলে,	
siddharther,	সিদ্ধার্থের,	সিদ্ধার্থের,	
prothati,	প্রথাটি,	প্রথাটি,	
sikarder,	শিকারদের,	শিকারদের,	
lidars,	লিডারস,	লিডার্স,	
somraatra,	সম্রাত্র,	সম্রাটরা,	
pulivendla,	পুলিভেন্ডলা,	পুলিভেন্ডলা,	
argead,	আর্জিড,	আর্জিদ,	
shiulijhra,	শিউলিঝরা,	শিউলিঝরা,	
kade,	কাদে,	কোড,	
sadbi,	সাদবি,	সাধ্বী,	
welaqama,	ওয়ালাম,	ওয়েলকাম,	
bane,	বানে,	বনে,	
niropekshtar,	নিরপেক্ষাতর,	নিরপেক্ষতার,	
thare,	থারে,	থরে,	
pachchi,	পঞ্চচি,	পাচ্ছি,	
klaud,	ক্যাউড,	ক্লাউড,	
juktorastrer,	যুক্তরস্ত্রের,	যুক্তরাষ্ট্রের,	
medilek,	মেদিলেক,	মেডিলেক,	
pharanyeta,	ফহানেয়েতা,	ফরম্যাট,	
barbadoj,	বারবাদজ,	বার্বাডোজ,	
lakshmir,	লক্ষ্মীর,	লক্ষ্মীর,	
venkates,	ভেঙ্কেটেস,	ভেঙ্কটেশ,	
drabyatah,	দ্রাব্যতঃ,	দ্রব্যতঃ,	
modhumotii,	মধুমতিই,	মধুমতী,	
byaboharkarike,	ব্যবহারকারীকে,	ব্যবহারকারীকে,	
shashtra,	শাস্ত্রা,	শাস্ত্র,	
awrbit,	আবরীত,	অরবিট,	
dera,	দেরা,	ডেরা,	
camerapersoner,	ক্যামেরাপারসেনের,	ক্যামেরাপার্সনের,	
vitti,	ভিত্তি,	ভিত্তিই,	
ekla,	একলা,	একলা,	
elaakaa,	এলাকা,	এলাকা,	
install,	ইনস্টাল,	ইন্সটল,	
osomorthito,	অসমর্থিত,	অসমর্থিত,	
daaktikit,	দাক্িিি,	ডাকটিকিট,	
lopjonito,	লম্পজিত,	লোপজনিত,	
kaathhmaandute,	কা্মধন্ুুতে,	কাঠমান্ডুতে,	
sangbadmadhyomgulote,	সংবাদমাধ্যমগুলোতে,	সংবাদমাধ্যমগুলোতে,	
as,	আসএস,	অস,	
ramonar,	রামনার,	রমনার,	
osamarik,	ওসামারিক,	অসামরিক,	
dajhyo,	দাঝ্য,	দাহ্য,	
chaalkee,	চালকি,	চালকে,	
rata,	রাটা,	রত,	
qonfliqt,	কনফসিক্ট,	কনফ্লিক্ট,	
kalkarkhana,	কলকারখানা,	কলকারখানা,	
spredashiita,	স্প্রেডশাইটা,	স্প্রেডশীট,	
bisheshyo,	বিষেষ্য,	বিশেষ্য,	
kolkarkhana,	কোলকারখানা,	কলকারখানা,	
gondogol,	গঙ্গডোল,	গন্ডগোল,	
spashtotai,	স্পষ্টটায়,	স্পষ্টতই,	
lagche,	লাগচে,	লাগছে,	
bikargrasta,	বিকারগ্রাত্ত,	বিকারগ্রস্ত,	
osommotite,	অসম্মতিতে,	অসম্মতি,	
opohoron,	অপহরণ,	অপহরন,	
machhti,	মাছটি,	মাছটি,	
anyarup,	অন্যরূপ,	অন্যরূপ,	
sombhobonaao,	সম্ভবনাও,	সম্ভবনাও,	
sommotitey,	সম্মতিতে,	সম্মতিতে,	
gonjona,	গঞ্জনা,	গঞ্জনা,	
pray,	প্রয়,	প্রায়,	
muradpur,	মুরাদপুর,	মুরাদপুর,	
kyatagorir,	ক্যাটাগরির,	ক্যাটাগরির,	
gazetted,	গ্যাজেটদে,	গেজেটেড,	
byabaharkareederke,	ব্যবহারকরীদেরকে,	ব্যবহারকারীদেরকে,	
katateo,	কাটাতেও,	কাটাতেও,	
disni,	ডিসনি,	ডিজনী,	
jonomukhi,	জনমুখী,	জনমুখী,	
mitrota,	মিত্রটা,	মিত্রতা,	
chalachchitro,	চলচ্চিত্র,	চলচ্চিত্র,	
bade,	বাদে,	বাদে,	
probeshkari,	প্রবেশকারী,	প্রবেশকারী,	
sobrakamer,	সব্রাামের,	সবরকমের,	
concerter,	কনসার্টের,	কানসাটের,	
redcrosser,	রেডক্সরসের,	রেডক্রসের,	
chadake,	চড়াকে,	চড়াকে,	
carlos,	কার্লস,	কার্লোস,	
pitiler,	পিতিলের,	পিটিলের,	
aqram,	আক্রম,	আকরাম,	
vorkendra,	ভোরকেন্দ্র,	ভরকেন্দ্র,	
haripur,	হরিপুর,	হরিপুর,	
anusvara,	অনুষ্বররা,	অনুস্বার,	
aatmobishwasi,	আত্মবিশ্বাসী,	আত্মবিশ্বাসী,	
sharif,	শারফ,	শরিফ,	
informetion,	ইনফররেশনন,	ইনফরমেশন,	
nikate,	নিকাতে,	নিকটে,	
somratra,	সম্রাত্র,	সম্রাটরা,	
prakalpoguli,	প্রকালগোগুলি,	প্রকল্পগুলি,	
palkee,	পালকি,	পাল্কি,	
chhuteer,	ছুটির,	ছুটির,	
choshon,	চসন,	চোষণ,	
akar,	আকার,	একার,	
meloonborrone,	মেলুনবর্ণে,	মেলবোর্নে,	
chhaikalo,	ছাইকালো,	ছাইকালো,	
bike,	বিকে,	বাইক,	
graminphonor,	গ্রামিংপনর,	গ্রামীণফোনর,	
damakalkarmirao,	দমকলকর্মীরাও,	দমকলকর্মীরাও,	
poripaker,	পরিপাকের,	পরিপাকের,	
jwar,	জ্বর,	জ্বর,	
olympicer,	অলিম্পিসের,	অলিম্পিকের,	
qonflict,	কনফ্লিক্ট,	কনফ্লিক্ট,	
gamdan,	গামদান,	গামদান,	
nagorikderkey,	নাগরিকদদরকে,	নাগরিকদেরকে,	
teemothy,	টিমোটি,	টিমোথি,	
firti,	ফিরটি,	ফিরতি,	
salmanul,	সালমানুল,	সালমানুল,	
orthobochorke,	অর্থবচরকে,	অর্থবছরকে,	
pachattar,	পাচতটার,	পাচাত্তার,	
ingreziteo,	ইনরেজিতেও,	ইংরেজিতেও,	
playtey,	প্লিটে,	প্লেটে,	
uchchotara,	উচ্চতারা,	উচ্চতর,	
soteciety,	সটিকিটি,	সোসাইটিতে,	
shajano,	শাজানো,	সাজানো,	
khali,	খালি,	খালি,	
thailandshoho,	থাইলান্দসহ,	থাইল্যান্ডসহ,	
agomonke,	আগমনকে,	আগমনকে,	
tahalo,	তাহালো,	তাহলো,	
timathi,	তিমাথি,	টিমোথি,	
dibi,	দিবি,	দিবি,	
meghachchanno,	মেঘাচ্ছন্ন,	মেঘাচ্ছন্ন,	
khanonkaj,	খননকাজ,	খননকাজ,	
abadamoner,	আবদমননের,	অবদমনের,	
anchalgulir,	অঞ্চলগুলির,	অঞ্চলগুলির,	
bhittiti,	ভিত্তিটি,	ভিত্তিটি,	
stanahenja,	স্তনাহঞঞ্জ,	স্টোনহেঞ্জ,	
brekthrough,	ব্রক্রুর্গ,	ব্রেকথ্রু,	
jaubankal,	যৌবনকাল,	যৌবনকাল,	
akpashe,	আকপাশে,	একপাশে,	
narsaari,	নরসারী,	নার্সারি,	
karpeter,	কারপেটের,	কার্পেটের,	
hitlere,	হিটলারে,	হিটলারে,	
kloud,	ক্লুউড,	ক্লাউড,	
fastag,	ফ্স্্যাগ,	ফ্যাসট্যাগ,	
ebhara,	এথারা,	এভার,	
supparak,	সুপ্রাক,	সুপ্পারক,	
charger,	চার্গের,	চার্জার,	
mangoleek,	মঙ্গলিক,	মাঙ্গলিক,	
irana,	ইরানা,	ইরান,	
fokskon,	ফকসকন,	ফক্সকন,	
cena,	সেনা,	সিনা,	
dharmantor,	ধর্মন্তর,	ধর্মান্তর,	
grambaasheeo,	গ্রামবাশনও,	গ্রামবাসীও,	
query,	কুয়েরি,	কোয়েরি,	
gagee,	গাগি,	গেজ,	
gotihin,	গতিহীন,	গতিহীন,	
kurdider,	কুর্দিদের,	কুর্দিদের,	
shahanara,	শাহানারা,	শাহানারা,	
bapio,	বাপিও,	বাপিও,	
joki,	জকি,	জকি,	
gaujano,	গৌজানো,	গজানো,	
akkhunno,	অক্ষুণ্য,	অক্ষুণ্ণ,	
bhenkates,	ভেঙ্কেটস,	ভেঙ্কটেশ,	
indrakanan,	ইন্দ্রকানান,	ইন্দ্রকানন,	
tunaita,	টুনাইটা,	টুনাইট,	
promothesh,	প্রমেঠশ,	প্রমথেশ,	
bhebechili,	ভেবেছিলি,	ভেবেছিলি,	
chakti,	চাকটি,	চাকতি,	
chhintayikari,	ছিন্নয়েকারী,	ছিনতাইকারী,	
kei,	কেই,	কেই,	
ayumi,	আযুমি,	আয়ুমি,	
eupheike,	আইফোকে,	ইউফেইকে,	
parkasa,	পারকাস,	পার্কস,	
somonwitobhabey,	সমন্বিতভাবে,	সমন্বিতভাবে,	
safiin,	সফফিন,	সাফিন,	
korimpur,	করিমপুর,	করিমপুর,	
tolemyr,	তোলেমির,	টলেমির,	
fevarite,	ফেভারিতে,	ফেভারিট,	
lesense,	লেসেন্সে,	লাইসেন্স,	
hooldim,	হাউদ্দিম,	হোল্ডিং,	
steena,	স্তিনা,	স্টেন,	
nyata,	ন্যাটা,	ম্যাট,	
tecnokret,	টেকন্ক্রট,	টেকনোক্র্যাট,	
meropenemer,	মেরোপেনেমের,	মেরোপেনেমের,	
ekoirokom,	একরোকম,	একইরকম,	
soomitrar,	সুমিত্রার,	সুমিত্রার,	
swairacharibirodhi,	স্বরারিচারীবোধী,	স্বৈরাচারীবিরোধী,	
nirbahey,	নির্বাহে,	নির্বাহে,	
vezano,	ভেজানো,	ভেজানো,	
akhandata,	অখণ্ডতা,	অখণ্ডতা,	
janagononar,	জানগণনার,	জনগণনার,	
dhanche,	ধাঁচে,	ধাঁচে,	
macbeth,	ম্যাকবে,	ম্যাকবেথ,	
argho,	অরঘঘ,	অর্ঘ্য,	
chinito,	চিনিত,	চিনতো,	
sangharshik,	সংঘর্ষিক,	সাংঘর্ষিক,	
raagei,	রাগেই,	রাগেই,	
houzgulite,	হৌজগুলিতে,	হাউজগুলিতে,	
kuronir,	কুরোনির,	কুরনীর,	
shrabosty,	শ্রাবস্টি,	শ্রাবস্তী,	
bharpur,	ভারপুর,	ভরপুর,	
paner,	পানের,	পানের,	
ponera,	পনেরা,	পনের,	
taalaal,	তালাল,	তালাল,	
modele,	মডেলে,	মডেলে,	
besirbhaagi,	বেশীর্ভাগী,	বেশিরভাগই,	
saabyastha,	সাব্যস্থা,	সাব্যস্থ,	
selim,	সেলিম,	সেলিম,	
hariner,	হরিনের,	হরিণের,	
bodhirota,	বোধিরতা,	বধিরতা,	
venus,	ভেনুস,	ভেনাস,	
lyataa,	ল্যাটা,	ল্যাটা,	
akhhunno,	অখুন্ন,	অক্ষুণ্ণ,	
ray,	রয়,	রায়,	
difinision,	ডিফিনিশন,	ডেফিনেশন,	
katiusha,	কাটিউশা,	কাতিউশা,	
prokalpagulo,	প্রকালগাগুলো,	প্রকল্পগুলো,	
digree,	দিগ্রী,	ডিগ্রি,	
kani,	কানি,	কানি,	
bangobandhu,	বঙ্গবন্ধু,	বঙ্গবন্ধু,	
sawam,	সওয়াম,	সাওম,	
foolkopi,	ফলকুি,	ফুলকপি,	
militarir,	মিলিতারীর,	মিলিটারির,	
kushakhali,	কুশাখালি,	কুশাখালি,	
mirina,	মিরিনা,	মিরিনা,	
shekarmani,	শেখারমণি,	শেকরমানি,	
sahocorje,	সহকর্যে,	সাহচর্যে,	
sten,	স্টেন,	স্টেন,	
favorite,	ফ্যাভেরিতে,	ফেভারিট,	
bite,	বিতে,	বাইট,	
masjidti,	মসজিদটি,	মসজিদটি,	
porobortii,	পরবর্তী,	পরর্বতী,	
sethai,	সেথাই,	সেথাই,	
korimkey,	করিমকে,	করিমকে,	
byabaharkareer,	ব্যবহারকররীর,	ব্যবহারকারীর,	
danab,	দানাব,	দানব,	
beshyasdone,	বেশ্যান্ডনে,	বেশ্যাসদনে,	
asaciates,	এসযাসিয়াটেস,	এসোসিয়েটস,	
directorete,	ডাইরেক্টরেতে,	ডিরেক্টরেট,	
soundarja,	সৌন্দর্য,	সৌর্ন্দয্য,	
antarctica,	অ্্ট্র্যাকটিকা,	অ্যান্টার্কটিকার,	
mahibur,	মহিবুর,	মহিবুর,	
jaanar,	যানার,	জানার,	
shoreefpur,	শর্ফিপুর,	শরিফপুর,	
eucalyptus,	ইউক্লিপেটাস,	ইউক্যালিপ্টাস,	
assaciates,	অ্যাসাসিয়েটেস,	এসোসিয়েটস,	
oindrila,	ঐন্দ্রিলা,	ঐন্দ্রিলা,	
idyi,	আইডিই,	আইডিই,	
crucer,	ক্রুসের,	ক্রুশের,	
agomoney,	আগমনে,	আগমনে,	
shibraj,	শিবরাজ,	শিবরাজ,	
zozyota,	যোজ্যতা,	যোজ্যতা,	
anchalo,	অঞ্চলো,	অঞ্চলও,	
durgotsab,	দুর্গতসব,	দুর্গোৎসব,	
dhanyi,	ধননী,	ধন্যি,	
deool,	দেওল,	দেউল,	
lotharan,	লোথারান,	লুথেরান,	
ganoporibahoner,	গণপারববহণের,	গণপরিবহনের,	
daltyagi,	দল্্যাগী,	দলত্যাগী,	
saarbhaarti,	সার্ভারটি,	সার্ভারটি,	
abanishankar,	অবনিশন্কর,	অবনিশংকর,	
neelfamarir,	নিলফামীরীর,	নীলফামারীর,	
elakaai,	এলাকাই,	এলাকাই,	
dupleks,	ডাপলেক্স,	ডুপ্লে,	
oxfordey,	অক্সপোর্ড,	অক্সফোর্ডে,	
asif,	আসিফ,	আসিফ,	
zakharovar,	যাখারোভার,	জাখারোভার,	
foloshrutite,	ফলশররুটিতে,	ফলশ্রুতিতে,	
rachanakal,	রচনাকাল,	রচনাকাল,	
rajotta,	রাজত্য,	রাজত্ব,	
prachando,	প্রাচাণ্ড,	প্রচণ্ড,	
dharabahikotitey,	ধারাবাহিকটিতে,	ধারাবাহিকটিতে,	
liedtke,	লিয়েটকে,	লইডটক,	
noiteekotar,	নৈতিকতার,	নৈতিকতার,	
kusumeshu,	কুসুমেষু,	কুসুমেষু,	
scoore,	স্কুরো,	স্কোর,	
rajyotiro,	রাজ্যটিরও,	রাজ্যটিরও,	
rudrasagar,	রুদ্রসাগর,	রুদ্রসাগরের,	
courtcaser,	কোর্টকেসের,	কোর্টকেসের,	
teemothi,	তীমোথি,	টিমোথি,	
karam,	কারাম,	কেরাম,	
atibiplabi,	অতিবিপ্বলী,	অতিবিপ্লবি,	
chalochchitro,	চালচ্চিত্র,	চলচ্চিত্র,	
beem,	বিম,	বিম,	
directarate,	ডাইরেক্টারেট,	ডিরেক্টরেট,	
madhumati,	মধুমতি,	মধুমতী,	
perry,	পেরি,	পেরি,	
mosjidsoho,	মসজিদসহ,	মসজিদসহ,	
ekbakye,	একবাকে,	একবাক্যে,	
laesensh,	লেসেন্স,	লাইসেন্স,	
ipl,	আইপিএল,	আইপিএল,	
sheshdinti,	শেষদিনটি,	শেষদিনটি,	
piulir,	পিলির,	পিউলির,	
plate,	প্লাটে,	প্লেটে,	
rahimed,	রহিমেদ,	রহিমেদ,	
panchasjan,	পঞ্চাজন,	পঞ্চাশজন,	
themekey,	থেমেকে,	থিমকে,	
naraphoka,	নারোফাকো,	নরফোক,	
cheento,	চিন্ত,	চিনতো,	
nichols,	নিচোলস,	নিকলস,	
dajjha,	দাজঝা,	দাহ্য,	
smarok,	স্মররক,	স্মারক,	
ramantic,	রামন্টিক,	রোমান্টিক,	
keyboarder,	কিওবোর্ডের,	কীবোর্ডের,	
serveray,	সার্ভারে,	সার্ভারে,	
babare,	বাবারে,	বাবারে,	
bosontokke,	বসন্তককে,	বসন্তকে,	
teta,	টেট,	টেটা,	
basakey,	বাসাকে,	বাসাকে,	
chilahatee,	চিলাহাটি,	চিলাহাটি,	
photanor,	ফোটানোর,	ফোটানোর,	
chalochchitraeeo,	চললচ্ছিত্রীয়েও,	চলচ্চিত্রেও,	
mookhomaundoler,	মুখুউন্ডগলের,	মুখমণ্ডলের,	
jeebonnogor,	জীবনগোগর,	জীবননগর,	
ciima,	সিইমা,	সীমা,	
nakkal,	নাককাল,	নক্কল,	
moushum,	মাুুম,	মৌসুম,	
somraat,	সম্রাত,	সম্রাট,	
byomkes,	ব্যোমকেস,	ব্যোমকেশ,	
directorate,	ডাইরেক্টরেট,	ডিরেক্টরেট,	
edaning,	এডানিং,	ইদানিং,	
chalachchitrotike,	চলচচচিত্রটিকে,	চলচ্চিত্রটিকে,	
innahu,	ইন্নাহু,	ইন্নাহু,	
uponishad,	উপনিষাদ,	উপনিষদ,	
birmuktijoddhagan,	বীর্মুক্তিদদ্ধগণ,	বীরমুক্তিযোদ্ধাগণ,	
dakteekiter,	দাকটিকিতের,	ডাকটিকিটের,	
uttor,	উত্তর,	উওর,	
talaa,	তালা,	তালা,	
backflipe,	ব্যাক্সপিল,	ব্যাকফ্লিপে,	
jakso,	জাক্স,	যক্ষ,	
uthhaane,	উঠানে,	উঠানে,	
mononiitoder,	মনোনিতদের,	মনোনীতদের,	
abheedhaaneeck,	অভিধাননয়ক,	অভিধানিক,	
mirakela,	মিরাকেলা,	মিরাকেল,	
engrejra,	এংরজেরা,	ইংরেজরা,	
makong,	মাকং,	মেকং,	
nirmankarmisaha,	নির্মাণক্রমীসহ,	নির্মাণকর্মীসহ,	
bossoben,	বসবেন,	বসবেন,	
seoul,	সেওউল,	সোল,	
bodhirta,	বোধিরতা,	বধিরতা,	
shtona,	স্তোনা,	স্টোন,	
licencedhari,	লাইসনেন্টারি,	লাইসেন্সধারী,	
konflict,	কনফ্লিক্ট,	কনফ্লিক্ট,	
gandogol,	গান্ডগোল,	গন্ডগোল,	
qyantana,	ক্যান্টননা,	ক্যান্টন,	
kandy,	কান্ডি,	ক্যান্ডি,	
jamseder,	জমসেদের,	জামসেদের,	
uqeliptas,	উকেলিপ্টাস,	ইউক্যালিপ্টাস,	
stander,	স্ট্যান্ডের,	স্ট্যাণ্ডের,	
ispreedshiit,	ইস্প্রিদিধ,	স্প্রেডশীট,	
proteemar,	প্রতিমার,	প্রতিমার,	
parisankhanvid,	পরিসংসম্ভীদ,	পরিসংখ্যানবিদ,	
abodamaner,	অবদামনের,	অবদমনের,	
matt,	ম্যাট,	ম্যাট,	
shit,	শিত,	শীত,	
murali,	মুরালি,	মুরলী,	
atwabishvashi,	অত্ববিশভাষী,	আত্মবিশ্বাসী,	
akten,	আকেতেন,	অকটেন,	
futote,	ফুটোতে,	ফুটোতে,	
chaudhurider,	চৌধুরীদের,	চৌধুরীদের,	
nojder,	নজদের,	নজদের,	
dakope,	ডাকোপ,	দাকোপ,	
bosante,	বসন্তে,	বসন্তে,	
tirmijii,	তির্মিজি,	তিরমিজি,	
muchi,	মুচি,	মুচি,	
phonekari,	ফোনকারি,	ফোনকারী,	
kogake,	কোগাকে,	কোগাকে,	
israelbahini,	ইস্রালেলবাহীনী,	ইস্রায়েলবাহিনী,	
khaaneker,	খানেকের,	খানেকের,	
dushtogone,	দুষ্টগণে,	দুষ্টগণে,	
baire,	বাইরে,	বাইরে,	
malinga,	মালিংগা,	মালিংগা,	
ohalyar,	ওহল্যার,	অহল্যার,	
boudher,	বৌধের,	বৌদ্ধের,	
punorabortonte,	পুনরাবর্তন্তে,	পুনরাবর্তন্তে,	
abheedhaneek,	অভিধানীক,	অভিধানিক,	
poste,	পোস্টে,	পোষ্টে,	
bakhyateet,	বাক্যাটিত,	ব্যাখ্যাতীত,	
kyatgarite,	ক্যাটগারিতে,	ক্যাটগারিতে,	
manabmaner,	মানবমানের,	মানবমনের,	
oiteejye,	ঐতিহ্যে,	ঐতিহ্যে,	
hood,	হুড,	হুড,	
phiqsa,	ফিকস,	ফিক্স,	
makhno,	মাখোন,	মাখনো,	
oblivion,	অবলিভিওন,	অবলিভিয়ন,	
durtomo,	দুর্তমো,	দূরতম,	
tawnship,	তাবশিপ,	টাউনশিপ,	
khelaphate,	খেলাফাতে,	খেলাফতে,	
chandrima,	চন্দ্রিমা,	চন্দ্রিমা,	
taateo,	তাতেও,	তাতেও,	
sima,	সিমা,	সীমা,	
graambaashio,	গ্রামবাশশও,	গ্রামবাসীও,	
tukrote,	তুকর্তে,	টুকরোতে,	
valobasen,	ভালোবাসেন,	ভালোবাসেন,	
badargaji,	বদরগাজি,	বদরগাজী,	
kekru,	কেকরু,	কেকরু,	
rojapalaner,	রোজাপলনের,	রোজাপালনের,	
peengna,	পীংনা,	পিংনা,	
dormetori,	দরমেতরি,	ডরমিটরি,	
senabahineeow,	সেনাবাহিন্বিও,	সেনাবাহিনীও,	
goshthiti,	গোষথিতি,	গোষ্ঠীটি,	
shucharita,	শুচরিতা,	সুচরিতা,	
nichupattir,	নিছুপত্তির,	নিচুপট্টির,	
sarder,	সার্ডের,	সরদার,	
capshule,	ক্যাপশুলে,	ক্যাপসুল,	
humira,	হুমিরা,	হুমিরা,	
shniper,	শ্নীপের,	স্নাইপার,	
muradke,	মুরাদকে,	মুরাদকে,	
raghubar,	রঘুবার,	রঘুবীর,	
venisey,	ভেনিসে,	ভেনিসে,	
kormyi,	কর্মই,	কর্মই,	
magar,	মাগর,	মাগার,	
bulan,	বুলান,	বুলান,	
ekjoge,	একযোগে,	একযোগে,	
oboshore,	অশোরে,	অবসরে,	
firalem,	ফিরালেম,	ফিরালেম,	
bouddho,	বৌদ্ধ,	বৌদ্ধ,	
simaa,	সিমা,	সীমা,	
avidur,	আভিদুর,	আভিদুর,	
noitikota,	নৈতিকতা,	নৈতিকতা,	
chhuteete,	ছুটিতে,	ছুটিতে,	
jaistho,	জৈষ্ঠ,	জ্যৈষ্ঠ,	
jommu,	জম্মু,	জম্মু,	
nathivukteer,	নাথিবুক্তির,	নথিভুক্তির,	
probolshoktio,	প্রবলক্ষটিও,	প্রবলশক্তিও,	
ronodeep,	রণডেপ,	রণদীপ,	
notey,	নটি,	নোটে,	
chikittsar,	চিকিৎসসার,	চিকিত্সার,	
samanyai,	সামন্যই,	সামান্যই,	
zaire,	জায়ের,	জাইরে,	
suparichiti,	সুপরিচিতি,	সুপরিচিতি,	
bandi,	বান্দি,	বন্দী,	
barrageke,	বারারেজকে,	ব্যারেজকে,	
subade,	সুবাদে,	সুবাদে,	
attorkite,	অত্ররকিতে,	অতর্কিতে,	
ddheela,	ঢেল,	ঢিলা,	
showtey,	শুটে,	শোতে,	
prokolpogulor,	প্রকল্পগুলোর,	প্রকল্পগুলোর,	
poderthobid,	পদেরবোবিদ,	পদার্থবিদ,	
nanabornobishishto,	নানাবন্বিশিষ্ট,	নানাবর্ণবিশিষ্ট,	
krom,	ক্রোম,	ক্রম,	
taunsheep,	টাউনশিপ,	টাউনশিপ,	
sikkharthirao,	শিক্ষার্থীরাও,	শিক্ষার্থীরাও,	
tep,	টেপ,	ট্যাপ,	
bornanukrome,	বর্ণানুক্রমে,	বর্নানুক্রমে,	
bishshaasho,	বিশ্শাশ,	বিশ্বাসও,	
bondishalatei,	বন্দিশালাতেই,	বন্দিশালাতেই,	
onshogrohoner,	অংশগ্রহণের,	অংশগ্রহনের,	
sollallhu,	সোল্লাল্লু,	সল্লাল্লাহু,	
prodiiper,	প্রদিপের,	প্রদীপের,	
abdan,	আবদান,	আব্দান,	
olpo,	অল্পো,	অল্প,	
chhutir,	ছুটির,	ছুটির,	
dweepgoolotey,	দ্বিপগৌলটে,	দ্বীপগুলোতে,	
phutonta,	ফুটনাটা,	ফুটন্ত,	
laaishheshh,	লৈশশে,	লাইসেন্স,	
planeti,	প্লানেটি,	প্লেনটি,	
flexta,	ফ্লেক্সটা,	ফ্লেক্সটা,	
rilayensha,	রিলায়েনসহ,	রিলায়েন্স,	
gaddaafee,	গাদ্ডাফি,	গাদ্দাফী,	
bhejaano,	ভেজানো,	ভেজানো,	
protijogii,	প্রতিযোগী,	প্রতিযোগী,	
supplenza,	সাপ্লেম্যা,	সাপলেঞ্জা,	
shommotite,	শম্মতিতে,	সম্মতিতে,	
windo,	উইন্দো,	উইন্ডো,	
aarik,	আরিক,	আরিক,	
vaider,	ভাইদের,	ভাইদের,	
soori,	সুরী,	সুরি,	
shunani,	শুনানি,	শুনানী,	
nabayug,	নবয়ুু,	নবযুগ,	
notti,	নটটি,	নোটটি,	
ved,	ভেড,	বেদ,	
torabgonj,	তোরাগঞ্জ,	তোরাবগঞ্জ,	
karmoi,	কারমই,	কর্মই,	
dosha,	দোশা,	দোসা,	
nirbachakder,	নির্বাচকদের,	নির্বাচকদের,	
oyebjin,	ওয়েবজিন,	ওয়েবজিন,	
shudhui,	শুধুই,	শুধুই,	
sarjur,	সরজুর,	সরযূর,	
deares,	ডেয়েরেস,	ডিআরএস,	
simons,	সিমনস,	সিমন্স,	
gajetted,	গ্যাজেটদে,	গেজেটেড,	
direqtareta,	ডিরেক্টরেটা,	ডিরেক্টরেট,	
iub,	ইউব,	আইইউবি,	
sthaponagulo,	স্থাপনাগুলো,	স্থাপনাগুলো,	
daayitto,	দায়িত্ব,	দায়িত্ব,	
milea,	মিলেয়া,	মাইলে,	
elakaate,	এলাকাতে,	এলাকাতে,	
neutrinoo,	নিউটিনরণ,	নিউট্রিনো,	
ghoomato,	ঘৌমাতো,	ঘুমাতো,	
hoteltite,	হোটেলটিতে,	হোটেলটিতে,	
chaudhurio,	চৌধুরীও,	চৌধুরীও,	
boshoborty,	বশোবরটি,	বশবর্তী,	
bishwaashshoi,	বিশ্বসশশে,	বিশ্বাসই,	
joubanbatee,	যৌবনবাতী,	যৌবনবতী,	
sohinsotar,	সহিনসতার,	সহিংসতার,	
suraaropito,	সুরারপিত,	সুরারোপিত,	
tecno,	টেকনো,	টেকনো,	
kraim,	ক্রেম,	ক্রাইম,	
jotsna,	জো্সনা,	জ্যোৎস্না,	
flux,	ফ্লাক্স,	ফ্লাস্ক,	
poroborti,	পরবর্তী,	পরর্বতী,	
manober,	মানবের,	মানবের,	
ghumachhe,	ঘুমাছে,	ঘুমাচ্ছে,	
bijepi,	বিজেপি,	বিজেপি,	
ganaparibahan,	গণপরীবাহন,	গণপরিবহন,	
satan,	সাতান,	শয়তান,	
ajuhat,	অজুহাট,	অজুহাত,	
kokeyin,	কোকেনিন,	কোকেইন,	
mitrata,	মিত্রাটা,	মিত্রতা,	
godabari,	গোদাবারি,	গোদাবরী,	
oikhan,	ঐখখ,	ঐখান,	
niroja,	নিরোজা,	নিরোজা,	
dakter,	ডাক্টের,	ডাকতের,	
nutan,	নুতান,	নূতন,	
sayatana,	সাযাতনা,	শয়তান,	
gandharir,	গানধারীর,	গান্ধারীর,	
flirt,	ফ্লার্ট,	ফ্লার্ট,	
purborekorde,	পূর্বরেরকদে,	পূর্বরেকর্ডে,	
sedikei,	সেদিকেই,	সেদিকেই,	
kuthibarike,	কুঠিবারীকে,	কুঠিবাড়ীকে,	
chittronatyokar,	চিত্রন্যতাযাকার,	চিত্রনাট্যকার,	
uindos,	উইন্ডস,	উইন্ডোস,	
mele,	মেলে,	মাইল,	
pranidero,	প্রাণীদেরও,	প্রানীদেরও,	
andamana,	আন্দামানা,	আন্দামান,	
heart,	হার্ট,	হার্ট,	
mukherjee,	মুখরর্,	মুখার্জী,	
bibadey,	বিবাদে,	বিবাদে,	
sqalastiqa,	স্কাসক্সিতা,	স্কলাস্টিক,	
harbare,	হারবারে,	হারবারে,	
horas,	হোরাস,	হোরাস,	
nirikhe,	নিরীখে,	নিরিখ,	
bosontoke,	বসন্তকে,	বসন্তকে,	
laishensh,	লেইশেনস,	লাইসেন্স,	
firozaa,	ফিরোজা,	ফিরোজা,	
suraropito,	সুরারপিত,	সুরারোপিত,	
rashider,	রাশিদের,	রশিদের,	
sweety,	স্বিটি,	সুইটি,	
hingsar,	হিংসার,	হিংসার,	
bsnleu,	বিএনএনআল,	বিএসএনএলইইউ,	
kuttake,	কুট্টাকে,	কুত্তাকে,	
beatleser,	বিটলসের,	বিটলসের,	
sangitanusthane,	সঙ্গীতানস্থানে,	সঙ্গীতানুষ্ঠানে,	
vince,	ভিন্স,	ভিন্স,	
digrir,	ডিগ্রির,	ডিগ্রির,	
ponjikar,	পঞ্জিকার,	পঞ্জিকার,	
gananatyo,	গণনাত্য,	গণনাট্য,	
avisongson,	অভিসংসন,	অভিশংসন,	
uparzoner,	উপার্জনের,	উপার্জনের,	
cheenja,	চিঞ্জা,	চেঞ্জ,	
show,	শো,	শো,	
ghomtaa,	ঘোমটা,	ঘোমটা,	
irish,	ইরিশ,	আইরিস,	
nopdnodir,	নপ্ডনীর,	নদনদীর,	
rachonakal,	রচনাকাল,	রচনাকাল,	
shahjapur,	শাহজাপুর,	শাহজাপুর,	
yuroo,	যুরু,	ইউরো,	
melborrone,	মেলবররণে,	মেলবোর্নে,	
zoubankal,	যৌবনকাল,	যৌবনকাল,	
kottar,	কোট্তার,	কট্টর,	
prosadhoni,	প্রসাধনী,	প্রসাধনী,	
himchi,	হিমছি,	হিমচি,	
osoborno,	অসবর্ণ,	অসবর্ণ,	
jarmaniteo,	জারমানিতেও,	জার্মানিতেও,	
brail,	ব্রেইল,	ব্রেইল,	
masjidsaha,	মাসজিদসহ,	মসজিদসহ,	
ganakantha,	গণকান্থ,	গণকণ্ঠ,	
sahachke,	সহচকে,	সাহাচকে,	
stona,	স্টোনা,	স্টোন,	
marry,	মারি,	ম্যারি,	
narishwar,	নারীশ্বর,	নারীশ্বরের,	
sobche,	সবচে,	সবচে,	
krus,	ক্রুস,	ক্রুশ,	
nimitte,	নিমিত্তে,	নিমিত্তে,	
fatakesto,	ফাটাকেস্ত,	ফাটাকেষ্ট,	
plusey,	প্লুসে,	প্লাসে,	
satarkokari,	সতারককাকীর,	সতর্ককারী,	
sipa,	সিপা,	শিপ,	
angsogrohone,	আংংগ্রহণে,	অংশগ্রহনের,	
asaktibandhan,	অস্কতিবন্ধন,	আসক্তিবন্ধন,	
forex,	ফোরেক্স,	ফরেক্স,	
asbab,	আসবাব,	আসবাব,	
bairer,	বাইরের,	বাইরের,	
govindarajan,	গোবিন্দরাজন,	গোবিন্দরাজন,	
proshtutkarok,	প্রশ্তুতকরক,	প্রস্তুতকারক,	
faskari,	ফাসকারী,	ফাঁসকারী,	
annimated,	অ্যানিনমেট,	এনিমেটেড,	
mitro,	মিত্র,	মিত্র,	
keyu,	কেয়ু,	কেউ,	
pacchi,	পাচচি,	পাচ্ছি,	
durbhagya,	দুর্ভা্গ,	দূর্ভাগ্য,	
tetela,	টেটেলা,	টাইটেল,	
scuvi,	স্কাভি,	স্কুভি,	
windows,	ইউন্ডিওস,	উইন্ডোস,	
hertj,	হের্ট,	হার্জ,	
monohputo,	মনোসূপত,	মনঃপুত,	
duburir,	দুবুরির,	ডুবুরির,	
raunanganey,	রানাঙ্গনে,	রণাঙ্গনে,	
rohasyati,	রোহস্যতি,	রহস্যটি,	
qlauda,	ক্লাউড,	ক্লাউড,	
tigmanshu,	তিজমানসহু,	তিগমংশু,	
uddhrita,	উদ্ধৃত,	উদ্ধৃত,	
sursur,	সুরসুর,	সুরসুর,	
seekkhokbrindo,	শিক্ষসবৃদ্্ড,	শিক্ষকবৃন্দ,	
nirvachokder,	নির্বাচকদের,	নির্বাচকদের,	
laaishenshh,	লেশশনেশ,	লাইসেন্স,	
alpakichudin,	আল্পকিচুদিন,	অল্পকিছুদিন,	
farna,	ফার্না,	ফার্ন,	
roopmatro,	রূপমাত্র,	রূপমাত্র,	
chowdhuryke,	চৌধুরীকে,	চৌধুরীকে,	
amiretus,	অমিরিটাউস,	এমিরেটাস,	
treend,	ট্রিং্ড,	ট্রেন্ড,	
somoibo,	সময়ব,	সমৈব,	
bibader,	বিবাদের,	বিবাদের,	
gajano,	গজনা,	গজানো,	
dharmadasbabu,	ধর্মদাসবাবু,	ধর্মদাসবাবু,	
rifleksa,	রিফলেকসা,	রিফ্লেক্স,	
remacry,	রিম্যাক্রি,	রেমাক্রী,	
munsi,	মুনসি,	মুন্সী,	
cantan,	ক্যান্টান,	ক্যান্টন,	
chokrantosoho,	চক্রানাসসহ,	চক্রান্তসহ,	
kobulennechha,	কবুলেননেছা,	কবুলেন্নেছা,	
peethey,	পেথে,	পীঠে,	
pinogbagke,	পিনোগবাগকে,	পিনগবাগকে,	
byomkesh,	ব্যমকেশ,	ব্যোমকেশ,	
bishaashke,	বিশাষকে,	বিশ্বাসকে,	
bondhuvabaponyo,	বন্ধুবাব্যপন্য,	বন্ধুভাবাপন্ন,	
chenza,	চেঞ্জা,	চেঞ্জ,	
mehsus,	মেহসুস,	মেহসুস,	
transform,	ট্রান্সফর্ম,	ট্রান্সফর্ম,	
dhaleshorii,	ধালেররই,	ধলেশ্বরী,	
sommotite,	সম্মতিতে,	সম্মতিতে,	
snehban,	স্নেহবান,	স্নেহবান,	
afzol,	আফজোল,	আফজল,	
jonoshongjog,	জনসংযোগ,	জনসংযোগ,	
orgho,	অর্ঘ,	অর্ঘ্য,	
cheerontan,	চিরনাটান,	চিরন্তন,	
taunship,	টাউনশিপ,	টাউনশিপ,	
aachhis,	আছিস,	আছিস,	
chandil,	চাঁদিল,	চান্ডিল,	
giitikobitar,	গীতিতিবিতার,	গীতিকবিতার,	
nodiitei,	নদীীতেই,	নদীতেই,	
annorup,	অন্যরূপ,	অন্যরূপ,	
orbit,	অরবিট,	অরবিট,	
francine,	ফ্রান্সিন,	ফ্রান্সিন,	
dipke,	দিপকে,	দ্বীপকে,	
artherer,	আর্থরের,	আর্থারের,	
samajikatar,	সমাজিকতার,	সামাজিকতার,	
juakhelar,	জুয়াখেলার,	জুয়াখেলার,	
tennis,	টেনিস,	টেনিস,	
besirvagei,	বেশিরবাগেই,	বেশিরভাগেই,	
helloin,	হেল্লিন,	হ্যালোইন,	
taunasipa,	তানাসিপা,	টাউনশিপ,	
duuma,	দুউমা,	দুমা,	
mumtajer,	মুমতাজের,	মুমতাজের,	
manushsoho,	মানুষসহ,	মানুষসহ,	
judge,	জুডগে,	জাজ,	
nirbachokder,	নির্বাচকদের,	নির্বাচকদের,	
kathmandute,	কাঠমণ্ডুতে,	কাঠমান্ডুতে,	
hondooras,	হন্ডডারস,	হন্ডুরাস,	
mozlis,	মজলিস,	মজলিশ,	
prosadhaner,	প্রসাধনের,	প্রসাধনের,	
mukhya,	মুখ্যা,	মুখ্য,	
norfolk,	নরফলক,	নরফোক,	
highcomissione,	হাইস্মোসেনন,	হাইকমিশনে,	
samajikotar,	সমাজিকতার,	সামাজিকতার,	
batistambhatike,	বাতিস্থাভভক্তিকে,	বাতিস্তম্ভটিকে,	
matorom,	মাতরম,	মাতরম,	
boikalyo,	বৈকল্য,	বৈকল্য,	
nirgomon,	নির্গমণ,	নির্গমন,	
suporichita,	সুপরিচিতা,	সুপরিচিত,	
promodwara,	প্রমোদ্বারা,	প্রমদ্বারা,	
alsaar,	আলসার,	আলসার,	
meshmeshya,	মেশেেশ্য,	মেশহমেশহিইয়া,	
encidablu,	এনকিসবললু,	এনসিডাব্লু,	
peterke,	পেটারকে,	পিটারকে,	
gloria,	গ্লোরিয়া,	গ্লোরিয়া,	
talgachh,	তালগাছ,	তালগাছ,	
mach,	মাচ,	মাছ,	
juddhahato,	যুদ্ধহাত,	যুদ্ধাহত,	
prothar,	প্রথার,	প্রথার,	
mekapgulo,	মেকাপগুলো,	মেকআপগুলো,	
brindabane,	বৃন্দাবনে,	বৃন্দাবনে,	
huqa,	হুকা,	হুক,	
bibechyo,	বিবেচ্য,	বিবেচ্য,	
niurolaji,	নিউরোলজি,	নিউরোলজি,	
jyesttha,	জ্যেস্তথা,	জ্যেষ্ঠা,	
edaningkale,	এডানিংকালে,	ইদানীংকালে,	
gemske,	গেমসসকে,	জেমসকে,	
konistho,	কনিষ্ঠ,	কনিষ্ঠ,	
srisri,	শ্রীসৃ,	শ্রীশ্রী,	
protijogi,	প্রতিযোগী,	প্রতিযোগী,	
sookumari,	সুকুমারী,	সুকুমারী,	
bhramarotsab,	ভ্রমরোপস্ব,	ভ্রমরোৎসব,	
hajeerhatt,	হজয়ারহাট,	হাজিরহাট,	
dologuloo,	দলগুলো,	দলগুলোও,	
abheedhanik,	অভিধানিক,	অভিধানিক,	
baieq,	বাই়েক,	বাইক,	
karima,	কারিমা,	করিম,	
beila,	বেইলা,	বেইলা,	
kichutei,	কিছুতেই,	কিছুতেই,	
pothnirdeshona,	পথনির্দেশনা,	পথনির্দেশনা,	
minister,	মিইনসসটার,	মিনিস্টার,	
bedanta,	বেদান্ত,	বেদান্ত,	
dinara,	দিনারা,	ডিনার,	
bijito,	বিজিত,	বিজিত,	
hoondayi,	হোঁডায়ি,	হুন্দাই,	
naubom,	নওবম,	নবম,	
bipradas,	বিপরাদস,	বিপ্রদাস,	
dadar,	দাদার,	দাদার,	
ghotleo,	ঘটলেও,	ঘটলেও,	
bheenisa,	ভিনিসা,	ভেনিস,	
chikitsanirbhar,	চিকিৎসানির্ভর,	চিকিৎসানির্ভর,	
upobaashee,	উপবাশী,	উপবাসী,	
sahajlabhbhotar,	সহল্যভভাতর,	সহজলভ্যতার,	
vishnuu,	বিষ্ণুয়ু,	বিষ্ণু,	
kram,	ক্রাম,	ক্রম,	
dakticket,	ডাক্িটিক,	ডাকটিকিট,	
ispredseet,	ইস্প্রেডিন্ট,	স্প্রেডশীট,	
baarnis,	বার্নিস,	বার্নিশ,	
ponchasjon,	পঞ্চাজন,	পঞ্চাশজন,	
ghetu,	ঘেটু,	ঘেটু,	
saatzoner,	সাতজনের,	সাতজনের,	
nilkuthir,	নীলকুঠির,	নীলকুঠির,	
everestey,	এভারসিস্টে,	এভারেস্টে,	
langhaner,	লঙ্ঘনের,	লংঘনের,	
ishahak,	ইশাহক,	ইসাহাক,	
maladabha,	মালাদাভা,	মলদোভা,	
dalip,	ডালিপ,	দালিপ,	
alumni,	আলুমনি,	অ্যালমনি,	
sobaiderke,	সবাইদেরকে,	সবাইদেরকে,	
lobbytey,	লববটি,	লবিতে,	
jeshh,	ঝেশ,	জেস,	
protijogitamulok,	প্রতিযোগিতামূলক,	প্রতিযোগীতামূলক,	
kiibord,	কেইবর্ড,	কীবোর্ড,	
daaoon,	ডাওন,	ডাউন,	
pracharanamulak,	প্রচারণাূূলক,	প্রচারণামূলক,	
sinaake,	সিনাকে,	সিনাকে,	
vaticaner,	ভ্যাটিকানের,	ভ্যাটিকানের,	
choukato,	চৌকাত,	চৌকাত,	
firth,	ফিরথ,	ফার্থ,	
chhatrodiger,	ছাত্রদিগের,	ছাত্রদিগের,	
blogarra,	ব্লগগররা,	ব্লগাররা,	
nabyata,	নব্যতা,	নাব্যতা,	
muktijuddhojato,	মুক্তিযুদ্ধাতত,	মুক্তিযুদ্ধজাত,	
gorjon,	গর্জন,	গর্জন,	
aditisaha,	আদিতিসহ,	অদিতিসহ,	
sathik,	সাথিক,	সঠিক,	
baibasthaar,	বৈবস্থার,	ব্যবস্থার,	
scorey,	স্কোরে,	স্কোরে,	
ishton,	ইস্তন,	স্টোন,	
bojhaao,	বোঝাও,	বোঝাও,	
baait,	বাইট,	বাইট,	
cholchhee,	চলছি,	চলছে,	
qredita,	ক্রিডিটা,	ক্রেডিট,	
dong,	ডনং,	ডং,	
alankorana,	আলঙ্করণ,	অলঙ্করণ,	
sahozlabhbhatar,	সহ্লবাভাাতার,	সহজলভ্যতার,	
rilayensa,	রিলায়েনসা,	রিলায়েন্স,	
gandhikey,	গান্ধিকে,	গান্ধীকে,	
awatar,	আওতার,	অবতার,	
reshidensha,	রেশেডেশনা,	রেসিডেন্স,	
rakim,	রাকিম,	রাকিম,	
hastantar,	হস্তান্তর,	হস্তান্তর,	
shem,	শেম,	সেম,	
ansarir,	আনসারীর,	আনসারীর,	
gatibege,	গাতিবেগে,	গতিবেগে,	
bossonte,	বসন্তে,	বসন্তে,	
khargosher,	খারগোষের,	খরগোসের,	
daakticketer,	ডাকটিকেটের,	ডাকটিকিটের,	
homeser,	হোমেসের,	হোমসের,	
himsrot,	হিমস্রোট,	হিমস্রোত,	
dianes,	ডায়েনস,	ডিএনএস,	
debeting,	ডেবেটিং,	ডিবেটিং,	
dharavahik,	ধরাবাহিক,	ধারাবাহিক,	
bosoben,	বসবেন,	বসবেন,	
tonoo,	টননো,	তনু,	
armstronz,	আর্ম্স্ট্রঞ্জ,	আর্মস্ট্রং,	
horipur,	হরিপুর,	হরিপুর,	
nazranar,	নাজরানার,	নাজরানার,	
hetimganje,	হেতিমঙ্গে,	হেতিমগঞ্জে,	
birishiritey,	বিরিশিরিতে,	বিরিশিরিতে,	
oncholshomuher,	অনচ্লসমূহের,	অঞ্চলসমূহের,	
onkush,	অঙ্কুশ,	অংকুশ,	
salsa,	সালসা,	সালসা,	
brojomohun,	ব্রজমহহুন,	ব্রোজোমোহন,	
nadnadeer,	নদনদীর,	নদনদীর,	
roktokhoron,	রক্তখরণ,	রক্তক্ষরণের,	
apad,	আপদ,	আপদ,	
uddharkarmirai,	উদ্ধারকর্মীরাই,	উদ্ধারকর্মীরাই,	
utotoro,	উততরর,	উততর,	
mette,	মেট্টে,	ম্যাট,	
fatakasto,	ফাটাকাস্ত,	ফাটাকেষ্ট,	
gonesher,	গনেষের,	গণেশের,	
adhyattikota,	অধ্যাত্মিকতা,	আধ্যাত্মিকতা,	
shainyader,	শৈন্যদের,	সৈন্যদের,	
jati,	জাতি,	যাতি,	
sealvi,	সিলভি,	সিলভি,	
duiekdiner,	ডুই়েক্নিডের,	দুইএকদিনের,	
detik,	ডেটিক,	দেতিক,	
ghomta,	ঘোমটা,	ঘোমটা,	
nottee,	নটি,	নোটটি,	
vagini,	ভাগিনী,	ভগিনী,	
graambaaseeo,	গ্রামবাসীও,	গ্রামবাসীও,	
jibanto,	জীবন্ত,	জীবন্ত,	
doloo,	দলল,	ডলু,	
ghotleyo,	ঘটলেও,	ঘটলেও,	
shomser,	শমসের,	সমশের,	
parqa,	পারকা,	পার্ক,	
akhandota,	অখণ্ডটা,	অখণ্ডতা,	
renoo,	রেনু,	রেনো,	
spenser,	স্পেনসের,	স্পেন্সার,	
dharabahikbhabe,	ধারাবাহিকভাবে,	ধারাবাহিকভাবে,	
pancbaar,	পান্কাবার,	পাঁচবার,	
eshtoniya,	এসতনিয়া,	এস্তোনিয়া,	
thaanobhi,	থানভী,	থানভী,	
kheylechen,	খেয়েলেন,	খেলেছেন,	
guha,	গুহা,	গোহ,	
mukhomandaler,	মুখোমন্ডলের,	মুখমণ্ডলের,	
maailey,	মাইলে,	মাইলে,	
vabook,	ভবুক,	ভাবুক,	
eesosiyeetasa,	ইসসিিয়েস,	এসোসিয়েটস,	
srabosty,	স্রোবস্টি,	শ্রাবস্তী,	
graambasider,	গ্রামবাসীদের,	গ্রামবাসীদের,	
aansaareer,	আনসারীর,	আনসারীর,	
bondiira,	বন্দিরা,	বন্দীরা,	
emargency,	এমারগেন্সি,	এমার্জেন্সি,	
badhamuktovabe,	বাধামুক্তভাবে,	বাধামুক্তভাবে,	
alkatra,	আলকাত্রা,	আলকাতরা,	
salapheeta,	সালাফেটা,	সালফেট,	
rajbandi,	রাজবন্দি,	রাজবন্দী,	
khalidkay,	খালিদকায়,	খালিদকে,	
dharabahikvabe,	ধারাবাহিকভাবে,	ধারাবাহিকভাবে,	
aro,	আরো,	আরও,	
bbiswashi,	ব্বিশ্বাসী,	বিশ্বাসই,	
beshakbar,	বেশাকবার,	বেশকবার,	
bhabanipur,	ভবানীপুর,	ভবানীপুর,	
brake,	ব্রাকে,	ব্রেক,	
punosthaner,	পুনস্থানের,	পুনঃস্থানের,	
ghotolen,	ঘটলেন,	ঘটলেন,	
madhuri,	মধুরী,	মাধুরী,	
maaktoome,	মাক্ুমে,	মাকতুম,	
shhikara,	শিকারা,	শিকার,	
dibet,	দিবেত,	ডিবেট,	
jund,	জান্ড,	জুন্দ,	
kruser,	ক্রুসের,	ক্রুশের,	
jonee,	জনী,	জনি,	
ji,	জিই,	জি,	
schilling,	স্কিলিং,	শিলিং,	
ekghore,	একঘরে,	একঘরে,	
upobasher,	উপবাশের,	উপবাসের,	
providere,	প্রভিদেরে,	প্রভাইডারে,	
karore,	কারোরে,	কারোর,	
sqalarashipa,	স্কালাশিশপ,	স্কলারশিপ,	
aashtikotaa,	অষ্টিকতায়,	আস্তিকতা,	
khamotagulor,	ক্ষমতাগুলোর,	ক্ষমতাগুলোর,	
gorrer,	গরের,	গোরের,	
ganoparibahaner,	গণপরিবাহনের,	গণপরিবহনের,	
doula,	দৌলা,	দৌলা,	
shatan,	শতান,	শয়তান,	
manush,	মানুশ,	মানুষ,	
plasse,	প্লাসে,	প্লাসে,	
osthishondhi,	অস্থিন্ধ্ি,	অস্থিসন্ধি,	
janghu,	জঙ্ঘু,	জঙ্ঘু,	
teliha,	তেলিহা,	তেলিহা,	
mmadhuri,	মাধধুরী,	মাধুরী,	
times,	টাইমস,	টাইমস্,	
chorban,	চোরবান,	চর্বন,	
naazi,	নাজি,	নাত্সি,	
qirq,	কিরক,	কার্ক,	
rajotwo,	রাজত্ব,	রাজত্ব,	
seramiks,	সেরামিক্স,	সিরামিকস,	
jokkher,	যক্ষের,	যক্ষের,	
nothivukto,	নথিভূক্ত,	নথিভুক্ত,	
chowdhurir,	চোুধুরির,	চৌধুরীর,	
nirmalata,	নির্মলতা,	নির্মলতা,	
deilee,	ডেলি,	ডেইলি,	
provritike,	প্রভৃতিকে,	প্রভৃতিকে,	
maila,	মাইলা,	মাইল,	
shift,	সিফ,	শিফট,	
abdi,	আব্দি,	অব্দি,	
talgach,	তালগাছ,	তালগাছ,	
bhalobasar,	ভালোবাসার,	ভালোবাসার,	
institutione,	ইনস্টিটিশনে,	ইনস্টিটিউশনে,	
aarmstrong,	আর্মস্ট্রং,	আর্মস্ট্রং,	
sinakey,	সিনাকে,	সিনাকে,	
veenis,	ভিনিস,	ভেনিস,	
khagen,	খাগেন,	খগেন,	
shilbar,	শিলবার,	সিলভার,	
pujit,	পুজিত,	পুজিত,	
byaboharkareer,	ব্যবহারকারীর,	ব্যবহারকারীর,	
hepatetisa,	হেপাটেটিসা,	হেপাটাইটিস,	
treebhuj,	ত্রিভূজ,	ত্রিভূজ,	
heteler,	হেতেলের,	হেটেলের,	
rakshanbhag,	রক্ষণভাগ,	রক্ষণভাগ,	
prasadhoner,	প্রসাধনের,	প্রসাধনের,	
toranganj,	তোরঙ্গঞ্জ,	তোরাবগঞ্জ,	
chalochchitreei,	চল্চচিত্রীতেই,	চলচ্চিত্রেই,	
itastata,	ইতাস্ততা,	ইতস্তত,	
artilary,	আর্টিলারি,	আর্টিলারি,	
danakana,	দনকানা,	ডানকান,	
teenisa,	টিনিসা,	টেনিস,	
korle,	করলে,	করলে,	
mitrer,	মিত্রের,	মিত্রের,	
kirti,	কিরটি,	কীর্তি,	
basaake,	বাসাকে,	বাসাকে,	
gandagol,	গান্ডাগল,	গন্ডগোল,	
swastir,	স্বস্তির,	স্বস্তির,	
chikkingsasoho,	চিক্সিকাসসহ,	চিকিংসাসহ,	
bhandar,	ভান্দার,	ভাণ্ডার,	
hizrite,	হিজরিতে,	হিজরীতে,	
buth,	বুথ,	বুথ,	
elakai,	এলাকাই,	এলাকাই,	
militarite,	মিলিটারিতে,	মিলিটারিতে,	
gobeshonar,	গবেষণার,	গবেষনার,	
parijaner,	পরিজানের,	পরিজনের,	
manjushri,	মঞ্জিশ্রী,	মঞ্জুশ্রী,	
pathanatak,	পাঠানাটক,	পথনাটক,	
asantosh,	অসন্তোষ,	অসন্তোষ,	
naajii,	নাজি,	নাত্সি,	
bishshasho,	বিশ্ষাশ,	বিশ্বাসও,	
atak,	আতাক,	আটক,	
riphleksa,	রিফলেকসা,	রিফ্লেক্স,	
parking,	পারকিং,	পার্কিং,	
tapdei,	তাপদেই,	তাপড়েই,	
jetam,	জেতাম,	যেতাম,	
segulo,	সেগুলো,	সেগুলো,	
motke,	মটকে,	মতকে,	
tennys,	টেনিস,	টেনিস,	
feroza,	ফেরোজা,	ফিরোজা,	
zoojyota,	যোজুয়তা,	যোজ্যতা,	
ostad,	অস্তাদ,	ওস্তাদ,	
norpholk,	নরফলক,	নরফোক,	
venuser,	ভেনুসের,	ভেনাসের,	
mukhmondole,	মুখমন্ডলে,	মুখমণ্ডলে,	
soleel,	সলিল,	সলিল,	
debete,	দেবেতে,	ডিবেট,	
gurmukh,	গুরমুখ,	গুরমুখ,	
karaponner,	কারাপন্নের,	কারাপণ্যের,	
susamo,	সুসামো,	সুসম,	
obdi,	অব্দি,	অব্দি,	
guzober,	গুজবের,	গুজবের,	
siddhantoke,	সিদ্ধান্তকে,	সিদ্ধান্তকে,	
brittakare,	বৃত্তকারে,	বৃত্তাকারে,	
ase,	আসে,	আসে,	
armori,	আর্মরি,	আরমোরি,	
registrikrito,	রেজিস্ত্রিকৃত,	রেজিস্ট্রীকৃত,	
bishwasho,	বিশ্বাশো,	বিশ্বাসও,	
khalid,	খালিদ,	খালিদ,	
konnoder,	কন্যদের,	কন্যদের,	
korkotkraantee,	কর্কক্্রান্তে,	কর্কটক্রান্তি,	
shahabike,	শাহাবিকে,	সাহাবীকে,	
nirbaho,	নির্বাহ,	নির্বাহ,	
eporjonto,	এপর্যন্ত,	এপর্যন্ত,	
saarbharti,	সার্ভারটি,	সার্ভারটি,	
heepatitis,	হিপাটিটিস,	হেপাটাইটিস,	
oncholke,	অনচকলে,	অঞ্চলকে,	
kaalki,	কালকি,	কালকি,	
lambi,	লাম্বি,	লম্বি,	
croak,	ক্রাক,	ক্রোক,	
bokul,	বোকুল,	বকুল,	
phokser,	ফকসের,	ফক্সের,	
cheekitshar,	চিকিতশার,	চিকিত্সার,	
shfingtar,	সিফিংটার,	স্ফিংটার,	
madrasake,	মাদ্রাসাকে,	মাদ্রাসাকে,	
dhandu,	ধান্দু,	ধন্দু,	
zerusalem,	জেরুসালেম,	জেরুসালেম,	
choudhurike,	চৌধুরীকে,	চৌধুরীকে,	
soceitytey,	সোসিটিতে,	সোসাইটিতে,	
bouddher,	বৌদ্ধের,	বৌদ্ধের,	
bhenom,	ভেনম,	ভেনম,	
johny,	জননী,	জনি,	
ritesh,	ঋতেশ,	রিতেশ,	
adhikartai,	অধিকারটাই,	অধিকর্তাই,	
asthishondhi,	অস্থিসন্ধি,	অস্থিসন্ধি,	
utpotti,	উৎপত্তি,	উতপত্তি,	
dada,	ডাদা,	দাদা,	
jonosomaj,	জনসমাজ,	জনসমাজ,	
registaner,	রেজিস্টানের,	রেগিস্তানের,	
brookoleen,	ব্রুকলিন,	ব্রুকলিন,	
eukalyptus,	ইইক্লাপিটাস,	ইউক্যালিপ্টাস,	
machgulo,	মাচগুলো,	মাছগুলো,	
coons,	কনস্,	কুনস,	
salchak,	সালচাক,	সালচাক,	
podotyagsongkranto,	পদ্্যাংসংক্রান্ত,	পদত্যাগসংক্রান্ত,	
manab,	মানব,	মানব,	
queri,	কুয়েরি,	কোয়েরি,	
siddhanto,	সিদ্ধান্ত,	সিদ্ধান্তও,	
mandape,	মণ্ডপে,	মন্ডপে,	
michir,	মিচির,	মিচির,	
hol,	হোল,	হোল,	
tukroke,	তুকরোকে,	টুকরোকে,	
angibhutovabe,	অঙ্গিভূতভাবে,	অঙ্গীভূতভাবে,	
bhardwaj,	ভাদ্বাজ,	ভরদ্বাজ,	
barnis,	বার্নিস,	বার্নিশ,	
vugoley,	ভুগোলে,	ভূগোলে,	
moddhyoshtho,	মধ্যস্্থ,	মধ্যস্থ,	
paadee,	পায়েদ,	পাড়ে,	
nirmolotaa,	নির্মলতা,	নির্মলতা,	
station,	স্টেশন,	ষ্টেশন,	
aamor,	আমর,	আমর,	
ummool,	উম্ুল,	উম্মুল,	
echhti,	এছটি,	এছটি,	
shringge,	শৃঙ্গে,	শৃঙ্গে,	
horiddar,	হরিদ্দার,	হরিদ্বার,	
gara,	গারা,	গোর,	
torunosomriddho,	তরুণসমৃৃদ্ধ,	তরুণসমৃদ্ধ,	
dinifitian,	ডিনিফিটিয়ান,	ডেফিনেশন,	
ekshoti,	একশটি,	একশোটি,	
katbe,	কাতবে,	কাটবে,	
mathews,	ম্যাথেস,	ম্যাথিউস,	
mukhbondho,	মুখবন্ধ,	মুখবন্ধ,	
pharn,	ফার্ন,	ফার্ন,	
metropalitana,	মেট্রোপালিটান,	মেট্রোপলিটন,	
ultrasonography,	আল্ট্রোস্কাগাফ্পী,	আলট্রাসনোগ্রাফিও,	
tanu,	তানু,	তনু,	
whole,	হোলে,	হোল,	
priseflex,	প্রাইসফেক্স,	প্রাইজফ্লেক্স,	
chheher,	ছেহের,	ছেহের,	
chamski,	চমস্কি,	চমস্কি,	
bhujangta,	ভুগাংটা,	ভুজঙ্গটা,	
firozapure,	ফিরোজাপুরে,	ফিরোজাপুরে,	
shikshagata,	শিক্ষাগতা,	শিক্ষাগত,	
ramchander,	রামচন্দের,	রামচন্দরের,	
chakradhare,	চক্রধরে,	চক্রধরে,	
jhumjhumita,	ঝুমঝুমিতা,	ঝুমঝুমিটা,	
avinetar,	অভিনেতার,	অভিনেতার,	
sqirt,	স্কির্ট,	স্কার্ট,	
aporishodhito,	অপরিষোধিত,	অপরিশোধিত,	
chasee,	চাসে,	চেস,	
hojurer,	হজুরের,	হজুরের,	
akkelpure,	আক্কেলপুরে,	আক্কেলপুরে,	
rahi,	রাহি,	রাহী,	
hank,	হ্যাংক,	হাঙ্ক,	
kanasarabhesana,	কনসারভভনে,	কনসারভেশন,	
sushposhtolikhito,	সুষ্প্্ষিলখিত,	সুষ্পষ্টলিখিত,	
marpit,	মারপিত,	মারপিট,	
brindaboney,	বৃন্দাবনে,	বৃন্দাবনে,	
seebiai,	সিবিয়া,	সিবিআই,	
sahittopritite,	সাহিত্যপৃত্তিতে,	সাহিত্যপ্রীতিতে,	
habshi,	হাবশি,	হাবশী,	
chintamani,	চিন্তামনি,	চিন্তামনি,	
ekatto,	একাত্ত,	একাত্ব,	
bohudeen,	বহুদেন,	বহুদিন,	
anyorup,	অন্যরূপ,	অন্যরূপ,	
mah,	মাহ,	মাহে,	
batsmanei,	বাঁসমানেই,	ব্যাটসম্যানই,	
addata,	আদ্দাতা,	আড্ডাটা,	
rubidium,	রুবিডিয়াম,	রুবিডিয়াম,	
nutoner,	নুটনের,	নূতনের,	
lyandim,	ল্যান্ডিন,	ল্যান্ডিং,	
fooloo,	ফুল,	পোলো,	
kormoke,	কর্মকে,	কর্মকে,	
adorsho,	অদর্শ,	আর্দশ,	
shomostigoto,	সমস্তিগত,	সমষ্টিগত,	
cholochchitraeeo,	চলচ্চিত্রারীও,	চলচ্চিত্রেও,	
kisti,	কিস্তি,	কিস্তি,	
peshto,	পেষ্ট,	পেষ্ট,	
dhangsantup,	ধনবসং্তূপ,	ধ্বংসন্তুপ,	
mangolic,	ম্যাঙ্গুলিক,	মাঙ্গলিক,	
sarollo,	সারোল্ল,	সারল্য,	
soommo,	সমমমো,	সুমো,	
chanoo,	চানু,	চানু,	
baarbadoj,	বারবাবজ,	বার্বাডোজ,	
venice,	ভেনিস,	ভেনিস,	
emerjency,	এমের্জন্সি,	এমার্জেন্সি,	
cholochchitratike,	চলচ্চিত্রাটিকে,	চলচ্চিত্রটিকে,	
sithilotar,	সিথিলতার,	শিথিলতার,	
pravura,	প্রভুরা,	প্রভুরা,	
karmojog,	কর্মযোগ,	কর্মযোগ,	
zohns,	জনস্,	জন্স,	
megh,	মেঘ,	মেঘ,	
bayii,	বাইই,	বাঈ,	
kormoi,	কর্মই,	কর্মই,	
ukeliptas,	উইকেলিপ্যাস,	ইউক্যালিপ্টাস,	
kingsh,	কিংস,	কিংস,	
cloudbook,	ক্লাউববক,	ক্লাউডবুক,	
udbhaboney,	উদ্ভাবনে,	উদ্ভাবনে,	
antennal,	অ্যান্টেনাল,	অ্যান্টেনাল,	
muhaiminer,	মুহাইমিনের,	মুহাইমিনের,	
dhauto,	ধাউটো,	ধৌত,	
motabolombira,	মতাবলম্বীরা,	মতাবলম্বীরা,	
shoori,	শূরী,	সুরি,	
doorger,	ডুর্গের,	দুর্গের,	
ranangone,	রানাঙগণে,	রণাঙ্গনে,	
aalkaatra,	আলকাত্র,	আলকাতরা,	
toxoid,	টক্সড,	টক্সয়েড,	
heerani,	হিরানী,	হিরানি,	
bikromei,	বিক্রমেই,	বিক্রমেই,	
sbajan,	স্বজন,	স্বজন,	
hadisti,	হাদিস্তি,	হাদিসটি,	
habol,	হাবল,	হাবোল,	
kadakhonchar,	কাদাখন্চার,	কাদাখোঁচার,	
machsoho,	মাচসহ,	মাছসহ,	
vittiteo,	ভিত্তিতেও,	ভিত্তিতেও,	
jiland,	জিলান্ড,	জিল্যান্ড,	
dhhaabi,	ঢাবি,	ঢাবি,	
browser,	ব্রসসের,	ব্রাউজার,	
satyaky,	সত্যক্কি,	সাত্যকি,	
ajeejer,	আজিজের,	আজিজের,	
pader,	পাডের,	প্যাডের,	
ruptan,	রূপ্তান,	রূপটান,	
patrol,	পাত্রোল,	পেট্রোল,	
uzobekeestaan,	উজয়বেস্কান্,	উজবেকিস্তান,	
sheetke,	শীতকে,	শীতকে,	
bamon,	বামন,	বামন,	
baaiq,	বাসি,	বাইক,	
prasadhoni,	প্রসাধনী,	প্রসাধনী,	
yaak,	যাক,	ইয়াক,	
madhnagar,	মধনগর,	মাধনগরের,	
kuresher,	কুরেশের,	কুরেশের,	
bedey,	বেদে,	বেদে,	
dorgaaho,	দর্গাহ,	দরগাহ,	
hugheke,	হুঘেকে,	হিউজকে,	
nodiiteyi,	নদিয়েই,	নদীতেই,	
chhadite,	ছাড়িতে,	ছড়িতে,	
doorotaumo,	দৌরতাউমো,	দূরতম,	
pujito,	পুজিত,	পুজিত,	
elaakati,	এলাকাটি,	এলাকাটি,	
karmazog,	কর্মযোগ,	কর্মযোগ,	
jaandrel,	যান্দ্রেল,	জাঁদরেল,	
orthanitir,	অর্থনীতির,	অর্থনীতির,	
besur,	বেসুর,	বেসুর,	
zonsa,	জনসা,	জোন্স,	
aaireshe,	আইরেশে,	আইরেসে,	
tookror,	তুকরর,	টুকরোর,	
uparjon,	উপারজন,	উপার্জন,	
superheiroo,	সুপারহেরোরও,	সুপারহিরো,	
shommotir,	শম্মতির,	সম্মতির,	
mesenjjar,	মেসেনজ্জার,	মেসেঞ্জার,	
laicenshe,	লাইসেন্স,	লাইসেন্স,	
utpatti,	উৎপা্তি,	উতপত্তি,	
hindutirtha,	হিন্দুতীর্থ,	হিন্দুতীর্থ,	
deliver,	ডিলিভার,	ডেলিভার,	
agamane,	আগামানে,	আগমনে,	
narsinghomgulor,	নার্সিংখগগুলোর,	নার্সিংহোমগুলোর,	
prapokkey,	প্রপরককে,	প্রাপককে,	
mankisundar,	মানকিসুন্দর,	মানকিসুন্দর,	
bhaandar,	ভান্ডার,	ভাণ্ডার,	
kaloniir,	কালনির,	কালনীর,	
tistar,	টিস্টার,	তিস্তার,	
desiseyer,	দেসীয়েের,	ডিজিজের,	
atmabishvashi,	আত্মবিশাভাষী,	আত্মবিশ্বাসী,	
gingbhalobasen,	গিনবাগলবাসেন,	গিংভালোবাসেন,	
durgatsabe,	দুর্গাৎসবে,	দুর্গোৎসবে,	
cholochchitrai,	চলচ্চিত্রই,	চলচ্চিত্রই,	
drishyer,	দৃষ্যের,	দৃশ্যের,	
arsie,	আরসিই,	আরসিএ,	
fatkabazare,	ফাটকাবাজারে,	ফাটকাবাজারে,	
abosare,	অবসারে,	অবসরে,	
cholchhe,	চলছে,	চলছে,	
chet,	চেত,	চ্যাট,	
andon,	আন্দন,	আন্দোন,	
antorvuktimulak,	আন্তর্ভুক্তমূলক,	অন্তর্ভুক্তিমূলক,	
alonkaran,	আলনকরণ,	অলঙ্করণ,	
saifullahil,	সাইফুল্লাহিল,	সাইফুল্লাহিল,	
postac,	পোস্টাযাক,	পোস্টকে,	
ganochien,	গণচিয়েন,	গণচীন,	
rajnikant,	রাজনিকান্ত,	রাজনীকান্ত,	
poribahokotto,	পরিবাহক্ত,	পরিবাহকত্ব,	
superheroo,	সুপারহেরোও,	সুপারহিরো,	
chalachchitrer,	চলচ্চিত্রের,	চলচ্চিত্রের,	
uponeesoder,	উপনিসদের,	উপনিষদের,	
ghumachche,	ঘুমাচ্ছে,	ঘুমাচ্ছে,	
dekaner,	দেকানের,	দেকানের,	
qara,	কারা,	কর,	
accountdharira,	অ্যাকাউন্টরারিরা,	একাউন্টধারীরা,	
nothibhukto,	নথিভূক্ত,	নথিভুক্ত,	
sosoa,	সোসো,	শশা,	
ogovir,	অগভীর,	অগভীর,	
dibya,	দিব্য,	দিব্যা,	
existing,	এক্সটিনিং,	এক্সিসটিং,	
shektore,	শেকতরে,	সেক্টরে,	
bayshorkarikarone,	বয়শরকরীকরণকানে,	বেসরকারিকরণ,	
shkalarashhipa,	শ্কলাশশশীপ,	স্কলারশিপ,	
khoakshir,	খোয়াকশির,	খোয়াক্ষীর,	
varma,	ভারমা,	ভার্মা,	
jibonnogor,	জীবননগর,	জীবননগর,	
samajeek,	সমাজিক,	সামাজিক,	
sangbadmadhyame,	সংবাদমধ্যমে,	সংবাদমাধ্যমে,	
jonesh,	জনেশ,	জোন্স,	
shangsthaner,	সংস্থানের,	সংস্থানের,	
vagni,	ভাগনি,	ভগ্নী,	
maunchostho,	মঞ্চস্থ,	মঞ্চস্থ,	
bbiswasho,	ব্বিশ্বাস,	বিশ্বাসও,	
siddhantoo,	সিদ্ধান্ত,	সিদ্ধান্তও,	
khiladirao,	খিলাদিরাও,	খিলাড়িরাও,	
duryogamoyee,	দুর্যাযমময়ে,	দুর্যোগময়ী,	
koota,	কুটা,	কোটা,	
protyokkhovabey,	প্রত্যক্ষভাবে,	প্রত্যক্ষভাবে,	
bojhao,	বোঝাও,	বোঝাও,	
transhapharma,	ত্রাংসমর্ম্,	ট্রান্সফর্ম,	
shhow,	শু,	শো,	
footbalarra,	ফুটবলরারা,	ফুটবলাররা,	
chalachchitroi,	চলচ্চিত্রই,	চলচ্চিত্রই,	
goodamjato,	গৌদামজাত,	গুদামজাত,	
jatata,	জাতাতা,	যতোটা,	
capsul,	ক্যাপসাল,	ক্যাপসুল,	
lyaandeeng,	ল্যান্ডিং,	ল্যান্ডিং,	
pratool,	প্রাতুল,	প্রতুল,	
udyem,	উদয়েম,	উদ্যেম,	
dharabahiktite,	ধারাবাহিক্তিতে,	ধারাবাহিকটিতে,	
yathaarthabhaabe,	যথর্থবাভা,	যথার্থভাবে,	
spredsheet,	স্প্রডিশ,	স্প্রেডশীট,	
wodka,	উয়াক্কা,	ভদকা,	
siqh,	সিক,	শিখ,	
residensa,	রেসেডেসনা,	রেসিডেন্স,	
bhenasha,	ভেনস,	ভেনাস,	
dewaben,	দেওয়াবেন,	দেওয়াবেন,	
nirbaaho,	নির্বাহ,	নির্বাহ,	
disposes,	ডিসপ্সেস,	ডিসপোজেস,	
elakaasoho,	এলাকাসহ,	এলাকাসহ,	
sangkulaan,	সংকুলান,	সংকুলান,	
tochhnochh,	তচ্ছোছ,	তছনছ,	
arthanitike,	আর্থানিতিকে,	অর্থনীতিকে,	
seo,	সেও,	সেও,	
abdoone,	আবদুনে,	আবদুন,	
brekethru,	ব্রেকেঠ্রু,	ব্রেকথ্রু,	
kakhnoba,	কখ্নবা,	কখনওবা,	
bhagnekeo,	ভাগনেকেও,	ভাগ্নেকেও,	
sqolastiq,	স্কোলাস্টিক,	স্কলাস্টিক,	
nirvaha,	নির্বাহ,	নির্বাহ,	
bokahoke,	বকাহাকে,	বকাহকে,	
harris,	হ্রিস,	হ্যারিস,	
nariider,	নারিদের,	নারীদের,	
shikara,	শিকারা,	শিকার,	
satjaner,	সাতজনের,	সাতজনের,	
xpose,	এক্সপোজ,	এক্সপোজ,	
moshahidur,	মোশাহিদুর,	মোশাহিদুর,	
louhojato,	লৌহজাত,	লৌহজাত,	
hillse,	হিলসে,	হিলসে,	
achintopurer,	অচিন্তপুরের,	অচিন্তপুরের,	
prakare,	প্রকারে,	প্রকারে,	
lat,	লাত,	লাট,	
orthanitike,	অর্থানিতিকে,	অর্থনীতিকে,	
soinyo,	সৈন্য,	সৈন্য,	
bojhey,	বোঝে,	বোঝে,	
bahubar,	বহুবার,	বহুবার,	
aamoode,	আমুদে,	আমুদে,	
upbrazillian,	আপব্রজিলিয়াল,	আপব্রাজিলিয়ান,	
hosto,	হস্ত,	হস্ত,	
agaldar,	আগলদার,	আগলদার,	
munim,	মুনিম,	মুনিম,	
kaande,	কান্দে,	কাণ্ডে,	
potka,	পটকা,	পটকা,	
shulfate,	শুলফেতে,	সালফেট,	
durarohini,	দুরারোহিনী,	দুরারোহিণী,	
khanabale,	খানাবলে,	খানাবলে,	
ancholgoolote,	অঞ্চলগুলোতে,	অঞ্চলগুলোতে,	
kalenga,	কালেঙ্গা,	কালেঙ্গা,	
koordider,	কোর্দিদের,	কুর্দিদের,	
fulkapi,	ফুলকাপি,	ফুলকপি,	
logotype,	লগজিপপে,	লোগোটাইপ,	
chinto,	চিন্তো,	চিনতো,	
samaptir,	সমাপ্তির,	সমাপ্তির,	
dokaangoolote,	দকানিগুলোতে,	দোকানগুলোতে,	
siqhar,	সিকার,	শিকার,	
catholicbad,	ক্যাথবলিব্যা,	ক্যাথলিকবাদ,	
balatarin,	বালাতারীন,	বালাতারিয়ান,	
nischitobhabe,	নিশ্চিতভাবে,	নিশ্চিতভাবে,	
saranor,	সারানোর,	সরানোর,	
suisharke,	সুইশারকে,	সুইশারকে,	
shapad,	শাপদ,	শ্বাপদ,	
headquartus,	হেডকুয়ারেসাস,	হেডকোয়ার্টাস,	
santaa,	সান্তা,	সান্তা,	
sukumaree,	সুকুমারে,	সুকুমারী,	
ratishilatai,	রতিশীলতাই,	রতিশীলতায়,	
dienes,	ডিয়েনেস,	ডিএনএস,	
janmat,	জন্মত,	জন্মাত,	
saramukhe,	সররমুখে,	সারামুখে,	
commissionvogider,	কমিশনভিগদদদের,	কমিশনভোগীদের,	
sithilota,	সিথিলতা,	শিথিলতা,	
kkhur,	ক্কুর,	ক্ষুর,	
atorkitey,	আতরকিতে,	অতর্কিতে,	
prime,	প্রাইম,	প্রাইম,	
neerbachoker,	নির্বাচকের,	নির্বাচকের,	
musolmanera,	মুসলমানেরা,	মুসলমানেরা,	
halding,	হ্যালডং,	হোল্ডিং,	
samashtike,	সমাশটিকে,	সমষ্টিকে,	
boiporiityen,	বৈপরিয়িতেন,	বৈপরীত্যেন,	
maley,	ম্যালে,	মালে,	
dhormokorme,	ধর্মকর্মে,	ধর্মকর্মে,	
shansthagulo,	শাঁসসাঠগুলো,	সংস্থাগুলো,	
suchanakal,	সূচনাকাল,	সূচনাকাল,	
moresbai,	মোরেসবাই,	মোরেসবাই,	
jerushalema,	জেরুশালেমা,	জেরুসালেম,	
prakalpagulor,	প্রকালগাগুলোর,	প্রকল্পগুলোর,	
shaater,	সাটের,	শ্যুটার,	
chaaktir,	চাকটির,	চাকতির,	
uindoos,	উইনডাস,	উইন্ডোস,	
qor,	কোর,	কর,	
kormokarer,	কর্মকারের,	কর্মকারের,	
shrimoti,	শ্রীমতি,	শ্রীমতি,	
quary,	কুয়ারি,	কোয়েরি,	
nederlande,	নেডারল্যান্ডে,	নেদারল্যান্ডে,	
jones,	জনেস,	জোন্স,	
gazeetteed,	গেজিতদদ,	গেজেটেড,	
akheli,	আখেলি,	আখেলী,	
setikey,	সেতিকে,	সেটিকে,	
poriikkhateo,	পরিক্ষাতেও,	পরীক্ষাতেও,	
poscater,	পো্চাটের,	পশ্চাতের,	
jhimochchilo,	ঝিমোচছিল,	ঝিমোচ্ছিলো,	
soolke,	সুলকে,	শুল্কে,	
okritokarjo,	অকৃতকার্য,	অকৃতকার্য,	
simantarkkhibahinir,	সিমান্ত্রকণ্ধিহীনীর,	সীমান্তরক্ষীবাহিনীর,	
elakatir,	এলাকাটির,	এলাকাটির,	
arasie,	আরাসি,	আরসিএ,	
domonmulok,	দমনমুলক,	দমনমূলক,	
chhadura,	ছড়ুরা,	ছাদুরা,	
mulbhitti,	মুলভিত্তি,	মূলভিত্তি,	
sazanor,	সাজানোর,	সাজানোর,	
difinishion,	ডিফিনিশন,	ডেফিনেশন,	
byabaharkaree,	ব্যবহারকারী,	ব্যবহারকারী,	
bboponer,	ব্বোপনের,	বপনের,	
cholochchitrake,	চলচ্চিত্রকে,	চলচ্চিত্রকে,	
azimpur,	আজিমপুর,	আজিমপুর,	
siddhante,	সিদ্ধান্তে,	সিদ্ধান্তে,	
gondhe,	গন্ধে,	গন্ধে,	
batikromi,	বাতিকর্মি,	ব্যতিক্রমী,	
kinsa,	কিনসা,	কিংস,	
thyachara,	থ্যাচারা,	থ্যাচার,	
nirgamon,	নির্গামন,	নির্গমন,	
erajyobasi,	এরাজ্যবাসী,	এরাজ্যবাসী,	
eenameela,	ইনোমিলা,	এনামেল,	
poscime,	পশ্চিম,	পশ্চিমে,	
bosben,	বসবেন,	বসবেন,	
stana,	স্টনা,	স্টোন,	
bidghootey,	বিডঘটে,	বিদঘুটে,	
danata,	দানাটা,	ডোনাট,	
oswasteekor,	অস্বাস্িকর,	অস্বস্তিকর,	
shektor,	শেকটোর,	সেক্টর,	
onchalti,	অঞ্চলটি,	অঞ্চলটি,	
fud,	ফুড,	ফুড,	
vimsen,	ভিমসেন,	ভীমসেন,	
prasadhani,	প্রসাধনী,	প্রসাধনী,	
laiseensim,	লাইসিনিস,	লাইসেন্সিং,	
deep,	ডিপ,	দীপ,	
geejeeteeda,	গীজিতদদা,	গেজেটেড,	
difinisian,	ডিফিনিসিয়ান,	ডেফিনেশন,	
basaalt,	বাসালট,	ব্যাসল্ট,	
volivoler,	ভোলিভোলের,	ভলিভলের,	
olympic,	অলিম্পিক,	অলিম্পিক,	
madaspushto,	মাদসপুষ্ট,	মদদপুষ্ট,	
chaka,	চাকা,	চাকা,	
madrasi,	মাদ্রাসি,	মাদ্রাজি,	
dhila,	ধিলা,	ঢিলা,	
kachhakaachhi,	কাছাচাছি,	কাছাকাছি,	
kuhelika,	কুহেলিকা,	কুহেলিকা,	
jahara,	জাহারা,	যাহরা,	
dorgah,	দরগাহ,	দরগাহ,	
pakistanira,	পাকিস্তানীরা,	পাকিস্তানীরা,	
noitik,	নৈতিক,	নৈতিক,	
digri,	ডিগ্রি,	ডিগ্রি,	
mahafezkhanar,	মহাফেজখানার,	মহাফেজখানার,	
oshtader,	ওষ্টাদের,	ওস্তাদের,	
chakrapani,	চক্রপাণি,	চক্রপানী,	
ooporoshtho,	অপরস্থ,	উপরস্থ,	
karadando,	কারাদান্ড,	কারাদণ্ড,	
jothartho,	যথার্থ,	যথার্থ,	
utshahomulok,	উৎ্াামমুলক,	উৎসাহমূলক,	
chapchap,	চাঁপাপ,	চাপচাপ,	
ikbaaler,	ইকবালের,	ইকবালের,	
chopal,	চোপাল,	চপল,	
vetrillocuism,	ভ্ট্রিইলোলাইজম,	ভেট্রিলোকুইজম,	
seconder,	সেকন্ডার,	সেকেন্ডের,	
bondhukey,	বন্ধুকে,	বন্ধুকে,	
vaabnake,	ভাবনাকে,	ভাবনাকে,	
sompadonkaree,	সম্পাদনকারী,	সম্পাদনকারী,	
bonnypran,	বন্্পিরান,	বন্যপ্রাণ,	
hukar,	হুকার,	হুকার,	
jhalkanite,	ঝলকানিতে,	ঝলকানীতে,	
ghurte,	ঘুর্তে,	ঘুরতে,	
shalook,	শালুক,	শালুক,	
remacri,	রিমাস্কিরি,	রেমাক্রী,	
thyachar,	থ্যাচার,	থ্যাচার,	
kooshumba,	কুশুম্ব,	কুশুম্বা,	
plato,	প্ল্যাটো,	প্লেটো,	
ardasha,	আর্দাশা,	আর্দশ,	
dharavahikbhabe,	ধারাবাহিকভাবে,	ধারাবাহিকভাবে,	
abhidhaner,	অভিধনের,	অভিধানের,	
mitroder,	মিট্রোদের,	মিত্রদের,	
tyap,	ত্যাপ,	ট্যাপ,	
anutpadanshil,	অনুৎপাদনশীল,	অনুৎপাদনশীল,	
drishi,	দৃষি,	দৃশ্যই,	
mochlekha,	মোছলেখা,	মোছলেখা,	
chaudhuriyo,	চৌধুরীয়,	চৌধুরীও,	
bhittow,	ভিত্তব,	ভিত্তিও,	
bhotomulyoke,	ভোটমুল্যকে,	ভোটমূল্যকে,	
vobani,	ভবানী,	ভবানী,	
kodorer,	কদরের,	কদরের,	
shnaipara,	শ্নানপপরা,	স্নাইপার,	
antercticker,	অ্যান্টারক্টিকের,	অ্যান্টার্কটিকের,	
madhabike,	মাধবিকে,	মাধবীকে,	
rajtantra,	রাজতন্ত্র,	রাজতন্ত্র,	
horeepur,	হরিপুর,	হরিপুর,	
kanader,	কানাদের,	কণাদের,	
stonehenje,	স্তোনহেঞ্জে,	স্টোনহেঞ্জ,	
byatari,	ব্যাটারী,	ব্যাটারী,	
deil,	দেইল,	ডেইল,	
umedpoor,	উমেডপুর,	উমেদপুর,	
yaq,	যক,	ইয়াক,	
onker,	অঙ্কার,	ওঙ্কার,	
eeksapreeshana,	একস্প্রিশন,	এক্সপ্রেশন,	
harysoner,	হারিসনের,	হ্যারিসনের,	
ankanshilpe,	অঙ্কনশিল্পে,	অঙ্কনশিল্পে,	
shringey,	শৃঙ্গে,	শৃঙ্গে,	
jamjamat,	জমজামাত,	জমজমাট,	
smarak,	স্মরাক,	স্মারক,	
kharar,	খারার,	খরার,	
thakeni,	থাকেনি,	থাকেনি,	
logic,	লজিক,	লজিক,	
sanstha,	সনস্থ,	সংস্থা,	
masjidke,	মাজসিদকে,	মসজিদকে,	
rastagulikeo,	রাস্তাগুলিকেও,	রাস্তাগুলিকেও,	
ajeem,	আজেম,	আজিম,	
bhutbhut,	ভূতভুত,	ভুটভুট,	
ameettrakkhor,	অমিত্তরক্ষর,	অমিত্রাক্ষর,	
meloonborroner,	মেলুনবররণের,	মেলবোর্নের,	
udvaboney,	উদ্ভাবনে,	উদ্ভাবনে,	
ghaghat,	ঘাঘাট,	ঘাঘট,	
dwijenbabuder,	দ্বিজেনবাবুদের,	দ্বিজেনবাবুদের,	
bongshokey,	বংশকে,	বংশকে,	
sorsa,	সর্স,	সোর্স,	
bhushito,	ভূষিত,	ভূষিত,	
bujhtepari,	বুঝেতপারী,	বুঝতেপারি,	
rajtontre,	রাজতন্ত্রে,	রাজতন্ত্রে,	
tiunara,	তিউনারা,	টিউনার,	
siramikasa,	সিরামিকাসা,	সিরামিকস,	
shishupalgarh,	শিশুপালগার,	শিশুপালগড়ে,	
skirt,	স্কির্ট,	স্কার্ট,	
gaaddafee,	ঢাড়াফফি,	গাদ্দাফী,	
rajnoitik,	রাজনৈতিক,	রাজনৈতীক,	
dijijer,	দিজিজের,	ডিজিজের,	
karim,	কারিম,	করিম,	
atmira,	আত্মিরা,	আত্মীরা,	
laaisens,	লেইসেন্স,	লাইসেন্স,	
ponero,	পনেরও,	পনের,	
soinyora,	সৈন্যরা,	সৈন্যরা,	
dipankar,	দিপনকর,	দিপঙ্কর,	
progresh,	প্রোগ্রেশ,	প্রগ্রেস,	
enginiiring,	এঞ্জিনিরিং,	ইঞ্জিনিয়ারিং,	
saifai,	সাইফাই,	সাইফাই,	
scholarsip,	স্কোলারসিপ,	স্কলারশিপ,	
ovidhaner,	অভিধনের,	অভিধানের,	
alraji,	আলরাজি,	আলরাজী,	
amor,	আমর,	আমর,	
somoodrotote,	সমুদ্রটে,	সমুদ্রতটে,	
dibug,	দিবুগ,	ডিবাগ,	
dufresne,	ডাফরেন্স,	ডুফরেস্ন,	
pakhtunistan,	পাখতিন্ুত্ন,	পাখতুনিস্তান,	
chiraharit,	চিরাহারিত,	চিরহরিৎ,	
dormitory,	ডর্মিটরি,	ডরমিটরি,	
caramiks,	কারামিকস,	সিরামিকস,	
rajbandir,	রাজবন্দির,	রাজবন্দীর,	
kale,	কালে,	কালে,	
purohitra,	পুরোহিত্র,	পুরোহিতরা,	
asociatis,	অসোসিয়াটিস,	এসোসিয়েটস,	
mukhabandha,	মুখবন্ধ,	মুখবন্ধ,	
rokibul,	রকিবুল,	রকিবুল,	
grambasheeo,	গ্রামবাশীও,	গ্রামবাসীও,	
kinenni,	কিনেননি,	কিনেননি,	
sumeeta,	সুমিতা,	সুমিতা,	
nikote,	নিকোট,	নিকটে,	
bhuushito,	ভূশিত,	ভূষিত,	
aembed,	এম্বেড,	এম্বেড,	
poripake,	পরিপাকে,	পরিপাকে,	
heze,	হেজে,	হেজ,	
teestar,	তিস্টার,	তিস্তার,	
yucalyptus,	যুক্যালিপেস,	ইউক্যালিপ্টাস,	
chal,	চাল,	চাল,	
injiniyarim,	ইনজিনাইরিম,	ইঞ্জিনিয়ারিং,	
palestine,	প্যালেস্টাইন,	প্যালেস্টাইনে,	
neelkamal,	নিলকমাল,	নীলকমল,	
gronthowo,	গ্রন্থভূ,	গ্রন্থও,	
olympik,	অলিম্পিক,	অলিম্পিক,	
armeenian,	আরমিনিয়ান,	আর্মেনিয়ান,	
landin,	ল্যান্ডিন,	ল্যান্ডিং,	
baharamporer,	বাহারাপর্মের,	বহরমপুরের,	
asovarno,	অসভার্ণ,	অসবর্ণ,	
dhani,	ধনী,	ধানি,	
orunima,	অরুণিমা,	অরুণিমা,	
dhojovongo,	ধোবনগ্য,	ধ্বজভঙ্গ,	
autopromotioner,	অটোপারমোশনের,	অটোপ্রমোশনের,	
vool,	ভুল,	উল,	
greenald,	গ্রিনাল্ড,	গ্রিনল্ড,	
dadapur,	দাদাপুর,	দাদাপুর,	
shikkharthirao,	শিক্ষার্থীরাও,	শিক্ষার্থীরাও,	
makame,	মাকামে,	মাকামে,	
feemalee,	ফেমালি,	ফিমেল,	
pyetarna,	প্যাটার্ন,	প্যাটার্ন,	
karlei,	কারলেই,	করলেই,	
aairees,	আইরিস,	আইরিস,	
soomita,	সমমিতা,	সুমিতা,	
byabaharkarike,	ব্যবহারকারীকে,	ব্যবহারকারীকে,	
nibeditar,	নিবেদিতার,	নিবেদিতার,	
fotanor,	ফোটানোর,	ফোটানোর,	
kathmandu,	কাঠমণ্ডু,	কাঠমান্ডু,	
bbiswash,	বিবস্বাশ,	বিশ্বাস,	
premo,	প্রেমো,	প্রিমো,	
konisttha,	কনিস্ঠা,	কনিষ্ঠ,	
suparahiro,	সুপারহীরও,	সুপারহিরো,	
antarvuktimulak,	আন্তর্ভুক্তমূলক,	অন্তর্ভুক্তিমূলক,	
bandhan,	বানধান,	বাঁধন,	
chouhate,	চৌহাতে,	চৌহাটে,	
baptics,	ব্যাপ্টিকস,	ব্যাপটিকস,	
ivil,	ইভিল,	ইভিল,	
kaaferder,	কাফারদের,	কাফেরদের,	
satarkabhabe,	সতর্কভাবে,	সতর্কভাবে,	
bhyaatikaner,	ভ্যাতিকনের,	ভ্যাটিকানের,	
dokaanei,	দোকানেই,	দোকানেই,	
audioguloke,	আডিওগুলোকে,	অডিওগুলোকে,	
rajan,	রাজন,	রাজন,	
fanding,	ফ্যান্ডিং,	ফান্ডিং,	
chitronattakar,	চিত্রনাত্তকার,	চিত্রনাট্যকার,	
pyatarne,	প্যাটার্নে,	প্যাটার্নে,	
shatokeo,	শতকেও,	শতকেও,	
aanaan,	আনান,	আনান,	
kod,	কোড,	কোড,	
omkar,	ওমকার,	ওঙ্কার,	
naagaalyand,	নাগল্যান্ড,	নাগাল্যান্ড,	
groth,	গ্রোথ,	গ্রোথ,	
bee,	বিই,	বি,	
bhogni,	ভগ্নি,	ভগ্নী,	
habsi,	হাবসি,	হাবশী,	
bisnuke,	বিস্নুকে,	বিষ্ণুকে,	
ghurechen,	ঘুরেছেন,	ঘুরেছেন,	
barder,	বার্ডের,	বার্ডের,	
suraaropeeto,	সুরারপিত,	সুরারোপিত,	
bonshi,	বনশি,	বংশী,	
sharoker,	শারকের,	স্মারকের,	
atighataner,	আতিঘটনের,	অতিঘটনের,	
gobeshana,	গবেষণ,	গবেষনা,	
pooshteer,	পুশটির,	পুষ্টির,	
glanio,	গ্লানিও,	গ্লানিও,	
brittakar,	বৃত্তকর,	বৃত্তাকার,	
mataram,	মাতারাম,	মাতরম,	
pratisthanikvabe,	প্রতিষ্টানিকভাবে,	প্রাতিষ্ঠানিকভাবে,	
bonvumitey,	বনভভমিতে,	বনভূমিতে,	
mawdeel,	মাউডিল,	মডেল,	
deejeejer,	দেজিজের,	ডিজিজের,	
shangsthatikey,	সংস্থাটেকে,	সংস্থাটিকে,	
torkareer,	তর্করীর,	তরকারীর,	
safiha,	সফিহা,	সাফিহা,	
sambhabonao,	সম্ভাবনাও,	সম্ভবনাও,	
canflikt,	ক্যাপসিল্ক,	কনফ্লিক্ট,	
korimer,	করিমের,	করিমের,	
booroon,	বুউন,	বোরন,	
inphormeshon,	ইনফোরহেশন,	ইনফরমেশন,	
lutherana,	লুথেরানা,	লুথেরান,	
definition,	ডিফিনিশন,	ডেফিনেশন,	
moorali,	মুরালি,	মুরলী,	
postar,	পোস্তার,	পোস্টের,	
mashtarsha,	মাশ্টার্শ,	মাস্টার্স,	
spreedashita,	স্পেরদিশিত,	স্প্রেডশীট,	
engrezder,	এংরগেজদের,	ইংরেজদের,	
vabnakey,	ভাবনাকে,	ভাবনাকে,	
shaahaabiike,	শাহাওবিকে,	সাহাবীকে,	
gavaskar,	গাভাসকার,	গাভাস্কার,	
tachnach,	তাচনাচ,	তছনছ,	
maner,	মানের,	মানে,	
jackey,	জ্যাক,	জকি,	
johor,	জহর,	জহর,	
murad,	মুরাদ,	মুরাদ,	
holuder,	হলুদের,	হলুদের,	
zommu,	জমমু,	জম্মু,	
badaghat,	বাদাঘাট,	বাদাঘাট,	
ajij,	আজিজ,	আজিজ,	
grooth,	গ্রুথ,	গ্রোথ,	
saazano,	সাজানো,	সাজানো,	
jegulur,	যেগুলুর,	যেগুলুর,	
probhuder,	প্রভুদের,	প্রভুদের,	
shasonamoleri,	শাসনামলেরই,	শাসনামলেরই,	
mumtaj,	মুমতাজ,	মুমতাজ,	
aakabar,	আকাবার,	আকাবার,	
jotota,	যতটা,	যতোটা,	
torutoler,	তরুটলের,	তরুতলের,	
laishenshim,	লাইশনশিন,	লাইসেন্সিং,	
torabganj,	তৌরাগঞ্জ,	তোরাবগঞ্জ,	
armeeniyana,	আর্মিনিয়ন,	আর্মেনিয়ান,	
teamothy,	টিমোথি,	টিমোথি,	
granthatyke,	গ্রান্থাটিকে,	গ্রন্থটিকে,	
ganonanatto,	গণনানত্্,	গণনাট্য,	
devolapar,	দেবলাপার,	ডেভলপার,	
harja,	হার্জ,	হার্জ,	
madhobi,	মাধবি,	মাধবী,	
beekaargrasta,	বেকারগ্রাস্ত,	বিকারগ্রস্ত,	
sarajibonbyapi,	সাহাদিন্বারপপী,	সারাজীবনব্যাপী,	
mujuru,	মুজুরু,	মুজুরু,	
corymb,	করিম,	করিম,	
indrani,	ইন্দ্রানী,	ইন্দ্রাণী,	
tatey,	ট্যাট,	তাতে,	
pushtee,	পুষ্টি,	পুষ্টি,	
bhoutikeshu,	ভৌতিশেষু,	ভৌতিকেষু,	
qanasarabheshana,	কনসারভভনে,	কনসারভেশন,	
mercedes,	মার্সেডস,	মার্সেডেস,	
balokarak,	বালোকারক,	বলকারক,	
qaferderkey,	কেফরদেরকে,	কাফেরদেরকে,	
natshi,	নাটশি,	নাত্সি,	
satarkakari,	সতর্ককারী,	সতর্ককারী,	
mulvitti,	মুলভিত্তি,	মূলভিত্তি,	
ralf,	রাফফ,	রালফ,	
ddebet,	ডেবেট,	ডিবেট,	
tarkale,	তারকালে,	তারকালে,	
nartana,	নারতানা,	নর্টন,	
rubala,	রুবালা,	রুবল,	
laga,	লাগা,	লগ,	
khoka,	খোকা,	খোকা,	
nariderke,	নারীদেরকে,	নারীদেরকে,	
riazuddin,	রিয়াজুদ্দিন,	রিয়াজউদ্দীন,	
shasheja,	শাসেজা,	সসেজ,	
bishesyo,	বিশেষ্য,	বিশেষ্য,	
antarctika,	অ্্ত্রাকটিকা,	অ্যান্টার্কটিকা,	
enjineers,	এনজিনির্স,	ইঞ্জিনিয়ার্স,	
soheensotar,	সহিনস্তার,	সহিংসতার,	
peri,	পেরি,	পেরি,	
samanwitovabe,	সামন্যিতভাবে,	সমন্বিতভাবে,	
kalirkhal,	কালিরখাল,	কালিরখাল,	
dakkhinkare,	দক্ষিণকরে,	দক্ষিণকরে,	
russad,	রুসাদ,	রুশদ,	
oxite,	অক্সিট,	অক্সাইট,	
apolokbhabe,	অপলকভাবে,	অপলকভাবে,	
sokkhomotabriddhi,	সক্ষমপারবৃদ্ধি,	সক্ষমতাবৃদ্ধি,	
prokolpoti,	প্রকল্পটি,	প্রকল্পটি,	
gejetade,	গেজেতাদে,	গেজেটেড,	
chandrimaa,	চন্দ্রিমা,	চন্দ্রিমা,	
turkamena,	তুর্কেমানা,	তুর্কমেন,	
ghamta,	ঘামটা,	ঘোমটা,	
shahidputra,	শহিদপুত্র,	শহীদপুত্র,	
review,	রিভিউ,	রিভিউও,	
vaibon,	ভাইবন,	ভাইবোন,	
kuldip,	কুলদীপ,	কুলদীপ,	
seguloi,	সেগুলোই,	সেগুলোই,	
homshke,	হোমশেক,	হোমসকে,	
byathapather,	ব্যথাপথের,	ব্যথাপথের,	
grotha,	গ্রথা,	গ্রোথ,	
dubaate,	দুবাতে,	ডুবাতে,	
sookkho,	সুক্ষ,	সুক্ষ্ম,	
jaunotar,	যৌনতার,	যৌনতার,	
mukhobondho,	মুখবন্ধ,	মুখবন্ধ,	
bosonte,	বসন্তে,	বসন্তে,	
taufiq,	তৌফিক,	তৌফিক,	
magrey,	ম্যাগররে,	ম্যাগ্রে,	
satarkatar,	সতর্কাতার,	সতর্কতার,	
rezidence,	রেজিডেন্স,	রেসিডেন্স,	
konroop,	কনরূপ,	কোনরূপ,	
beshirbhaagei,	বেশির্ভাগেই,	বেশিরভাগেই,	
cn,	সিএন,	সিএন,	
otyacharito,	অত্যাচারিত,	অত্যাচারিত,	
mulyayonsapekkhe,	মূল্যযয়নসম্রেেে,	মূল্যায়নসাপেক্ষে,	
bbiseshyer,	ববিশেষ্যের,	বিশেষ্যের,	
soommita,	সমমিতা,	সুমিতা,	
cholocchitrer,	চলচ্চিত্রের,	চলচ্চিত্রের,	
teksuser,	টেকসসসের,	টেক্সাসের,	
shikare,	শিকারে,	শিকারে,	
upobasee,	উপবাসী,	উপবাসী,	
jeten,	জেতেন,	জেতেন,	
madeling,	ম্যাডেলিং,	মডেলিং,	
tolemy,	টোলেমি,	টলেমির,	
panchadadu,	পঞ্চদাদু,	পঞ্চাদাদু,	
turky,	টার্কি,	তুর্কি,	
corsin,	করসিন,	করসিন,	
panchashjon,	পঞ্চাশন,	পঞ্চাশজন,	
golghare,	গলঘারে,	গোলঘরে,	
tookrokey,	তরককরে,	টুকরোকে,	
quata,	কুয়াতা,	কোটা,	
sthitiko,	স্থিতিক,	স্থিতিকো,	
samoshtigato,	সম্থসিগত,	সমষ্টিগত,	
palta,	পাল্টা,	পালটা,	
konruup,	কননরুপ,	কোনরূপ,	
mardud,	মারদুদ,	মরদুদ,	
parikhar,	পরিখর,	পরিখার,	
uddhrito,	উদ্ধৃত,	উদ্ধৃত,	
sotorkobhabey,	সতর্কভাবে,	সতর্কভাবে,	
bohorompurer,	বহরমপুরের,	বহরমপুরের,	
blasterke,	ব্লাস্টারকে,	ব্লাস্টারকে,	
aborto,	অবর্ত,	আবর্ত,	
oitijje,	ঐতিহ্যে,	ঐতিহ্যে,	
probhura,	প্রভুরা,	প্রভুরা,	
sallallahu,	সাল্লাল্লাহু,	সল্লাল্লাহু,	
soundorjotakei,	সৌন্দর্যতাকেই,	সৌন্দর্যটাকেই,	
gaj,	গজ,	গেজ,	
debdebier,	দেবদেবীর,	দেবদেবীর,	
fasir,	ফাসির,	ফাসীর,	
debate,	দেবাতে,	ডিবেট,	
khudhartara,	ক্ষুধার্তরা,	ক্ষুধার্তরা,	
shef,	শেফ,	শেফ,	
kaferder,	কফেরদের,	কাফেরদের,	
byabostho,	ব্যবস্থ,	ব্যাবস্থা,	
monjooshree,	মনজুন্রী,	মঞ্জুশ্রী,	
gitikobita,	গীতিকবিতা,	গীতিকবিতা,	
highcommissionay,	হাইসমমসেশনায়,	হাইকমিশনে,	
booponer,	বরনের,	বপনের,	
otyacharer,	তৈ্যচারের,	অত্যাচারের,	
shringa,	শৃঙঙঙগা,	শৃঙ্গ,	
templet,	টেম্পলেট,	টেম্পলেট,	
nepchooner,	নেপচনের,	নেপচুনের,	
temonbhabe,	তেমনভাবে,	তেমনভাবে,	
sthapona,	স্থাপনা,	স্থাপনা,	
ship,	শিপ,	শিপ,	
aasar,	আসর,	আসর,	
khilaphat,	খিলাফাত,	খিলাফত,	
drishyogulotey,	দৃশ্যগুলোতেও,	দৃশ্যগুলোতে,	
degreeo,	দেগ্রীও,	ডিগ্রিও,	
sthapanar,	স্থাপনার,	স্থাপনার,	
baibosthaar,	বৈযবস্থার,	ব্যবস্থার,	
bbosben,	ব্বেসন,	বসবেন,	
senabahinio,	সেনাবাহিনীও,	সেনাবাহিনীও,	
sthapanatir,	স্থাপনাটির,	স্থাপনাটির,	
batikromee,	বাতিকর্মী,	ব্যতিক্রমী,	
kaathhaamaandu,	কারথমমা্দু,	কাঠমান্ডু,	
habathu,	হাবাথু,	হাবাথু,	
nothiboddho,	নথিবদ্ধ,	নথিবদ্ধ,	
doobate,	দৌবাতে,	ডুবাতে,	
jomjamat,	জমজামাত,	জমজমাট,	
wictor,	উইক্টর,	ভিক্টর,	
anchalgoolir,	আঞ্চলগুলির,	অঞ্চলগুলির,	
udbhaboni,	উদ্ভাবনী,	উদ্ভাবনী,	
obosorer,	অবসরের,	অবসরের,	
bangulzai,	বাঙ্গুলজাই,	বঙ্গুলিজাই,	
mmadhukkori,	ম্্ধুককররী,	মাধুকরী,	
patengar,	পাটেঙ্গার,	পতেঙ্গার,	
chikitshar,	চিকিতশার,	চিকিত্সার,	
ashor,	আশর,	আসর,	
abhidhaaner,	অভিধানের,	অভিধানের,	
hughes,	হুঘেস,	হিউজেস,	
uthe,	উঠে,	উঠে,	
manbe,	মানবে,	মানবে,	
hilser,	হিলসের,	হিলসের,	
aabarte,	আবর্তে,	আবর্তে,	
koyekbare,	কোয়েকবারে,	কয়েকবারে,	
skolarsip,	স্কোলারসিপ,	স্কলারশিপ,	
paolasthi,	পাওলাস্থি,	পাওলাসথি,	
lirikti,	লিরিকটি,	লিরিকটি,	
emiratas,	এমিরাটাস,	এমিরেটাস,	
jontropatigulite,	যন্ত্রপাতিগুলিতে,	যন্ত্রপাতিগুলিতে,	
zarniz,	জার্নিজ,	জারনিজ,	
shoodhooi,	শুধই,	শুধুই,	
kirke,	কিরকে,	কিরকে,	
orhan,	ওরহান,	ওরহান,	
hariken,	হারিকেন,	হ্যারিকেন,	
suparharo,	সুপারহার,	সুপারহিরো,	
protinito,	প্রতিনিত,	প্রতিনিত,	
ancholgoolir,	আঞ্চলগুলির,	অঞ্চলগুলির,	
arg,	আর্জ,	আর্গ,	
shroddhabihin,	শ্রদ্ধাবিহীন,	শ্রদ্ধাবিহীন,	
peeri,	পীরি,	পেরি,	
neerbahi,	নিউরবাহী,	নির্বাহি,	
baet,	বুট,	বাইট,	
rudiger,	রুদিগের,	রুদিগের,	
adarsho,	আদর্শ,	আর্দশ,	
pichte,	পিচতে,	পিছতে,	
karmosansthan,	কর্মসন্থানন,	কর্মসংস্থান,	
jatinke,	জাতিনকে,	যতীনকে,	
duio,	দুয়ো,	দুইও,	
sutir,	সুতির,	সুতির,	
vittimul,	ভিত্তিমুল,	ভিত্তিমূল,	
huk,	হুক,	হুক,	
karecho,	কারছো,	করেছ,	
sahinsatar,	সহিনস্তার,	সহিংসতার,	
rubidiyaam,	রুবিদিয়াম,	রুবিডিয়াম,	
ganesh,	গণেশ,	গণেশ,	
samley,	সমলে,	সামলে,	
bhiktara,	ভিকতারা,	ভিক্টর,	
alpo,	অ্যালপো,	অল্প,	
souripurang,	সৌরিপুরং,	সৌরিপুরং,	
plaiin,	প্লেইন,	প্লেন,	
palteche,	পালটেছে,	পাল্টেছে,	
upobashii,	উপবাশি,	উপবাসী,	
abarte,	আবর্তে,	আবর্তে,	
prithibir,	পৃথিবীর,	পৃথবীর,	
kinto,	কিন্তো,	কিনত,	
pabo,	পাবো,	পাব,	
ghotaibe,	ঘটাইবে,	ঘটাইবে,	
sompadon,	সম্পাদন,	সম্পাদন,	
jhanjra,	ঝঞ্জরা,	ঝাঁজরা,	
joones,	জননেস,	জোন্স,	
teunar,	তেউনার,	টিউনার,	
ancholsaha,	আঞ্চলসহ,	অঞ্চলসহ,	
dooburira,	দুবুরিরা,	ডুবুরিরা,	
sponsorshipe,	স্পন্সর্শিপে,	স্পন্সরশীপে,	
mag,	ম্যাগ,	এমএজি,	
hights,	হাইটস,	হাইটস,	
sahooseekotar,	সহসুসীকরার,	সাহসিকতার,	
danaqana,	দনকানা,	ডানকান,	
artore,	আর্তরে,	আর্টরে,	
nibobondhonkrito,	নিবন্নদনকৃত,	নিববন্ধনকৃত,	
nischoy,	নিশ্চয়,	নিশ্চয়,	
naitikatavodh,	নৈতিকতাবোধ,	নৈতিকতাবোধ,	
oitijjha,	ঐতিহ্জা,	ঐতিহ্য,	
taitela,	তাইতেলা,	টাইটেল,	
crime,	ক্রিমে,	ক্রাইম,	
bosturoi,	বস্তুরই,	বস্তুরই,	
vogno,	ভগ্ন,	ভগ্ন,	
naazee,	নাজ,	নাত্সি,	
aaps,	এপিএস,	এএপিএস,	
peerry,	পিরি,	পেরি,	
cooda,	কোডা,	কোডা,	
hijritey,	হিজৃতে,	হিজরীতে,	
ghoshanapatratio,	ঘোষণাপার্তিও,	ঘোষণাপত্রটিও,	
pratishthanik,	প্রতিষ্ঠানিক,	প্রাতিষ্ঠানিক,	
bhugol,	ভুগল,	ভূগোল,	
mexicoteo,	মেক্সিকোটেও,	মেক্সিকোতেও,	
dolu,	দোলু,	ডলু,	
daktickete,	ডাক্িটিকে,	ডাকটিকিটে,	
harbur,	হারবুর,	হারবার,	
blacker,	ব্ল্যাকের,	ব্ল্যাকের,	
ghenshei,	ঘেনশেই,	ঘেঁষেই,	
rakkhandurga,	রক্ষণদূর্গ,	রক্ষণদুর্গ,	
pratisthasaho,	প্রতিষ্ঠাসহ,	প্রতিষ্ঠাসহ,	
ovidhanik,	অভিধানিক,	অভিধানিক,	
mukhomandaley,	মুখোমন্ডলে,	মুখমণ্ডলে,	
bhabotarini,	ভাবাতারিনী,	ভবতারিণী,	
duhsthanostho,	দুঃস্থানস্থ,	দুঃস্থানস্থ,	
bolbo,	বলবো,	বলবো,	
gandhike,	গান্ধীকে,	গান্ধীকে,	
bizito,	বিজিত,	বিজিত,	
dristiheen,	দৃষ্টিনীন,	দৃষ্টিহীন,	
ceramiksh,	সেরিমিক্স,	সিরামিকস,	
yura,	যুরা,	ইউরো,	
udbhabaney,	উদ্ভাবনে,	উদ্ভাবনে,	
basturoi,	বাস্তুরই,	বস্তুরই,	
doneta,	দনেটা,	ডোনাট,	
obhijojan,	অভিজোজন,	অভিযোজন,	
fakhrul,	ফাখরুল,	ফাখরুল,	
supreetira,	সুপৃতিরা,	সুপ্রীতিরা,	
bhowanipur,	ভোয়ানীপুর,	ভবানীপুর,	
esprito,	এস্পৃত,	এস্পিরিটো,	
vobobibhuti,	ভববিভুটি,	ভববিভূতি,	
maritimer,	মারিতিমের,	মেরিটাইমের,	
bachai,	বাচাই,	বাছাই,	
procharona,	প্রচারণা,	প্রচারণা,	
asommoti,	অসম্মতি,	অসম্মতি,	
ispredsheet,	ইস্প্রিডিশ,	স্প্রেডশীট,	
nisader,	নিসাদের,	নিষাদের,	
rakkhanbhag,	রক্ষণভাগ,	রক্ষণভাগ,	
teennis,	টিনিস,	টেনিস,	
iling,	ইলিং,	ইলিং,	
safin,	সাফিন,	সাফিন,	
gronthoti,	গ্রন্থটি,	গ্রন্থটি,	
durotamo,	দুরতামো,	দূরতম,	
rena,	রেনা,	রেনো,	
duple,	ডাপলে,	ডুপ্লে,	
nutunotto,	নুতুনতত্ব,	নতুনত্ব,	
khelechen,	খেলেছেন,	খেলেছেন,	
proshadhoner,	প্রশাধনের,	প্রসাধনের,	
shamshernagar,	শমশশরণগরের,	শমশেরনগর,	
dito,	দিতো,	দিতো,	
taler,	তালের,	তালের,	
sheshardhe,	শেষার্ধে,	শেষার্ধে,	
tricksguli,	ট্রিকসগুলি,	ট্রিকসগুলি,	
neker,	নেকের,	নেকের,	
mahasava,	মহাসভা,	মহাসভা,	
hijrite,	হিজৃতে,	হিজরীতে,	
varote,	ভারোতে,	ভারতে,	
fake,	ফাকে,	ফাকে,	
ekatitto,	একাতিত্ব,	একাতিত্ব,	
pratijogider,	প্রতিযোগীদের,	প্রতিযোগীদের,	
tinage,	তিনেগে,	টিনেজ,	
tikta,	টিকটা,	তিক্ত,	
byabaharkariderke,	ব্যবহারকারীদেরকে,	ব্যবহারকারীদেরকে,	
odeb,	ওডেব,	ওদেব,	
monchostho,	মঞ্চস্থ,	মঞ্চস্থ,	
bbiswashke,	বিবসবাশ্কে,	বিশ্বাসকে,	
ceramiker,	সেরামিকের,	সিরামিকের,	
ashok,	আশক,	আশোক,	
jemy,	জেম,	জেমি,	
zubokder,	যুবকদের,	যুবকদের,	
lyaanding,	ল্যান্ডিং,	ল্যান্ডিং,	
shudhir,	শুধীর,	শুধীর,	
bhikkharthe,	ভিক্ষার্থে,	ভিক্ষার্থে,	
balabhadra,	বালাভদ্র,	বলভদ্র,	
telakucha,	তেলাকুচা,	তেলাকুচা,	
bandhano,	বান্ধানো,	বাঁধানো,	
uter,	উটের,	উটের,	
shikshakbrindo,	শিক্ষাবৃস্দ,	শিক্ষকবৃন্দ,	
kaleo,	কালেও,	কালেও,	
udvabani,	উদ্ভাবনী,	উদ্ভাবনী,	
middleton,	মিডলটটন,	মিডলটন,	
shcholastic,	শ্লোস্ট্কিট,	স্কলাস্টিক,	
bejiye,	বেজিয়ে,	বেজিয়ে,	
soource,	সুউর্স,	সোর্স,	
mmehonoti,	ম্যানহিটি,	মেহনতি,	
hari,	হারি,	হরি,	
upacharjo,	উপাচর্য,	উপাচার্য,	
krisenta,	ক্রিনেন্তা,	ক্রিসেন্ট,	
aholyar,	আহল্যার,	অহল্যার,	
moonshi,	মুনশি,	মুন্সি,	
suiza,	সুইজা,	সুইজা,	
amorendro,	অমরেন্দ্র,	অমরেন্দ্র,	
sportstar,	স্পার্টস্টার,	স্পোর্টসস্টার,	
rasunkunchi,	রসুনকুন্চি,	রসুনকুঁচি,	
codee,	কোডি,	কোডে,	
shukraanoo,	শুক্রানও,	শুক্রানু,	
temanti,	তেমন্তি,	তেমনটি,	
majdur,	মাজদুর,	মজদুর,	
modyer,	মড্যার,	মদ্যের,	
srivatsalakshanang,	শ্রীবালস্্্ধাংংং,	শ্রীবৎসলক্ষণং,	
nibirbhabe,	নিবর্ভভাবে,	নিবিরভাবে,	
darji,	দারজি,	দরজি,	
anchalei,	আঞ্চলেই,	অঞ্চলেই,	
bisnoo,	বিসননও,	বিষ্ণু,	
lutharen,	লুথারেন,	লুথেরান,	
bhromoner,	ভ্রমণের,	ভ্রমণের,	
sohojlovyotar,	সহজল্য্যতার,	সহজলভ্যতার,	
valobase,	ভালোবাসে,	ভালোবাসে,	
shikkhartheerao,	শিক্ষার্থীরাও,	শিক্ষার্থীরাও,	
ekroop,	একরূপ,	একরূপ,	
airish,	আইরিস,	আইরিস,	
marodeho,	মারদেহ,	মরদেহ,	
garora,	গাযারোরা,	গারোরা,	
dharmiyabhabei,	ধর্মিয়ভাবেই,	ধর্মীয়ভাবেই,	
gobeshakgon,	গবেষকগণ,	গবেষকগণ,	
oncholtee,	অনচলটি,	অঞ্চলটি,	
mugdha,	মুগদা,	মুগ্ধ,	
nirgoon,	নির্গুণ,	নির্গুণ,	
spredashita,	স্প্রেডশশিটা,	স্প্রেডশীট,	
hajirhat,	হজিিহাট,	হাজিরহাট,	
carlosh,	কার্লকোশ,	কার্লোস,	
ekbai,	একবাই,	একবাই,	
chhutee,	ছুটি,	ছুটি,	
jeebanjapon,	জীবাজনপপণ,	জীবনযাপন,	
dakshinangsho,	দক্ষিণংশং,	দক্ষিণাংশ,	
mekon,	মেকন,	মেকং,	
mohajote,	মহাজতে,	মহাজোট,	
ashociatesh,	অসোিয়েটেশ,	এসোসিয়েটস,	
idipasha,	ইদিপাশা,	ইডিপাস,	
graambaasheeo,	গ্রামবাশশও,	গ্রামবাসীও,	
deefinishion,	ডিফিনিশন,	ডেফিনেশন,	
jamaanor,	জামানোর,	জমানোর,	
bhaangchur,	ভাংচুর,	ভাংচুর,	
bodhir,	বোধির,	বধির,	
ashankai,	আশাঙকাই,	আশঙ্কাই,	
ganochin,	গণচিন,	গণচীন,	
sangram,	সংগ্রাম,	সঙ্গ্রাম,	
sures,	সুরেস,	সুরেশ,	
sangsakti,	সংস্কটি,	সংসক্তি,	
pretti,	প্রেত্তি,	প্রিটি,	
madelim,	মাদেলিম,	মডেলিং,	
sulfatee,	সুলফাতি,	সালফেট,	
arthurer,	অর্থুরের,	আর্থারের,	
futonta,	ফুনোটা,	ফুটন্ত,	
bifol,	বিফল,	বিফল,	
ukeliptash,	উকেলিপল্শ,	ইউক্যালিপ্টাস,	
chandanara,	চন্দনারা,	চন্দনারা,	
gyandaas,	জ্ঞানদাস,	জ্ঞানদাস,	
nazad,	নাজাদ,	নাজাদ,	
torunra,	তরুণরা,	তরুণরা,	
lebina,	লেবিনা,	লেবিনা,	
damodar,	দামোদার,	দামদর,	
dinar,	দিনার,	ডিনার,	
waal,	ওয়াল,	উল,	
obharbhiu,	অভ্রাভি,	ওভারভিউ,	
cholochchitro,	চলচ্ছিত্র,	চলচ্চিত্র,	
baffer,	বফফের,	বাফার,	
istoone,	ইস্তুনে,	স্টোন,	
gunje,	গুঞ্জে,	গুঁজে,	
huka,	হুকা,	হুক,	
prottokkhovabe,	প্রত্যক্ষভাবে,	প্রত্যক্ষভাবে,	
confliqt,	কনফলিক্ট,	কনফ্লিক্ট,	
bolechile,	বলেছিলে,	বলেছিলে,	
dwibidho,	দ্বিবিধ,	দ্বিবিধ,	
rajtantrey,	রাজতন্ত্রে,	রাজতন্ত্রে,	
dormroome,	দরমরমুমে,	ডর্মরুমে,	
veenish,	ভিনিশ,	ভেনিস,	
augustine,	অগাস্টাইন,	অগাস্টিন,	
romjaner,	রমজানের,	রমযানের,	
songasthaner,	সঙ্সা্থানের,	সংস্থানের,	
taroni,	তারনি,	তরণী,	
cinemapremider,	সিনেমাপ্রেমিদের,	সিনেমাপ্রেমীদের,	
bhabatarini,	ভবতর্ীী,	ভবতারিণী,	
militaryr,	মিলিটারর,	মিলিটারির,	
tata,	টাতা,	তাতা,	
bollov,	বোলভোভ,	বল্লভ,	
pohnpeic,	পোহনপিক,	ফোনপেইক,	
lendl,	লেন্ডল,	লেন্ডল,	
kabutorer,	কাবুতরের,	কবুতরের,	
siraju,	সিরাজু,	সিরাজু,	
shector,	শেক্টর,	সেক্টর,	
akhando,	অখণ্ড,	অখন্ড,	
balaruma,	বালারুমা,	বলরুম,	
jerusalemer,	জেরুসালেমের,	জেরুজালেমের,	
jontrangshogulor,	যন্ত্রাংশগুলোর,	যন্ত্রাংশগুলোর,	
oitijjo,	ঐতিহ্য,	ঐতিহ্য,	
manushe,	মানুষে,	মানুষে,	
aziza,	আজিজা,	আজিজা,	
keuoi,	কেউই,	কেউই,	
wishnu,	উষিন্ু,	বিষ্ণু,	
shikhbe,	শিখবে,	শিখবে,	
karadandey,	কারাদানদে,	কারাদণ্ডে,	
bisshasyi,	বিশ্সাসী,	বিশ্বাসই,	
vault,	ভাযালট,	ভল্ট,	
mosharroph,	মোশার্ফর,	মশাররফ,	
kayartara,	কয়ারতরা,	কোয়ার্টার,	
shurugulo,	শুরুগুলো,	শুরুগুলো,	
jolrong,	জলর্ং,	জলরঙ,	
messengerer,	মেসেনগেরের,	মেসেঞ্জারের,	
dombhoke,	দম্ভকে,	দম্ভকে,	
pleeta,	প্লিটা,	প্লেট,	
tooku,	তোকু,	টুকু,	
mokhmoley,	মকখমলে,	মখমলে,	
ucchosito,	উচ্চসিত,	উচ্ছসিত,	
mathieu,	ম্যাথিউ,	ম্যাথিউ,	
lyaataa,	ল্যাট,	ল্যাটা,	
deelibhara,	দীলিভরা,	ডেলিভার,	
akeeb,	আকীব,	আকিব,	
moushumei,	মৌশুমেই,	মৌসুমেই,	
standards,	স্টাযান্ডার্ডস,	স্টান্ডার্ডস,	
rashedul,	রশেদুল,	রাশিদুল,	
prarthitao,	প্রার্থিতাও,	প্রার্থীতাও,	
pustir,	পুস্তির,	পুষ্টির,	
proshikkhane,	প্রশিক্ষানে,	প্রশিক্ষণে,	
ragee,	রাগী,	রাগী,	
nationalser,	ন্যাশনলসেের,	ন্যাশনালসের,	
phareeksa,	ফরিকস,	ফরেক্স,	
daqten,	ডাকটেন,	ডাকতেন,	
rockibul,	রকিবুল,	রকিবুল,	
dheke,	ধেকে,	ঢেকে,	
lagchhe,	লাঘছে,	লাগছে,	
jens,	জেনস,	জিন্স,	
nirbahe,	নির্বাহে,	নির্বাহে,	
qraima,	ক্রাইমা,	ক্রাইম,	
bondi,	বন্ডি,	বন্দী,	
arekdol,	আরেকদল,	আরেকদল,	
hizriite,	হিজিরিতে,	হিজরীতে,	
billaho,	বিল্লাহ,	বিল্লাহ,	
niropekkho,	নিরপেক্ষ,	নিরপেক্ষ,	
shilpikuler,	শিল্পিকুলের,	শিল্পীকুলের,	
ap,	এপি,	আপ,	
shangkulaan,	শাংকুলান,	সংকুলান,	
dumaa,	দুমা,	দুমা,	
cxt,	কিএসটিআট,	সিএক্সটি,	
dayitta,	দায়িত্ব,	দায়িত্ব,	
jyaqasana,	জ্যাকাসন,	জ্যাকসন,	
bondira,	বন্দিরা,	বন্দীরা,	
hooq,	হুক,	হুক,	
popaike,	পোপাইকে,	পপাইকে,	
bolvodro,	বলদ্রর,	বলভদ্র,	
siit,	সিত,	শীত,	
jotharthovabey,	যথার্থবাভে,	যথার্থভাবে,	
average,	অভেরাজ,	এভারেজ,	
cuti,	কুটি,	কিউটি,	
chirkut,	চিরকুট,	চিরকুট,	
bhabaponno,	ভাবপন্ন,	ভাবাপন্ন,	
uporzon,	উপরজন,	উপার্জন,	
themeke,	থেমেকে,	থিমকে,	
songasthatike,	সঙ্চাস্থতিকে,	সংস্থাটিকে,	
laagche,	লাগচে,	লাগছে,	
fongli,	ফংগলি,	ফংলি,	
sumitrar,	সুমিত্রার,	সুমিত্রার,	
deefinision,	ডিফিনিশন,	ডেফিনেশন,	
deh,	দেহ,	দেহ্,	
ramachandranke,	রামচন্দ্রনকে,	রামাচন্দ্রনকে,	
shatodha,	শতধা,	শতধা,	
vromonkaley,	ভ্রমণকালে,	ভ্রমণকালে,	
bhangle,	ভাঙ্গল,	ভাঙলে,	
noditir,	নদিতির,	নদীটির,	
chilahaati,	চিলাহাটি,	চিলাহাটি,	
zerusaleme,	জেরুসালেমে,	জেরুসালেমে,	
rinattak,	ঋণত্যাক,	ঋনাত্মক,	
audiotike,	আডিওটিকে,	অডিওটিকে,	
orthoneeti,	অর্থনীতি,	অর্থনীতির,	
paramartha,	পরমার্থ,	পরমার্থ,	
munot,	মুনোট,	মুনোট,	
elakatite,	এলাকাটিতে,	এলাকাটিকে,	
rahshahi,	রাহশাহী,	রাহশাহী,	
lendol,	লেন্ডোল,	লেন্ডল,	
brittakarey,	বৃত্তকারে,	বৃত্তাকারে,	
siddhantei,	সিদ্ধান্তেই,	সিদ্ধান্তেই,	
ganaporibahaner,	গণপরিবাহনের,	গণপরিবহনের,	
biswashi,	বিশ্বাশী,	বিশ্বাসী,	
aakkaash,	আক্কাশ,	আককাস,	
hyaloyin,	হ্যালিয়ন,	হ্যালোইন,	
juktorashtreo,	যুক্তরাষ্ট্রেও,	যুক্তরাষ্ট্রেও,	
shahurgulor,	শাহুরগুলোর,	শহুরগুলোর,	
pranibigyani,	প্রাণিবিজ্ঞানী,	প্রাণীবিজ্ঞানী,	
chetanagoto,	চেতানগত,	চেতনাগত,	
bibhinno,	বিভিন্ন,	বিভন্ন,	
ajibooner,	অজিবনের,	আজীবনের,	
yukeliptash,	যুকিলেপুশ্শ,	ইউক্যালিপ্টাস,	
cholochchitrer,	চলচ্চিত্রের,	চলচ্চিত্রের,	
kormopontha,	কর্মপন্থ,	কর্মপন্থা,	
modhyekar,	মধ্যেকার,	মধ্যেকার,	
reejideencee,	রিজিডিন্সি,	রেসিডেন্স,	
lahano,	লাহানো,	লাহানো,	
nomo,	নম,	নমো,	
taatey,	তাউতে,	তাতে,	
bonbhumi,	বনভূমি,	বনভূমি,	
plator,	প্ল্যাটর,	প্লেটোর,	
shikh,	শিখ,	শিখ,	
niphelheim,	নিফেফাইম,	নিফেলহেইম,	
bashoborty,	বাশববর্তি,	বশবর্তী,	
proshtotto,	প্রশ্তত্ত্ব,	প্রস্ত্তত,	
oncholshomuh,	অনচ্লসমূহ,	অঞ্চলসমূহ,	
koyeeri,	কয়েরী,	কোয়েরি,	
ruby,	রুবি,	রুবী,	
cathalic,	ক্যাথালিক,	ক্যাথলিক,	
orthonitir,	অর্থনীতির,	অর্থনীতির,	
timoothi,	তিমৌথি,	টিমোথি,	
bahati,	বাহাটি,	বাহাতি,	
ahalyar,	আহল্যার,	অহল্যার,	
turisht,	টুরিশ্ট,	টুরিস্ট,	
nathivookteer,	নাথিভুক্তির,	নথিভুক্তির,	
jumlalancer,	জুমললাযান্সের,	জুমলাল্যান্সার,	
chhooteer,	ছুটির,	ছুটির,	
elaaka,	এলাকা,	এলাকা,	
shasankorta,	শাসনকর্তা,	শাসনকর্তা,	
tongaa,	টোঙ্গা,	টোঙ্গা,	
caroline,	ক্যারোলিন,	ক্যরোলিন,	
motkey,	মটকে,	মতকে,	
vodqa,	ভোডকা,	ভদকা,	
shrabastee,	শ্রাবস্তি,	শ্রাবস্তী,	
qarpeta,	কারপেটা,	কার্পেট,	
drissotir,	ড্রিস্টির,	দৃশ্যটির,	
jeher,	জেহের,	জেহের,	
lekhaksattwar,	লেখাকতস্ত্বর,	লেখকসত্ত্বার,	
gannaprakasham,	গণ্যপ্রকাশম,	গন্নাপ্রকাশম,	
prokolpow,	প্রকল্পব,	প্রকল্পও,	
zerusalemer,	জেরুসালেমের,	জেরুজালেমের,	
juboksoho,	যুবকসহ,	যুবকসহ,	
liseensee,	লিসিন্সি,	লাইসেন্স,	
vedanta,	ভেদন্ত,	বেদান্ত,	
chhanada,	ছানাদা,	ছানাদা,	
chalochchitrei,	চললচচিত্রেরই,	চলচ্চিত্রেই,	
pyor,	প্রৌ,	পিওর,	
daraider,	দারাইদের,	দরাইদের,	
prachirer,	প্রাচীরের,	প্রাচিরের,	
shikkhadikkhay,	শিক্ষাদিক্ষায়,	শিক্ষাদিক্ষায়,	
dara,	দারা,	দারা,	
shilpojaat,	শিল্পযাত,	শিল্পজাত,	
adbhanced,	অ্যাডভান্ডেড,	অ্যাডভান্সড,	
neemeetto,	নিমত,	নিমিত্ত,	
daaktikite,	দাকটিকিতে,	ডাকটিকিটে,	
porizoner,	পরিজনের,	পরিজনের,	
parjotaker,	পার্যটাকের,	পর্যটকের,	
sahittekder,	সাহিত্যকদের,	সাহিত্যেকদের,	
ishter,	ইস্টার,	ইস্টের,	
turista,	টুরিস্টা,	টুরিস্ট,	
toroonraa,	টররুনা,	তরুণরা,	
addabaj,	আদ্দাবাজ,	আড্ডাবাজ,	
mutar,	মুতার,	মুতার,	
paikgachha,	পাইখলা,	পাইকগাছা,	
ancholtike,	আঁচকলিিকে,	অঞ্চলটিকে,	
aprasangikbhabei,	অপ্রাস্জনিকভাবেই,	অপ্রাসঙ্গিকভাবেই,	
creshcent,	ক্রেসেন্ট,	ক্রিসেন্ট,	
utkhaat,	উৎখাত,	উত্খাত,	
saptahokal,	সপ্তাহকাল,	সপ্তাহকাল,	
eokee,	এইক,	এওকি,	
maarmaader,	মার্মাদের,	মারমাদের,	
elgoridom,	এলগরিডোম,	এলগরিদম,	
protishtan,	প্রতিষ্টান,	প্রতিষ্টান,	
neemeette,	নিমতে,	নিমিত্তে,	
mekong,	মেকং,	মেকং,	
swajan,	স্বজন,	স্বজন,	
saqara,	সাকারা,	সাকার,	
dishani,	দিশানী,	দিশানি,	
cheentaikaree,	চেন্টায়কারী,	ছিনতাইকারী,	
pet,	পেট,	পেত,	
nick,	নিক,	নিক্,	
salafeta,	সালাফেটা,	সালফেট,	
nathibhuktir,	নথিভূক্তির,	নথিভুক্তির,	
pinglateo,	পিংলাতেও,	পিংলাতেও,	
graambaaseeder,	গ্রামবাসীদের,	গ্রামবাসীদের,	
elaakaate,	এলাকাতে,	এলাকাতে,	
nagorikra,	নাগরিকরা,	নাগরিকরা,	
musabbirul,	মুসাবিবরুল,	মুসাব্বিরুল,	
paroner,	পারণের,	পারণের,	
borkhastokritora,	বরখাস্তকৃতরা,	বরখাস্তকৃতরা,	
soketgulor,	সোকেটগুলোর,	সকেটগুলোর,	
literacy,	লিটারেসি,	লিটারেসি,	
phising,	ফিসিং,	ফিসিং,	
krisenter,	ক্রিসেন্টের,	ক্রিসেন্টের,	
mukhamandoler,	মুখানমোলের,	মুখমণ্ডলের,	
terlarang,	টেরলার্ং,	তেরলারং,	
oitijhyotike,	ঐতিহ্যযিকে,	ঐতিহ্যটিকে,	
patigoniter,	পাতিগণীতের,	পাটিগণিতের,	
cholochchitra,	চলচ্চিত্র,	চলচ্চিত্র,	
biplobi,	বিপ্লবি,	বিপ্লবী,	
vugorvey,	ভুগরভে,	ভূগর্ভে,	
godamjato,	গোদামাত,	গুদামজাত,	
kaash,	কাশ,	কাস,	
liaodong,	লিয়াকোন,	লিয়াওদং,	
deqe,	দেকে,	ডেকে,	
sucre,	সুক্রে,	সাকার,	
totokson,	তোটকসন,	ততক্ষন,	
poriskoron,	পরিস্করণ,	পরিষ্করণ,	
taholo,	তাহলো,	তাহলো,	
jomoker,	জমকের,	জমকের,	
nagorikkey,	নাগরিককে,	নাগরিককে,	
biplabeer,	বিপ্লবের,	বিপ্লবীর,	
tigre,	তিগ্রে,	টাইগার,	
girilal,	গিরিলাল,	গিরিলাল,	
toching,	টচিং,	টোচিং,	
shhashtra,	শাস্ত্র,	শাস্ত্র,	
mozdur,	মোজদুর,	মজদুর,	
conservetion,	কনজারভেশন,	কনসারভেশন,	
turkyder,	টার্কযাডের,	তুর্কিদের,	
vandar,	ভান্ডার,	ভাণ্ডার,	
ramolino,	রামলীনো,	রামোলিনো,	
ancholsomuho,	আঞ্কলসমূহ,	অঞ্চলসমূহ,	
transformaarer,	ট্রান্সমফরমারের,	ট্রান্সফরমারের,	
khappar,	খাপপার,	খপ্পর,	
jonoikaa,	জনককা,	জনৈকা,	
sonaicha,	সোনাইচা,	সোনাইচা,	
teoner,	টেওনের,	টিওনার,	
vabuk,	ভাবুক,	ভাবুক,	
grambaasi,	গ্রামবাসী,	গ্রামবাসী,	
milekhanek,	মিলাখেনেক,	মাইলখানেক,	
graambasio,	গ্রামবাসীও,	গ্রামবাসীও,	
bipajjanak,	বিপঞ্জনক,	বিপজ্জনক,	
vobanipur,	ভবানীপুর,	ভবানীপুর,	
proteemake,	প্রতিমাকে,	প্রতিমাকে,	
karecho,	কারছো,	করেছো,	
ghoomachhilo,	ঘরমাছিল,	ঘুমাচ্ছিল,	
ongshogrohoner,	অংশগ্রহণের,	অংশগ্রহনের,	
shahoshikatar,	শাহসিকতার,	সাহসিকতার,	
ekok,	একক,	একক,	
choudhursoho,	চৌদুরসহ,	চৌধুরসহ,	
bisshonath,	বিশ্বনাথ,	বিশ্বনাথ,	
degree,	দেগ্রী,	ডিগ্রি,	
korley,	করলি,	করলে,	
rajtontro,	রাজতন্ত্র,	রাজতন্ত্র,	
landing,	ল্যান্ডিং,	ল্যান্ডিং,	
pharmesigulote,	ফার্মেসিগুলোতে,	ফার্মেসীগুলোতে,	
milton,	মিলটন,	মিলটন,	
nagorikra,	নাগরিকরা,	নাগরিকেরা,	
shoriph,	শরিফ,	শরিফ,	
ekhate,	এখাতে,	একহাতে,	
pyore,	প্রয়ের,	পিওর,	
debdebie,	দেববীদে,	দেবদেবী,	
mulor,	মুলোর,	মুলোর,	
nirmankaaj,	নির্মনকাজ,	নির্মাণকাজ,	
sip,	সিপ,	শিপ,	
chhootochhuti,	ছোটচুটি,	ছুটোছুটি,	
haitasha,	হাইতাশা,	হাইটস,	
laiseensee,	লাইসসিন্স,	লাইসেন্স,	
kanasharabheshhana,	কনশাভাষনে,	কনসারভেশন,	
anichchi,	অনিচ্ছি,	আনিচ্ছি,	
bagdadii,	বাগদাদি,	বাগদাদী,	
amar,	আমার,	আমর,	
nagorikota,	নাগরিকতা,	নাগরিকতা,	
ghoshito,	ঘোষিত,	ঘোষিত,	
shansthaner,	শানসষ্ঠানের,	সংস্থানের,	
upbasher,	উপবাশের,	উপবাসের,	
ul,	উল্,	উল,	
bisshaskey,	বিশ্সাকে,	বিশ্বাসকে,	
carbus,	কার্বাস,	কারবাস,	
qyapasula,	ক্যাপাসুলা,	ক্যাপসুল,	
charpanch,	চারপঞ্চ,	চারপাঁচ,	
songkulan,	সংকুলান,	সংকুলান,	
kanasarabheeshana,	কনসারভভষণ,	কনসারভেশন,	
somraatder,	সম্রাদদের,	সম্রাটদের,	
stagecraft,	স্টেগাক্রফ্যাট,	স্টেজক্রাফট,	
harasta,	হরসা্ত,	হারাস্তা,	
europia,	ইউরোপিয়া,	ইউরোপিয়া,	
bonobhumi,	বনভূমি,	বনভূমি,	
koordira,	কোরডিরা,	কুর্দিরা,	
adhyatmikata,	অধ্যাতমিকতা,	আধ্যাত্মিকতা,	
chuti,	চুটি,	ছুটি,	
america,	আমেরিকা,	আমেরিকা,	
deputee,	ডেপুটি,	ডেপুটি,	
maail,	মাইল,	মাইল,	
niemond,	নিয়ামন্ড,	নিমন্ড,	
asamanyo,	অসামন্য,	অসামান্য,	
holdim,	হোল্দিম,	হোল্ডিং,	
kaalengaa,	কালেঙ্গা,	কালেঙ্গা,	
chaloke,	চালকে,	চালকে,	
jaruri,	জারুরি,	জরূরী,	
sorting,	সর্টিং,	সর্টিং,	
sanghatakder,	সংখাতদের,	সংঘটকদের,	
sakshatkarer,	সাক্ষাতকের,	সাক্ষাৎকারের,	
pratijogitamulak,	প্রতিযোগিতামূলক,	প্রতিযোগীতামূলক,	
nilfamarir,	নীলফামীরির,	নীলফামারীর,	
daebug,	দাইবুগ,	ডিবাগ,	
siddhanter,	সিদ্ধান্তের,	সিদ্ধান্তের,	
unitgulo,	উনিতগুলো,	ইউনিটগুলো,	
tantubayer,	তন্তুবায়ের,	তন্তুবায়ের,	
dhonni,	ধননি,	ধন্যি,	
reflex,	রিফ্লেক্স,	রিফ্লেক্স,	
shumo,	শুমো,	সুমো,	
kanthar,	কানথার,	কাঁথার,	
surakarder,	সুরকরদের,	সুরকারদের,	
hisabagyan,	হিসাবাজ্ঞান,	হিসাবজ্ঞান,	
protijogiider,	প্রতিযোগীদের,	প্রতিযোগীদের,	
senabahineekey,	সেনাবাহিনীকে,	সেনাবাহিনীকে,	
shamshere,	শমশেরে,	শমসের,	
azaan,	আজান,	আজান,	
cinematographar,	সিনেমাটোগ্রাফার,	সিনেমাটোগ্রাফার,	
baibosthar,	বৈযবস্থার,	ব্যবস্থার,	
pretty,	প্রেটি,	প্রিটি,	
dabliudabliui,	দাবলিউবললিউ,	ডাব্লিউডাব্লিউই,	
blyaka,	ব্ল্যাক,	ব্ল্যাক,	
female,	ফেমালে,	ফিমেল,	
udor,	উদর,	উদর,	
laat,	লাত,	লাট,	
chirkoot,	চিরকুট,	চিরকুট,	
ekekrokom,	একেকরকম,	একেকরকম,	
chorchita,	চরচিটা,	চর্চিত,	
behrampurer,	বেহারমপুরের,	বহরমপুরের,	
sahojatprobritti,	সহজৎপ্রবৃত্তি,	সহজাতপ্রবৃত্তি,	
saver,	সাভার,	সেভার,	
madhuree,	মধুরী,	মাধুরী,	
elakatay,	এলাকাটায়,	এলাকাতে,	
shotodha,	শতধা,	শতধা,	
karaa,	কারা,	কারো,	
janosamaj,	জনসমাজ,	জনসমাজ,	
gaichhe,	গাইছে,	গাইছে,	
bisnukey,	বিস্নুকে,	বিষ্ণুকে,	
eshtonia,	এসতনিয়া,	এস্তোনিয়া,	
taufik,	তৌফিক,	তৌফিক,	
edic,	এডিক,	এডিক,	
ashamorthito,	অশামর্থিত,	অসমর্থিত,	
freekeh,	ফ্রিকেহ,	ফ্রিকেহ,	
ghatiti,	ঘাটিটি,	ঘাঁটিটি,	
licencer,	লাইসেন্সের,	লাইসেন্সের,	
aajeej,	আজীজ,	আজিজ,	
dhaleshwari,	ধলেশ্বরী,	ধলেশ্বরী,	
purohitder,	পুরোহিতদের,	পুরোহিতদের,	
probhritike,	প্রভৃতিকে,	প্রভৃতিকে,	
nabbata,	নব্বতা,	নাব্যতা,	
karuna,	করুনা,	করুণা,	
seqtara,	সেকটারা,	সেক্টর,	
kidambi,	কিদম্বী,	কিদম্বি,	
akkheperi,	অক্ষেপেরই,	আক্ষেপেরই,	
rakhtokkharoner,	রাক্তধারণের,	রক্তক্ষরণের,	
hames,	হামেস,	হোমস,	
poddhotiteyi,	পদ্ধটিতেই,	পদ্ধতিতেই,	
bojiye,	বজিয়ে,	বজিয়ে,	
barack,	ব্যারাক,	বারাক,	
bachhaikrito,	বাছারিক্ত,	বাছাইকৃত,	
poorohitder,	পোরহহিতদের,	পুরোহিতদের,	
mythological,	মিথলিয়াকল,	মাইথলজিকাল,	
daaun,	ডাউন,	ডাউন,	
oisamoyer,	ঐশমযয়ের,	ঐসময়ের,	
eexpreession,	এক্সপ্রেশন,	এক্সপ্রেশন,	
obosore,	অবসরে,	অবসরে,	
pisach,	পিসাচ,	পিশাচ,	
laaz,	লাজ,	লাজ,	
nodimaatrik,	নদিমা্যটিক,	নদীমাতৃক,	
hafsa,	হাফসা,	হাফসা,	
roopdan,	রুপডান,	রুপদান,	
thechar,	ঠেচার,	থ্যাচার,	
silabhara,	সিলাভারা,	সিলভার,	
sainyader,	সৈন্যদের,	সৈন্যদের,	
graambashee,	গ্রামবশশী,	গ্রামবাসী,	
sectore,	সেকটরর,	সেক্টরে,	
liceensee,	লিসিন্সি,	লাইসেন্স,	
manobikotao,	মানবিকতাও,	মানবিকতাও,	
hosney,	হোসনে,	হোসনে,	
mukhoshdharir,	মুখোষধারীর,	মুখোশধারীর,	
greep,	গ্রীপ,	গ্রিপ,	
chaalaabi,	চালাবি,	চালাবে,	
vangley,	ভাঙ্গলি,	ভাঙলে,	
jaanachhe,	যানাচে,	জানাচ্ছে,	
saurce,	সার্সে,	সোর্স,	
atarkitey,	আতরকিতে,	অতর্কিতে,	
chhutochhooti,	ছুটছছটি,	ছুটোছুটি,	
oporishodhito,	অপরিষোধিত,	অপরিশোধিত,	
maudelder,	মাউডেলদের,	মডেলদের,	
nirarthak,	নিরার্থক,	নিরর্থক,	
tasminer,	তাসমিনের,	তাসমিনের,	
shakar,	শাকর,	সকার,	
konar,	কোনার,	কণার,	
koreempoor,	করিমপুর,	করিমপুর,	
dhyana,	ধ্যানা,	ধ্যান,	
eporzonto,	এপরজন্ত,	এপর্যন্ত,	
ragei,	রাগেই,	রাগেই,	
popke,	পপকে,	পোপকে,	
wagadada,	ওয়াগাদাদা,	বাগদাদ,	
sanaktakaran,	সনকক্তকরণ,	সনাক্তকরণ,	
kormobuddhite,	কর্মবুদ্ধিতে,	কর্মবুদ্ধিতে,	
jothon,	যথন,	যথন,	
mohajot,	মহাজত,	মহাজোট,	
ekspression,	এক্সপ্রেশন,	এক্সপ্রেশন,	
swarther,	স্বর্থের,	স্বার্থের,	
sondhisthaponer,	সন্ধিস্থাপনের,	সন্ধিস্থাপনের,	
bhogiroth,	ভগীপথ,	ভগীরথ,	
dhhaloor,	ঢালুর,	ঢালুর,	
video,	ভিডেও,	ভিডিয়োও,	
miraqela,	মিরেকেলা,	মিরাকেল,	
lagto,	লাগতো,	লাগতো,	
chalochchitraeei,	চললচ্চিত্রীরেই,	চলচ্চিত্রেই,	
akmato,	আকমাতো,	একমত,	
gujob,	গুজব,	গুজব,	
shekender,	শেকেন্দর,	সেকেন্ডের,	
bishasey,	বিশাসে,	বিশ্বাসে,	
abhidhaanick,	অভিধানান্ক,	অভিধানিক,	
kortona,	কর্তনা,	করতনা,	
muhuriganj,	মুহুরীগঞ্জ,	মুহুরীগঞ্জ,	
spredasita,	স্প্রেডাসিটা,	স্প্রেডশীট,	
bishhnu,	বিষ্ণু,	বিষ্ণু,	
poorohitra,	পোরহহিত্র,	পুরোহিতরা,	
scholastik,	স্কল্সটিক,	স্কলাস্টিক,	
sausagee,	সসাগী,	সসেজ,	
akkaas,	আক্কাস,	আককাস,	
tookrote,	তরকুরতে,	টুকরোতে,	
ishtone,	ইস্তোন,	স্টোন,	
jounotar,	যৌনতার,	যৌনতার,	
miitar,	মিতার,	মিত্র,	
suri,	সুরি,	সুরি,	
prosadhoner,	প্রসাধনের,	প্রসাধনের,	
songasthatir,	সঙ্চাস্থতির,	সংস্থাটির,	
hert,	হার্ট,	হার্ট,	
zibonnogor,	জীবননগর,	জীবননগর,	
monjurul,	মন্জুরুল,	মনজুরুল,	
saria,	সারিয়া,	সরিয়া,	
gonohotyakey,	গণহত্যাকে,	গণহত্যাকে,	
donat,	দনাত,	ডোনাট,	
attacharito,	অট্চাচারিত,	অত্যাচারিত,	
oncoltike,	অন্কললটিকে,	অঞ্চলটিকে,	
biswashi,	বিশ্বাশী,	বিশ্বাসই,	
byke,	বাইক,	বাইক,	
ponthaar,	পন্থার,	পন্থার,	
euqalyptus,	ইইক্লিপিটাস,	ইউক্যালিপ্টাস,	
byaboharkari,	ব্যবহারকারী,	ব্যবহারকারী,	
recondishon,	রেকন্ডশন,	রিকন্ডিশন,	
bikargrosto,	বিকারগ্রস্ত,	বিকারগ্রস্ত,	
byaktikegreptar,	ব্যক্তিকেলস্্রেটর,	ব্যক্তিকেগ্রেপ্তার,	
besooro,	বেসুরো,	বেসুর,	
byaboharkarie,	ব্যবহারকারী,	ব্যবহারকারীই,	
panchashjan,	পঞ্চাশন,	পঞ্চাশজন,	
jorury,	জরুরী,	জরূরী,	
surke,	সুরকে,	সুরকে,	
tarunra,	তরুণরা,	তরুণরা,	
site,	সিতে,	সিটে,	
pleto,	প্লেটো,	প্লেটো,	
ghamtaa,	ঘামটা,	ঘোমটা,	
purushika,	পুরুষিকা,	পুরুষিকা,	
jolrang,	জলরাং,	জলরঙ,	
nischitvabe,	নিশ্চিতভাবে,	নিশ্চিতভাবে,	
bosantake,	বসন্তাকে,	বসন্তকে,	
boner,	বনের,	বনের,	
sorano,	সোরানো,	সরানো,	
deobonde,	দেওবন্ডে,	দেওবন্দে,	
niharkantibabu,	নিহারক্ষণণাববা,	নিহারকান্তিবাবু,	
ponchaashjon,	পঞ্চাশন,	পঞ্চাশজন,	
pratiyogitar,	প্রতিয়োগীতার,	প্রতিযোগীতার,	
cbi,	সিবিআই,	সিবিআই,	
bangladesh,	বাংলাদেশ,	বঙ্গালাদেস,	
humner,	হামনার,	হামনার,	
ajuhath,	অজুহাঠ,	অজুহাত,	
salphat,	সাফফাত,	সালফেট,	
raiialati,	রায়ায়ালিট,	রয়্যালটি,	
deaubande,	ডিউজবন্ডে,	দেওবন্দে,	
kourabe,	কৌরাবে,	কৌরবে,	
anektai,	অনেকটাই,	অনেকটাই,	
bonorajite,	বনরাজিতে,	বনরাজিতে,	
deraa,	দেরা,	ডেরা,	
shudden,	শুদ্দেন,	সাডেন,	
horidbar,	হরিদবার,	হরিদ্বার,	
ranangane,	রানাঙ্গানে,	রণাঙ্গনে,	
bhittitei,	ভিত্তিতেই,	ভিত্তিতেই,	
bojata,	বোজাতা,	বোজাটা,	
sossar,	সসসার,	সকার,	
kharavel,	খারাভেল,	খারবেল,	
scholastic,	স্কোলাসটিক,	স্কলাস্টিক,	
dibate,	দিবাতে,	ডিবেট,	
ramnathbabur,	রামথনাবাবুর,	রামনাথবাবুর,	
sarboshokteeman,	সর্বস্ক্ষমতন,	সর্বশক্তিমান,	
dharavassokar,	ধারাবোসসকর,	ধারাভাষ্যকার,	
choudry,	চাউড্রি,	চৌধুরী,	
karmake,	কারমাকে,	কর্মকে,	
elaakaati,	এলাকাটি,	এলাকাটি,	
daktikit,	দাক্তিটি,	ডাকটিকিট,	
baugey,	বাওয়ে,	বাগে,	
eigulor,	এইগুলোর,	এইগুলোর,	
zesa,	জেসা,	জেস,	
alexandar,	আলেক্স্ন্দার,	আলেকজান্ডার,	
abheedhaaneek,	অভিধানীক,	অভিধানিক,	
jamarate,	জামারাতে,	জামারাতে,	
songbadmadhyame,	সংবাদমাধ্যমে,	সংবাদমাধ্যমে,	
societytey,	সোসিয়েটে,	সোসাইটিতে,	
banshite,	বাঁশিতে,	বাঁশিতে,	
prashikkhane,	প্রশিক্ষণে,	প্রশিক্ষণে,	
oedipus,	ওডিপাস,	ইডিপাস,	
chakundite,	চকুন্ডিতে,	চাকুন্দিতে,	
societyke,	সোসিয়েটকে,	সোসাইটিকে,	
phood,	ফুড,	ফুড,	
dhangsachchi,	ধাবসচ্ছি,	ধ্বংসাচ্ছি,	
touraat,	তৌরাত,	তওরাত,	
dojo,	দোজো,	ডোজো,	
battery,	ব্যাটারি,	ব্যাটারী,	
iqbalke,	ইকবলকে,	ইকবালকে,	
stoonahenja,	শ্টুনোহহ্ঞা,	স্টোনহেঞ্জ,	
gostigulo,	গোস্টিগুলো,	গোষ্ঠীগুলো,	
neermol,	নির্মল,	নির্মল,	
nagorikke,	নাগরিককে,	নাগরিককে,	
fimela,	ফিমেলা,	ফিমেল,	
edipass,	এডিপাস,	ইডিপাস,	
qaro,	কারো,	কারো,	
jakatke,	জাকাটকে,	যাকাতকে,	
moomtaj,	মুমতাজ,	মুমতাজ,	
monir,	মনির,	মনির,	
plate,	প্লাটে,	প্লেট,	
foks,	ফকস,	ফক্স,	
mausumeo,	মৌসুমেও,	মৌসুমেও,	
chirantan,	চিরন্তন,	চিরন্তন,	
parqim,	পারকিম,	পার্কিং,	
dobhara,	দোভারা,	ডোভার,	
emarjensi,	এমারজেনসি,	এমার্জেন্সি,	
laishensha,	লাইশেন্সা,	লাইসেন্স,	
sanaktokaran,	সনাকত্ককরণ,	সনাক্তকরণ,	
sarboporee,	সর্বপরী,	সর্বোপরী,	
grambaseer,	গ্রামবাসীর,	গ্রামবাসীর,	
guzon,	গুজন,	গুজব,	
mukhomondoler,	মুখোন্ডোলের,	মুখমণ্ডলের,	
bidyadanke,	বিদ্যাদনকে,	বিদ্যাদানকে,	
shloker,	শ্লোকের,	শ্লোকের,	
bhenus,	ভেনাস,	ভেনাস,	
sooya,	সোয়া,	সোয়া,	
nodimatrik,	নদীমাত্রিক,	নদীমাতৃক,	
sheekar,	শিকর,	শিকার,	
bhenise,	ভেনিসে,	ভেনিসে,	
kartona,	কর্তনা,	করতনা,	
ajeeboner,	অজীবনের,	আজীবনের,	
everage,	এভারেজ,	এভারেজ,	
dei,	দেই,	দিই,	
lakkhero,	লক্ষেরও,	লক্ষেরও,	
difinishian,	ডিফিনিসিয়ান,	ডেফিনেশন,	
podarthobidder,	পদার্থবিদদের,	পদার্থবিদদের,	
amontronkarider,	অমন্ত্রনকারীদের,	আমন্ত্রণকারীদের,	
parswer,	পার্স্বের,	পার্শ্বের,	
shten,	স্টেন,	স্টেন,	
shilpajata,	শিল্পজাতা,	শিল্পজাত,	
kagbeni,	কাগবেনি,	কাগবেনি,	
aholya,	আহল্যা,	অহল্যা,	
bii,	বিইআই,	বি,	
bohoodin,	বহুদিন,	বহুদিন,	
senabahinikey,	সেনাবাহিনীকে,	সেনাবাহিনীকে,	
naabyota,	নাবয়তা,	নাব্যতা,	
minishtarer,	মিনিষ্টারের,	মিনিস্টারের,	
alexanderke,	আলেক্স্ন্দারকে,	আলেকজান্ডারকে,	
bone,	বোনে,	বনে,	
deciliter,	ডেসিলিটের,	ডেসিলিটার,	
kichudinpar,	কিছিদুনপার,	কিছুদিনপর,	
onupater,	অনুপতের,	অনুপাতের,	
nobotomo,	নবতম,	নবতম,	
gujab,	গুজাব,	গুজব,	
cheess,	চিস,	চেস,	
narbur,	নারবুর,	নরবুর,	
nabatarange,	নবতর্ঙ্গে,	নবতরঙ্গে,	
cheef,	চেফ,	শেফ,	
pravritir,	প্রভৃতির,	প্রভৃতির,	
korush,	করুশ,	ক্রুশ,	
mithener,	মিথেনের,	মিথেনের,	
venush,	ভেনুশ,	ভেনাস,	
taronee,	তারণী,	তরণী,	
rakhete,	রাখেতে,	রাখেতে,	
ministara,	মিনিস্টারা,	মিনিস্টার,	
eduardo,	এডুয়ার্ডো,	এডুয়ার্দো,	
plack,	প্ল্যাক,	প্ল্যাক,	
mosjidtir,	মসজিদটির,	মসজিদটির,	
jipiusamriddha,	জিপিপুরিদ্্ধ,	জিপিউসমৃদ্ধ,	
breakthrough,	ব্রেকচ্র্যাগ,	ব্রেকথ্রু,	
chupani,	চুপানি,	চুপানি,	
qaferder,	কাফারদের,	কাফেরদের,	
prosadhani,	প্রসাধনী,	প্রসাধনী,	
elahabade,	এলাহাবাদে,	এলাহাবাদে,	
wilderske,	উইলডারসেকে,	উইল্ডার্সকে,	
bolatkar,	বলাতকার,	বলাৎকার,	
sikha,	সিখা,	শিখ,	
auttacharer,	অট্টাচারের,	অত্যাচারের,	
erokomer,	এরকমের,	এরকমের,	
ramantika,	রামনীতকা,	রোমান্টিক,	
kazianis,	ক্যাজিনিস,	কাজানিস,	
bagicha,	বাগিচা,	বাগিচা,	
polashir,	পলাশির,	পলাশীর,	
jyesthaa,	জ্যেষ্ঠা,	জ্যেষ্ঠা,	
suiti,	সুইটি,	সুইটি,	
sangkoolan,	শংকুলন,	সংকুলান,	
protizogii,	প্রতিযোগী,	প্রতিযোগী,	
chalochchitraeer,	চলচ্চিত্রীয়ের,	চলচ্চিত্রের,	
longhan,	লঙ্ঘন,	লংঘন,	
baipass,	বাইপাসস,	বাইপাস,	
prity,	প্রিটি,	প্রিটি,	
remission,	রিমিশন,	রিমিশন,	
ssahocorze,	সাহরকর্জে,	সাহচর্যে,	
khudrokar,	ক্ষুদ্রকার,	ক্ষুদ্রকার,	
lettere,	লেটটারে,	লেটারে,	
landey,	ল্যান্ডে,	ল্যান্ডে,	
obosan,	অবসান,	অবসান,	
aizulke,	আইজুলকে,	আইজুলকে,	
nuhas,	নুহাস,	নুহাশ,	
ganokantha,	গণকান্থ,	গণকণ্ঠ,	
nachar,	নাচর,	নাচার,	
gabeshonar,	গবেশনার,	গবেষনার,	
ghumunoi,	ঘুমোনোই,	ঘুমুনোই,	
gaziipur,	গাজিপুর,	গাজীপুর,	
mahakabi,	মহাকবী,	মহাকবি,	
pare,	পারে,	পাড়ে,	
dhwajbhango,	ধ্বভঞ্জ,	ধ্বজভঙ্গ,	
patochitra,	পাতচিত্র,	পটচিত্র,	
obdee,	অব্দি,	অব্দি,	
manir,	মানির,	মনির,	
jonmobhumitir,	জন্মভূমিতির,	জন্মভূমিটির,	
goonoman,	গুনমান,	গুণমান,	
bhittimul,	ভিত্তিমুল,	ভিত্তিমূল,	
eesa,	ইসা,	আইএএস,	
dorneca,	ডর্নেকা,	ডরনেকা,	
slatgulor,	স্ল্যাগটুলোর,	স্ল্যাটগুলোর,	
chalachchitrei,	চলচচচিত্রেই,	চলচ্চিত্রেই,	
lubitz,	লুবিজজ,	লুবিৎজ,	
anagarikra,	অনাগরিকরা,	অনাগরিকরা,	
with,	উইথ,	ভিত,	
gabinius,	গ্বিনিয়াস,	গাবিনিআস,	
manatmulak,	মানতমূলক,	মানতমূলক,	
kathghera,	কাঠঘেরা,	কাঠঘেরা,	
restuarant,	রেস্টুয়ার্ত,	রেষ্টুরেন্ট,	
asamonjasyopurno,	অসামঞ্জস্যপূর্ণ,	অসামঞ্জস্যপূর্ণ,	
raagee,	রাগী,	রাগী,	
casper,	ক্যাসপার,	ক্যাসপার,	
leaders,	লিডারস,	লিডার্স,	
andra,	আন্দ্রা,	আন্ড্রা,	
romnar,	রোমনার,	রমনার,	
aansareer,	আনসারীর,	আনসারীর,	
residence,	রেসিডেন্স,	রেসিডেন্স,	
nisshongotake,	নিঃসংবক্তে,	নিঃসঙ্গতাকে,	
akreetokarjo,	আক্রিতারকর্য,	অকৃতকার্য,	
nili,	নীলি,	নিলি,	
sonaktokaran,	সোনাক্তকরণ,	সনাক্তকরণ,	
internship,	ইন্টারশনিপ,	ইন্টার্নশিপ,	
sikkhagata,	শিক্ষাগত,	শিক্ষাগত,	
nazad,	নাজাদ,	নজদ,	
aflatoxin,	অফ্লাটক্সিন,	আ্যফ্ল্যাটক্সিন,	
angkita,	অংকিত,	অঙ্কিতা,	
kantojir,	কান্তজির,	কান্তজির,	
joubankal,	যৌবনকাল,	যৌবনকাল,	
edmeeral,	এডমিরাল,	এডমিরাল,	
gaandaas,	গান্ডান,	জ্ঞানদাস,	
kanshat,	কানশাট,	কানসাট,	
kajangale,	কাজাঙ্গলে,	কজঙ্গলে,	
rahee,	রাহী,	রাহি,	
teenej,	তেনেজ,	টিনেজ,	
qrisenta,	ক্রিসেন্তা,	ক্রিসেন্ট,	
jibnagore,	জীবনাগরে,	জীবননগর,	
geographics,	জিওসারফ্ওসিক,	জিওগ্রাফিকস,	
ayantarqatiqa,	আয়নতরকককাকা,	অ্যান্টার্কটিকা,	
ooipoka,	উপোকা,	উইপোকা,	
shaddhi,	শাদ্ধি,	সাধ্বী,	
reliance,	রিলিয়ান্স,	রিলায়েন্স,	
munshiji,	মুনশিজি,	মুনশীজি,	
sthapanagulo,	স্থাপনাগুলো,	স্থাপনাগুলো,	
maudelgulo,	মাউডেলগুলো,	মডেলগুলো,	
nagarikera,	নাগরীকেরা,	নাগরিকেরা,	
boikolyo,	বৈকল্য,	বৈকল্য,	
mase,	মাসে,	মাসে,	
daaradaa,	ডারাডা,	দারদা,	
setike,	সেতিকে,	সেটিকে,	
prakar,	প্রকার,	প্রকার,	
ahong,	আহং,	অহং,	
hughkey,	হুঘকে,	হিউজকে,	
dacope,	ড্যাকোপ,	দাকোপ,	
ganosochetonota,	গণসচেতনতা,	গণসচেতনতা,	
abhidhaanic,	অভিধানানিক,	অভিধানিক,	
steen,	স্টিন,	স্টেন,	
pragreesa,	প্রোগ্রিসা,	প্রগ্রেস,	
aaziz,	আজিজ,	আজিজ,	
qarlosa,	কারলোসা,	কার্লোস,	
choson,	চসন,	চোষণ,	
niknayman,	নিক্যানমান,	নিকনেইমান,	
jerusaleme,	জেরুসালেমে,	জেরুসালেমে,	
fansi,	ফানসি,	ফাঁসী,	
inafarameshana,	ইনাফরেশনে,	ইনফরমেশন,	
ekghare,	একঘরে,	একঘরে,	
somosto,	সমস্ত,	সমস্ত,	
pratisthanik,	প্রতিষ্ঠানিক,	প্রাতিষ্ঠানিক,	
krush,	ক্রুশ,	ক্রুশ,	
baman,	বামান,	বামন,	
bharotchilo,	ভরতচিল,	ভারতছিল,	
ched,	চেদ,	ছেদ,	
mousumeo,	মৌসুমেও,	মৌসুমেও,	
jaadrel,	যাদ্রেল,	জাঁদরেল,	
saraiki,	সারাইকি,	সরাইকি,	
maktum,	মাকতুম,	মাকতুম,	
daybhager,	দয়ভাগের,	দায়ভাগের,	
lungiti,	লুঙ্গিতি,	লুঙ্গিটি,	
rajpur,	রাজপুর,	রাজপুর,	
amburi,	আম্বুরি,	আম্বুরি,	
comoros,	কমোরস,	কোমোরোস,	
bisshas,	বিশ্স,	বিশ্বাস,	
oncolsoho,	অন্কলসহ,	অঞ্চলসহ,	
hock,	হোক,	হুক,	
teentir,	তেনটির,	তিনটির,	
osamanno,	অসামন্ন,	অসামান্য,	
khaschandpur,	খাসচাঁদপুর,	খাসচাঁদপুর,	
turbiner,	টারবিনের,	টারবাইনের,	
horidwar,	হরিদ্বার,	হরিদ্বার,	
orbeet,	অরবিট,	অরবিট,	
shoreefer,	শরেফর,	শরিফের,	
bhagno,	ভাগনো,	ভগ্ন,	
sector,	সেকটর,	সেক্টর,	
zeland,	জেলান্ড,	জিল্যান্ড,	
bim,	বিআইএম,	বিম,	
dholeshwari,	ধোলেশ্বরী,	ধলেশ্বরী,	
bupher,	বুফফর,	বাফার,	
dharmee,	ধর্মী,	ধর্মী,	
itostatah,	ইতস্ততাহ,	ইতস্ততঃ,	
pouchute,	পৌঁচুতে,	পৌঁছুতে,	
perri,	পেররি,	পেরি,	
unchuporjayer,	উঁচুফর্যায়ের,	উঁচুপর্যায়ের,	
bowie,	বয়ায়ে,	বওই,	
dreeshtiheen,	দৃষ্টিহীন,	দৃষ্টিহীন,	
beam,	বিইম,	বিম,	
kheshar,	খেশার,	খেশার,	
seniar,	সেনিয়ার,	সিনিয়র,	
hansasya,	হনসসস্য,	হংসস্য,	
jeebnagore,	জীবনাগরে,	জীবননগর,	
mandope,	মাণ্ডপে,	মন্ডপে,	
ganoporibahon,	গণপরিবহন,	গণপরিবহন,	
kaatbey,	কাটবে,	কাটবে,	
faltu,	ফালটু,	ফালতু,	
pachak,	পাচাক,	পাচক,	
provur,	প্রভুর,	প্রভুর,	
reshmirekha,	রেশমিরেখা,	রেশমীরেখা,	
buddhitii,	বুদ্ধিতিই,	বুদ্ধিটিই,	
shardotsobei,	শার্দতসবেই,	শারদোৎসবেই,	
bhangchur,	ভাংচুর,	ভাংচুর,	
bamni,	বামনি,	বামনী,	
mukhomandal,	মুখোমন্ডল,	মুখমণ্ডল,	
gasthi,	গাস্থি,	গোষ্ঠী,	
yuro,	যুরো,	ইউরো,	
meshintao,	মেশিনটাও,	মেশিনটাও,	
bage,	বাগে,	বাগে,	
jeelyaand,	জিলিয়ান্দ,	জিল্যান্ড,	
mercial,	মারসিয়াল,	মার্শিয়াল,	
fitarsaho,	ফিতারসহ,	ফিতরসহ,	
dimbacriti,	ডিম্বাকারটি,	ডিম্বাকৃতি,	
shiqara,	শিকারা,	শিকার,	
jewellery,	জেয়ালেরি,	জুয়েলারির,	
pacbar,	পাকবার,	পাঁচবার,	
onchalgulir,	অঞ্চালগুলির,	অঞ্চলগুলির,	
phox,	ফস্ক,	ফক্স,	
sthaponagulor,	স্থাপনাগুলোর,	স্থাপনাগুলোর,	
kode,	কোড়ে,	কোড,	
chhuti,	ছুটি,	ছুটি,	
baikalyo,	বাইকাল্য,	বৈকল্য,	
nogore,	নগরে,	নগরে,	
eura,	এইরা,	ইউরো,	
pothon,	পথন,	পঠন,	
panchbar,	পাঁচবার,	পাঁচবার,	
sahojlovyotar,	সহজলগঠ্যতার,	সহজলভ্যতার,	
matrirup,	মাতৃরূপ,	মাতৃরূপ,	
niketon,	নিকেতন,	নিকেতন,	
keui,	কেউ,	কেউই,	
nachiketa,	নাচিকেতা,	নচিকেতা,	
ramzaner,	রামজানের,	রমযানের,	
trenda,	ট্রেন্ডা,	ট্রেন্ড,	
rohosyo,	রহস্য,	রহস্য,	
enamela,	এনামেলা,	এনামেল,	
ansareer,	আনসারীর,	আনসারীর,	
ceramicer,	সেরামিসের,	সিরামিকের,	
sharifpur,	শরিফপুর,	শরিফপুর,	
shho,	শো,	শো,	
bhalobaas,	ভালোবাস,	ভালোবাসা,	
shubhag,	শুভগ,	শুভাগ,	
townshhip,	তৌনশিপ,	টাউনশিপ,	
jalbe,	জলবে,	জ্বলবে,	
jamanataswarup,	জমনাত্স্বরূপ,	জামানতস্বরূপ,	
songkoloney,	সংকোলনে,	সংকলনে,	
drishyogulote,	দৃশ্যগুলোতে,	দৃশ্যগুলোতে,	
koomarir,	কোমারির,	কুমারীর,	
bunot,	বুনোট,	বুনট,	
taffsherer,	তাফশাররের,	তাফসীরের,	
samany,	সামানি,	সামান্য,	
bharatey,	ভারাতে,	ভারতে,	
kiuti,	কিউটি,	কিউটি,	
nishad,	নিষাদ,	নিষাদ,	
tanshree,	তনশ্রী,	তানশ্রী,	
gronthao,	গ্রন্থাও,	গ্রন্থও,	
sarsa,	সারসা,	সোর্স,	
distance,	ডিস্্যান্স,	ডিসট্যান্স,	
fostar,	ফোস্টার,	ফস্টার,	
ghuznavi,	গুজনাভি,	গজনভি,	
fol,	ফল,	ফল,	
protiakromonei,	প্রতিয়াকর্মণেই,	প্রতিআক্রমণেই,	
michhilti,	মিছিলটি,	মিছিলটি,	
cholechi,	চলেছি,	চলেছি,	
bajpa,	বাজপা,	বাজপা,	
tokeo,	টকেও,	টোকেও,	
akkharkey,	অক্ষরকে,	অক্ষরকে,	
bm,	বিএমএ,	বিএম,	
krishibigyani,	কৃষিবিজ্ঞানী,	কৃষিবিজ্ঞানী,	
aniyantrita,	অনিয়ন্ত্রিত,	অনিয়ন্ত্রিত,	
change,	চাঙ্গে,	চেঞ্জ,	
sobchey,	সবচে,	সবচে,	
serup,	সেরূপ,	সেরূপ,	
dhanijomite,	ধনিজমিতে,	ধানিজমিতে,	
dobhaar,	দোভার,	ডোভার,	
hevy,	হেভি,	হেভি,	
dubureer,	দুবুরীর,	ডুবুরির,	
musalmanderke,	মুসলমানকদরকে,	মুসলমানদেরকে,	
palbongser,	পালবংসের,	পালবংশের,	
prangulo,	প্রাণগুলো,	প্রানগুলো,	
saom,	স্যাওম,	সাওম,	
kyathlik,	ক্যাথলিক,	ক্যাথলিক,	
toufiq,	টুফিক,	তৌফিক,	
bulano,	বুলানো,	বুলান,	
daqop,	ডাকপ,	দাকোপ,	
nathivukta,	নাথিবুক্ত,	নথিভুক্ত,	
teoyana,	তওওয়ানা,	তাইওয়ান,	
calabe,	ক্যালাবে,	চালাবে,	
hossne,	হোস্নে,	হোসনে,	
larson,	লারসন,	লারসন,	
tintir,	তিনটির,	তিনটির,	
chalake,	চালাকে,	চালকে,	
madhukori,	মধুকররী,	মাধুকরী,	
doltyagi,	দল্ত্যগী,	দলত্যাগী,	
gosthike,	গোষ্ঠীকে,	গোষ্ঠীকে,	
rajendracholer,	রাজেন্দ্রকগলের,	রাজেন্দ্রচোলের,	
sharansthal,	শরানস্থল,	শরণস্থল,	
neemitte,	নিমিত্বে,	নিমিত্তে,	
mastarsa,	মাস্তারসা,	মাস্টার্স,	
premoronge,	প্রেমরোঙ্গে,	প্রেমরঙে,	
epiela,	এপিয়েল,	আইপিএল,	
aosafur,	আওসফুর,	আওশাফুর,	
nirbahi,	নির্বাহী,	নির্বাহি,	
durgotshob,	দুর্ভৎসভ,	দুর্গোৎসব,	
taderek,	তাদেরেক,	তাদেরেক,	
anusthane,	অনুষ্ঠানে,	অনুষ্ঠানে,	
dalee,	ডালি,	ডালে,	
nirmolota,	নির্মলতা,	নির্মলতা,	
utsahamulak,	উৎসাহমূলক,	উৎসাহমূলক,	
dipon,	ডিপন,	দীপন,	
robot,	রোবট,	রোবোট,	
nanilalke,	নানিলালকে,	ননীলালকে,	
nosihote,	নসীহতে,	নসিহতে,	
parikha,	পারিখা,	পরিখার,	
nothivookta,	নথিভাক্ত,	নথিভুক্ত,	
ajijer,	আজিজের,	আজিজের,	
prarthonakokkher,	প্রার্থনকক্ষের,	প্রার্থনাকক্ষের,	
dakten,	ডাকতেন,	ডাকতেন,	
rohinibabu,	রোহিনীবাবু,	রোহিনীবাবু,	
chitlar,	চিতলার,	চিতলার,	
kul,	কুল,	কুল,	
annanere,	আন্নানেরে,	অন্যানেরে,	
kotibondhe,	কতিবন্ধে,	কটিবন্ধে,	
rabo,	রাবো,	রব,	
drissogulo,	ড্রিসগগুলো,	দৃশ্যগুলো,	
debdebyr,	ডেবদেবীর,	দেবদেবীর,	
kutubuddinke,	কুটুবদ্দিনকে,	কুতুবুদ্দিনকে,	
diibug,	দিবিগ,	ডিবাগ,	
foxcon,	ফোক্সন,	ফক্সকন,	
postay,	পো্টে,	পোস্টে,	
lajik,	লাজিক,	লজিক,	
icelands,	ইইকেল্যান্ডস,	আইসল্যান্ডসহ,	
kash,	কাশ,	কাস,	
chhooteete,	ছুটিতে,	ছুটিতে,	
parther,	পার্থের,	পার্থের,	
taims,	টাইমস,	টাইমস্,	
daltagi,	দাততাগী,	দলত্যাগী,	
grootha,	গ্রুথা,	গ্রোথ,	
chalochchitrogulor,	চল্চচিত্রগুলোর,	চলচ্চিত্রগুলোর,	
uparjoner,	উপার্যনের,	উপার্জনের,	
manjushree,	মঞ্জুশ্রী,	মঞ্জুশ্রী,	
tophaat,	তোফাযাট,	তফাৎ,	
janoganonar,	জানগাননার,	জনগণনার,	
patishapta,	পাতিশাপ্ত,	পাটিসাপটা,	
chargar,	চরগার,	চার্জার,	
kanar,	কানার,	কণার,	
siitei,	সিতেই,	শীতেই,	
ateetkaale,	আতিতকালে,	অতীতকালে,	
shamijir,	শামিজির,	স্বামীজীর,	
pluck,	প্লাক,	প্ল্যাক,	
kaalaam,	কালাম,	কালাম,	
dai,	জেএ,	দিই,	
khude,	খুড়ে,	ক্ষুদে,	
kada,	কাদা,	কোডা,	
balatkar,	বালাতকর,	বলাৎকার,	
marmaraa,	মারমারা,	মারমারা,	
dwipke,	দ্বিপকে,	দ্বীপকে,	
alaoler,	আলাওলের,	আলাওলের,	
aswasteekor,	অস্বাসতিকর,	অস্বস্তিকর,	
overholing,	ওভারহোলিং,	ওভারহোলিং,	
dijmarescu,	ডিজমারেস্কু,	দিজমার্সাকু,	
thanvi,	থানভী,	থানভী,	
boiragirhat,	বৈরাগিরহাট,	বৈরাগিরহাট,	
dhalur,	ধালুর,	ঢালুর,	
kleentoner,	ক্লিন্টনের,	ক্লিনটনের,	
scholars,	স্কলারস,	স্কলার্স,	
santoshpore,	সান্তস্পরে,	সন্তোষপুর,	
ekoghore,	একঘরে,	একঘরে,	
adhunikkale,	আধুনিককালে,	আধুনিককালে,	
bisheshya,	বিশেষ্য,	বিশেষ্য,	
markeetim,	মার্কিটিম,	মার্কেটিং,	
quota,	কুউটা,	কোটা,	
shuperheiro,	শুপেরহেরোর,	সুপারহিরো,	
myat,	ম্যাট,	ম্যাট,	
daacktickete,	ডাটকিকিটে,	ডাকটিকিটে,	
dii,	ডিইউ,	দিই,	
suchonakal,	সূচনাকাল,	সূচনাকাল,	
naabbota,	নাববোতা,	নাব্যতা,	
baarnish,	বার্ণিশ,	বার্নিশ,	
infarmatian,	ইনফারহিয়ান,	ইনফরমেশন,	
mile,	মিলে,	মিলে,	
sommoteer,	সম্মতির,	সম্মতির,	
ongkush,	অংকুশ,	অংকুশ,	
jahangirbad,	জাহাঙ্গীরবাদ,	জাহাঙ্গীরবাদ,	
sahozlabhbhotar,	সহ্লবাভভাতার,	সহজলভ্যতার,	
agomone,	আগমনে,	আগমনে,	
charban,	চারবান,	চর্বন,	
prijon,	প্রজজন,	প্রিজন,	
grahoksebai,	গ্রহককসেবাই,	গ্রাহকসেবায়,	
rinobodh,	ঋণবোধ,	ঋণবোধ,	
anubhutimalar,	অনুভূতিমালার,	অনুভূতিমালার,	
cheekitsar,	চিকিতসার,	চিকিত্সার,	
borendroke,	বরেন্দ্রকে,	বরেন্দ্রকে,	
asabhya,	অসভ্য,	অসভ্য,	
pathanirdeshona,	পাঠানিরেখনসন,	পথনির্দেশনা,	
path,	প্যাথ,	পাথ,	
nabatamo,	নবতাম,	নবতম,	
raia,	রাইয়া,	রায়,	
bornolikhon,	বর্ণলিখন,	বর্ণলিখন,	
shilver,	শিলভের,	সিলভার,	
biplabee,	বিপ্লববী,	বিপ্লবী,	
erythrian,	এরিথ্রিয়ান,	এরিথ্রিয়ান,	
thaii,	থইইই,	থাই,	
teter,	টেটের,	টেটের,	
hazat,	হাজাত,	হজত,	
poddhotitei,	পদ্ধটিতেই,	পদ্ধতিতেই,	
somabeshti,	সমাবেশটি,	সমাবেশটি,	
rayyaleti,	রয়য়লীতে,	রয়্যালটি,	
shlok,	শ্লক,	শ্লোক,	
colgirl,	কোলারগল,	কলগার্ল,	
shchalastik,	শ্বস্ত্্ক,	স্কলাস্টিক,	
murader,	মুরাদের,	মুরাদের,	
pronoti,	প্রণতি,	প্রণতি,	
cocaine,	কোকেন,	কোকেইন,	
azijer,	আজিজের,	আজিজের,	
aaeerese,	আইরেসে,	আইরেসে,	
horash,	হরাশ,	হোরাস,	
oitijhya,	ঐতিহ্যা,	ঐতিহ্য,	
krema,	ক্রেমা,	ক্রাইম,	
bufer,	বুফের,	বাফার,	
matis,	ম্যাটিস,	ম্যাটিস,	
achintyabhedaved,	অচিন্ত্যভেবাদে,	অচিন্ত্যভেদাভেদ,	
laaisensh,	লেইসেনস,	লাইসেন্স,	
shikshagato,	শিক্ষাগত,	শিক্ষাগত,	
emarjenshi,	এমারজেনশি,	এমার্জেন্সি,	
khitkar,	খিতকার,	ক্ষিতকর,	
shabkam,	শবকম,	শবকাম,	
survative,	সার্ভাটিভ,	সারভেটিভ,	
churger,	চুরগের,	চার্জের,	
somsher,	সম্শের,	সমশের,	
masjidsaho,	মাসজিদসহ,	মসজিদসহ,	
stoic,	স্টোয়,	স্টোয়িক,	
prothakey,	প্রথাকে,	প্রথাকে,	
ingrejra,	ইংরেজরা,	ইংরেজরা,	
ekirokom,	একিরকম,	একইরকম,	
footballerra,	ফুটবলরেরা,	ফুটবলাররা,	
arashie,	আরশাই,	আরসিএ,	
bonke,	বোনকে,	বনকে,	
pingna,	পিংনা,	পিংনা,	
prokar,	প্রকার,	প্রকার,	
bhenicer,	ভেনিসের,	ভেনিসের,	
poste,	পোস্টে,	পোস্টে,	
karmokarke,	কর্মকারকে,	কর্মকারকে,	
pratijogira,	প্রতিযোগীরা,	প্রতিযোগীরা,	
kathla,	কাঠলা,	কাঠলা,	
carzar,	কার্জার,	চার্জার,	
carloos,	কার্লুস,	কার্লোস,	
thabai,	থাবাই,	থাবাই,	
janamukhi,	জানামুখী,	জনমুখী,	
esasiyetasa,	এসায়েসেসা,	এসোসিয়েটস,	
benojir,	বেনোজির,	বেনজীর,	
manushti,	মনুষ্টি,	মানুষটি,	
muradkey,	মুরাদকে,	মুরাদকে,	
phutbolarder,	ফুটবলদরদের,	ফুটবলারদের,	
bodna,	বোদা,	বদনা,	
chaiten,	চাইতেন,	চাইতেন,	
societykey,	সোসিয়েটে,	সোসাইটিকে,	
hijri,	হিজরি,	হিজরী,	
basermick,	বেসেরমিক,	বেসারমিক,	
hupile,	হুপিলে,	হুপিলে,	
poripakey,	পরিপাকে,	পরিপাকে,	
gandhiio,	গান্ধিও,	গান্ধীও,	
somonnitobhabe,	সমন্থিতভাবে,	সমন্বিতভাবে,	
rca,	আরএসএ,	আরসিএ,	
windos,	উইন্ডস,	উইন্ডোস,	
dokan,	দোকান,	দোকান,	
vejjanno,	ভেজজ্নন,	ভেজানো,	
licensedhari,	লাইসনেন্ারী,	লাইসেন্সধারী,	
khoor,	খোর,	ক্ষুর,	
shakankti,	শাকাঙ্কটি,	শকাঙ্কটি,	
kadapaker,	কাড়াপাকের,	কড়াপাকের,	
acrolect,	অ্যাক্রোলেক্ট,	অ্যাক্রোলেক্ট,	
jesh,	জেশ,	জেস,	
basab,	বাসব,	বাসাব,	
vange,	ভাঙ্গে,	ভাঙ্গে,	
nabotom,	নাবতম,	নবতম,	
toroonra,	টররুনা,	তরুণরা,	
peeth,	পীত,	পীঠ,	
prabhritite,	প্রভৃতিতে,	প্রভৃতিতে,	
summer,	সাম্মার,	সামার,	
poschimey,	পশ্চিমে,	পশ্চিমে,	
pettern,	পিটের্ন,	প্যাটার্ন,	
vaisoho,	ভাইসহ,	ভাইসহ,	
tenishe,	তেনিশে,	টেনিসে,	
jalarong,	জালারং,	জলরঙ,	
mulyabriddhikale,	মূল্যৃবিদ্ধিকালে,	মূল্যবৃদ্ধিকালে,	
roy,	রোয়,	রায়,	
chalaabi,	চালাবি,	চালাবে,	
rekhapat,	রেখাপাত,	রেখাপাত,	
omeettrakkhor,	অমিত্রার্্্চর,	অমিত্রাক্ষর,	
kommandar,	কোম্নান্দার,	কমাণ্ডার,	
pack,	প্যাক,	প্ল্যাক,	
sangaskritipreme,	সংস্কৃতিপ্রীমে,	সংস্কৃতিপ্রেমে,	
rahee,	রাহী,	রাহী,	
saralya,	সরল্য,	সারল্য,	
alaul,	আলাউল,	আলাওল,	
chhotogolper,	ছোটগল্পের,	ছোটগল্পের,	
laesens,	লেসেন্স,	লাইসেন্স,	
rajyabhogi,	রাজ্যভগগী,	রাজ্যভোগী,	
karmasampadon,	কর্মসামানদ,	কর্মসম্পাদন,	
protisthar,	প্রতিষ্ঠার,	প্রতিষ্ঠার,	
nariderke,	নারীদেরকে,	নারিদেরকে,	
indra,	ইন্দ্রা,	ইন্দ্র,	
miley,	মিলে,	মিলে,	
sepha,	সেফ,	শেফ,	
gafeeloti,	গফফিলটি,	গাফিলতি,	
bo,	বোও,	বু,	
munjur,	মুঞ্জুর,	মুনজুর,	
konagoolo,	কোনাগুলো,	কণাগুলো,	
tateo,	টাতেও,	তাতেও,	
nothibhukta,	নথিভূক্ত,	নথিভুক্ত,	
titarer,	তিতারের,	তিতারের,	
oichchheek,	ঐচ্ছিক,	ঐচ্ছিক,	
chereche,	চেরেছে,	ছেড়েছে,	
proboleme,	প্রবলমেম,	প্রবলেমে,	
juktarashtrasaha,	যুক্তার্থ্রসসহ,	যুক্তরাষ্ট্রসহ,	
hozot,	হজট,	হজত,	
dankaan,	দানকান,	ডানকান,	
conflict,	কনফলিক্ট,	কনফ্লিক্ট,	
toufik,	তৌফিক,	তৌফিক,	
refleks,	রেফ্লকস,	রিফ্লেক্স,	
sheets,	শিস,	শীটস,	
hena,	হেনা,	হেনা,	
lutheerana,	লুথিরানা,	লুথেরান,	
choopi,	চুপি,	চুপি,	
graambaashee,	গ্রামবাশশে,	গ্রামবাসী,	
masjidtir,	মাজিদটির,	মসজিদটির,	
dai,	জেএ,	ডে,	
dhos,	ধোস,	ধস,	
rejidens,	রেজিডেন্স,	রেসিডেন্স,	
seeramiks,	সিরামিক্স,	সিরামিকস,	
chirontan,	চিরন্তান,	চিরন্তন,	
bongsho,	বংশ,	বংশ,	
chiroharit,	চিরোহারিত,	চিরহরিৎ,	
collaborators,	কলারবটেটরস,	কলাবরেটরস,	
sikkhokder,	শিক্ষোকদের,	শিক্ষকদের,	
debholopar,	দেভলোপার,	ডেভলপার,	
shringgo,	শৃঙ্গ,	শৃঙ্গ,	
rananganey,	রণনঙ্গে,	রণাঙ্গনে,	
sangbadmadhyome,	সংবাদমধ্যমে,	সংবাদমাধ্যমে,	
satarkabhabey,	সতর্কভাবে,	সতর্কভাবে,	
crashlands,	ক্রাকাল্যান্ডস,	ক্র্যাশল্যান্ডস,	
generalissimo,	জেনারেলাইজিমি,	জেনারেলিসিমো,	
swatantrata,	স্বত্ন্ত্ততা,	স্বতন্ত্রতা,	
maailkhanek,	মাললখেনেক,	মাইলখানেক,	
deepan,	দীপান,	দীপন,	
taigara,	টাইগগরা,	টাইগার,	
taposgoner,	তাপসগণের,	তাপসগণের,	
chatrorai,	চাত্ররাই,	ছাত্ররাই,	
musalmani,	মুসলমানি,	মুসলমানই,	
charukala,	চারুকালা,	চারুকলা,	
mooney,	মুনে,	মুনে,	
minilosar,	মিনিলোসার,	মিনিলোসার,	
nanir,	নানির,	নানীর,	
mookhomandoler,	মোখখান্ডলের,	মুখমণ্ডলের,	
sadeep,	সাদীপ,	সদীপ,	
bonvumi,	বনভুমি,	বনভূমি,	
dokkhinangsho,	দক্ষিণাংশ,	দক্ষিণাংশ,	
yak,	যক,	ইয়াক,	
metropolitan,	মেট্রোপলিটান,	মেট্রোপলিটন,	
procharjontrogulo,	প্রচারযন্ত্রগুলো,	প্রচারযন্ত্রগুলো,	
uponeeshod,	উপনিষদ,	উপনিষদ,	
toki,	টকি,	তকি,	
prokolpotike,	প্রকল্পটিকে,	প্রকল্পটিকে,	
deputy,	ডেপুটি,	ডেপুটি,	
ghumacchilo,	ঘুমাচ্ছিল,	ঘুমাচ্ছিল,	
sadadyarao,	সদদ্যরাও,	সদদ্যরাও,	
evaner,	ইভানের,	ইভানের,	
bagdad,	বাগগাড়,	বাগদাদে,	
shangkalonti,	শাংকানটি,	সংকলনটি,	
mesenjarer,	মেসেনজারের,	মেসেঞ্জারের,	
pratista,	প্রতিষ্টা,	প্রতিষ্টা,	
purple,	পার্লল,	পার্পেল,	
porishongkhanbid,	পরিষংস্থানীদ,	পরিসংখ্যানবিদ,	
kobutorer,	কবুতরের,	কবুতরের,	
byatikrami,	ব্যতিকারমমি,	ব্যতিক্রমী,	
akai,	আকাই,	একাই,	
tuleche,	তুলেছে,	তুলেছে,	
sudrishya,	সুদৃশ্য,	সুদৃশ্য,	
eevil,	ইভিল,	ইভিল,	
ahmed,	আহমেদ,	আহামদ,	
saamaanya,	সমন্য,	সামান্য,	
braqe,	ব্রাকে,	ব্রেক,	
forma,	ফরমা,	ফর্মা,	
farhetin,	ফার্েতিন,	ফারহেতিন,	
rohosyoti,	রহস্যটি,	রহস্যটি,	
paira,	পাইরা,	পাইরা,	
subader,	সুবাদের,	সুবাদে,	
anandamahale,	আনন্দমহলে,	আনন্দমহলে,	
masto,	মাস্তো,	মাস্ত,	
matthews,	ম্যাথেস,	ম্যাথিউস,	
maradeha,	মারাদেহা,	মরদেহ,	
dikpal,	দিকপাল,	দিকপাল,	
baipash,	বাইপাশ,	বাইপাস,	
nirvachaker,	নির্ভাচকের,	নির্বাচকের,	
shootar,	শুতার,	শ্যুটার,	
dhormoprobortokder,	ধর্মপ্রবর্কদদের,	ধর্মপ্রবর্তকদের,	
nowel,	নোয়েল,	নভেল,	
marri,	মারি,	ম্যারি,	
baganoto,	বাগানত,	বাগানত,	
aziboner,	আজিবনের,	আজীবনের,	
helly,	হেলি,	হিলি,	
jani,	জানি,	জনি,	
kaamij,	কামিজ,	কামিজ,	
arthonitite,	অর্থনীতিতে,	অর্থনীতিতে,	
naobihar,	নওবিহার,	নৌবিহার,	
aieesha,	আইস,	আইএএস,	
shpredshiit,	স্পারডেশিট,	স্প্রেডশীট,	
dhache,	ধাচে,	ধাঁচে,	
salmaner,	সালমানের,	সালমানের,	
akatwa,	আকত্ব,	একাত্ব,	
kamla,	কমলা,	কামলা,	
koruna,	করুনা,	করুণা,	
tarkareer,	তারকারীর,	তরকারীর,	
byabosthar,	ব্যবস্থার,	ব্যাবস্থার,	
krimlin,	ক্রিমলিন,	ক্রিমলিন,	
sikkhakbrinda,	শিক্ষাবৃৃন্দ,	শিক্ষকবৃন্দ,	
orthisoho,	অর্থিসহ,	অর্থিসহ,	
turkii,	তুর্কিই,	তুর্কি,	
kadam,	কাদাম,	কদম,	
chintakarma,	চিন্তাকর্ম,	চিন্তাকর্ম,	
noiteek,	নৈতিক,	নৈতিক,	
holding,	হোল্ডিং,	হোল্ডিং,	
ganjana,	গঞ্জনা,	গঞ্জনা,	
musallati,	মুসলল্লি,	মুসল্লাটি,	
oncholgulir,	অঞ্চলগুলির,	অঞ্চলগুলির,	
shuchonakal,	শুচনাকাল,	সূচনাকাল,	
neerbahe,	নির্বাহে,	নির্বাহে,	
chai,	চেই,	ছাই,	
gabhaskaar,	গাভাসকার,	গাভাস্কার,	
antorvukta,	অন্তর্ভুক্ত,	অন্তর্ভুক্ত,	
nirgaman,	নির্গামান,	নির্গমন,	
morathee,	মোরথথী,	মরাঠি,	
chire,	চিরে,	চিরে,	
arthonitir,	অর্থনীতির,	অর্থনীতির,	
scholarship,	স্কলারশিপ,	স্কলারশিপ,	
shishu,	শিশু,	শিশু,	
umb,	ইউম্বাব,	ইউএমবি,	
protizogiita,	প্রতিযোগিতাত,	প্রতিযোগীতা,	
trutimatra,	ত্রিটুমাত্র,	ত্রুটিমাত্র,	
kortam,	কর্তাম,	করতাম,	
naper,	নাপের,	ন্যাপের,	
sontoshpur,	সন্তোষপুর,	সন্তোষপুর,	
philo,	ফিলো,	ফিলো,	
sarbhare,	সর্ভরে,	সার্ভারে,	
phund,	ফুন্ড,	ফান্ড,	
licensin,	লাইসেন্সিন,	লাইসেন্সিং,	
jansha,	জনশা,	জন্স,	
zerusalem,	জেরুসালেম,	জেরুজালেম,	
torikher,	তরিকের,	তরিখের,	
bhabaaponno,	ভবপান্ন,	ভাবাপন্ন,	
jhijhi,	ঝিঝি,	ঝিঝি,	
ahalya,	আহল্য,	অহল্যা,	
chyeta,	চ্যেতা,	চ্যাট,	
sampadon,	সম্পাদন,	সম্পাদন,	
zeeland,	জিলান্ড,	জিল্যান্ড,	
yatharthabhabe,	যাঠরর্থভাবে,	যথার্থভাবে,	
shandra,	শান্দ্রা,	শান্দ্রার,	
sumita,	সুমিতা,	সুমিতা,	
kosambir,	কোসম্বীর,	কোসাম্বীর,	
blacq,	ব্ল্যাক,	ব্ল্যাক,	
fibergulote,	ফিইবারগুলোতে,	ফাইবারগুলোতে,	
yanqee,	যাঙকে,	ইয়াংকি,	
evereste,	এভারেস্টে,	এভারেস্টে,	
jitpur,	জিতপুর,	জিতপুরের,	
jins,	জিনস,	জিন্স,	
monur,	মনুর,	মনুর,	
shuri,	শুরী,	সুরি,	
byboshthar,	বিবস্থার,	ব্যাবস্থার,	
dolphiny,	ডলফিনি,	ডলফিনি,	
lavta,	লাভটা,	লাভটা,	
bhaisaho,	ভাইসহ,	ভাইসহ,	
pariyech,	পরিয়েছে,	পরিয়েছ,	
siima,	সিয়ামা,	সীমা,	
bibecchyo,	বিবেচ্ছি,	বিবেচ্য,	
cloring,	ক্লোরিং,	ক্লোরিং,	
hool,	হুল,	হুল,	
bharotiyotar,	ভারতিয়তার,	ভারতীয়তার,	
bhageri,	ভাগেরি,	ভাগেরই,	
shithilata,	শিথিলতা,	শিথিলতা,	
relance,	রিল্যান্স,	রিলায়েন্স,	
rakhtokkharone,	রাক্তধা্ষণে,	রক্তক্ষরণে,	
aashanka,	আশংকা,	আশংকা,	
songbadmadhyomer,	সংবাদমাধ্যমের,	সংবাদমাধ্যমের,	
sift,	সিফট,	শিফট,	
choddo,	চ্দদ,	চোদ্দো,	
dighol,	দিঘল,	দীঘল,	
palashir,	পালাশির,	পলাশীর,	
muktilav,	মুক্তিলভ,	মুক্তিলাভ,	
municipal,	মুনিসিপাল,	মিউনিসিপ্যাল,	
bapokotor,	বাপকোতর,	ব্যাপকতর,	
chhon,	ছন,	ছোঁ,	
shite,	শিতে,	শীতে,	
roopdaan,	রূপডান,	রুপদান,	
hul,	হুল,	হুল,	
chakurijibirao,	চাকুরিজীবীরাও,	চাকুরীজীবীরাও,	
booksar,	বোকসার,	বুক্সার,	
inziniyarsa,	ইনজিজিয়েরসা,	ইঞ্জিনিয়ার্স,	
iksaprishana,	ইক্সপ্রিশন,	এক্সপ্রেশন,	
chhooti,	ছুটি,	ছুটি,	
spancer,	স্প্যানসের,	স্পেন্সার,	
bhupal,	ভূপাল,	ভূপাল,	
jamjomat,	জমজমাত,	জমজমাট,	
bedantodhormo,	বেদানতধর্ম,	বেদান্তধর্ম,	
metrikoleshana,	মেট্রিকলেশন,	মেট্রিকোলেশন,	
temonvabe,	তেমনাবাবে,	তেমনভাবে,	
domone,	ডোমোন,	দমনে,	
siropa,	সিরোপা,	শিরোপা,	
asamorik,	আসামরিক,	অসামরিক,	
phiksim,	ফিকসিম,	ফিক্সিং,	
durgatsober,	দুর্গাসসবের,	দুর্গোৎসবে,	
gotirodh,	গতিরোধ,	গতিরোধ,	
champa,	চম্পা,	চাঁপা,	
krusher,	ক্রুশের,	ক্রুশের,	
rajashri,	রাজশ্রী,	রাজশ্রী,	
naneer,	নানীর,	নানীর,	
grambaashi,	গ্রামবাশশী,	গ্রামবাসী,	
mukhyo,	মুখ্য,	মুখ্য,	
uthaney,	উঠানে,	উঠানে,	
dola,	দোলা,	দলা,	
ganosachetanata,	গণসাচেতনতা,	গণসচেতনতা,	
shanno,	শান্ন,	সান্নো,	
parshwer,	পার্শ্বের,	পার্শ্বের,	
ashonkai,	আশঙ্কাই,	আশঙ্কাই,	
binakar,	বিনাকার,	বিনাকার,	
skolastik,	স্কোলাস্টিক,	স্কলাস্টিক,	
monchosthol,	মঞ্চস্থল,	মঞ্চস্থল,	
sahapathike,	সহপথীকে,	সহপাঠীকে,	
kalnir,	কালনির,	কালনীর,	
ispredsiit,	ইস্প্রেডিই,	স্প্রেডশীট,	
eekbalke,	একবললকে,	ইকবালকে,	
srichoitonnodeb,	শ্রিচৈতন্যদেব,	শ্রীচৈতন্যদেব,	
sayanaida,	সায়নাদা,	সায়ানাইড,	
amarika,	আমারিকা,	আমেরিকা,	
amittrakkhor,	অমিত্তাক্ষর্ষ,	অমিত্রাক্ষর,	
modelkey,	মডেলকে,	মডেলকে,	
porbotmala,	পর্বলমালা,	পর্বতমালা,	
torunderke,	তরুণ্ডরকে,	তরুণদেরকে,	
rudroke,	রুদ্রকে,	রুদ্রকে,	
rodney,	রডনে,	রেডনি,	
palbongsher,	পালবংশের,	পালবংশের,	
purbancoler,	পার্বানকোলের,	পূর্বাঞ্চলের,	
bostubad,	বস্তুবাদ,	বস্তুবাদ,	
vortuki,	ভর্তুকি,	ভর্তুকি,	
mohit,	মোহিত,	মুহিত,	
hakone,	হাকনে,	হাকোনে,	
chhedon,	ছেদন,	ছেদন,	
veemsen,	ভিমসেন,	ভীমসেন,	
shatoke,	শাটকে,	শতকে,	
keu,	কেউ,	কেউ,	
ashamarthita,	অশামর্থীত,	অসমর্থিত,	
ostheesandhi,	অস্থবিন্ধী,	অস্থিসন্ধি,	
madraser,	মাদ্রাসের,	মাদ্রাজের,	
harbore,	হারবোর,	হারবারে,	
bhimsen,	ভিমসেন,	ভীমসেন,	
langhangulir,	লঙ্ঘলনগুলির,	লঙ্ঘনগুলির,	
hattey,	হ্যাতে,	হাঁটতে,	
sthapanagulor,	স্থাপনাগুলোর,	স্থাপনাগুলোর,	
ebham,	এভাম,	ইভিএম,	
shattoki,	শাত্যকি,	সাত্যকি,	
shariba,	শরিবা,	শরিবা,	
direectoratee,	ডিরিক্টরটি,	ডিরেক্টরেট,	
poketchorder,	পকেচকর্দের,	পকেটচরদের,	
tahorir,	তাহরীর,	তাহরীর,	
manibhaijaner,	মনিভাইজানের,	মণিভাইজানের,	
jotinkey,	জতিনকে,	যতীনকে,	
kompeeto,	কম্পিত,	কম্পিত,	
uporoshtho,	উপরস্থ,	উপরস্থ,	
pleta,	প্লেটা,	প্লেটো,	
ernad,	এরনাড,	এরনাড,	
fiksing,	ফিকসিং,	ফিক্সিং,	
hamburgey,	হ্যামববারগগে,	হামবুর্গে,	
vvimsenn,	ভাভিমস্ন,	ভীমসেন,	
jathartho,	যথার্থ,	যথার্থ,	
kalakushalir,	কলাকুশলীর,	কলাকুশলীর,	
parabortee,	পারবর্তী,	পরর্বতী,	
goteehin,	গতিহীন,	গতিহীন,	
kaia,	কাইয়া,	কায়া,	
lendal,	লেন্ডল,	লেন্ডল,	
remakri,	রেমাক্রি,	রেমাক্রী,	
oojbekistan,	অয়েসবিস্তান,	উজবেকিস্তান,	
moshzidtike,	মোখবিদটিকে,	মসজিদটিকে,	
aairish,	আইরিস,	আইরিস,	
jor,	জর,	জ্বর,	
karir,	কারির,	কারীর,	
dokaangulotey,	দোকানগুলিতেও,	দোকানগুলোতে,	
labonaktatar,	লবনাক্ততার,	লবণাক্ততার,	
bouddha,	বৌদ্ধ,	বৌদ্ধ,	
weelcomee,	ওয়ালকমি,	ওয়েলকাম,	
chemjong,	চেমজং,	চেমজং,	
adorso,	আদোর্স,	আর্দশ,	
said,	সেয়,	সাইদ,	
title,	তিলে,	টাইটেল,	
chetanagato,	চেতনাগত,	চেতনাগত,	
beetloser,	বিটলসের,	বিটলসের,	
biphal,	বিফফ,	বিফল,	
hoil,	হেল,	হইল,	
satarka,	সাতারকা,	সতর্ক,	
sangosrobomukto,	সংস্রবমমুক্ত,	সংস্রবমুক্ত,	
gobeshokgon,	গবেষকগণ,	গবেষকগণ,	
elaakate,	এলাকাতে,	এলাকাতে,	
asovyo,	অসভ্য,	অসভ্য,	
ooipokar,	উপসকর,	উইপোকার,	
sikkharrtheerao,	শিক্ষার্থীরাও,	শিক্ষার্থীরাও,	
nirikho,	নিরীখো,	নিরিখ,	
plainey,	প্লেনে,	প্লেনে,	
qarqa,	কারকা,	কার্ক,	
digreeke,	দিগ্রীকে,	ডিগ্রিকে,	
plak,	প্ল্যাক,	প্ল্যাক,	
jhamala,	ঝামালা,	ঝামালা,	
mast,	মাস্ট,	মাস্ত,	
phaltu,	ফল্লু,	ফালতু,	
diznee,	দিজন,	ডিজনী,	
myathiou,	ম্যাঠিও,	ম্যাথিউ,	
deefinition,	ডিফিনিশন,	ডেফিনেশন,	
cs,	সিএস,	সিএস,	
drissoteer,	ড্রিস্টির,	দৃশ্যটির,	
adhunikkaley,	আধুনিককালে,	আধুনিককালে,	
grontho,	গ্রন্থ,	গ্রন্থ,	
chhayi,	ছায়,	ছাই,	
deenesh,	দেনেশ,	দীনেশ,	
muhurtati,	মুহুরতটি,	মুহুর্তটি,	
graambaaseer,	গ্রম্বাসীর,	গ্রামবাসীর,	
lettar,	লেটটার,	লেটার,	
tottorat,	টোট্রোটাট,	তওরাত,	
sylvi,	সিলভি,	সিলভি,	
jinsa,	জিনসা,	জিন্স,	
sumoo,	সুমু,	সুমো,	
amarjito,	অমরজজিত,	অমার্জিত,	
oncholsomuho,	অনচ্লসমূহ,	অঞ্চলসমূহ,	
meridiane,	মেরিডিয়ান,	মেরিডিয়ানে,	
arshie,	আর্শী,	আরসিএ,	
arke,	আরকে,	আরকে,	
gronther,	গ্রন্থের,	গ্রন্থের,	
thandabhabe,	থান্ডাভাবে,	ঠাণ্ডাভাবে,	
antorbhuktimulak,	অন্তর্ভুক্তমূলক,	অন্তর্ভুক্তিমূলক,	
jyaqa,	জ্যাকা,	জ্যাক,	
romarder,	রোমার্ডের,	রোমারদের,	
shrichaitanyadev,	শ্রীচৈতন্যাদেব,	শ্রীচৈতন্যদেব,	
labonaaktotaar,	লবনোক্ততার,	লবণাক্ততার,	
welcome,	ওয়েলকোম,	ওয়েলকাম,	
mugdal,	মুগদল,	মুগডাল,	
jini,	জিনি,	যিনি,	
breqathru,	ব্রকাঠার্,	ব্রেকথ্রু,	
edmiral,	এডমিরাল,	এডমিরাল,	
engrejer,	এংরেজের,	ইংরেজের,	
bhandti,	ভান্ডটি,	ভাণ্ডটি,	
victor,	ভিক্টর,	ভিক্টর,	
byepass,	ব্যাপেস,	বাইপাস,	
saras,	সারাস,	সরস,	
purbanchaler,	পূর্বাঞ্চলের,	পূর্বাঞ্চলের,	
rotheen,	রথীন,	রথীন,	
elbamtite,	এলবামিতিতে,	এলবামটিতে,	
baaik,	বায়ক,	বাইক,	
janar,	জানার,	জানার,	
shamuker,	শামুকের,	শামুকের,	
navaratri,	নাভাত্রী,	নবরাত্রি,	
abeganuvutir,	অবেগানুভূতির,	আবেগানুভূতির,	
manushgulor,	মানুষগুলোর,	মানুষগুলোর,	
patjata,	পাটজাতা,	পাটজাত,	
heawy,	হেওয়,	হেভি,	
aranyani,	অরণ্যনী,	অরণ্যানী,	
ceramicsh,	সেরিমিক্স,	সিরামিকস,	
nirmol,	নির্মোল,	নির্মল,	
projanankal,	প্রজাননকাল,	প্রজননকাল,	
bidhirnityang,	বিধির্নিত্যং,	বিধির্নিত্যং,	
shasankarta,	শাসনকর্ত,	শাসনকর্তা,	
elakaatite,	এলাকাটিতে,	এলাকাটিকে,	
mausumer,	মৌসুমের,	মৌসুমের,	
jatotaa,	যোটাটা,	যতোটা,	
associatis,	অ্যাসোয়াসিটিস,	এসোসিয়েটস,	
sheepha,	শিফ,	শেফ,	
faaj,	ফাজ,	ফাজ,	
suhasini,	সুহাসিনী,	সুহাসিনী,	
probhur,	প্রভুর,	প্রভুর,	
swartho,	স্বার্থ,	স্বার্থ,	
abhirupbabuke,	অভিরূপবাবুকে,	অভিরূপবাবুকে,	
wrighter,	থৃঘটর,	রাইটের,	
atmobonchito,	আত্মবন্চিত,	আত্মবঞ্চিত,	
dala,	দালা,	দলা,	
jubokti,	যুবক্তি,	যুবকটি,	
raiji,	রাইজি,	রাইজি,	
tuni,	তুনি,	টুনি,	
hepatitis,	হেপাটাইটিস,	হেপাটাইটিস,	
shikhaboudi,	শিখাবৌদি,	শিখাবৌদি,	
daakten,	ডাকতেন,	ডাকতেন,	
mandarbani,	মন্দরবাণী,	মন্দারবাণী,	
madhoboir,	মাধবরই,	মাধবীর,	
gandhariir,	গান্ধারীর,	গান্ধারীর,	
eshiyetika,	এশিয়েকিকা,	এশিয়াটিক,	
adwanced,	অ্যাডব্যান্ড,	অ্যাডভান্সড,	
gudamjat,	গুদামজাত,	গুদামজাত,	
saoum,	সাওম,	সাওম,	
joumana,	জৌমানা,	জুমানা,	
grambaashio,	গ্রামবাশীও,	গ্রামবাসীও,	
rupert,	রুপার্ট,	রুপার্ট,	
gardeen,	গার্েন,	গার্ডেন,	
sachetanvabe,	সচেতনাভবে,	সচেতনভাবে,	
nathivookto,	নাথিবক্ত,	নথিভুক্ত,	
lishenshe,	লিশেন্সে,	লাইসেন্স,	
ronangane,	রোনাঙ্গানে,	রণাঙ্গনে,	
bangalore,	বাঙ্গালোরে,	ব্যাঙ্গালুরে,	
bitertrate,	বিটার্ট্রেট,	বাইটারট্রেট,	
engreziteo,	এনরগজিতেও,	ইংরেজিতেও,	
sofie,	সফিয়,	সোফি,	
japanostho,	জাপনস্থ,	জাপানস্থ,	
puroheetder,	পুরোহীতদের,	পুরোহিতদের,	
byapoktor,	ব্যাপক্তর,	ব্যাপকতর,	
antarctica,	অ্্ট্র্যাকটিকা,	অ্যান্টার্কটিকা,	
prokolpogulikei,	প্রকল্পগুলিকেই,	প্রকল্পগুলিকেই,	
talaal,	তালাল,	তালাল,	
sumi,	সুমি,	সুমি,	
vabaponno,	বাপান্ন,	ভাবাপন্ন,	
anisa,	আনিসা,	আনিস,	
bonsho,	বনশ,	বংশ,	
abikaul,	অবিকাল,	অবিকল,	
durgotsabe,	দুর্গতসাবে,	দুর্গোৎসবে,	
vittio,	ভিত্তিও,	ভিত্তিও,	
parkin,	পারকিন,	পার্কিং,	
rajtantro,	রাজতন্ত্র,	রাজতন্ত্র,	
paab,	পাব,	পাব,	
impaction,	ইম্পেকশন,	ইমপ্যাকশন,	
korijachilen,	করিয়াছিলেন,	করিযাছিলেন,	
ixprission,	ইক্সপিরনশ,	এক্সপ্রেশন,	
railliner,	রেলিনার,	রেললাইনের,	
antarbhutto,	অন্তর্ভূত্ত,	অন্তর্ভুক্ত,	
nirapattamulok,	নিরাপত্তামূলক,	নিরাপত্তামূলক,	
youth,	উযু,	ইয়ুথ,	
deenes,	দেনেস,	দীনেশ,	
kumbhalnar,	কুম্ভললার,	কুম্ভালনার,	
planea,	প্ল্যানা,	প্লেনে,	
dipti,	ডিপটি,	ডেপুটি,	
nadike,	নাদিকে,	নদীকে,	
swadesh,	স্বাদেশ,	স্বদেশ,	
probeshan,	প্রবেশন,	প্রবেশন,	
ponchaasjon,	পঞ্চাজন,	পঞ্চাশজন,	
canservatian,	ক্যানজেরভা্টায়,	কনসারভেশন,	
moreecha,	মরিচা,	মরিচা,	
tukroti,	তুকরোটি,	টুকরোটি,	
khuizza,	খুইজ্জা,	খুইজ্জা,	
latsaheb,	লা্সাহেব,	লাটসাহেব,	
majlishpur,	মজলিশপুর,	মজলিশপুর,	
myari,	ম্যারি,	ম্যারি,	
kalki,	কালকি,	কালকি,	
lutharan,	লুথারান,	লুথেরান,	
rajbondir,	রাজবন্দির,	রাজবন্দীর,	
hunine,	হুনিনে,	হুনাইন,	
shtonehenge,	স্টননেঞ্জে,	স্টোনহেঞ্জ,	
seekkharthirao,	শিক্ষার্থীরাও,	শিক্ষার্থীরাও,	
madhoori,	মাধুরি,	মাধুরী,	
dantahin,	দন্তাহীন,	দন্তহীন,	
gazipur,	গাজিপুর,	গাজিপুর,	
shingping,	শিংপিং,	শিংপিং,	
avetar,	আভেতার,	অবতার,	
melbourner,	মেলবর্নের,	মেলবোর্নের,	
husni,	হুসনি,	হুসনি,	
bikretara,	বিক্রেতারা,	বিক্রেতারা,	
chat,	চাত,	চ্যাট,	
monzushree,	মন্ুশ্রী,	মঞ্জুশ্রী,	
elakasoho,	এলাকাসহ,	এলাকাসহ,	
joisttho,	জৈস্থ্য,	জ্যৈষ্ঠ,	
niketaner,	নিকেতানের,	নিকেতনের,	
manoharpur,	মনোহরপুর,	মনোহরপুর,	
durgatsob,	দুর্গাসব,	দুর্গোৎসব,	
mail,	মাইল,	মাইল,	
parka,	পারকা,	পার্ক,	
gratha,	গ্রাথা,	গ্রোথ,	
giitikobita,	গীতিতিবিতা,	গীতিকবিতা,	
srk,	সিরিকে,	শাহরুখ,	
heelser,	হেলসের,	হিলসের,	
monzooshree,	মনজুন্রী,	মঞ্জুশ্রী,	
licenshe,	লাইসেন্স,	লাইসেন্স,	
abhijitda,	অভিজিতদা,	অভিজিতদা,	
pratiyogita,	প্রতিয়গিতা,	প্রতিযোগীতা,	
eoki,	এইকি,	এওকি,	
golimodhye,	গোলিমধ্যে,	গলিমধ্যে,	
bhromonkaale,	ভ্রমণকালে,	ভ্রমণকালে,	
spreadshiit,	স্প্রিডশি,	স্প্রেডশীট,	
bastubad,	বস্তুবাদ,	বস্তুবাদ,	
ala,	আলা,	আলা,	
rakkhanvag,	রক্ষণভাগ,	রক্ষণভাগ,	
ghotol,	ঘটল,	ঘটল,	
fastara,	ফাস্তারা,	ফস্টার,	
vogiroth,	ভগীরথ,	ভগীরথ,	
bitlaser,	বিটলাসের,	বিটলসের,	
nothivukta,	নথিভূক্ত,	নথিভুক্ত,	
baju,	বাজু,	বাজু,	
urey,	উরি,	ইউরি,	
steeit,	স্টিট,	স্টেইট,	
sombhobonao,	সম্ভবনাও,	সম্ভবনাও,	
wedanta,	ওয়ান্ডটা,	বেদান্ত,	
lampot,	ল্যাম্পট,	লম্পট,	
byaboharkariyi,	ব্যবহারকারীীী,	ব্যবহারকারীই,	
geja,	গেজা,	গেজ,	
komanera,	কোমানেরা,	কমানেরা,	
khonjena,	খোনজেনা,	খোঁজেনা,	
iuro,	ইউরো,	ইউরো,	
nehle,	নেহলে,	নেহলে,	
bohudin,	বহুদিন,	বহুদিন,	
upobaasee,	উপবাসী,	উপবাসী,	
monzeele,	মনজেলে,	মঞ্জিলে,	
porirshoder,	পরির্ষদের,	পরির্ষদের,	
sadeena,	সাদিনা,	সাডেন,	
miraclee,	মারাকলি,	মিরাকেল,	
abhidhaaneeck,	অভিধানায়ক,	অভিধানিক,	
lambaate,	লাম্বাতে,	লম্বাটে,	
romancha,	রোমাঞ্চা,	রোমাঞ্চ,	
falasrutite,	ফালসরুটিতে,	ফলশ্রুতিতে,	
spredshiit,	স্প্রেডশি,	স্প্রেডশীট,	
jounatar,	যৌনাতার,	যৌনতার,	
loombinee,	লুমবিন,	লুম্বিনী,	
kayech,	কায়েচ,	কায়েছ,	
bodhukeo,	বধুকেও,	বধুকেও,	
footbalarer,	ফুটবলারের,	ফুটবলারের,	
nirbaahe,	নির্বাহে,	নির্বাহে,	
maudelti,	মাউডেলটি,	মডেলটি,	
tigmanshu,	তিজমানসহু,	তিগ্মাংশু,	
rushod,	রুশোদ,	রুশদ,	
bisheshshyer,	বিশেষশ্যের,	বিশেষ্যের,	
modelgulo,	মডেলগুলো,	মডেলগুলো,	
torkarite,	তর্কারিতে,	তরকারিতে,	
mimgulor,	মিমগুলোর,	মিমগুলোর,	
abhidhanick,	অভিধানিক,	অভিধানিক,	
aviyojan,	অভিযোজন,	অভিযোজন,	
dhyanastha,	ধ্যানস্থ,	ধ্যানস্থ,	
aasirbaad,	আসীরবাদ,	আশির্বাদ,	
bujhechhila,	বুঝেছিলা,	বুঝেছিল,	
distibutor,	ডিস্টিবুটর,	ডিস্টিবিউটারের,	
sexperter,	সেক্সপার্টের,	সেক্সপার্টের,	
taranee,	তারানী,	তরণী,	
volapuk,	ভোলাপুক,	ভোলাপুক,	
gandhiir,	গান্ধীর,	গান্ধীর,	
tinhazar,	তিনহাজার,	তিনহাজার,	
chongar,	চঙ্গার,	চোঙ্গার,	
shitei,	শিতেই,	শীতেই,	
gej,	গেজ,	গেজ,	
planey,	প্ল্যানে,	প্লেনে,	
armashtram,	আরমাশ্্রম্,	আর্মস্ট্রং,	
manob,	মানব,	মানব,	
mukharji,	মুখরজজি,	মুখার্জী,	
aagera,	আগেরা,	আগোরা,	
iraner,	ইরানের,	ইরানের,	
drissogulote,	ড্রিসগগুলোতে,	দৃশ্যগুলোতে,	
dekhso,	দেখস,	দেখসো,	
armshtrong,	আর্মক্ষপ্ং,	আর্মস্ট্রং,	
probondhobhittik,	প্রবন্ধভিত্তিক,	প্রবন্ধভিত্তিক,	
ghoomachhe,	ঘোমাছে,	ঘুমাচ্ছে,	
vushito,	ভুশিত,	ভূষিত,	
shhepha,	শেফা,	শেফ,	
mohammadi,	মোহাম্মদী,	মুহাম্মদী,	
shommoteer,	শম্মতির,	সম্মতির,	
patininda,	পাতিনিন্দ,	পতিনিন্দ,	
samyuktha,	সাম্যুক্ত,	সামিউক্তা,	
songrahak,	সংগ্রহক,	সংগ্রাহক,	
taap,	তাপ,	ট্যাপ,	
amudey,	আমুদে,	আমুদে,	
puding,	পুডিং,	পুডিং,	
philipiner,	ফিলিপিনের,	ফিলিপাইনের,	
breel,	ব্রিল,	ব্রিল,	
quartar,	কোয়ার্টার,	কোয়ার্টার,	
aakaabar,	আকাবার,	আকাবার,	
fasi,	ফাসি,	ফাঁসী,	
hundai,	হুন্দাই,	হুন্দাই,	
boudhher,	বৌখের,	বৌদ্ধের,	
tyapa,	ত্যাপা,	ট্যাপ,	
ruble,	রাবল,	রুবল,	
sangkalanti,	সংকলনটি,	সংকলনটি,	
parinati,	পরিনাটি,	পরিণতি,	
drissoke,	ড্রিসোকে,	দৃশ্যকে,	
rayyalati,	রোয়ায়ততি,	রয়্যালটি,	
foxer,	ফোস্সার,	ফক্সের,	
balithubar,	বালিঠুবার,	বালিথুবার,	
falak,	ফালাক,	ফলক,	
swasthohinotay,	স্বাস্থ্যহানতায়,	স্বাস্থ্যহীনতায়,	
catholicder,	ক্যাথলিকদের,	ক্যাথলিকদের,	
chokhwala,	চোখাবলা,	চোখওয়ালা,	
hisaber,	হিসাবের,	হিসাবের,	
ghatleo,	ঘাটলেও,	ঘটলেও,	
chhutochhuti,	ছুটুচুটি,	ছুটোছুটি,	
bahjya,	বাহ্যা,	বাহ্য,	
bandra,	বান্দ্রা,	বন্দীরা,	
durlabhatwang,	দুর্লভভব্্ং,	দুর্লভত্বং,	
kailashrao,	কৈলাশরাও,	কৈলাশরাও,	
omarader,	ওমারাদের,	ওমারাদের,	
bethikata,	বেথিকাটা,	বেঠিকতা,	
senior,	সেনিওর,	সিনিয়র,	
shrabasti,	শ্রাবস্তি,	শ্রাবস্তী,	
manohputa,	মনোহপূত,	মনঃপুত,	
mane,	মানে,	মানে,	
haris,	হরিস,	হ্যারিস,	
aarke,	আরকে,	আরকে,	
ovarview,	ওভারভিইজ,	ওভারভিউ,	
kayed,	কায়েদ,	কায়েদ,	
brahmanera,	ব্রহ্মণেরা,	ব্রাহ্মণেরা,	
hastamathun,	হস্তাথনুন,	হস্তমথুন,	
khalidke,	খালিদকে,	খালিদকে,	
chalachchitroke,	চালচচিত্রকে,	চলচ্চিত্রকে,	
shikshakbrinda,	শিক্ষাবৃষ্ণ্দ,	শিক্ষকবৃন্দ,	
sabrakamer,	সব্রকামের,	সবরকমের,	
inapharameshana,	ইনাফরেসমন,	ইনফরমেশন,	
primoo,	প্রীমৌ,	প্রিমো,	
jamkaalo,	জাকালো,	জমকালো,	
samajik,	সমাজিক,	সামাজিক,	
shourshe,	শৌর্সে,	সোর্স,	
heena,	হিনা,	হেনা,	
shukrabab,	শুক্রবাব,	শুক্রবাব,	
felto,	ফেল্টো,	ফেলত,	
nimnosakkharkari,	নিম্নসসক্ষাকরকীর,	নিম্নস্বাক্ষরকারী,	
udbodhani,	উদ্বোধনী,	উদ্বোধনী,	
parisankhanbid,	পরিসংখ্যান্দ,	পরিসংখ্যানবিদ,	
mumtaz,	মুমতাজ,	মুমতাজ,	
bonnopran,	বন্যপ্রাণ,	বন্যপ্রাণ,	
tukrowti,	টুকরোবটি,	টুকরোটি,	
chalachchitra,	চলচচচিত্র,	চলচ্চিত্র,	
marathi,	মারাথি,	মরাঠি,	
dorun,	ডরুন,	দরুণ,	
balakarak,	বালাকারক,	বলকারক,	
oxforde,	অক্সপোর্ড,	অক্সফোর্ডে,	
folleni,	ফলেনি,	ফলেনি,	
starker,	স্ট্রাকের,	স্টার্কের,	
kindom,	কিন্ডম,	কিংডম,	
orbi,	ওরবি,	ওরবি,	
dooburir,	দুবুরির,	ডুবুরির,	
assexe,	আ্যাসেক্সে,	অ্যাসেক্সে,	
hitokor,	হিতোকর,	হিতকর,	
saqara,	সাকারা,	সকার,	
dip,	ডিপ,	দীপ,	
proo,	প্রুও,	প্রো,	
onurbar,	অনুর্বর,	অনুর্বর,	
ovinetar,	অভিনেটার,	অভিনেতার,	
horippur,	হরিপপুর,	হরিপুর,	
kings,	কিংস,	কিংস,	
uposhthit,	উপশ্থিত,	উপস্থিত,	
jatinkey,	জাতিনকে,	যতীনকে,	
zubokra,	যুবকরা,	যুবকরা,	
milayatane,	মিলাযাতনে,	মিলায়তনে,	
protul,	প্রতুল,	প্রতুল,	
bojhe,	বোঝে,	বোঝে,	
neck,	নেক,	নেক,	
semai,	সেমাই,	সেমাই,	
shasonkarta,	শাসনকর্তা,	শাসনকর্তা,	
nothivuktir,	নথিভূক্তির,	নথিভুক্তির,	
vaphara,	ভাফারা,	বাফার,	
kkomandar,	ক্মানা্দার,	কমাণ্ডার,	
chikitsar,	চিকিৎসার,	চিকিত্সার,	
protisthan,	প্রতিষ্ঠান,	প্রতিষ্টান,	
laatimer,	লাতিমের,	লাটিমের,	
rupantarer,	রুপান্তরের,	রুপান্তরের,	
hurricane,	হুরিকানে,	হ্যারিকেন,	
hydrological,	হাইড্রোলিকোকাল,	হাইড্রোলজিক্যাল,	
orrgho,	অর্ঘ্,	অর্ঘ্য,	
conflikt,	কনফলিক্ট,	কনফ্লিক্ট,	
shiter,	শিতের,	শীতের,	
kareer,	কারীর,	কারীর,	
votar,	ভোটার,	ভোটার,	
konoroop,	কনরুর,	কোনরূপ,	
madrasa,	মাদ্রাসা,	মাদ্রাসা,	
tokee,	টকি,	তকি,	
poschime,	পশ্চিমে,	পশ্চিমে,	
nirobota,	নিরবতা,	নিরবতা,	
transapharma,	ট্রান্সপফর্মা,	ট্রান্সফর্ম,	
freelancerra,	ফ্রিল্যান্সাররা,	ফ্রিল্যান্সাররা,	
oncoleo,	অনকোলেও,	অঞ্চলেও,	
magical,	ম্যাগিক্যাল,	ম্যাজিকাল,	
seekkhaou,	শিক্ষৌৌ,	শিক্ষাও,	
saalsa,	সালসা,	সালসা,	
dhadhiye,	ধধীয়ে,	ধাধিয়ে,	
byabosthar,	ব্যবস্থার,	ব্যবস্থার,	
tintikey,	তিনটিকে,	তিনটিকে,	
porinoti,	পরিণতি,	পরিণতি,	
brixfield,	ব্রিকফিল্ড,	ব্রিক্সফিল্ড,	
nirabota,	নিরাবতা,	নিরবতা,	
protectionism,	প্রোটকশিনিজম,	প্রোটেকশনিজম,	
madhobeer,	মাধবীর,	মাধবীর,	
oncholeo,	অনচলেও,	অঞ্চলেও,	
abheedhanic,	অভিধানিক,	অভিধানিক,	
notikotar,	নতিকতার,	নৈতিকতার,	
bhogno,	ভগ্ন,	ভগ্ন,	
faase,	ফাসে,	ফাঁসে,	
tiger,	টিগের,	টাইগার,	
adhyatmik,	অধ্যাতিমক,	আধ্যাত্মিক,	
jhonkar,	ঝন্কার,	ঝঙ্কার,	
shresthoshcho,	শ্রেষ্ঠশ্চ,	শ্রেষ্ঠশ্চ,	
gaphiloti,	গাফিলটি,	গাফিলতি,	
oswastikor,	অস্বাসীতকর,	অস্বস্তিকর,	
kanshater,	কানশাতের,	কানসাটের,	
atwobishvashi,	অত্ববিশ্বাষী,	আত্মবিশ্বাসী,	
dapadpi,	দপপদী,	দাপাদপি,	
batom,	বাতম,	বাটম,	
sahab,	সাহাব,	সাহাব,	
maadla,	মাডলা,	মাদলা,	
rajnaiteek,	রাজনৈতিক,	রাজনৈতীক,	
khuliechilam,	খুলিওয়েছিলাম,	খুলিয়েছিলাম,	
aalkatraa,	আলকাত্রা,	আলকাতরা,	
protistha,	প্রতিষ্ঠা,	প্রতিষ্টা,	
mahbunur,	মাহবুনুর,	মাহবুনুর,	
lokhindorer,	লোখিন্দরের,	লখিন্দরের,	
ikboler,	ইকবলের,	ইকবলের,	
afrazuler,	আফরাজুলের,	আফরাজুলের,	
thailand,	থাইল্যান্ড,	থাইল্যান্ড,	
goora,	গোররা,	গোর,	
goolen,	গুলেন,	গুলেন,	
osthisondhi,	অস্থিসন্ধি,	অস্থিসন্ধি,	
prakalpatike,	প্রকল্পটিকে,	প্রকল্পটিকে,	
vushi,	ভুশি,	ভুষি,	
bisshasi,	বিশাসসী,	বিশ্বাসী,	
marketing,	মার্কেটিং,	মার্কেটিং,	
phuda,	ফুড়া,	ফুড,	
uddhritto,	উদ্ধৃত্ব,	উদ্ধৃত,	
tiuning,	টিউনিং,	টিউনিং,	
pyaleshtainer,	প্লেলশশিনের,	প্যালেস্টাইনের,	
ponchashjon,	পঞ্চাশন,	পঞ্চাশজন,	
uporitoler,	উপরিতলের,	উপরিতলের,	
bairey,	বাইরে,	বাইরে,	
obhaarbhiu,	অভার্ভু,	ওভারভিউ,	
grauth,	গ্রুথ,	গ্রোথ,	
kaansaat,	কানসাত,	কানসাট,	
phormat,	ফোরমম,	ফরম্যাট,	
gate,	গাতে,	গ্যেটে,	
abosan,	অবসান,	অবসান,	
elakayi,	এলাকাই,	এলাকাই,	
ashirbadatri,	অশির্বাদ্্রী,	আশীর্বাদাত্রী,	
dhaanche,	ধাঁচে,	ধাঁচে,	
romantik,	রোমান্তিক,	রোমান্টিক,	
chopol,	চপল,	চপল,	
homsher,	হোমশের,	হোমসের,	
banglota,	বাংলোটা,	বাংলোটা,	
nek,	নেক,	নেক,	
mandondo,	মন্দন্ড,	মানদণ্ড,	
dhrubaker,	ধ্রুবাকের,	ধ্রুবকের,	
nobotom,	নবতম,	নবতম,	
sanghitar,	সংহীতার,	সংহিতার,	
manushera,	মানুষেরা,	মানুষেরা,	
kraanti,	ক্রাণ্টি,	ক্রান্তি,	
land,	ল্যান্ড,	ল্যান্ড,	
bhorkendra,	ভোরকেন্দ্র,	ভরকেন্দ্র,	
sudrissho,	সুদৃশ্য,	সুদৃশ্য,	
bandhubhaabaapanna,	বন্ধুবাভাবপ্যান,	বন্ধুভাবাপন্ন,	
dep,	ডেপ,	ডেপ,	
bulichev,	বুলিচেভ,	বুলিচেভ,	
graambasi,	গ্রামবাসী,	গ্রামবাসী,	
panthar,	পান্থার,	পন্থার,	
karu,	কারু,	কারু,	
dembakreeti,	দেম্বকেরীতি,	ডিম্বাকৃতি,	
tikto,	তিক্ত,	তিক্ত,	
graambasheeo,	গ্রামবশীও,	গ্রামবাসীও,	
nibondhocheler,	নিবন্ধচেলের,	নিবন্ধছেলের,	
deputi,	দেপুটি,	ডেপুটি,	
bhramapraban,	ভ্রমপ্রবণ,	ভ্রমপ্রবণ,	
kk,	কেকি,	কেকে,	
shikshakrom,	শিক্ষাক্রম,	শিক্ষাক্রম,	
ujbekistaner,	উজ্বেকসিন্তের,	উজবেকিস্তানের,	
okkhorke,	অক্ষরকে,	অক্ষরকে,	
mukhomandoler,	মুখোমন্ডলের,	মুখমণ্ডলের,	
saainyo,	সান্য,	সৈন্য,	
amiya,	আমিয়া,	অমিয়,	
alpa,	আল্পা,	অল্প,	
shakara,	শাকারা,	সাকার,	
abti,	এবটি,	আবতি,	
shikkharrthirao,	শিক্ষার্থীররাও,	শিক্ষার্থীরাও,	
hoonayin,	হোনাইন,	হুনাইন,	
kanuner,	কানুনের,	কানুনের,	
kholdhular,	খোলধুলার,	খোলধূলার,	
sausage,	সাসাগে,	সসেজ,	
sikkhakromer,	শিক্ষাক্রমের,	শিক্ষাক্রমের,	
sikara,	সিকারা,	শিকার,	
aireshe,	আইরেশে,	আইরেসে,	
segular,	সেগুলার,	সেগুলোর,	
babona,	বাবনা,	বাবনা,	
horiddare,	হরিদ্দারে,	হরিদ্বারে,	
juboke,	যুবকে,	যুবকে,	
shorifer,	শরিফের,	শরিফের,	
prrajanankaal,	প্রজানন্কল,	প্রজননকাল,	
kurdira,	কুরদিরা,	কুর্দিরা,	
neshnos,	নেশননোস,	নেশনস,	
ashanka,	আশাংকা,	আশংকা,	
bhabanir,	ভবনীর,	ভবানীর,	
kamti,	কামটি,	কমতি,	
granada,	গ্রানাডা,	গ্র্যানাডা,	
bhoolapuka,	ভৌলাপুকা,	ভোলাপুক,	
aalaa,	আলা,	আলা,	
sanghar,	সংঘর,	সংহার,	
nirikh,	নিরীখ,	নিরিখ,	
aatto,	এটিএি,	আত্ম,	
hypar,	হিইপার,	হাইপার,	
shasyadi,	শাস্যাদি,	শস্যাদি,	
porjotoker,	পর্যটকের,	পর্যটকের,	
noditei,	নদীতেই,	নদীতেই,	
hoteltee,	হোটেলটি,	হোটেলটি,	
phiksa,	ফিকসা,	ফিক্স,	
nikela,	নিকেলা,	নিকেল,	
bajite,	বাজিতে,	বাজিতে,	
azin,	আজিন,	আজিন,	
alimpiqa,	আলিম্পিকা,	অলিম্পিক,	
dovaar,	দোভার,	ডোভার,	
akpaase,	আকপাসে,	একপাশে,	
sachetonvabe,	সচেতনাভবে,	সচেতনভাবে,	
dipgulote,	ডিপগুলোতে,	দ্বীপগুলোতে,	
neshnosh,	নেশ্নোশ,	নেশনস,	
bopoon,	বপুন,	বপন,	
si,	সিই,	এসআই,	
mozdoor,	মজডুর,	মজদুর,	
shikhra,	শিখরা,	শিখরা,	
kantajir,	কান্তাজির,	কান্তজির,	
chalochchitreer,	চললচচিত্রীর,	চলচ্চিত্রের,	
seshardhe,	শেষার্ধে,	শেষার্ধে,	
deeares,	দিয়ারেস,	ডিআরএস,	
bishashke,	বিশাষকে,	বিশ্বাসকে,	
sbaajan,	স্ববান,	স্বজন,	
panda,	পান্ডা,	পান্ডে,	
ardasho,	আর্দাশো,	আর্দশ,	
marketin,	মার্কেটিন,	মার্কেটিং,	
shiropar,	শিরোপার,	শিরোপার,	
amanisa,	আমানিসা,	অমানিশা,	
pathkrom,	পাঠকররম,	পাঠক্রম,	
pradoshik,	প্রদাশিক,	প্রাদশিক,	
jaatti,	যাত্তি,	জাতটি,	
protibedokrao,	প্রতিবেদকরাও,	প্রতিবেদকরাও,	
prajanankal,	প্রজননাকাল,	প্রজননকাল,	
maryir,	মারিয়ার,	ম্যারির,	
unchiyechilo,	উনচিয়েছিল,	উঁচিয়েছিল,	
poriharsoho,	পরিহারসহ,	পরিহারসহ,	
delibhara,	ডেলিভারা,	ডেলিভার,	
capsule,	ক্যাপসুলে,	ক্যাপ্সুল,	
edseler,	এডসেলের,	এডসেলের,	
jolbe,	জলবে,	জ্বলবে,	
armshtronj,	আর্ম্্্্রঞ্জ,	আর্মস্ট্রং,	
sarbhaarti,	সারভারটি,	সার্ভারটি,	
ajibon,	অজীবন,	আজীবন,	
asovya,	অসভ্য,	অসভ্য,	
sikarer,	শিকারের,	শিকারের,	
bajhyo,	বাঝ্য,	বাহ্য,	
chalchhe,	চালছে,	চলছে,	
farid,	ফরিদ,	ফরিদ,	
gajiipur,	গাজিপুর,	গাজীপুর,	
gonona,	গননা,	গননা,	
sampadoner,	সম্পাদনের,	সম্পাদনের,	
kaley,	কালে,	কালে,	
sardar,	সর্দার,	সরদার,	
indro,	ইন্দ্র,	ইন্দ্র,	
dokanei,	দোকানেই,	দোকানেই,	
serology,	সেরোলজি,	সেরোলজি,	
choritrotakeo,	চরিত্রটাকেও,	চরিত্রটাকেও,	
jontrototto,	যন্ত্রত্ত্ব,	যন্ত্রতত্ত্ব,	
chahidapotrer,	চাহিরাপাত্রের,	চাহিদাপত্রের,	
saseza,	সাসেজা,	সসেজ,	
gaje,	গাজে,	গেজ,	
hosne,	হোসেনে,	হোসনে,	
tomader,	তোমাদের,	তোমাদের,	
mandanda,	মন্ডন্ডা,	মানদণ্ড,	
kaferderke,	কাফেরদেরকে,	কাফেরদেরকে,	
dhamshrenite,	ধমশ্রণীতে,	ধামশ্রেণীতে,	
gaddaphii,	গ্যাডডাফি,	গাদ্দাফী,	
turbine,	টারবিনে,	টারবাইন,	
nischitobhave,	নিশ্চিতভাবে,	নিশ্চিতভাবে,	
vins,	ভিনস,	ভিন্স,	
fishing,	ফিশিং,	ফিসিং,	
mojlish,	মজলিশ,	মজলিশ,	
fuss,	ফুস,	ফাস,	
jerusalema,	জেরুসালেমা,	জেরুসালেম,	
harza,	হারজা,	হার্জ,	
noteti,	নটটি,	নোটটি,	
batikromshalee,	বাতিক্রমশশলে,	ব্যতিক্রমধর্মী,	
veniser,	ভেনিসের,	ভেনিসের,	
udbodhaney,	উদ্বোধনে,	উদ্বোধনে,	
rohasyer,	রহাস্যের,	রহস্যের,	
niutrino,	নিউট্রিনো,	নিউট্রিনো,	
gejeted,	গেজেতেদ,	গেজেটেড,	
protishta,	প্রতিষ্টা,	প্রতিষ্টা,	
kinsha,	কিনশা,	কিংস,	
nodnodeer,	নদনদীর,	নদনদীর,	
khabarsoho,	খাবারসহ,	খাবারসহ,	
votarer,	ভোটারের,	ভোটারের,	
samaveshke,	সমভেষকে,	সমাবেশকে,	
sharthe,	শর্থে,	স্বার্থে,	
bhadaka,	ভড়াকা,	ভদকা,	
ujobekeestaner,	উজৈবস্তিন্তের,	উজবেকিস্তানের,	
dephinishion,	ডিফিনিশন,	ডেফিনেশন,	
harees,	হরিস,	হ্যারিস,	
katui,	কাতুই,	কাতুই,	
firoza,	ফিরোজা,	ফিরোজা,	
mishal,	মিশাল,	মিশাল,	
aakaabaar,	আকাবার,	আকাবার,	
swadhinotatukui,	স্বাধীনতাটুকুই,	স্বাধীনতাটুকুই,	
omanisa,	ওমানিসা,	অমানিশা,	
kushumba,	কুশুম্ব,	কুশুম্বা,	
padee,	পাদি,	পাড়ে,	
firoze,	ফিরোজে,	ফিরোজ,	
kramp,	ক্রাম্প,	ক্র্যাম্প,	
pillai,	পিল্লাই,	পিল্লাই,	
mailkhanek,	মাইলখানেক,	মাইলখানেক,	
jocqey,	জকক,	জকি,	
fand,	ফ্যান্ড,	ফান্ড,	
rijoor,	ঋজুর,	রিজুর,	
byaptikaler,	ব্যাপ্তিকালের,	ব্যাপ্তিকালের,	
gyada,	জ্ঞাদা,	গ্যাদা,	
aamontrito,	আযন্তৃত্ত,	আমন্ত্রিত,	
borlen,	বর্লেন,	বরলেন,	
mumtazer,	মুমতাজের,	মুমতাজের,	
bishnu,	বিষ্ণু,	বিষ্ণু,	
hugeke,	হুগেকে,	হিউজকে,	
cheerokoomari,	চীরকুমারাই,	চিরকুমারী,	
agora,	আগোরা,	আগোরা,	
thailandsaho,	থাইলাদ্নসহ,	থাইল্যান্ডসহ,	
gyandas,	জ্ঞানদাস,	জ্ঞানদাস,	
qulim,	কুলিম,	কুলিং,	
langhoner,	লঙ্ঘনের,	লংঘনের,	
ingrezeeteo,	ইনরেজিতেও,	ইংরেজিতেও,	
uporitaley,	উপরিতালে,	উপরিতলে,	
muchlima,	মুচলিমা,	মুছলিমা,	
weenis,	ওয়িনস,	ভেনিস,	
alaol,	আলাউল,	আলাওল,	
carlo,	কারলো,	কার্লো,	
ghoorchen,	ঘররচেন,	ঘুরেছেন,	
darjiling,	ডার্জিলিং,	দার্জিলিং,	
gopalrao,	গোপালরাও,	গোপালরাও,	
jaaygata,	জয়গত,	জায়গাটা,	
sangasthagulo,	সংস্থাগুলো,	সংস্থাগুলো,	
jacksonke,	জ্যাকসনকে,	জ্যাকসনকে,	
protijogiitamulok,	প্রতিযোগিতামূলক,	প্রতিযোগীতামূলক,	
binee,	বিনে,	বেনি,	
jacksoner,	জ্যাকননের,	জ্যাকসনের,	
byaktigotovabeo,	ব্যক্তিগতভাবেও,	ব্যাক্তিগতভাবেও,	
songkolonti,	সংকোনটটি,	সংকলনটি,	
hitaishi,	হিতাশি,	হিতৈষী,	
aakik,	আকিক,	আকিক,	
jeshtha,	জেশথা,	জ্যেষ্ঠা,	
nothibhukteer,	নথিভূক্তির,	নথিভুক্তির,	
arifin,	আরিফিন,	আরিফিন,	
mentither,	মেনটিথের,	মেনটিথের,	
marmader,	মরমদের,	মারমাদের,	
milekhaanek,	মিলেখানেক,	মাইলখানেক,	
sanaktokaron,	সনাকতাকরণ,	সনাক্তকরণ,	
harishankar,	হরিশনকর,	হরিশংকর,	
phakay,	ফকয়ে,	ফাকে,	
aakkas,	আক্কাস,	আককাস,	
uddhritir,	উদ্ধৃতির,	উদ্ধৃতির,	
dharavahiker,	ধারাবাহীকের,	ধারাবাহিকের,	
machkabar,	মাচকাবার,	মাচকাবার,	
streegon,	স্ত্রীগণ,	স্ত্রীগণ,	
deebug,	দীবিগ,	ডিবাগ,	
madhabi,	মাধবি,	মাধবী,	
esoosiyetasa,	এসুইয়েসেস,	এসোসিয়েটস,	
gore,	গোরে,	গোর,	
paripakey,	পরিপাকে,	পরিপাকে,	
codeti,	কোডিটি,	কোডটি,	
abhiyojan,	অভিযোজন,	অভিযোজন,	
addhattikotar,	আদ্ধত্যিকতার,	আধ্যাত্মিকতার,	
daakteekite,	ডাকটিকিতে,	ডাকটিকিটে,	
taxikeo,	ট্যাক্সিকেও,	ট্যাক্সিকেও,	
meshenjar,	মেশেঞ্জার,	মেসেঞ্জার,	
chomski,	চমস্কি,	চমস্কি,	
moshjidke,	মসবিদকে,	মসজিদকে,	
laps,	ল্যাসস,	ল্যাপস,	
ekbakke,	একবাককে,	একবাক্যে,	
chaanoo,	চানু,	চানু,	
chalai,	চালাই,	চালাবে,	
dhanak,	ধনক,	ধানক,	
phutanta,	ফুটান্তা,	ফুটন্ত,	
zeebonto,	জীবন্ত,	জীবন্ত,	
suparichito,	সুপারিচিত,	সুপরিচিত,	
bhabarlaler,	ভবারলালের,	ভবরলালের,	
gabhaaskar,	গাভাসকার,	গাভাস্কার,	
byan,	ব্যান,	ব্যাং,	
parishram,	পরিশ্রম,	পরিশ্রম,	
pleena,	প্লিনা,	প্লেন,	
shrabostee,	শ্রাবস্তি,	শ্রাবস্তী,	
elakatike,	এলাকাটিকে,	এলাকাটিকে,	
krechi,	ক্রেছি,	করেছি,	
becha,	বেচ,	বেচা,	
parq,	পার্ক,	পার্ক,	
bishwaashshke,	বিশ্বসশ্কে,	বিশ্বাসকে,	
monroe,	মনরও,	মনেরোর,	
rajdhani,	রাজধানী,	রাজধানি,	
kampita,	কম্পিতা,	কম্পিত,	
shekarone,	শেকারণে,	সেকারণে,	
soorsa,	সোর্স,	সোর্স,	
akram,	আক্রম,	আকরাম,	
paste,	পাস্তে,	পেষ্ট,	
vesselli,	ভেসেলি,	ভেসেলি,	
uporitale,	উপরিতালে,	উপরিতলে,	
mayily,	মায়িলি,	মাইলি,	
bipti,	বিপ্তি,	বিপ্তি,	
kaale,	কালে,	কালে,	
gasthii,	গাস্থি,	গোষ্ঠীই,	
samratra,	সম্রাত্র,	সম্রাটরা,	
breq,	ব্রেক,	ব্রেক,	
turkeyder,	টার্কেদের,	তুর্কিদের,	
groundta,	গ্রুন্ডটা,	গ্রাউন্ডটা,	
beauby,	বিউবি,	বিউবি,	
bhimsenkei,	ভিমসনেকেই,	ভীমসেনকেই,	
hosbaleke,	হোসবালেকে,	হোসবালেকে,	
ujobekeestan,	উজয়বসেস্তান,	উজবেকিস্তান,	
reetesh,	রিতেশ,	রিতেশ,	
utsahi,	উৎসাহী,	উৎসাহী,	
trabuco,	ট্রাবুকো,	ট্র্যাবুকো,	
drissogoolote,	ড্রিসগুলোতে,	দৃশ্যগুলোতে,	
swostir,	স্বস্তির,	স্বস্তির,	
koro,	কোরো,	করো,	
jansa,	জানসা,	জন্স,	
furio,	ফুরিও,	ফুরিও,	
ateetkale,	আতিতকালে,	অতীতকালে,	
chrystal,	ক্রিস্টাল,	ক্রাইস্টাল,	
lisense,	লাইসেন্সে,	লাইসেন্স,	
bisheshshyo,	বিশেষশ্য,	বিশেষ্য,	
hafej,	হাফেজ,	হাফেয,	
temone,	তেমোন,	তেমনই,	
toptoshele,	তপ্তশশেলে,	তপ্তশেলে,	
teman,	টেমান,	তেমন,	
contemporary,	কন্টেমাররারি,	কন্টেম্পোরারি,	
diniphition,	ডিনিফিশন,	ডেফিনেশন,	
dalnata,	দালনাটা,	ডালনাটা,	
nirdesika,	নির্দেসিকা,	নির্দেশিকা,	
heavy,	হিভি,	হেভি,	
laaisheesh,	লাইশিশ,	লাইসেন্স,	
sambatsarkal,	সম্বলসক্কল,	সম্বৎসরকাল,	
sobrakomer,	সব্রাকমের,	সবরকমের,	
atmiyasulabh,	আত্মীয়সালভভ,	আত্মীয়সুলভ,	
baasaate,	বাসাতে,	বাসাতে,	
phartha,	ফার্থা,	ফার্থ,	
toler,	টোলের,	তালের,	
neshadrabyer,	নেশাদ্বার্যের,	নেশাদ্রব্যের,	
sohokari,	সহকারী,	সহকারী,	
amanisha,	আমানিশ,	অমানিশা,	
shchalastic,	শ্লাস্্টিক,	স্কলাস্টিক,	
dagmukta,	দাগমুক্ত,	দাগমুক্ত,	
samratder,	সামরতদের,	সম্রাটদের,	
kormokarke,	কর্মকরকে,	কর্মকারকে,	
fanse,	ফানসে,	ফাঁসে,	
konorup,	কোনরূপ,	কোনরূপ,	
bbosonto,	ব্বসন্ত,	বসন্ত,	
onucheeder,	অনুচিদের,	অনুচ্ছেদের,	
shikkhakram,	শিক্ষাক্রম,	শিক্ষাক্রম,	
bhumija,	ভূমিজা,	ভূমিজ,	
megacaldera,	মেগাকালাডেরা,	মেগাক্যাল্ডেরা,	
dabarer,	দাবারের,	দাবারের,	
jolaatonko,	জলাতনকক,	জলাতঙ্ক,	
bhyatikaner,	ভ্যাটিকানের,	ভ্যাটিকানের,	
totokhon,	তোটখোন,	ততক্ষন,	
ghatla,	ঘাটলা,	ঘটল,	
boshoborti,	বশোবর্তি,	বশবর্তী,	
pnouchute,	পৌঁচুুতে,	পৌঁছুতে,	
bihar,	বিহার,	বিহার,	
kiandi,	কিয়ান্দি,	ক্যান্ডি,	
mojdur,	মজদুর,	মজদুর,	
pooshti,	পুষটি,	পুষ্টি,	
jandrel,	জ্যান্ডরেল,	জাঁদরেল,	
chotogolper,	চটগল্পের,	ছোটগল্পের,	
chilona,	চিলোনা,	ছিলনা,	
elakatikay,	এলাকাটিকায়,	এলাকাটিকে,	
meghacchonno,	মেঘাচ্ছন্ন,	মেঘাচ্ছন্ন,	
nutaner,	নুতানের,	নূতনের,	
expreshshion,	এক্সপ্রেশনশ,	এক্সপ্রেশন,	
chapal,	চাপাল,	চপল,	
