cholochchitrai,	চলচ্চিত্রায়,	চলচ্চিত্রই,	
timathi,	তিমথী,	টিমোথি,	
poorohitder,	পুরহীতদের,	পুরোহিতদের,	
oyebjin,	ওয়েবজীন,	ওয়েবজিন,	
bsnleu,	বিএসএনএলইউ,	বিএসএনএলইইউ,	
antarbhutto,	অন্তর্ভূত্ত,	অন্তর্ভুক্ত,	
shootar,	শূতার,	শ্যুটার,	
roopdaan,	রূপদান,	রুপদান,	
ap,	এপ,	আপ,	
oiteejye,	ঐতিয্যে,	ঐতিহ্যে,	
pratiyogita,	প্রতিযোগিতা,	প্রতিযোগীতা,	
brittakar,	বৃত্তকার,	বৃত্তাকার,	
protinito,	প্রতিনিত,	প্রতিনিত,	
naubom,	নবম,	নবম,	
omanisa,	ওমানিসা,	অমানিশা,	
spenser,	স্পেন্সের,	স্পেন্সার,	
ostad,	ওস্তাদ,	ওস্তাদ,	
dighol,	দিঘল,	দীঘল,	
husni,	হুসনি,	হুসনি,	
hariken,	হারিকেন,	হ্যারিকেন,	
ritesh,	রিটেস,	রিতেশ,	
ashonkai,	অশঙ্কাই,	আশঙ্কাই,	
carzar,	ক্যারজার,	চার্জার,	
ajij,	অ্জিজ,	আজিজ,	
nutan,	নুতান,	নূতন,	
monroe,	মনর্,	মনেরোর,	
shipley,	শিপলে,	শিপলে,	
chhooteer,	ছোটির,	ছুটির,	
armshtrong,	আর্মস্ট্রো,	আর্মস্ট্রং,	
totokson,	টটকসন,	ততক্ষন,	
gaichey,	গাইছে,	গাইছে,	
dishani,	দিশানী,	দিশানি,	
thailandsaho,	থাইলান্দসহ,	থাইল্যান্ডসহ,	
uporitoler,	উপরিতলের,	উপরিতলের,	
ujobekeestaner,	উজোবিকেষ্টানের,	উজবেকিস্তানের,	
nikela,	নিকেলা,	নিকেল,	
talgach,	তালগাছ,	তালগাছ,	
camerapersoner,	ক্যামেরাপারসনের,	ক্যামেরাপার্সনের,	
transformaarer,	ট্রান্সফররামের,	ট্রান্সফরমারের,	
deefinition,	ডিফিনিশন,	ডেফিনেশন,	
vobobibhuti,	বববিভূতি,	ভববিভূতি,	
parkasa,	পারকাসা,	পার্কস,	
amanisa,	আমানিসা,	অমানিশা,	
literacy,	লিটারেসি,	লিটারেসি,	
farhetin,	ফারহেতিন,	ফারহেতিন,	
pravritir,	প্রাৃতির,	প্রভৃতির,	
damodar,	দামোদার,	দামদর,	
thaii,	থাই,	থাই,	
andon,	অ্যান্ডন,	আন্দোন,	
baet,	বেইট,	বাইট,	
societytey,	সসিটেটি,	সোসাইটিতে,	
haitasha,	হাইতাশ,	হাইটস,	
ekjoge,	একযোগে,	একযোগে,	
byaptikaler,	ব্যা্তিকালের,	ব্যাপ্তিকালের,	
swostir,	স্বস্তির,	স্বস্তির,	
batom,	ব্টোম,	বাটম,	
aakkas,	আক্কাস,	আককাস,	
oitijjha,	ঐতিহ্য,	ঐতিহ্য,	
heena,	হেন,	হেনা,	
hetimganje,	হেটিমগঞ্জে,	হেতিমগঞ্জে,	
doorotomo,	দূরতম,	দূরতম,	
dhyanastha,	ধ্যানস্থ,	ধ্যানস্থ,	
jokkher,	যক্ষের,	যক্ষের,	
seeramiks,	সিরামিক্স,	সিরামিকস,	
bishwaashshoi,	বিশ্বাশই,	বিশ্বাসই,	
romarder,	রোমারদের,	রোমারদের,	
punosthaner,	পুনস্থানের,	পুনঃস্থানের,	
jumlalancer,	জুমলালান্সের,	জুমলাল্যান্সার,	
niurolaji,	নিউরলাজি,	নিউরোলজি,	
bulano,	বুলানো,	বুলান,	
gonohotyakey,	গণহত্যাকে,	গণহত্যাকে,	
kinto,	কিন্তো,	কিনত,	
afzol,	আফজল,	আফজল,	
shkalarashhipa,	স্কলরশশিপ,	স্কলারশিপ,	
khaschandpur,	খাসচন্দপুর,	খাসচাঁদপুর,	
difinisian,	ডিফিনাইজান,	ডেফিনেশন,	
spreadshiit,	স্প্রেডিভিট,	স্প্রেডশীট,	
senabahineekey,	সেনাবাহিনীকে,	সেনাবাহিনীকে,	
asovya,	আসোভ্য,	অসভ্য,	
sahojatprobritti,	সহজতপ্রবৃত্তি,	সহজাতপ্রবৃত্তি,	
sumitrar,	সুমিত্রার,	সুমিত্রার,	
directorete,	ডাইরেক্টরে,	ডিরেক্টরেট,	
maailkhanek,	মাইলখানেক,	মাইলখানেক,	
mataram,	মাতারাম,	মাতরম,	
ramachandranke,	রামাচন্দ্রনকে,	রামাচন্দ্রনকে,	
probhura,	প্রভুরা,	প্রভুরা,	
sazanor,	সাজানোর,	সাজানোর,	
vagini,	ভাগিনী,	ভগিনী,	
ovidhaner,	অভিধানের,	অভিধানের,	
bojhe,	বঝে,	বোঝে,	
somoodrotote,	সমৌদ্রততে,	সমুদ্রতটে,	
monjurul,	মঞ্জুরুল,	মনজুরুল,	
shringgo,	শ্রিংগো,	শৃঙ্গ,	
chaanoo,	চানু,	চানু,	
nazranar,	নাজরানার,	নাজরানার,	
batsmanei,	ব্যাটসমেনেই,	ব্যাটসম্যানই,	
besur,	বেসুর,	বেসুর,	
seo,	সাইও,	সেও,	
chhintayikari,	ছিন্তায়কারী,	ছিনতাইকারী,	
karir,	কারির,	কারীর,	
dharmiyabhabei,	ধর্মিয়ভাবেই,	ধর্মীয়ভাবেই,	
vobanipur,	ভবানীপুর,	ভবানীপুর,	
shasankarta,	শশনকর্তা,	শাসনকর্তা,	
sthapanar,	স্থাপনার,	স্থাপনার,	
aashtikotaa,	অষ্টিকতা,	আস্তিকতা,	
taufiq,	তৌফিক,	তৌফিক,	
andamana,	আন্দমানা,	আন্দামান,	
obosorer,	অবসরের,	অবসরের,	
udbodhaney,	উদ্বোধনে,	উদ্বোধনে,	
chaka,	চাকা,	চাকা,	
durgotsab,	দুর্গতৎবা,	দুর্গোৎসব,	
asamonjasyopurno,	অসামঞ্জনাস্পূর্ণ,	অসামঞ্জস্যপূর্ণ,	
elakai,	এলাকাই,	এলাকাই,	
mukhobondho,	মুখবদ্ধ,	মুখবন্ধ,	
lyataa,	ল্যাটা,	ল্যাটা,	
vittio,	ভিত্তিও,	ভিত্তিও,	
poripake,	পরিপাকে,	পরিপাকে,	
grambasheeo,	গ্রামবাশিও,	গ্রামবাসীও,	
cena,	সেনা,	সিনা,	
amorendro,	অমরেন্দ্র,	অমরেন্দ্র,	
shudhui,	শুধুই,	শুধুই,	
dekaner,	দেকানের,	দেকানের,	
sikara,	সিকারা,	শিকার,	
jatata,	জাতাটা,	যতোটা,	
ekoirokom,	একররকম,	একইরকম,	
bhimsen,	ভীমসেন,	ভীমসেন,	
zesa,	জেসা,	জেস,	
dhwajbhango,	ধ্বাধবঙ্গ,	ধ্বজভঙ্গ,	
shahjapur,	শাহজাপুর,	শাহজাপুর,	
trenda,	ট্রেন্ডা,	ট্রেন্ড,	
pray,	প্রই,	প্রায়,	
nodimaatrik,	নদীমাত্রীক,	নদীমাতৃক,	
kolkarkhana,	কলকর্খানা,	কলকারখানা,	
korkotkraantee,	কর্কটকরান্তি,	কর্কটক্রান্তি,	
angkita,	অংকিটা,	অঙ্কিতা,	
pohnpeic,	পন্পেক,	ফোনপেইক,	
kanthar,	কান্থার,	কাঁথার,	
dagmukta,	দাগমুক্ত,	দাগমুক্ত,	
folleni,	ফলেনি,	ফলেনি,	
hattey,	হাত্তে,	হাঁটতে,	
shamuker,	শামুকের,	শামুকের,	
indrani,	ইন্দ্রনী,	ইন্দ্রাণী,	
bo,	পো,	বু,	
wishnu,	উইনশু,	বিষ্ণু,	
lobbytey,	লবি্ে,	লবিতে,	
bhenise,	ভেনিসে,	ভেনিসে,	
bhaisaho,	ভাইসহ,	ভাইসহ,	
biswashi,	বিশ্বশি,	বিশ্বাসী,	
alsaar,	আলসার,	আলসার,	
sookkho,	সুখ্ষ,	সুক্ষ্ম,	
stoonahenja,	স্তনহেন্জন,	স্টোনহেঞ্জ,	
kurdider,	কুর্দীদের,	কুর্দিদের,	
peri,	পারি,	পেরি,	
russad,	রুশদাদ,	রুশদ,	
kutubuddinke,	কুতুবুদ্দিনকে,	কুতুবুদ্দিনকে,	
manober,	মানবের,	মানবের,	
erajyobasi,	এরাজ্যবাসী,	এরাজ্যবাসী,	
sanghar,	সংঘর,	সংহার,	
sedikei,	সেদিকেই,	সেদিকেই,	
muchi,	মুচি,	মুচি,	
dharabahikvabe,	ধারাবাহিকভাবে,	ধারাবাহিকভাবে,	
miley,	মিলে,	মিলে,	
bangobandhu,	বঙ্গবন্ধুই,	বঙ্গবন্ধু,	
humner,	হামনার,	হামনার,	
volapuk,	ভোলাপুক,	ভোলাপুক,	
porbotmala,	পর্বতমালা,	পর্বতমালা,	
zerusaleme,	জেরুসালেমে,	জেরুসালেমে,	
forex,	ফোরেক্স,	ফরেক্স,	
nirmalata,	নির্মলতা,	নির্মলতা,	
purborekorde,	পূর্বরকর্ডে,	পূর্বরেকর্ডে,	
bhromoner,	ভ্রমণের,	ভ্রমণের,	
masto,	মাস্তো,	মাস্ত,	
porirshoder,	পরির্শদের,	পরির্ষদের,	
edmeeral,	এদমিরাল,	এডমিরাল,	
kortona,	কর্তনা,	করতনা,	
chokrantosoho,	চক্রান্তসহ,	চক্রান্তসহ,	
abdoone,	আব্দৌনে,	আবদুন,	
aarmstrong,	আর্মস্ট্রং,	আর্মস্ট্রং,	
ase,	এোএস,	আসে,	
megacaldera,	মেগাক্লাডেরা,	মেগাক্যাল্ডেরা,	
pronoti,	প্রণতি,	প্রণতি,	
popke,	পোপকে,	পোপকে,	
cs,	সিএস,	সিএস,	
ruble,	রুবল,	রুবল,	
ramolino,	রামোলনো,	রামোলিনো,	
everestey,	ইভারেস্টে,	এভারেস্টে,	
madeling,	মাদেলিং,	মডেলিং,	
maryir,	মারির,	ম্যারির,	
tennis,	টেনিস,	টেনিস,	
elaakaa,	এলাকা,	এলাকা,	
damakalkarmirao,	দমকলকর্মীরাও,	দমকলকর্মীরাও,	
purohitder,	পুরোহিতদের,	পুরোহিতদের,	
saraiki,	সারাইকি,	সরাইকি,	
oblivion,	অবলিভন,	অবলিভিয়ন,	
deputee,	দিপুটি,	ডেপুটি,	
neermol,	নির্মল,	নির্মল,	
shilver,	শিলভের,	সিলভার,	
chintakarma,	চিন্তাকর্ম,	চিন্তাকর্ম,	
atwobishvashi,	অত্ববিশবাসী,	আত্মবিশ্বাসী,	
enginiiring,	ইঞ্জিনিয়ারিং,	ইঞ্জিনিয়ারিং,	
tapdei,	টাপদেই,	তাপড়েই,	
danaqana,	দননান,	ডানকান,	
jonesh,	জনেষ,	জোন্স,	
dakticket,	ড্যাকটিকেট,	ডাকটিকিট,	
rayyalati,	রায়য়লতি,	রয়্যালটি,	
gejetade,	জেজেটাদে,	গেজেটেড,	
bisshas,	বিশ্বাস,	বিশ্বাস,	
kuresher,	কুরেশের,	কুরেশের,	
gobeshakgon,	গবেষকগণ,	গবেষকগণ,	
abdi,	আবদি,	অব্দি,	
hajirhat,	হাজিরহাট,	হাজিরহাট,	
sepha,	সেপা,	শেফ,	
ooporoshtho,	অররস্থ,	উপরস্থ,	
soomita,	সূমিতা,	সুমিতা,	
ekghore,	একঘরে,	একঘরে,	
torabgonj,	তরাবগঞ্জ,	তোরাবগঞ্জ,	
neck,	নেক,	নেক,	
nyeta,	ন্যেট,	ম্যাট,	
toufik,	তৌফিক,	তৌফিক,	
jontrototto,	যন্ত্রতত্ত্ব,	যন্ত্রতত্ত্ব,	
sarollo,	সরোল্লো,	সারল্য,	
hazat,	হাজাত,	হজত,	
torkareer,	তর্ারীর,	তরকারীর,	
sangbadmadhyome,	সংবাদমাধ্যমে,	সংবাদমাধ্যমে,	
muhaiminer,	মুহাইমিনের,	মুহাইমিনের,	
gotihin,	গতিহীন,	গতিহীন,	
harasta,	হারাস্তা,	হারাস্তা,	
grambaasi,	গ্রামবাসী,	গ্রামবাসী,	
lagchhe,	লাগছে,	লাগছে,	
maail,	মাইল,	মাইল,	
engreziteo,	এংরেজিতেও,	ইংরেজিতেও,	
tikta,	তিকটা,	তিক্ত,	
nirmolota,	নির্মলতা,	নির্মলতা,	
satjaner,	সাতজনের,	সাতজনের,	
yura,	য়ুরা,	ইউরো,	
sures,	সারেস,	সুরেশ,	
dharabahiktite,	ধারাবাহিকটিতে,	ধারাবাহিকটিতে,	
platform,	প্ল্যাটফর্ম,	প্লাটফর্ম,	
ray,	রায়,	রায়,	
bornanukrome,	বর্ণানুক্রমে,	বর্নানুক্রমে,	
podarthobidder,	পদার্থবিদদের,	পদার্থবিদদের,	
bibhinno,	বিভীন্ন,	বিভন্ন,	
balakarak,	বালাকারক,	বলকারক,	
nakkal,	নাক্কাল,	নক্কল,	
samashtike,	সমস্তিকে,	সমষ্টিকে,	
michhilti,	মিছিলটি,	মিছিলটি,	
akeeb,	আকিব,	আকিব,	
madraser,	মাদ্রাসের,	মাদ্রাজের,	
delibhara,	ডেলিভারা,	ডেলিভার,	
konruup,	কনরুলপ,	কোনরূপ,	
naabyota,	নাব্যতা,	নাব্যতা,	
olympicer,	অলিম্পিকের,	অলিম্পিকের,	
dipankar,	দিপানকার,	দিপঙ্কর,	
janamukhi,	জনমুখী,	জনমুখী,	
byaboharkarie,	ব্যবহারকারী,	ব্যবহারকারীই,	
jamaanor,	জামানোর,	জমানোর,	
deefinishion,	ডিফিশন,	ডেফিনেশন,	
municipal,	মুনিসিপাল,	মিউনিসিপ্যাল,	
harris,	হারিস,	হ্যারিস,	
sangaskritipreme,	সংস্কৃতিপ্রেমে,	সংস্কৃতিপ্রেমে,	
sanghatakder,	সংঘতকদের,	সংঘটকদের,	
bosontokke,	বসন্তকে,	বসন্তকে,	
shahidputra,	শহিদপুত্র,	শহীদপুত্র,	
tochhnochh,	তচ্ছছ,	তছনছ,	
pisach,	পিসাচ,	পিশাচ,	
esprito,	এসপ্রিত,	এস্পিরিটো,	
kuldip,	কুলদিপ,	কুলদীপ,	
cathalic,	ক্যাথালিক,	ক্যাথলিক,	
metropolitan,	মেট্রোপোলিটন,	মেট্রোপলিটন,	
masjidsaha,	মসজিদসহ,	মসজিদসহ,	
chakundite,	চাকুন্দিতে,	চাকুন্দিতে,	
joki,	জকই,	জকি,	
uindoos,	উইনওডুস,	উইন্ডোস,	
mumtaj,	মুমতাজ,	মুমতাজ,	
tantubayer,	তন্তুবায়ের,	তন্তুবায়ের,	
mekapgulo,	মেকাপগুলো,	মেকআপগুলো,	
hights,	হাইটস,	হাইটস,	
madhobi,	মাধবী,	মাধবী,	
sthapanagulor,	স্থাপনাগুলোর,	স্থাপনাগুলোর,	
kodorer,	কদরের,	কদরের,	
bijito,	বিজিত,	বিজিত,	
pakistanira,	পাকিস্তানিরা,	পাকিস্তানীরা,	
bohorompurer,	বহরম্পুরের,	বহরমপুরের,	
mishal,	মিশাল,	মিশাল,	
bishesyo,	বিশেষ্য,	বিশেষ্য,	
morodeho,	মরদেহ,	মরদেহ,	
krush,	কুরুশ,	ক্রুশ,	
cholochchitro,	চলচ্চিত্র,	চলচ্চিত্র,	
karu,	কারু,	কারু,	
chowdhurir,	চৌধধুরির,	চৌধুরীর,	
bishwaashshke,	বিশ্বাসশকে,	বিশ্বাসকে,	
mayily,	মেয়ালি,	মাইলি,	
hondooras,	হন্ডৌরাস,	হন্ডুরাস,	
nek,	নেক,	নেক,	
hertj,	হের্ক,	হার্জ,	
pratisthanikvabe,	প্রতিস্থানিকভাবে,	প্রাতিষ্ঠানিকভাবে,	
abhijitda,	অভিজিতদা,	অভিজিতদা,	
somraat,	সম্রাত,	সম্রাট,	
korijachilen,	করিযালিলেন,	করিযাছিলেন,	
drissogoolote,	দৃষ্ণগুলোতে,	দৃশ্যগুলোতে,	
yathaarthabhaabe,	যথার্থভাবে,	যথার্থভাবে,	
graambasider,	গ্রামবাসীদের,	গ্রামবাসীদের,	
welaqama,	ওয়েকামা,	ওয়েলকাম,	
tongaa,	টোঙ্গা,	টোঙ্গা,	
birmuktijoddhagan,	বীর্মুক্তিদু্ধযগন,	বীরমুক্তিযোদ্ধাগণ,	
krishibigyani,	কৃষিবিজ্ঞানি,	কৃষিবিজ্ঞানী,	
kkhur,	খ্ষুর,	ক্ষুর,	
parq,	পার্ক,	পার্ক,	
obdi,	অবদি,	অব্দি,	
megh,	মেঘ,	মেঘ,	
qraima,	ক্রেমা,	ক্রাইম,	
vaider,	ভাইদের,	ভাইদের,	
gannaprakasham,	গন্নাপ্রকাষ,	গন্নাপ্রকাশম,	
choudhursoho,	চৌধুরসহ,	চৌধুরসহ,	
panchashjon,	পঞ্চাশজন,	পঞ্চাশজন,	
pulivendla,	পুলিভেন্ডলা,	পুলিভেন্ডলা,	
juboke,	যুবকে,	যুবকে,	
backflipe,	ব্যাকফ্লাপে,	ব্যাকফ্লিপে,	
turbiner,	টারবিনের,	টারবাইনের,	
prashikkhane,	প্রশিক্ষণে,	প্রশিক্ষণে,	
sponsorshipe,	স্পন্সরশীপে,	স্পন্সরশীপে,	
kaalki,	কালকি,	কালকি,	
biprodas,	বিপ্রদাস,	বিপ্রদাস,	
turkamena,	তুরককেনা,	তুর্কমেন,	
nirbahi,	নির্বাহি,	নির্বাহি,	
metropalitana,	মেট্রোপ্লেটন,	মেট্রোপলিটন,	
norpholk,	নরফোলক,	নরফোক,	
itastata,	ইতস্ততা,	ইতস্তত,	
karlei,	কারলেই,	করলেই,	
chopol,	চোপল,	চপল,	
jonosomaj,	জনসমাজ,	জনসমাজ,	
mitrata,	মিত্রটা,	মিত্রতা,	
boikolyo,	বৈকল্য,	বৈকল্য,	
proteemar,	প্রতিমার,	প্রতিমার,	
khudhartara,	ক্ষুধার্তর,	ক্ষুধার্তরা,	
chopal,	চোপাল,	চপল,	
huk,	হুক,	হুক,	
juboksoho,	যুবকসহ,	যুবকসহ,	
remakri,	রেমাক্রি,	রেমাক্রী,	
esoosiyetasa,	এসোটিয়েস,	এসোসিয়েটস,	
bhikkharthe,	ভিক্ষার্থে,	ভিক্ষার্থে,	
nederlande,	নেডারল্যান্ডে,	নেদারল্যান্ডে,	
kadapaker,	কাড়াপাকের,	কড়াপাকের,	
karmasampadon,	কর্মসম্পাদন,	কর্মসম্পাদন,	
shloker,	শ্লোকের,	শ্লোকের,	
kul,	কুল,	কুল,	
koordira,	কোর্ডিরা,	কুর্দিরা,	
shikkharthirao,	শিক্ষার্থীরাও,	শিক্ষার্থীরাও,	
breqathru,	ব্রেকথাররু,	ব্রেকথ্রু,	
selim,	সেলিম,	সেলিম,	
dharabahikotitey,	ধারাবাহিকতিতে,	ধারাবাহিকটিতে,	
moushum,	মৌুচুম,	মৌসুম,	
templet,	টেম্পলেট,	টেম্পলেট,	
larson,	লার্সন,	লারসন,	
sahab,	সাহাব,	সাহাব,	
parking,	পারকিং,	পার্কিং,	
tanshree,	তানশ্রী,	তানশ্রী,	
jothartho,	যথার্থ,	যথার্থ,	
prabhritite,	প্রভৃতিতে,	প্রভৃতিতে,	
rezidence,	রেজিডেন্স,	রেসিডেন্স,	
grambaashio,	গ্রামবাশীও,	গ্রামবাসীও,	
tinhazar,	তিনহাজার,	তিনহাজার,	
sobchey,	সবচে,	সবচে,	
langhoner,	লঙ্ঘনের,	লংঘনের,	
siitei,	সিতেই,	শীতেই,	
nirmankarmisaha,	নির্মানকররীসহ,	নির্মাণকর্মীসহ,	
bayshorkarikarone,	বাইশররকরিকরণে,	বেসরকারিকরণ,	
hughkey,	হুগকে,	হিউজকে,	
durgatsober,	দুর্গাৎসবের,	দুর্গোৎসবে,	
elaakati,	এলাকাটি,	এলাকাটি,	
chandrima,	চাঁদ্রীমা,	চন্দ্রিমা,	
prasadhoni,	প্রসাধনী,	প্রসাধনী,	
nobotomo,	নবতম,	নবতম,	
deqe,	ডেকে,	ডেকে,	
hajeerhatt,	হাজেহাত্ত,	হাজিরহাট,	
shuri,	শুরী,	সুরি,	
jontrangshogulor,	যন্ত্রাঙ্গগুলোর,	যন্ত্রাংশগুলোর,	
nischitobhave,	নিশ্চিতভাবে,	নিশ্চিতভাবে,	
aziboner,	আজিবনের,	আজীবনের,	
shikhra,	শিখরা,	শিখরা,	
liaodong,	লিয়াওডং,	লিয়াওদং,	
rayyaleti,	রায়য়লেটি,	রয়্যালটি,	
aieesha,	আইশস,	আইএএস,	
laishensh,	লেইশেনস,	লাইসেন্স,	
dhila,	ধীলা,	ঢিলা,	
engrezder,	এংগ্রেজদের,	ইংরেজদের,	
madhumati,	মধুমতি,	মধুমতী,	
jaruri,	জারুরী,	জরূরী,	
xpose,	কেসিপোএস,	এক্সপোজ,	
besooro,	বেসরও,	বেসুর,	
subader,	সুবাদের,	সুবাদে,	
inphormeshon,	ইনফর্মেশন,	ইনফরমেশন,	
bhenasha,	ভেনাশ,	ভেনাস,	
streegon,	স্ত্রীগণ,	স্ত্রীগণ,	
saras,	সারাস,	সরস,	
gloria,	গ্লোরিয়া,	গ্লোরিয়া,	
kathmandu,	কাঠমণ্ডু,	কাঠমান্ডু,	
addabaj,	আড্ডাবাজ,	আড্ডাবাজ,	
saranor,	সারানোর,	সরানোর,	
shtonehenge,	স্টোনহেন্জে,	স্টোনহেঞ্জ,	
shilbar,	শিলবার,	সিলভার,	
shangkalonti,	সংকলনটি,	সংকলনটি,	
zozyota,	যোজ্যতা,	যোজ্যতা,	
nothibhukto,	নথিভুক্ত,	নথিভুক্ত,	
nothivuktir,	নথিভুক্তির,	নথিভুক্তির,	
skolastik,	স্কোলাস্টিক,	স্কলাস্টিক,	
sollallhu,	সোল্লাল্ঘু,	সল্লাল্লাহু,	
kanasarabheeshana,	কননার্ভেশন,	কনসারভেশন,	
onker,	অঙ্কের,	ওঙ্কার,	
manabmaner,	মানবমনের,	মানবমনের,	
aamontrito,	আমন্ত্রিত,	আমন্ত্রিত,	
elakatikay,	এলাকাটিকায়,	এলাকাটিকে,	
phormat,	ফররমেট,	ফরম্যাট,	
unitgulo,	ইউনিটগুলো,	ইউনিটগুলো,	
glanio,	গ্লানিও,	গ্লানিও,	
bosoben,	বসবেন,	বসবেন,	
ganoporibahon,	গণপরিবহণ,	গণপরিবহন,	
nirikh,	নিরিখ,	নিরিখ,	
akkharkey,	অক্ষরকে,	অক্ষরকে,	
janoganonar,	জনগণনার,	জনগণনার,	
ardasho,	আর্দাশো,	আর্দশ,	
gurmukh,	গুরমুখ,	গুরমুখ,	
chhadite,	ছাদিতে,	ছড়িতে,	
bojhaao,	বোঝাও,	বোঝাও,	
madhoboir,	মাধবইর,	মাধবীর,	
manushgulor,	মানুষগুলোর,	মানুষগুলোর,	
zerusalem,	জেরুসালেম,	জেরুসালেম,	
shtona,	স্তোনা,	স্টোন,	
deeares,	দ্য়ারেস,	ডিআরএস,	
hozot,	হজত,	হজত,	
panchasjan,	পঞ্চসজন,	পঞ্চাশজন,	
cloudbook,	ক্লাউববুক,	ক্লাউডবুক,	
alpa,	আলপা,	অল্প,	
bapio,	বাপিও,	বাপিও,	
chadake,	চাদাকে,	চড়াকে,	
palbongser,	প্যালবংসের,	পালবংশের,	
neker,	নেকের,	নেকের,	
notti,	নটটি,	নোটটি,	
gate,	গাতে,	গ্যেটে,	
militarite,	মিলিতারিতে,	মিলিটারিতে,	
spredshiit,	স্প্রেবিথিট,	স্প্রেডশীট,	
nirikhe,	নিরিখে,	নিরিখ,	
railliner,	রেলিনের,	রেললাইনের,	
jolrong,	জলরং,	জলরঙ,	
dhanijomite,	ধনিযমতিতে,	ধানিজমিতে,	
magrey,	ম্যাগ্রে,	ম্যাগ্রে,	
obhaarbhiu,	ওভারভিউ,	ওভারভিউ,	
torunderke,	তরুণদেরকে,	তরুণদেরকে,	
kayech,	কায়েছ,	কায়েছ,	
jotota,	যতোতা,	যতোটা,	
dibet,	দিবেত,	ডিবেট,	
pnouchute,	প্রযুতে,	পৌঁছুতে,	
charger,	চার্জের,	চার্জার,	
poscater,	পোস্কেটের,	পশ্চাতের,	
mahafezkhanar,	মহাফেজনানার,	মহাফেজখানার,	
oedipus,	ওদিপাস,	ইডিপাস,	
carlosh,	কার্লোশ,	কার্লোস,	
tyap,	ট্যাপ,	ট্যাপ,	
planea,	প্ল্যান,	প্লেনে,	
baugey,	বাউগে,	বাগে,	
bharotiyotar,	ভারতীয়তার,	ভারতীয়তার,	
chilahatee,	চিলাহাটি,	চিলাহাটি,	
plaiin,	প্লেইন,	প্লেন,	
markeetim,	মার্কিটিম,	মার্কেটিং,	
bishhnu,	বিষ্ণু,	বিষ্ণু,	
rahi,	রাহি,	রাহী,	
batikromshalee,	বাতিক্রমশশীল,	ব্যতিক্রমধর্মী,	
hugeke,	হুগেকে,	হিউজকে,	
subade,	সুবাদে,	সুবাদে,	
kanader,	কানাদের,	কণাদের,	
porjotoker,	পর্যটকের,	পর্যটকের,	
godabari,	গোদাবারী,	গোদাবরী,	
mardud,	মার্দুদ,	মরদুদ,	
vushi,	ভুশি,	ভুষি,	
chiroharit,	চিরোহারিত,	চিরহরিৎ,	
dharmantor,	ধর্মান্তর,	ধর্মান্তর,	
omkar,	ওমকার,	ওঙ্কার,	
mimgulor,	মিমগুলোর,	মিমগুলোর,	
vool,	ভুল,	উল,	
gronthao,	গ্রন্থাও,	গ্রন্থও,	
nagorikderkey,	নাগরিকদেরকে,	নাগরিকদেরকে,	
myari,	ম্যারি,	ম্যারি,	
armeenian,	আর্মিনিয়ান,	আর্মেনিয়ান,	
patigoniter,	পাটিগণীতের,	পাটিগণিতের,	
chalochchitrogulor,	চালচ্ছিত্রগুলোর,	চলচ্চিত্রগুলোর,	
jamjomat,	জমজমতম,	জমজমাট,	
pachattar,	পাচাত্তর,	পাচাত্তার,	
minishtarer,	মিনিশতারের,	মিনিস্টারের,	
soori,	ওুরি,	সুরি,	
tennys,	টেনিস,	টেনিস,	
raunanganey,	রওনঙ্গনে,	রণাঙ্গনে,	
tanu,	টানু,	তনু,	
aosafur,	আওসাফুর,	আওশাফুর,	
rockibul,	রোকিবুল,	রকিবুল,	
dakshinangsho,	দক্ষিণাংশ,	দক্ষিণাংশ,	
konorup,	কোনোরূপ,	কোনরূপ,	
siropa,	সিরোপা,	শিরোপা,	
fastara,	ফাস্তার,	ফস্টার,	
sima,	সিম,	সীমা,	
balabhadra,	বলভা্র,	বলভদ্র,	
juktarashtrasaha,	যুক্তরর্ত্রসহ,	যুক্তরাষ্ট্রসহ,	
bangalore,	বাঙ্গালোরে,	ব্যাঙ্গালুরে,	
brixfield,	ব্রিক্সফিল্ড,	ব্রিক্সফিল্ড,	
charban,	চারবান,	চর্বন,	
hul,	হোল,	হুল,	
bhabotarini,	ভবতারিণী,	ভবতারিণী,	
paramartha,	পরমার্থ,	পরমার্থ,	
barbadoj,	বারবাদজ,	বার্বাডোজ,	
sanaktokaron,	সনসক্তকরণ,	সনাক্তকরণ,	
noditei,	নদীতেই,	নদীতেই,	
stona,	স্তোনা,	স্টোন,	
nirgaman,	নির্গমন,	নির্গমন,	
artherer,	আর্থারের,	আর্থারের,	
songkolonti,	সংকলনটি,	সংকলনটি,	
chandanara,	চন্দনারা,	চন্দনারা,	
fanding,	ফ্যান্ডিং,	ফান্ডিং,	
kajangale,	কাজাঙ্গলে,	কজঙ্গলে,	
donat,	দোনাত,	ডোনাট,	
onurbar,	অনুরবার,	অনুর্বর,	
teenej,	তেনেজ,	টিনেজ,	
kaatbey,	কাটবে,	কাটবে,	
sanstha,	সংস্থা,	সংস্থা,	
vange,	ভ্যাঙ্গে,	ভাঙ্গে,	
biphal,	বিফাল,	বিফল,	
asaciates,	অ্যাস্যালিটিস,	এসোসিয়েটস,	
rinobodh,	ঋণবোধ,	ঋণবোধ,	
byabaharkariderke,	ব্যবহারকারীদেরকে,	ব্যবহারকারীদেরকে,	
title,	টিতল,	টাইটেল,	
wictor,	উইকটর,	ভিক্টর,	
prijon,	প্রিজন,	প্রিজন,	
avisongson,	অভিসংসন,	অভিশংসন,	
catholicbad,	ক্যাথলিকবাদ,	ক্যাথলিকবাদ,	
peshto,	পেষ্ট,	পেষ্ট,	
raiialati,	রাইয়ালাটি,	রয়্যালটি,	
shaddhi,	শাদ্ধী,	সাধ্বী,	
bairey,	বেয়েরে,	বাইরে,	
chalachchitroi,	চলচ্চিত্রই,	চলচ্চিত্রই,	
dadar,	দাদার,	দাদার,	
sthaponagulo,	স্থাপনাগুলো,	স্থাপনাগুলো,	
aaps,	এপিএস,	এএপিএস,	
yucalyptus,	যুকালপিটাস,	ইউক্যালিপ্টাস,	
aatto,	আ্যাটো,	আত্ম,	
becha,	বেচা,	বেচা,	
rashedul,	রাশেদুল,	রাশিদুল,	
deebug,	দীবুগ,	ডিবাগ,	
surakarder,	সুরকরদের,	সুরকারদের,	
rajnoitik,	রাজনৈতিক,	রাজনৈতীক,	
baipass,	বাইপাস,	বাইপাস,	
mutar,	মুতার,	মুতার,	
mookhomandoler,	মোখমন্দলের,	মুখমণ্ডলের,	
choudry,	চৌদ্রী,	চৌধুরী,	
neemeette,	নিমেত্তে,	নিমিত্তে,	
ancholtike,	অঞ্চলটিকে,	অঞ্চলটিকে,	
utkhaat,	উৎখাত,	উত্খাত,	
firoza,	ফিরোজা,	ফিরোজা,	
dadapur,	দাদাপুর,	দাদাপুর,	
chemjong,	চেমজং,	চেমজং,	
indra,	ইন্দ্র,	ইন্দ্র,	
kaande,	কান্ডে,	কাণ্ডে,	
senabahinio,	সেনাবাহিনীও,	সেনাবাহিনীও,	
sakshatkarer,	সাক্ষাতকারের,	সাক্ষাৎকারের,	
deepan,	দীপান,	দীপন,	
talaal,	তালাল,	তালাল,	
taposgoner,	তাপসগণের,	তাপসগণের,	
aswasteekor,	অস্বাস্তিকর,	অস্বস্তিকর,	
heart,	হোর্ট,	হার্ট,	
jerushalema,	জেরুশালেমা,	জেরুসালেম,	
phareeksa,	ফরেকস,	ফরেক্স,	
eevil,	ইভিল,	ইভিল,	
nepchooner,	নেপচৌনের,	নেপচুনের,	
ayumi,	আয়ুমি,	আয়ুমি,	
shasheja,	শাসেজা,	সসেজ,	
ddheela,	ঢিলা,	ঢিলা,	
hafej,	হাফেজ,	হাফেয,	
ekatto,	একাত্ত,	একাত্ব,	
tonoo,	টনউ,	তনু,	
nikote,	নিকোতে,	নিকটে,	
bbiseshyer,	ব্বিবেষ্যের,	বিশেষ্যের,	
ratishilatai,	রতিশীলতাই,	রতিশীলতায়,	
modelgulo,	মডেলগুলো,	মডেলগুলো,	
qyantana,	ক্যান্তনা,	ক্যান্টন,	
ohalyar,	ওহাল্যার,	অহল্যার,	
dembakreeti,	ডেম্বকৃতি,	ডিম্বাকৃতি,	
dhos,	ধোস,	ধস,	
matorom,	মাতোরম,	মাতরম,	
video,	ভিদেও,	ভিডিয়োও,	
bongsho,	বংশ,	বংশ,	
manushera,	মনুষেরা,	মানুষেরা,	
ultrasonography,	আলট্রোস্টোসরামী,	আলট্রাসনোগ্রাফিও,	
marodeho,	মারোদেহ,	মরদেহ,	
sinaake,	সিনাকে,	সিনাকে,	
dinar,	দিনার,	ডিনার,	
tiuning,	টিউনিং,	টিউনিং,	
temone,	টেমনে,	তেমনই,	
nibobondhonkrito,	নিববন্ধনকৃত,	নিববন্ধনকৃত,	
bojata,	বোজাতা,	বোজাটা,	
aziza,	আজিজা,	আজিজা,	
panchbar,	পাঁচবার,	পাঁচবার,	
tokeo,	টোকেও,	টোকেও,	
jaanachhe,	যানাচে,	জানাচ্ছে,	
bokahoke,	বোকাহোকে,	বকাহকে,	
protibedokrao,	প্রতিবদেকরাও,	প্রতিবেদকরাও,	
quary,	কোয়ারি,	কোয়েরি,	
oncoleo,	অনকোলেও,	অঞ্চলেও,	
maailey,	মেইলে,	মাইলে,	
hyaloyin,	হ্যালোইন,	হ্যালোইন,	
kormobuddhite,	কর্মবুদ্ধিতে,	কর্মবুদ্ধিতে,	
dobhaar,	দোভার,	ডোভার,	
eekbalke,	একবালকে,	ইকবালকে,	
abheedhaaneeck,	অভেধানিক,	অভিধানিক,	
khoor,	খরর,	ক্ষুর,	
sangkoolan,	সংকুলন,	সংকুলান,	
biswashi,	বিশ্বশি,	বিশ্বাসই,	
anandamahale,	আনন্দমহলে,	আনন্দমহলে,	
sompadon,	সম্পাদন,	সম্পাদন,	
gabinius,	গাবিনিয়াস,	গাবিনিআস,	
militaryr,	মিলিটারীর,	মিলিটারির,	
dhrubaker,	ধ্রুবাকের,	ধ্রুবকের,	
phutonta,	ফুটনটা,	ফুটন্ত,	
jerusaleme,	জেরুসালেমে,	জেরুসালেমে,	
hepatitis,	হেপাটাইটিস,	হেপাটাইটিস,	
dupleks,	ডুপ্লেক্স,	ডুপ্লে,	
shattoki,	শত্তকী,	সাত্যকি,	
ahalyar,	আহাল্যার,	অহল্যার,	
stoic,	স্টোইক,	স্টোয়িক,	
upacharjo,	উপাচার্য,	উপাচার্য,	
gaddaphii,	গাড়ভিই,	গাদ্দাফী,	
noteti,	নোটেটি,	নোটটি,	
internship,	ইন্টারনিশপ,	ইন্টার্নশিপ,	
arifin,	আরিফিন,	আরিফিন,	
bhyaatikaner,	ভ্যাটিকানের,	ভ্যাটিকানের,	
nirbaahe,	নির্বাহে,	নির্বাহে,	
macbeth,	ম্যাকবেথ,	ম্যাকবেথ,	
lidars,	লিডার্স,	লিডার্স,	
jerusalema,	জেরুসালেমা,	জেরুসালেম,	
firti,	ফিরটি,	ফিরতি,	
kortam,	কোরতাম,	করতাম,	
kartona,	কার্োনা,	করতনা,	
rupantarer,	রূপন্তরের,	রুপান্তরের,	
soommo,	সুমু,	সুমো,	
lendl,	লেন্ডল,	লেন্ডল,	
sausage,	সৌসাগে,	সসেজ,	
neerbahe,	নির্বাহে,	নির্বাহে,	
oncholsomuho,	অঞ্চকসমূহ,	অঞ্চলসমূহ,	
procharjontrogulo,	প্রচারযোত্তগুলো,	প্রচারযন্ত্রগুলো,	
batikromi,	বাতিক্রমি,	ব্যতিক্রমী,	
batikromee,	বাতিক্রমী,	ব্যতিক্রমী,	
anusthane,	অনুষ্ঠানে,	অনুষ্ঠানে,	
shahurgulor,	শহুরগুলোর,	শহুরগুলোর,	
lyaandeeng,	ল্যান্ডিং,	ল্যান্ডিং,	
harysoner,	হার্সনের,	হ্যারিসনের,	
beem,	বিএম,	বিম,	
abarte,	আবার্তে,	আবর্তে,	
dormroome,	ডররমরুম,	ডর্মরুমে,	
uzobekeestaan,	উজোবেকবিস্তান,	উজবেকিস্তান,	
madhuri,	মধুরী,	মাধুরী,	
deobonde,	দেওবন্দে,	দেওবন্দে,	
orthisoho,	অর্থিসহ,	অর্থিসহ,	
chandrimaa,	চান্দ্রীমা,	চন্দ্রিমা,	
sangbadmadhyame,	সংবাদমাধ্যমে,	সংবাদমাধ্যমে,	
ahalya,	আহল্যা,	অহল্যা,	
haris,	হারিস,	হ্যারিস,	
mathieu,	মাঠিউ,	ম্যাথিউ,	
bhoutikeshu,	ভৌতিকেষু,	ভৌতিকেষু,	
shiulijhra,	শিউলিহরা,	শিউলিঝরা,	
torunra,	তোরুনরা,	তরুণরা,	
urey,	ইউরে,	ইউরি,	
ragei,	রাগেই,	রাগেই,	
hoteltite,	হোটেলটিতে,	হোটেলটিতে,	
amburi,	আম্বুরী,	আম্বুরি,	
bhimsenkei,	ভীমসেনকেই,	ভীমসেনকেই,	
daayitto,	ডায়িত্ব,	দায়িত্ব,	
bhaangchur,	ভাংচুর,	ভাংচুর,	
amontronkarider,	আমন্ত্রণকারীদের,	আমন্ত্রণকারীদের,	
mase,	মাসে,	মাসে,	
dai,	দাই,	দিই,	
drishyogulote,	দৃশ্যগুলোতে,	দৃশ্যগুলোতে,	
parabortee,	পারবর্তী,	পরর্বতী,	
bhandti,	ভান্ডটি,	ভাণ্ডটি,	
canflikt,	ক্যানফ্লিক্ট,	কনফ্লিক্ট,	
volivoler,	ভলিভলের,	ভলিভলের,	
aholyar,	অহল্যার,	অহল্যার,	
ekla,	একলা,	একলা,	
saalsa,	সালসা,	সালসা,	
somoibo,	সময়ব,	সমৈব,	
dwijenbabuder,	দ্বিজেনবাবুদের,	দ্বিজেনবাবুদের,	
ovinetar,	অভিনেটার,	অভিনেতার,	
blyaka,	ব্ল্যাক,	ব্ল্যাক,	
tahorir,	তাহরীর,	তাহরীর,	
manohputa,	মানোপুতা,	মনঃপুত,	
modhyekar,	মধ্যেকর,	মধ্যেকার,	
gyandaas,	জ্ঞানদাস,	জ্ঞানদাস,	
dharavahik,	ধারাবাহিক,	ধারাবাহিক,	
lampot,	লাম্পট,	লম্পট,	
karima,	কারিমা,	করিম,	
bondhuvabaponyo,	বন্ধুবাবাপন্য,	বন্ধুভাবাপন্ন,	
oindrila,	ঐন্দ্রিলা,	ঐন্দ্রিলা,	
wodka,	ওয়েকা,	ভদকা,	
chalochchitreer,	চলচ্চিত্রীর,	চলচ্চিত্রের,	
abhidhaanick,	অভিধানিক,	অভিধানিক,	
dhani,	ধনি,	ধানি,	
palestine,	প্যালেস্টাইন,	প্যালেস্টাইনে,	
tokee,	তোঁক,	তকি,	
jeebnagore,	জীবনাগরে,	জীবননগর,	
doula,	দৌলা,	দৌলা,	
bagdad,	বাগদাদ,	বাগদাদে,	
habshi,	হাবশি,	হাবশী,	
plate,	প্লেট,	প্লেটে,	
jonmobhumitir,	জন্মভূমিতির,	জন্মভূমিটির,	
teestar,	টিস্টার,	তিস্তার,	
kamla,	কামলা,	কামলা,	
kanasarabhesana,	কননারাষেশন,	কনসারভেশন,	
homshke,	হোমশকে,	হোমসকে,	
prodiiper,	প্রদীপের,	প্রদীপের,	
somraatra,	সোমরাত্র,	সম্রাটরা,	
evaner,	ইভানের,	ইভানের,	
edaning,	এডানিং,	ইদানিং,	
nilkuthir,	নীলকুঠির,	নীলকুঠির,	
dharavahikbhabe,	ধারাভাদিখভাবে,	ধারাবাহিকভাবে,	
shilpikuler,	শিল্পিকুলের,	শিল্পীকুলের,	
pathanatak,	পাথানতক,	পথনাটক,	
tateo,	তাতেও,	তাতেও,	
rajotwo,	রাজত্ব,	রাজত্ব,	
moshzidtike,	মশজিদটিকে,	মসজিদটিকে,	
bondishalatei,	বন্ধিশালাতেই,	বন্দিশালাতেই,	
anhu,	আনহু,	আনহু,	
baait,	বাইট,	বাইট,	
stagecraft,	স্টেগেক্রাফ্ট,	স্টেজক্রাফট,	
sursur,	সুরসুর,	সুরসুর,	
agomonke,	আগমনকে,	আগমনকে,	
nirapattamulok,	নিরাপত্তমূলক,	নিরাপত্তামূলক,	
prakalpagulor,	প্রকল্পগুলোর,	প্রকল্পগুলোর,	
sangram,	সংগ্রাম,	সঙ্গ্রাম,	
jhimochchilo,	ঝিমোচ্ছিল,	ঝিমোচ্ছিলো,	
soundorjotakei,	সৌন্দর্যটাকেই,	সৌন্দর্যটাকেই,	
heze,	হেজে,	হেজ,	
rena,	রেন,	রেনো,	
bifol,	বিফোল,	বিফল,	
sahittekder,	সাহিত্যেকদের,	সাহিত্যেকদের,	
naajii,	নাজি,	নাত্সি,	
charpanch,	চারপঞ্চ,	চারপাঁচ,	
gafeeloti,	গাফিলোটি,	গাফিলতি,	
america,	আমেরিকা,	আমেরিকা,	
mosjidsoho,	মসজিদসহ,	মসজিদসহ,	
shasonkarta,	শাসনকার্তা,	শাসনকর্তা,	
veenish,	ভীনিশ,	ভেনিস,	
anagarikra,	অনাগরিকরা,	অনাগরিকরা,	
shotodha,	শতধা,	শতধা,	
sthitiko,	স্থিতিকও,	স্থিতিকো,	
kada,	কোদা,	কোডা,	
nagorikkey,	নাগরিককে,	নাগরিককে,	
madhobeer,	মধবীর,	মাধবীর,	
srabosty,	স্রাবোস্টি,	শ্রাবস্তী,	
uttor,	উত্তর,	উওর,	
mithener,	মিথেনের,	মিথেনের,	
jaandrel,	য্যান্ড্রেল,	জাঁদরেল,	
jeebonnogor,	জীবনগৌগর,	জীবননগর,	
poroborti,	পরবর্তী,	পরর্বতী,	
bornolikhon,	বর্ণলিখন,	বর্ণলিখন,	
osomorthito,	অসমর্থিত,	অসমর্থিত,	
nirobota,	নিরবতা,	নিরবতা,	
moddhyoshtho,	মধ্যস্থ,	মধ্যস্থ,	
sushposhtolikhito,	সুষ্পষ্টিলোখিত,	সুষ্পষ্টলিখিত,	
ajeeboner,	জজবেনের,	আজীবনের,	
phuda,	ফুদ,	ফুড,	
bbosonto,	ব্ববন্ত,	বসন্ত,	
bhabaaponno,	ভাবাপন্ন,	ভাবাপন্ন,	
tachnach,	টাচনাচ,	তছনছ,	
zibonnogor,	জীবননগোর,	জীবননগর,	
laicenshe,	লেইকেন্সে,	লাইসেন্স,	
chenza,	চেঞ্জা,	চেঞ্জ,	
bbosben,	ব্ববসেন,	বসবেন,	
sossar,	সোসার,	সকার,	
goodamjato,	গুদমজাত,	গুদামজাত,	
kandy,	ক্যান্ডি,	ক্যান্ডি,	
mangoleek,	মঙ্গলিক,	মাঙ্গলিক,	
sorsa,	সোর্স,	সোর্স,	
dito,	দিত,	দিতো,	
kaferder,	কাফেরদের,	কাফেরদের,	
plato,	প্ল্যাটো,	প্লেটো,	
jamseder,	জামসেদের,	জামসেদের,	
bhumija,	ভূমিজা,	ভূমিজ,	
transform,	ট্রান্সফর্ম,	ট্রান্সফর্ম,	
bipti,	বিপটি,	বিপ্তি,	
bonnypran,	বোন্র্পরান,	বন্যপ্রাণ,	
nazad,	নাজাদ,	নজদ,	
footbalarra,	ফুটবলরার,	ফুটবলাররা,	
saurce,	সার্স,	সোর্স,	
kinsha,	কিনশা,	কিংস,	
choopi,	চুপী,	চুপি,	
nazad,	নাজাদ,	নাজাদ,	
onchalti,	অঞ্চলটি,	অঞ্চলটি,	
boudhher,	বৌধের,	বৌদ্ধের,	
chalachchitrotike,	চালাচ্রিত্রটিকে,	চলচ্চিত্রটিকে,	
monchostho,	মন্চস্থ,	মঞ্চস্থ,	
serup,	সেরূপ,	সেরূপ,	
laps,	ল্যাপস,	ল্যাপস,	
hastamathun,	হস্তমাথুন,	হস্তমথুন,	
muradpur,	মুরদপুর,	মুরাদপুর,	
sikkharthirao,	শিক্ষার্থীরাও,	শিক্ষার্থীরাও,	
champa,	চাম্পা,	চাঁপা,	
chalake,	চালাকে,	চালকে,	
sobrakomer,	সব্রকমের,	সবরকমের,	
seguloi,	সেগুলোই,	সেগুলোই,	
salafeta,	সালাফেটা,	সালফেট,	
samratra,	সম্রাত্র,	সম্রাটরা,	
hillse,	হাইলস,	হিলসে,	
chowdhuryke,	চৌধধুরিকে,	চৌধুরীকে,	
muchlima,	মুছলিমা,	মুছলিমা,	
sachetonvabe,	সচেতনভাবে,	সচেতনভাবে,	
karim,	কারিম,	করিম,	
proshtotto,	প্রশ্তত্ব,	প্রস্ত্তত,	
adarsho,	আদার্শ,	আর্দশ,	
turisht,	তুরিষ্ট,	টুরিস্ট,	
lopjonito,	লবলনিত,	লোপজনিত,	
bikretara,	বিক্রেতারা,	বিক্রেতারা,	
reflex,	রিফ্লেক্স,	রিফ্লেক্স,	
nutaner,	নুতানের,	নূতনের,	
bamon,	বামন,	বামন,	
hilser,	হিলসের,	হিলসের,	
gasthi,	গাস্থি,	গোষ্ঠী,	
kaia,	কাইয়া,	কায়া,	
keyboarder,	কেববোর্ডের,	কীবোর্ডের,	
bandhano,	বাঁধানো,	বাঁধানো,	
nuhas,	নুহাস,	নুহাশ,	
basturoi,	বাস্তুরই,	বস্তুরই,	
shubhag,	শুভাগ,	শুভাগ,	
dong,	ডং,	ডং,	
neshadrabyer,	নেশাদ্রব্যের,	নেশাদ্রব্যের,	
skolarsip,	স্কোলোরসিপ,	স্কলারশিপ,	
munshiji,	মুন্সীজী,	মুনশীজি,	
mahibur,	মহিবুর,	মহিবুর,	
vabook,	ভাবুক,	ভাবুক,	
mahbunur,	মাহবুনুর,	মাহবুনুর,	
sahachke,	সাহাচকে,	সাহাচকে,	
kailashrao,	কৈলাশরাও,	কৈলাশরাও,	
marry,	মারি,	ম্যারি,	
jaadrel,	জাদ্রেল,	জাঁদরেল,	
digri,	ডিগরি,	ডিগ্রি,	
lettar,	লেট্ার,	লেটার,	
cinemapremider,	সিনেমাপ্রেমীদের,	সিনেমাপ্রেমীদের,	
akram,	আকরাম,	আকরাম,	
modelkey,	মডেলকে,	মডেলকে,	
sheetke,	শীটকে,	শীতকে,	
kottar,	কোট্টার,	কট্টর,	
johor,	জোহর,	জহর,	
meghacchonno,	মেঘাচ্ছন্ন,	মেঘাচ্ছন্ন,	
siima,	সিয়া,	সীমা,	
syfy,	সিফি,	সাইফাই,	
rajendracholer,	রাজেন্দ্রচালের,	রাজেন্দ্রচোলের,	
dikpal,	ডিকপাল,	দিকপাল,	
deenesh,	দেনেশ,	দীনেশ,	
dada,	দাদা,	দাদা,	
booroon,	বুরুন,	বোরন,	
rajdhani,	রাজধানি,	রাজধানি,	
musalmani,	মুসলমানি,	মুসলমানই,	
jatotaa,	জাতোটা,	যতোটা,	
kumbhalnar,	কুম্ভলনার,	কুম্ভালনার,	
anusvara,	অনুস্বরা,	অনুস্বার,	
upobasher,	উপবাশের,	উপবাসের,	
kaaferder,	কাফেরদের,	কাফেরদের,	
venkates,	ভেঙ্কটেস,	ভেঙ্কটেশ,	
jyaqa,	জ্ঞাক,	জ্যাক,	
shroddhabihin,	শ্রদ্ধাবিহীন,	শ্রদ্ধাবিহীন,	
land,	ল্যান্ড,	ল্যান্ড,	
uqeliptas,	ইউকেলিপ্টাস,	ইউক্যালিপ্টাস,	
manobikotao,	মানবিকতাও,	মানবিকতাও,	
rajbandir,	রাজবন্দির,	রাজবন্দীর,	
lavta,	লাভটা,	লাভটা,	
elaakaate,	এলাকাতে,	এলাকাতে,	
byaboharkarir,	ব্যবহারকারীর,	ব্যবহারকারীর,	
bulan,	বুলান,	বুলান,	
jamkaalo,	জামকালো,	জমকালো,	
ponthaar,	পন্থার,	পন্থার,	
manir,	মানির,	মনির,	
byatikrami,	ব্যতিক্রমী,	ব্যতিক্রমী,	
corsin,	করসিন,	করসিন,	
bonvumi,	বনভুমি,	বনভূমি,	
sumeeta,	সুমিত,	সুমিতা,	
ganosochetonota,	গণসচেতনাতা,	গণসচেতনতা,	
pleeta,	প্লেট,	প্লেট,	
mukhomandal,	মুখমন্দল,	মুখমণ্ডল,	
abheedhanic,	অভিধানিক,	অভিধানিক,	
ved,	ভেড,	বেদ,	
vushito,	বুষিত,	ভূষিত,	
bishnoo,	বিষ্ণ,	বিষ্ণু,	
deejeejer,	দেজীজের,	ডিজিজের,	
krusher,	ক্রুশের,	ক্রুশের,	
khali,	খালী,	খালি,	
antarctica,	অ্যান্টার্কটিকা,	অ্যান্টার্কটিকা,	
reshidensha,	রেশিদনেস,	রেসিডেন্স,	
shalook,	শালোক,	শালুক,	
trutimatra,	ত্রুতিমাত্র,	ত্রুটিমাত্র,	
annimated,	অ্যানিমেটেড,	এনিমেটেড,	
puroheetder,	পুরোহিতদের,	পুরোহিতদের,	
europia,	ইউরোপিয়া,	ইউরোপিয়া,	
promothesh,	প্রমথেশ,	প্রমথেশ,	
konnoder,	কোন্যদের,	কন্যদের,	
weelcomee,	ভাইকোলিম,	ওয়েলকাম,	
ongkush,	অঙ্কুশ,	অংকুশ,	
provritike,	প্রভৃতিকে,	প্রভৃতিকে,	
manushsoho,	মানুষসহ,	মানুষসহ,	
sheshdinti,	শেষদিনটি,	শেষদিনটি,	
niharkantibabu,	নিহারকান্তিবাবু,	নিহারকান্তিবাবু,	
obdee,	অবদি,	অব্দি,	
capsul,	ক্যাপসুল,	ক্যাপসুল,	
scholastik,	স্কলাস্টিক,	স্কলাস্টিক,	
chalochchitraeeo,	চলচ্চিত্রারীও,	চলচ্চিত্রেও,	
pratista,	প্রতিস্তা,	প্রতিষ্টা,	
standards,	স্ট্যান্ডার্ডসহ,	স্টান্ডার্ডস,	
bim,	বিম,	বিম,	
transapharma,	ট্রান্সফফ্রম,	ট্রান্সফর্ম,	
teliha,	তেলিহা,	তেলিহা,	
dii,	ডিই,	দিই,	
dipti,	দিপটি,	ডেপুটি,	
sobaiderke,	সোবাইদেরকে,	সবাইদেরকে,	
marketing,	মার্কেটিং,	মার্কেটিং,	
koomarir,	কমারীর,	কুমারীর,	
kaleo,	কালেও,	কালেও,	
habsi,	হাবসি,	হাবশী,	
nationalser,	নেশনালসের,	ন্যাশনালসের,	
somonnitobhabe,	সমন্নিতভাবে,	সমন্বিতভাবে,	
krechi,	ক্রেচি,	করেছি,	
olpo,	অল্পো,	অল্প,	
prarthonakokkher,	প্রার্থনাকক্ষের,	প্রার্থনাকক্ষের,	
konoroop,	কনোরূপ,	কোনরূপ,	
meshintao,	মেশিনটাও,	মেশিনটাও,	
arg,	আর্গ,	আর্গ,	
ghotol,	ঘটল,	ঘটল,	
milekhaanek,	মিলেখানেক,	মাইলখানেক,	
abadamoner,	আবাদমণের,	অবদমনের,	
ghumunoi,	ঘুমুনোই,	ঘুমুনোই,	
chilahaati,	চিলাহাটি,	চিলাহাটি,	
zerusalem,	জেরুসালেম,	জেরুজালেম,	
dubureer,	ডুবুরীর,	ডুবুরির,	
sethai,	সেথাই,	সেথাই,	
rajbondir,	রাজবন্দির,	রাজবন্দীর,	
adorso,	অ্যাডরস,	আর্দশ,	
itostatah,	ইতোস্তাহ,	ইতস্ততঃ,	
naper,	নাপের,	ন্যাপের,	
vogno,	ভোগনো,	ভগ্ন,	
cholechi,	চলেছি,	চলেছি,	
songkoloney,	সংকলনে,	সংকলনে,	
byathapather,	ব্যথাপথের,	ব্যথাপথের,	
prasadhoner,	প্রসাধনের,	প্রসাধনের,	
chamski,	চামস্কি,	চমস্কি,	
asabhya,	অসভ্য,	অসভ্য,	
munjur,	মুঞ্জুর,	মুনজুর,	
batistambhatike,	বাতিস্তমভাযটিকে,	বাতিস্তম্ভটিকে,	
peeri,	পেরই,	পেরি,	
qyapasula,	ক্যাপাসুলা,	ক্যাপসুল,	
rajtantra,	রাজতন্ত্র,	রাজতন্ত্র,	
bikretaara,	বিক্রেতারা,	বিক্রেতারা,	
chongar,	চঙ্গর,	চোঙ্গার,	
mah,	মাহ,	মাহে,	
contemporary,	কন্টেমপোর্রি,	কন্টেম্পোরারি,	
sikha,	সিখা,	শিখ,	
adhyatmikata,	অধ্যাত্মিকতা,	আধ্যাত্মিকতা,	
feroza,	ফেরোজা,	ফিরোজা,	
ponchasjon,	পঞ্চাসজন,	পঞ্চাশজন,	
tookror,	টুকোর,	টুকরোর,	
ramantic,	রামান্তিক,	রোমান্টিক,	
trabuco,	ট্রাবুকো,	ট্র্যাবুকো,	
banglota,	বাংলোটা,	বাংলোটা,	
lakshmir,	লক্ষ্মীর,	লক্ষ্মীর,	
qaro,	কারো,	কারো,	
protizogiita,	প্রতিযোগিতা,	প্রতিযোগীতা,	
chahidapotrer,	চাহিদাপত্রের,	চাহিদাপত্রের,	
naabbota,	নাববোটা,	নাব্যতা,	
dristiheen,	দৃষ্টিহীন,	দৃষ্টিহীন,	
oswastikor,	অস্বাস্তিকর,	অস্বস্তিকর,	
hari,	হারী,	হরি,	
satarkakari,	সতর্ককারী,	সতর্ককারী,	
windo,	উইন্ডো,	উইন্ডো,	
salmanul,	সালমানুল,	সালমানুল,	
horidwar,	হরিদ্বার,	হরিদ্বার,	
udvabani,	উদ্ভাবানী,	উদ্ভাবনী,	
kiibord,	কিবর্ড,	কীবোর্ড,	
sanaktakaran,	সনক্তকরণ,	সনাক্তকরণ,	
taholo,	তাহলো,	তাহলো,	
times,	টিমস,	টাইমস্,	
nanilalke,	নানিলালকে,	ননীলালকে,	
duuma,	দুরমা,	দুমা,	
crashlands,	ক্রাযাশল্যান্ডস,	ক্র্যাশল্যান্ডস,	
dokan,	দোকান,	দোকান,	
perry,	পেরি,	পেরি,	
baarnis,	ব্যারনিস,	বার্নিশ,	
deilee,	দেইলী,	ডেইলি,	
diibug,	দিবুগ,	ডিবাগ,	
vittiteo,	ভিত্তিতেও,	ভিত্তিতেও,	
asommoti,	অসম্মতি,	অসম্মতি,	
refleks,	রেফলেক্স,	রিফ্লেক্স,	
themeke,	থেমেকে,	থিমকে,	
utpatti,	উৎপত্তি,	উতপত্তি,	
nirbahey,	নির্বাহে,	নির্বাহে,	
machkabar,	মাছকাবার,	মাচকাবার,	
sangkalanti,	সংকলনটি,	সংকলনটি,	
registaner,	রেজিস্টানের,	রেগিস্তানের,	
anchalsaho,	অঞ্চলসহ,	অঞ্চলসহ,	
gandhiir,	গান্ধীর,	গান্ধীর,	
shresthoshcho,	শ্রেষ্ঠস্চ,	শ্রেষ্ঠশ্চ,	
bhogiroth,	ভোগিরথ,	ভগীরথ,	
shef,	শেছ,	শেফ,	
station,	স্ট্যাশন,	ষ্টেশন,	
surke,	সুরকে,	সুরকে,	
akheli,	আখেলি,	আখেলী,	
chaudhurider,	চৌধুরীদের,	চৌধুরীদের,	
bonvumitey,	বনভুমিতে,	বনভূমিতে,	
tyapa,	ট্যাপা,	ট্যাপ,	
rifleksa,	রিফলেক্স,	রিফ্লেক্স,	
middleton,	মিডলটন,	মিডলটন,	
armori,	আর্মরী,	আরমোরি,	
jotsna,	জৎসনা,	জ্যোৎস্না,	
existing,	এক্সিস্টিং,	এক্সিসটিং,	
rata,	রাতা,	রত,	
aalkatraa,	অলকাত্রও,	আলকাতরা,	
sambatsarkal,	সম্বসতরকল,	সম্বৎসরকাল,	
khude,	খুদে,	ক্ষুদে,	
kanasharabheshhana,	কণশররভেষণ,	কনসারভেশন,	
soceitytey,	সসেটিটি,	সোসাইটিতে,	
danakana,	দনকানা,	ডানকান,	
kyatagorir,	ক্যাটাগরির,	ক্যাটাগরির,	
obharbhiu,	ওভারভিউ,	ওভারভিউ,	
shpredshiit,	স্প্রেডশিট,	স্প্রেডশীট,	
onshogrohoner,	অনশগ্রহণের,	অংশগ্রহনের,	
daebug,	দাবেগ,	ডিবাগ,	
pradoshik,	প্রদোশিক,	প্রাদশিক,	
srichoitonnodeb,	শ্রীচৈতন্নবেব,	শ্রীচৈতন্যদেব,	
shatodha,	শতদো,	শতধা,	
nabayug,	নাবাইগ,	নবযুগ,	
giitikobitar,	গীতিকাবিতার,	গীতিকবিতার,	
sahinsatar,	সহিনসাতার,	সহিংসতার,	
dorgah,	দররাহ,	দরগাহ,	
kuhelika,	কুহেলিকা,	কুহেলিকা,	
songrahak,	সংগ্রহক,	সংগ্রাহক,	
abosare,	অবসারে,	অবসরে,	
gonesher,	গণেশের,	গণেশের,	
chotogolper,	চটোগ্লপর,	ছোটগল্পের,	
odeb,	ওউদেব,	ওদেব,	
bhabanipur,	ভবানীপুর,	ভবানীপুর,	
halding,	হ্যালডিং,	হোল্ডিং,	
kalki,	কালকি,	কালকি,	
torunosomriddho,	তরুণসমৃদ্ধ,	তরুণসমৃদ্ধ,	
utpotti,	উৎপত্তি,	উতপত্তি,	
sainyader,	সৈন্যদের,	সৈন্যদের,	
echhti,	এচটি,	এছটি,	
udbhaboney,	উদ্ভাবনে,	উদ্ভাবনে,	
bodna,	বোদনা,	বদনা,	
nottee,	নটটি,	নোটটি,	
rakhtokkharoner,	রাক্ষটকরণের,	রক্তক্ষরণের,	
wedanta,	ওয়েনানটা,	বেদান্ত,	
bolechile,	বলেছিলে,	বলেছিলে,	
moshjidke,	মশজিদকে,	মসজিদকে,	
poketchorder,	পকেশফরদের,	পকেটচরদের,	
licencedhari,	লাইসেন্সধারী,	লাইসেন্সধারী,	
sikkhagata,	শিক্ষাগত,	শিক্ষাগত,	
kidambi,	কিদাম্বি,	কিদম্বি,	
toler,	তলার,	তালের,	
bike,	বিকে,	বাইক,	
vorkendra,	ভোরকেন্দ্র,	ভরকেন্দ্র,	
shamshernagar,	শমশেরনগর,	শমশেরনগর,	
bhoolapuka,	ভৌলাপুকা,	ভোলাপুক,	
parswer,	পারস্বের,	পার্শ্বের,	
akpaase,	আকপাসে,	একপাশে,	
fol,	ফোল,	ফল,	
nirmolotaa,	নির্মলতা,	নির্মলতা,	
aholya,	অহল্যা,	অহল্যা,	
fiksing,	ফিক্সিং,	ফিক্সিং,	
pratijogider,	প্রতিযোগীদের,	প্রতিযোগীদের,	
sheets,	শিটস,	শীটস,	
shiter,	শিতের,	শীতের,	
auttacharer,	অট্টাচারের,	অত্যাচারের,	
kachhakaachhi,	কাচাকাচি,	কাছাকাছি,	
songasthatike,	সংস্থাটিকে,	সংস্থাটিকে,	
shikshakbrinda,	শিক্ষাবৃন্দ,	শিক্ষকবৃন্দ,	
rotheen,	রথিন,	রথীন,	
orbi,	ওরবি,	ওরবি,	
nathibhuktir,	নাথিভুক্তির,	নথিভুক্তির,	
mmadhukkori,	ম্মাধুককরি,	মাধুকরী,	
rakkhanbhag,	রক্ষণভাগ,	রক্ষণভাগ,	
kekru,	কেকরু,	কেকরু,	
taunasipa,	টাউনাপিপা,	টাউনশিপ,	
plator,	প্ল্যাটর,	প্লেটোর,	
byan,	ব্যান,	ব্যাং,	
pratiyogitar,	প্রতিযোগিতার,	প্রতিযোগীতার,	
songbadmadhyomer,	সংবাদমাধ্যমের,	সংবাদমাধ্যমের,	
nutunotto,	নুতুনত্ব,	নতুনত্ব,	
agamane,	আগামানে,	আগমনে,	
katui,	কাতুই,	কাতুই,	
ghotleyo,	ঘটলিও,	ঘটলেও,	
sexperter,	সেক্সপার্টের,	সেক্সপার্টের,	
dola,	দোলা,	দলা,	
audiotike,	অডিওটিকে,	অডিওটিকে,	
varma,	ভারমা,	ভার্মা,	
milea,	মিলিয়া,	মাইলে,	
rajnikant,	রাজনীকান্ত,	রাজনীকান্ত,	
akmato,	আকমত,	একমত,	
yukeliptash,	যুকেলিপ্টাশ,	ইউক্যালিপ্টাস,	
ajuhat,	অজুহাত,	অজুহাত,	
ekatitto,	একাতিত্ব,	একাতিত্ব,	
fostar,	ফস্্টার,	ফস্টার,	
elakayi,	এলাকাই,	এলাকাই,	
baibosthar,	বাযবস্থার,	ব্যবস্থার,	
mele,	মেল,	মাইল,	
saseza,	সাসেজা,	সসেজ,	
mukhya,	মুখ্যা,	মুখ্য,	
shho,	পোনা,	শো,	
nirbahe,	নির্বাহে,	নির্বাহে,	
telakucha,	তেলাকুচা,	তেলাকুচা,	
homeser,	হোমেসের,	হোমসের,	
ekghare,	একঘরে,	একঘরে,	
sangbadmadhyamgulote,	সংবাদমাধ্যমগুলোতে,	সংবাদমাধ্যমগুলোতে,	
tawnship,	টেউশশিপ,	টাউনশিপ,	
mitrer,	মিত্রের,	মিত্রের,	
dala,	দালা,	দলা,	
korimkey,	করিমকে,	করিমকে,	
aakaabar,	আকাবার,	আকাবার,	
korimer,	করিমের,	করিমের,	
domone,	ডোমোন,	দমনে,	
debdebyr,	দেবদেবীর,	দেবদেবীর,	
bisshaskey,	বিশ্বাসকে,	বিশ্বাসকে,	
ship,	শিপ,	শিপ,	
shishupalgarh,	শিশুপললঘর,	শিশুপালগড়ে,	
poddhotitei,	পদ্ধতিতেই,	পদ্ধতিতেই,	
tigre,	টিগ্রে,	টাইগার,	
ashiatic,	অ্যাশিয়াটিক,	এশিয়াটিক,	
baasaate,	বাসাতে,	বাসাতে,	
nabbata,	নব্বতা,	নাব্যতা,	
lendal,	লেন্ডাল,	লেন্ডল,	
nibeditar,	নিবেদিতার,	নিবেদিতার,	
ispredsiit,	ইসপ্রেডিসেট,	স্প্রেডশীট,	
shangsthaner,	সাংস্থানের,	সংস্থানের,	
karmakarke,	কর্মকারকে,	কর্মকারকে,	
deputi,	দেপুটি,	ডেপুটি,	
ceramicer,	সেরামিসের,	সিরামিকের,	
nothivukto,	নথিভুক্ত,	নথিভুক্ত,	
chyeta,	চ্যাট,	চ্যাট,	
windos,	উইন্ডস,	উইন্ডোস,	
bodhukeo,	বোধুকেও,	বধুকেও,	
daqten,	ডাকেটেন,	ডাকতেন,	
hughes,	হুগেশ,	হিউজেস,	
parijaner,	পারিজানের,	পরিজনের,	
shikshakbrindo,	শিক্ষাবৃন্দ,	শিক্ষকবৃন্দ,	
tintir,	তিনটির,	তিনটির,	
teta,	টেট,	টেটা,	
nischitobhabe,	নিশ্চিতভাবে,	নিশ্চিতভাবে,	
bonorajite,	বনরাজিতে,	বনরাজিতে,	
chiraharit,	চিরাহারিত,	চিরহরিৎ,	
uponeesoder,	উপনিষদের,	উপনিষদের,	
rupert,	রাপার্ট,	রুপার্ট,	
gabhaaskar,	গাভাসকার,	গাভাস্কার,	
armshtronj,	আর্মস্ট্রোজন,	আর্মস্ট্রং,	
bhromonkaale,	ভ্রমণকালে,	ভ্রমণকালে,	
munim,	মুনিম,	মুনিম,	
nachiketa,	নচিকেতা,	নচিকেতা,	
abikaul,	আবিকৌল,	অবিকল,	
juddhahato,	যুদ্ধাহাত,	যুদ্ধাহত,	
foolkopi,	ফুলকোপি,	ফুলকপি,	
forma,	ফরমা,	ফর্মা,	
sikkhakbrinda,	শিক্ষকবৃন্দ,	শিক্ষকবৃন্দ,	
shift,	সিফট,	শিফট,	
sosoa,	সোসোয়া,	শশা,	
aniyantrita,	অনিয়ন্ত্রীতা,	অনিয়ন্ত্রিত,	
kusumeshu,	কুসুমেষু,	কুসুমেষু,	
shoriph,	শরীফ,	শরিফ,	
laat,	ল্ট,	লাট,	
taunsheep,	টাউন্প,	টাউনশিপ,	
bikromei,	বিক্রমেই,	বিক্রমেই,	
shoodhooi,	শুধই,	শুধুই,	
suparichito,	সুপরিচিত,	সুপরিচিত,	
meghachchanno,	মেঘাচ্ছন্ন,	মেঘাচ্ছন্ন,	
pichte,	পিছতে,	পিছতে,	
premo,	প্রেমো,	প্রিমো,	
bangladesh,	বাংলাদেশ,	বঙ্গালাদেস,	
bajhyo,	বাঝ্য,	বাহ্য,	
liceensee,	লিসিনসি,	লাইসেন্স,	
lisense,	লিসেন্স,	লাইসেন্স,	
kaale,	কাল,	কালে,	
poddhotiteyi,	পদ্ধতিতেই,	পদ্ধতিতেই,	
foloshrutite,	ফলশ্রুটিতে,	ফলশ্রুতিতে,	
thailand,	থাইলান্দ,	থাইল্যান্ড,	
lagto,	লাগতো,	লাগতো,	
upobaashee,	উপবাশী,	উপবাসী,	
senior,	সেনিওর,	সিনিয়র,	
dhanche,	ধনচে,	ধাঁচে,	
landey,	ল্যান্ডে,	ল্যান্ডে,	
abeganuvutir,	আবেগানুতুটির,	আবেগানুভূতির,	
hitaishi,	হিতাইশি,	হিতৈষী,	
towraat,	তওরাাত,	তওরাত,	
ruptan,	রূপ্তন,	রূপটান,	
qulim,	কুলিম,	কুলিং,	
tenishe,	তেনিশে,	টেনিসে,	
bedey,	বেদে,	বেদে,	
faaj,	ফাযাজ,	ফাজ,	
siqh,	সিখ,	শিখ,	
khalidkay,	খালিদকা,	খালিদকে,	
makong,	মাকোং,	মেকং,	
phakay,	ফাকেয়,	ফাকে,	
khonjena,	খোঁজেনা,	খোঁজেনা,	
cholochchitrake,	চলচ্চিত্রাকে,	চলচ্চিত্রকে,	
doloo,	দলল,	ডলু,	
ponchaasjon,	পঞ্চাবজন,	পঞ্চাশজন,	
prapokkey,	প্রপোককে,	প্রাপককে,	
shomostigoto,	শমস্তিগত,	সমষ্টিগত,	
gejeted,	জেজেটেড,	গেজেটেড,	
scorey,	স্কোরে,	স্কোরে,	
qonfliqt,	কনফলিক্ট,	কনফ্লিক্ট,	
samle,	সামলে,	সামলে,	
vangley,	ভ্যাংলে,	ভাঙলে,	
chalachchitrei,	চলচ্চিত্রেই,	চলচ্চিত্রেই,	
liseensee,	লিসেন্স,	লাইসেন্স,	
guzober,	গুজবের,	গুজবের,	
simaa,	সিমা,	সীমা,	
kisti,	কিস্তি,	কিস্তি,	
mekon,	মেকন,	মেকং,	
nodiitei,	নদীতেই,	নদীতেই,	
ashamorthito,	আশামর্থিত,	অসমর্থিত,	
rahee,	রহহি,	রাহি,	
uponishad,	উপনিষাদ,	উপনিষদ,	
ogovir,	ওগভীর,	অগভীর,	
hames,	হামেস,	হোমস,	
barack,	ব্যারাক,	বারাক,	
debete,	দেবেতে,	ডিবেট,	
rahimed,	রহিমেদ,	রহিমেদ,	
shem,	শেম,	সেম,	
samoshtigato,	সমস্তিগত,	সমষ্টিগত,	
jewellery,	জুভ়েলিরি,	জুয়েলারির,	
anyorup,	অন্যরূপ,	অন্যরূপ,	
gandhariir,	গান্ধারীর,	গান্ধারীর,	
prangulo,	প্রানগুলো,	প্রানগুলো,	
akhando,	অখণ্ড,	অখন্ড,	
dipgulote,	ডিপগুলোতে,	দ্বীপগুলোতে,	
meshmeshya,	মেশমেশ্যা,	মেশহমেশহিইয়া,	
dorun,	ডোরুন,	দরুণ,	
nopdnodir,	নদ্নদির,	নদনদীর,	
michir,	মিচির,	মিচির,	
nadnadeer,	নদনাদীর,	নদনদীর,	
moresbai,	মোরেসবাই,	মোরেসবাই,	
tistar,	তিস্তার,	তিস্তার,	
jhanjra,	ঝঞ্জরা,	ঝাঁজরা,	
pothnirdeshona,	পথ্নিরদেশনা,	পথনির্দেশনা,	
pouchute,	পৌছুতে,	পৌঁছুতে,	
aaeerese,	আইরেস,	আইরেসে,	
daaktikite,	ডাক্তিকতে,	ডাকটিকিটে,	
progresh,	প্রোগ্রেশ,	প্রগ্রেস,	
upobasee,	উপবাসী,	উপবাসী,	
dharmee,	ধর্মী,	ধর্মী,	
soteciety,	সটেসিটি,	সোসাইটিতে,	
prarthitao,	প্রার্থীতাও,	প্রার্থীতাও,	
rubidium,	রুবিডিয়াম,	রুবিডিয়াম,	
riphleksa,	রিফলেক্স,	রিফ্লেক্স,	
nojder,	নজদের,	নজদের,	
parisankhanvid,	পরিসংখ্বননিদ,	পরিসংখ্যানবিদ,	
arthanitike,	অর্থনীতিকে,	অর্থনীতিকে,	
debdebier,	দেবদেবীর,	দেবদেবীর,	
bhaibon,	ভাওদন,	ভাইবোন,	
danata,	দানাটা,	ডোনাট,	
jibonnogor,	জীবনগরগর,	জীবননগর,	
sthapanatir,	স্থাপনাটির,	স্থাপনাটির,	
sohokari,	সোহাকারী,	সহকারী,	
melborrone,	মেলবোর্টনে,	মেলবোর্নে,	
bhaandar,	ভান্দার,	ভাণ্ডার,	
ajuhath,	অজুহাত,	অজুহাত,	
bishashke,	বিষাশকে,	বিশ্বাসকে,	
toroonra,	তরোনরা,	তরুণরা,	
vogiroth,	ভোগীরথ,	ভগীরথ,	
dushtogone,	দুষ্টগণে,	দুষ্টগণে,	
nathivookteer,	নাথভুুক্তির,	নথিভুক্তির,	
machsoho,	মাচসহ,	মাছসহ,	
drissotir,	দৃষ্পটির,	দৃশ্যটির,	
maaktoome,	মাক্তোমে,	মাকতুম,	
piulir,	পিলির,	পিউলির,	
zeland,	জেলান্দ,	জিল্যান্ড,	
beshakbar,	বেশকবার,	বেশকবার,	
rahee,	রহহি,	রাহী,	
uporitale,	উপরিতালে,	উপরিতলে,	
bondhukey,	বন্ধুকে,	বন্ধুকে,	
mugdha,	মুগীধা,	মুগ্ধ,	
oncoltike,	অনকোলটিকে,	অঞ্চলটিকে,	
saazano,	সাজানো,	সাজানো,	
shikare,	শিকারে,	শিকারে,	
mankisundar,	মানকিসুন্দর,	মানকিসুন্দর,	
kalakushalir,	কলাকুশালীর,	কলাকুশলীর,	
jemy,	জেয়াম,	জেমি,	
annanere,	আন্নানেরে,	অন্যানেরে,	
lirikti,	লিরিকটি,	লিরিকটি,	
sikkharrtheerao,	শিক্ষার্থীরাও,	শিক্ষার্থীরাও,	
ddebet,	ডিডেবে,	ডিবেট,	
azijer,	আজিজের,	আজিজের,	
madelim,	মাদেলিম,	মডেলিং,	
brekthrough,	ব্রেকথর্গ,	ব্রেকথ্রু,	
sbajan,	সোবাজন,	স্বজন,	
bhittow,	ভিত্ত,	ভিত্তিও,	
haripur,	হরিপুর,	হরিপুর,	
show,	শোভ,	শো,	
koreempoor,	করিমপুর,	করিমপুর,	
dhandu,	ধন্দু,	ধন্দু,	
jaaygata,	জায়গাটা,	জায়গাটা,	
bayii,	বায়ুই,	বাঈ,	
ghumacchilo,	ঘুমাচিলো,	ঘুমাচ্ছিল,	
ponero,	পনেরও,	পনের,	
catholicder,	ক্যাথলিটদের,	ক্যাথলিকদের,	
elakaate,	এলাকাতে,	এলাকাতে,	
hijritey,	হিজরিতে,	হিজরীতে,	
poriskoron,	পরিসকরণ,	পরিষ্করণ,	
nirdesika,	নির্দেসিকা,	নির্দেশিকা,	
aflatoxin,	আফলাট্টিন,	আ্যফ্ল্যাটক্সিন,	
ukeliptas,	ইউকেলিপ্তাস,	ইউক্যালিপ্টাস,	
chirkoot,	চিরকৌট,	চিরকুট,	
fud,	ফুড,	ফুড,	
naobihar,	নাওবিহার,	নৌবিহার,	
shhepha,	শেফা,	শেফ,	
lat,	ল্ট,	লাট,	
deh,	দেহ,	দেহ্,	
bahubar,	বাহুবার,	বহুবার,	
thanvi,	থানভি,	থানভী,	
dhaleshorii,	ধলেশরী,	ধলেশ্বরী,	
vvimsenn,	ভিভিমস্নেন,	ভীমসেন,	
juktorashtreo,	যুক্তরাষ্ট্রেও,	যুক্তরাষ্ট্রেও,	
nirbachakder,	নির্বাচকদের,	নির্বাচকদের,	
gabhaskaar,	গাভাসকার,	গাভাস্কার,	
samratder,	সম্রাতদের,	সম্রাটদের,	
grambaaseeder,	গ্রামবাসীদের,	গ্রামবাসীদের,	
ala,	আলা,	আলা,	
asbab,	আসবাব,	আসবাব,	
polashir,	পলাশির,	পলাশীর,	
teman,	তেমান,	তেমন,	
nirmol,	নির্মল,	নির্মল,	
futonta,	ফুটোট্টা,	ফুটন্ত,	
chapchap,	চাপচাপ,	চাপচাপ,	
korle,	করলে,	করলে,	
bhenom,	ভেনম,	ভেনম,	
teemothi,	তীমোথি,	টিমোথি,	
maladabha,	মালাদা,	মলদোভা,	
ameettrakkhor,	অমিত্রাক্ষর,	অমিত্রাক্ষর,	
roopmatro,	রূপমাত্র,	রূপমাত্র,	
confliqt,	কনফ্লিক্ট,	কনফ্লিক্ট,	
dhanak,	ধনক,	ধানক,	
kokeyin,	কোকেইন,	কোকেইন,	
samajik,	সামাজিক,	সামাজিক,	
dai,	দাই,	ডে,	
biplabee,	বিপ্লবী,	বিপ্লবী,	
khudrokar,	ক্ষুদ্রকার,	ক্ষুদ্রকার,	
artilary,	আর্টিলারি,	আর্টিলারি,	
khaaneker,	খানেকের,	খানেকের,	
chapal,	চাপাল,	চপল,	
browser,	ব্রোই়ারের,	ব্রাউজার,	
dheke,	ধেকে,	ঢেকে,	
satarka,	সাতারকা,	সতর্ক,	
jeelyaand,	জিল্যান্দ,	জিল্যান্ড,	
conflict,	কনফ্লিক্ট,	কনফ্লিক্ট,	
asamorik,	আসামরিক,	অসামরিক,	
sheepha,	শীফা,	শেফ,	
hizrite,	হিজরিতে,	হিজরীতে,	
ghotleo,	ঘটলেও,	ঘটলেও,	
porishongkhanbid,	পরিশংখ্যানবিদ,	পরিসংখ্যানবিদ,	
kirke,	কিরকে,	কিরকে,	
qarpeta,	কারপেটা,	কার্পেট,	
chhadura,	ছদুরা,	ছাদুরা,	
ghoshanapatratio,	ঘোষণাপত্রটিও,	ঘোষণাপত্রটিও,	
shunani,	শুনানি,	শুনানী,	
taffsherer,	তাফশেরের,	তাফসীরের,	
ingreziteo,	ইংরেজিতেও,	ইংরেজিতেও,	
redcrosser,	রেডক্রোসের,	রেডক্রসের,	
ranangane,	রণাঙ্গনে,	রণাঙ্গনে,	
chikitsanirbhar,	চিকিৎসানির্ভর,	চিকিৎসানির্ভর,	
ekspression,	এক্সপ্রেশন,	এক্সপ্রেশন,	
shhashtra,	ষাস্ট্রা,	শাস্ত্র,	
somratra,	সোমরাত্র,	সম্রাটরা,	
gananatyo,	গণনাত্ম,	গণনাট্য,	
chakurijibirao,	চাকুরিজীবিরাও,	চাকুরীজীবীরাও,	
bastubad,	বাস্তুবাদ,	বস্তুবাদ,	
gaandaas,	গান্দাস,	জ্ঞানদাস,	
chaudhuriyo,	চৌধুরিয়,	চৌধুরীও,	
tiger,	টিগের,	টাইগার,	
sahozlabhbhotar,	সহজলভভবতার,	সহজলভ্যতার,	
sarboshokteeman,	সর্বশক্তিমান,	সর্বশক্তিমান,	
bhardwaj,	ভারদ্বাজ,	ভরদ্বাজ,	
segulo,	সেগুলো,	সেগুলো,	
machhti,	মাছটি,	মাছটি,	
probhur,	প্রভুর,	প্রভুর,	
procharona,	প্রচারণা,	প্রচারণা,	
sipa,	সিপা,	শিপ,	
wagadada,	ওয়াগাদাদা,	বাগদাদ,	
tooku,	টোকু,	টুকু,	
niknayman,	নিক্নমমান,	নিকনেইমান,	
photanor,	ফটানোর,	ফোটানোর,	
jwar,	জ্বার,	জ্বর,	
goonoman,	গুনমান,	গুণমান,	
playtey,	প্লেইটে,	প্লেটে,	
gaichhe,	গাইছে,	গাইছে,	
pachchi,	পাচ্ছি,	পাচ্ছি,	
disposes,	ডিস্পোস,	ডিসপোজেস,	
mozdur,	মজদুর,	মজদুর,	
masjidsaho,	মসজিদসহ,	মসজিদসহ,	
francine,	ফ্রান্সিন,	ফ্রান্সিন,	
fatakasto,	ফাতাকাস্ত,	ফাটাকেষ্ট,	
saatzoner,	সাতজনের,	সাতজনের,	
shumo,	শুমো,	সুমো,	
soorsa,	সূর্স,	সোর্স,	
alimpiqa,	আলিমিপিকা,	অলিম্পিক,	
bondi,	বন্দী,	বন্দী,	
foreks,	ফোরেক্স,	ফরেক্স,	
chalachchitra,	চলচ্চিত্র,	চলচ্চিত্র,	
karmojog,	কার্যোোগ,	কর্মযোগ,	
chhatrodiger,	ছাত্রদিগের,	ছাত্রদিগের,	
shit,	শিত,	শীত,	
emiratas,	এমিরাতাস,	এমিরেটাস,	
choudhurike,	চৌধুরীকে,	চৌধুরীকে,	
creshcent,	ক্রেসচেন্ট,	ক্রিসেন্ট,	
logic,	লজিক,	লজিক,	
sahozlabhbhatar,	সহজলভাবতার,	সহজলভ্যতার,	
siddhanto,	সিদ্ধান্ত,	সিদ্ধান্তও,	
provur,	প্রভুর,	প্রভুর,	
torikher,	তরিখের,	তরিখের,	
plak,	প্ল্যাক,	প্ল্যাক,	
probhritike,	প্রভৃতিকে,	প্রভৃতিকে,	
bhalobaas,	ভালোবাস,	ভালোবাসা,	
borkhastokritora,	বরখাস্ত্মিকরা,	বরখাস্তকৃতরা,	
khorsed,	খোর্সেদ,	খোরশেদ,	
jalbe,	জালবে,	জ্বলবে,	
turista,	তুরিস্তা,	টুরিস্ট,	
seoul,	সেওয়েল,	সোল,	
monchosthol,	মঞ্চস্থল,	মঞ্চস্থল,	
collaborators,	কোলাবর্টরসহ,	কলাবরেটরস,	
kei,	কেই,	কেই,	
stonehenje,	স্টোনহেনজে,	স্টোনহেঞ্জ,	
ganoporibahoner,	গণপরিবহণের,	গণপরিবহনের,	
byabostho,	ব্যবস্থ,	ব্যাবস্থা,	
bouddher,	বৌদ্ধের,	বৌদ্ধের,	
dhojovongo,	ধ্বজভঙ্গ,	ধ্বজভঙ্গ,	
probeshkari,	প্রবেশকারী,	প্রবেশকারী,	
chanoo,	চানু,	চানু,	
dufresne,	ডুফ্রেন্স,	ডুফরেস্ন,	
hakone,	হাকনে,	হাকোনে,	
amar,	আমার,	আমর,	
protijogitamulok,	প্রতিযোগিতামূলক,	প্রতিযোগীতামূলক,	
jacksonke,	জ্যাকসনকে,	জ্যাকসনকে,	
manjushree,	মঞ্জুষ্রী,	মঞ্জুশ্রী,	
suchanakal,	সুচননকাল,	সূচনাকাল,	
doobate,	দউবাতে,	ডুবাতে,	
siit,	সিত,	শীত,	
sardar,	সারদার,	সরদার,	
bachhaikrito,	বাছাইকৃত,	বাছাইকৃত,	
nirikho,	নিরিখো,	নিরিখ,	
joisttho,	জৈষ্টত্,	জ্যৈষ্ঠ,	
mukhoshdharir,	মুখোষধারীর,	মুখোশধারীর,	
welcome,	ওয়েলকোম,	ওয়েলকাম,	
ghotaibe,	ঘটাইবে,	ঘটাইবে,	
onchalgulir,	অঞ্চলগুলির,	অঞ্চলগুলির,	
hojurer,	হজুরের,	হজুরের,	
jetam,	জেতম,	যেতাম,	
ebhara,	এভারা,	এভার,	
sondhisthaponer,	সন্ধিষ্ঠাসমের,	সন্ধিস্থাপনের,	
miitar,	মিতার,	মিত্র,	
marmader,	মারমাদের,	মারমাদের,	
chai,	চাই,	ছাই,	
erythrian,	এরিথ্রিয়ান,	এরিথ্রিয়ান,	
dorneca,	দর্নেকা,	ডরনেকা,	
thaanobhi,	থানোভী,	থানভী,	
greep,	গ্রিপ,	গ্রিপ,	
edic,	ইডিক,	এডিক,	
chuti,	চুটি,	ছুটি,	
nirbaho,	নির্বাহও,	নির্বাহ,	
maila,	মাইলা,	মাইল,	
otyacharito,	অত্যাচারিত,	অত্যাচারিত,	
kyatgarite,	ক্যাটগারিতে,	ক্যাটগারিতে,	
plack,	প্ল্যাক,	প্ল্যাক,	
nothivookta,	নথিভুক্ত,	নথিভুক্ত,	
shorifer,	শরিফের,	শরিফের,	
komanera,	কমানেরা,	কমানেরা,	
shringge,	শ্রীংগে,	শৃঙ্গে,	
keui,	কেউই,	কেউই,	
zubokder,	যুবকদের,	যুবকদের,	
mitrota,	মিত্রটা,	মিত্রতা,	
nowel,	নউবেল,	নভেল,	
poscime,	পশ্চিমে,	পশ্চিমে,	
dharavahiker,	ধারাবাহিকের,	ধারাবাহিকের,	
si,	সিই,	এসআই,	
akkelpure,	আক্কেলপুরে,	আক্কেলপুরে,	
laaishheshh,	লৈশশে,	লাইসেন্স,	
ongshogrohoner,	অংশগ্রহণের,	অংশগ্রহনের,	
borlen,	বোরলেন,	বরলেন,	
graambaashio,	গ্রামবাশীও,	গ্রামবাসীও,	
bosben,	বসবেন,	বসবেন,	
mokhmoley,	মোখমলে,	মখমলে,	
barder,	বার্দের,	বার্ডের,	
alraji,	আলরাজি,	আলরাজী,	
naitikatavodh,	নৈতিকতাবোধ,	নৈতিকতাবোধ,	
inapharameshana,	ইনাফরেশন,	ইনফরমেশন,	
bisshasi,	বিশ্সাসী,	বিশ্বাসী,	
kampita,	কাম্পিতা,	কম্পিত,	
difinishion,	ডিফিনশন,	ডেফিনেশন,	
jomoker,	জমকের,	জমকের,	
crime,	ক্রাইম,	ক্রাইম,	
shomser,	শমসের,	সমশের,	
mohajote,	মহাজোতে,	মহাজোট,	
mugdal,	মুগদাল,	মুগডাল,	
korimpur,	করিমপুর,	করিমপুর,	
aabarte,	আবার্তে,	আবর্তে,	
conflikt,	কনফ্লিক্ট,	কনফ্লিক্ট,	
bite,	বিতে,	বাইট,	
schilling,	স্লিলিং,	শিলিং,	
jonomukhi,	জনমুখী,	জনমুখী,	
spreedashita,	স্প্রীদাশিত,	স্প্রেডশীট,	
lesense,	লেসেন্সে,	লাইসেন্স,	
konar,	কোনার,	কণার,	
tricksguli,	ট্রিকসসগুলি,	ট্রিকসগুলি,	
sudrishya,	সুদৃশ্য,	সুদৃশ্য,	
hooldim,	হুল্ডিম,	হোল্ডিং,	
garora,	গ্যারোরা,	গারোরা,	
shasankorta,	শাসনকর্তা,	শাসনকর্তা,	
geja,	গেজ,	গেজ,	
bbiswashi,	ব্বিব্বাশী,	বিশ্বাসই,	
firalem,	ফিয়ারেম,	ফিরালেম,	
sumoo,	সুমৌ,	সুমো,	
brake,	ব্রেক,	ব্রেক,	
helly,	হেল্,	হিলি,	
bishwasho,	বিশ্বাসও,	বিশ্বাসও,	
pratijogitamulak,	প্রতিযোগিতামূলক,	প্রতিযোগীতামূলক,	
hert,	হার্ট,	হার্ট,	
phonekari,	ফোনেকারি,	ফোনকারী,	
deliver,	ডেলিভার,	ডেলিভার,	
ronodeep,	রণদীপ,	রণদীপ,	
poste,	পোস্তে,	পোস্টে,	
ganakantha,	গণকান্থা,	গণকণ্ঠ,	
kheylechen,	খেলেছেন,	খেলেছেন,	
sheshardhe,	শেষার্ধে,	শেষার্ধে,	
rakim,	রাকিম,	রাকিম,	
debdebie,	দেবদেবী,	দেবদেবী,	
chhaikalo,	ছাইকালো,	ছাইকালো,	
holuder,	হোলুদের,	হলুদের,	
deep,	দিপ,	দীপ,	
nagarikera,	নাগারিকেরা,	নাগরিকেরা,	
nathivukteer,	নাথিভুক্তির,	নথিভুক্তির,	
azaan,	আজানান,	আজান,	
toufiq,	তৌফিক,	তৌফিক,	
potka,	পটকা,	পটকা,	
iuro,	আইর়,	ইউরো,	
dhanyi,	ধননই,	ধন্যি,	
devolapar,	ডেভলোপার,	ডেভলপার,	
phox,	ফক্স,	ফক্স,	
temonvabe,	তেমনভাবে,	তেমনভাবে,	
akar,	আকার,	একার,	
houzgulite,	হাউজগুলিতে,	হাউজগুলিতে,	
udbhabaney,	উদ্ভাবনে,	উদ্ভাবনে,	
mailkhanek,	মাইলখানেক,	মাইলখানেক,	
hingsar,	হিংসার,	হিংসার,	
musallati,	মুসল্লাটি,	মুসল্লাটি,	
dakter,	ডাক্টের,	ডাকতের,	
poste,	পোস্তে,	পোষ্টে,	
bongshokey,	বংশকে,	বংশকে,	
ji,	জেই,	জি,	
narishwar,	নারীশ্বর,	নারীশ্বরের,	
osommotite,	অসম্মতিতে,	অসম্মতি,	
bhushito,	ভূষিত,	ভূষিত,	
soinyora,	সৈন্যরা,	সৈন্যরা,	
gandhiio,	গান্ধিও,	গান্ধীও,	
bonobhumi,	বনভূমি,	বনভূমি,	
shangkulaan,	সংকুল্নন,	সংকুলান,	
daaoon,	ডাউন,	ডাউন,	
dokaangulotey,	দোকানগুলোতে,	দোকানগুলোতে,	
alankorana,	অলঙ্করণা,	অলঙ্করণ,	
maudelti,	মড়েলটি,	মডেলটি,	
chatrorai,	ছাত্ররাই,	ছাত্ররাই,	
nirvaha,	নির্ভাহ,	নির্বাহ,	
bangulzai,	বাঙ্গুজলায়,	বঙ্গুলিজাই,	
orthonitir,	অর্থনীতির,	অর্থনীতির,	
ekhate,	এখাতে,	একহাতে,	
gamdan,	গামদান,	গামদান,	
philo,	ফাইলো,	ফিলো,	
osthisondhi,	অস্থিসন্ধি,	অস্থিসন্ধি,	
prakalpoguli,	প্রকালপগুলি,	প্রকল্পগুলি,	
moreecha,	মরিচা,	মরিচা,	
beila,	বেইলা,	বেইলা,	
titarer,	তিতারের,	তিতারের,	
thabai,	থাবাই,	থাবাই,	
bandra,	ব্ন্দ্রা,	বন্দীরা,	
elakatike,	এলাকাটিকে,	এলাকাটিকে,	
laaishenshh,	লেইশেনশ,	লাইসেন্স,	
kurdira,	কুর্দিরা,	কুর্দিরা,	
lajik,	লাজিক,	লজিক,	
ayantarqatiqa,	আযন্তর্কটিকা,	অ্যান্টার্কটিকা,	
chinto,	চিন্ত,	চিনতো,	
chhotogolper,	ছোটগল্পের,	ছোটগল্পের,	
ghaghat,	ঘাঘাট,	ঘাঘট,	
bhadaka,	ভাদাকা,	ভদকা,	
sahooseekotar,	সহহসিকতার,	সাহসিকতার,	
sikkhakromer,	শিক্ষাক্রমের,	শিক্ষাক্রমের,	
shlok,	শ্লোক,	শ্লোক,	
poriikkhateo,	পরীক্ষাতেও,	পরীক্ষাতেও,	
raiji,	রাইজি,	রাইজি,	
oncholshomuh,	অঞ্চলসমূহ,	অঞ্চলসমূহ,	
whole,	হোলে,	হোল,	
townshhip,	টেউশশিপ,	টাউনশিপ,	
gobeshokgon,	গবেষকগণ,	গবেষকগণ,	
ganaporibahaner,	গণপরিবাহনের,	গণপরিবহনের,	
shapad,	শাপাদ,	শ্বাপদ,	
dakkhinkare,	দক্ষিণকারে,	দক্ষিণকরে,	
lakkhero,	লক্ষেরও,	লক্ষেরও,	
dalnata,	দলনাটা,	ডালনাটা,	
popaike,	পোপাইকে,	পপাইকে,	
senabahineeow,	সেনাবাহিন্যইও,	সেনাবাহিনীও,	
pharn,	ফার্ন,	ফার্ন,	
meshenjar,	মেশেঞ্জার,	মেসেঞ্জার,	
paolasthi,	পাওলাস্থি,	পাওলাসথি,	
dephinishion,	ডেফিশনিস,	ডেফিনেশন,	
probhuder,	প্রভুদের,	প্রভুদের,	
diniphition,	ডিনিফিশন,	ডেফিনেশন,	
kompeeto,	কম্পিত,	কম্পিত,	
lyandim,	ল্যান্ডিং,	ল্যান্ডিং,	
bonshi,	বনশি,	বংশী,	
cxt,	সিসিসিটি,	সিএক্সটি,	
okkhorke,	অক্ষরকে,	অক্ষরকে,	
opohoron,	অপহরণ,	অপহরন,	
tolemy,	টোলেমি,	টলেমির,	
porobortii,	পরবর্তী,	পরর্বতী,	
jontropatigulite,	যন্ত্রপাতিগুলিতে,	যন্ত্রপাতিগুলিতে,	
liedtke,	লিডডেককে,	লইডটক,	
hitokor,	হিতকর,	হিতকর,	
summer,	সুমারের,	সামার,	
hafsa,	হাফসা,	হাফসা,	
jamjamat,	জমজামাত,	জমজমাট,	
bipradas,	বিপ্রদাস,	বিপ্রদাস,	
shukrabab,	শুক্রাবাব,	শুক্রবাব,	
themekey,	থেমেকে,	থিমকে,	
setikey,	সেটিকে,	সেটিকে,	
gandharir,	গান্ধারীর,	গান্ধারীর,	
ipl,	আইপিএল,	আইপিএল,	
akatwa,	অকাত্ব,	একাত্ব,	
daltyagi,	দল্ত্যাগী,	দলত্যাগী,	
korush,	করুশ,	ক্রুশ,	
daraider,	দারাইদের,	দরাইদের,	
adwanced,	অ্যাডভ্যান্ড,	অ্যাডভান্সড,	
nabatamo,	নবতম,	নবতম,	
rachanakal,	রচনাকাল,	রচনাকাল,	
olympik,	অল্মিপিক,	অলিম্পিক,	
somabeshti,	সমাবেশটি,	সমাবেশটি,	
mojdur,	মজদুর,	মজদুর,	
siddhantoke,	সিদ্ধান্তকে,	সিদ্ধান্তকে,	
primoo,	প্রিময়,	প্রিমো,	
bisnuke,	বিস্নুকে,	বিষ্ণুকে,	
aro,	আরো,	আরও,	
khagen,	খাগেন,	খগেন,	
groundta,	গ্রান্ডটা,	গ্রাউন্ডটা,	
patochitra,	পাতচিত্র,	পটচিত্র,	
raagee,	রাগী,	রাগী,	
baaiq,	বাইক,	বাইক,	
cheenja,	চেঞ্জা,	চেঞ্জ,	
drishyer,	দৃশ্যের,	দৃশ্যের,	
grauth,	গ্রাউথ,	গ্রোথ,	
bandhubhaabaapanna,	বন্ধুভাবপন্ন,	বন্ধুভাবাপন্ন,	
bamni,	বামনি,	বামনী,	
laagche,	লাগছে,	লাগছে,	
bhabarlaler,	ভবরলললের,	ভবরলালের,	
logotype,	লোকোটাইপ,	লোগোটাইপ,	
romancha,	রোমাঞ্চা,	রোমাঞ্চ,	
khanonkaj,	খননকাজ,	খননকাজ,	
mawdeel,	মাইডলীল,	মডেল,	
jotinkey,	জোটিংকে,	যতীনকে,	
sulfatee,	সেলফটি,	সালফেট,	
munot,	মুনোট,	মুনোট,	
mandondo,	মান্ডন্ড,	মানদণ্ড,	
taxikeo,	ট্যাক্সিকেও,	ট্যাক্সিকেও,	
seramiks,	সেরামিকস,	সিরামিকস,	
nimitte,	নিমিত্তে,	নিমিত্তে,	
bhotomulyoke,	ভোটমূল্যকে,	ভোটমূল্যকে,	
jothon,	যথন,	যথন,	
phutanta,	ফুটান্টা,	ফুটন্ত,	
vimsen,	ভিমসেন,	ভীমসেন,	
arasie,	আরাসি,	আরসিএ,	
mochlekha,	মোচলেখা,	মোছলেখা,	
gandogol,	গণ্ডোোল,	গন্ডগোল,	
durgatsabe,	দুর্গাৎসবে,	দুর্গোৎসবে,	
shrabosty,	শ্রাবস্তি,	শ্রাবস্তী,	
jaistho,	জয়স্থ,	জ্যৈষ্ঠ,	
shrabasti,	শ্রাবস্তি,	শ্রাবস্তী,	
nyata,	ন্যাতা,	ম্যাট,	
toranganj,	তোরাঙ্গজ,	তোরাবগঞ্জ,	
simons,	সিমনস্,	সিমন্স,	
kanshat,	কানশাত,	কানসাট,	
licenshe,	লাইসেন্সে,	লাইসেন্স,	
gemske,	জেম্সকে,	জেমসকে,	
kamti,	কামটি,	কমতি,	
adorsho,	আদর্শ,	আর্দশ,	
foxer,	ফক্সার,	ফক্সের,	
padee,	পদী,	পাড়ে,	
puding,	পুডিং,	পুডিং,	
sobrakamer,	সব্রাকামের,	সবরকমের,	
katateo,	কাটাতেও,	কাটাতেও,	
phund,	ফুন্ড,	ফান্ড,	
minister,	মিনিস্টার,	মিনিস্টার,	
stander,	স্ট্যান্ডের,	স্ট্যাণ্ডের,	
notey,	নটে,	নোটে,	
bonsho,	বনশো,	বংশ,	
omarader,	ওমারাদের,	ওমারাদের,	
deraa,	দেরা,	ডেরা,	
satarkatar,	সতর্কতার,	সতর্কতার,	
shamijir,	শামিজির,	স্বামীজীর,	
daltagi,	দালতগী,	দলত্যাগী,	
turky,	টার্কি,	তুর্কি,	
venisey,	ভেনিসি,	ভেনিসে,	
fulkapi,	ফুলকাপি,	ফুলকপি,	
udbodhani,	উদ্বোধনী,	উদ্বোধনী,	
nilfamarir,	নীলফামারির,	নীলফামারীর,	
kommandar,	কম্মান্ডার,	কমাণ্ডার,	
nischitvabe,	নিশ্চিতভাবে,	নিশ্চিতভাবে,	
sudrissho,	সুদৃশ্ধ,	সুদৃশ্য,	
kiuti,	কিউটি,	কিউটি,	
mukhomondoler,	মুখমন্ডলের,	মুখমণ্ডলের,	
keyu,	কেউয়ু,	কেউ,	
utotoro,	উততর,	উততর,	
dhhaabi,	ঢাবি,	ঢাবি,	
deool,	দেওলল,	দেউল,	
uporzon,	উপরজন,	উপার্জন,	
behrampurer,	বেহরামপুরের,	বহরমপুরের,	
juktorastrer,	যুক্তরাস্ত্রের,	যুক্তরাষ্ট্রের,	
vaibon,	ভাইবন,	ভাইবোন,	
irana,	ইরানা,	ইরান,	
gujob,	গুজব,	গুজব,	
suporichita,	সুপরিচিত,	সুপরিচিত,	
ghoomachhilo,	ঘুমাছিল,	ঘুমাচ্ছিল,	
shainyader,	শৈযন্দাদের,	সৈন্যদের,	
pariyech,	পারিয়েছ,	পরিয়েছ,	
jens,	জেনস,	জিন্স,	
chokhwala,	চোখবোলা,	চোখওয়ালা,	
parinati,	পরিণতি,	পরিণতি,	
chalachchitro,	চলচ্ছিত্র,	চলচ্চিত্র,	
langhaner,	লঙ্ঘনের,	লংঘনের,	
smarak,	স্মরক,	স্মারক,	
highcomissione,	হাইকোমিসনে,	হাইকমিশনে,	
shashtra,	শাস্ত্র,	শাস্ত্র,	
janar,	জানার,	জানার,	
konagoolo,	কননগোলো,	কণাগুলো,	
taler,	তালের,	তালের,	
chaudhurio,	চৌধুরিও,	চৌধুরীও,	
shudhir,	শুধীর,	শুধীর,	
change,	ছ্যাঙ্গে,	চেঞ্জ,	
ganokantha,	গণকণ্ঠা,	গণকণ্ঠ,	
makame,	মাকামে,	মাকামে,	
sarbhare,	সর্ারে,	সার্ভারে,	
chalchhe,	চাল্ছে,	চলছে,	
fatkabazare,	ফাটকাবাজারে,	ফাটকাবাজারে,	
protistha,	প্রতিষ্ঠা,	প্রতিষ্টা,	
coons,	কা্ন,	কুনস,	
uparjon,	উপারজন,	উপার্জন,	
holding,	হোল্ডিং,	হোল্ডিং,	
krema,	ক্রেম,	ক্রাইম,	
bhogni,	ভোগনি,	ভগ্নী,	
mujuru,	মুজুরু,	মুজুরু,	
purohitra,	পুরোহিত্র,	পুরোহিতরা,	
hisaber,	হিসাবের,	হিসাবের,	
jocqey,	জেকি,	জকি,	
jolbe,	জলবে,	জ্বলবে,	
pretti,	প্রেত্তি,	প্রিটি,	
rushad,	রুশাদ,	রুশদ,	
residensa,	রেসিডেনসা,	রেসিডেন্স,	
ateetkale,	অতীতকালে,	অতীতকালে,	
prosadhoni,	প্রসাধনী,	প্রসাধনী,	
dokanei,	দোকানেই,	দোকানেই,	
magical,	ম্যাগিক্যাল,	ম্যাজিকাল,	
durlabhatwang,	দুর্লভতবাং,	দুর্লভত্বং,	
foxcon,	ফক্সকন,	ফক্সকন,	
carbus,	কার্বাস,	কারবাস,	
nabotom,	নবতম,	নবতম,	
mausumeo,	মৌসুমেও,	মৌসুমেও,	
oitijhyotike,	ঐতিহ্যটিকে,	ঐতিহ্যটিকে,	
postar,	পোস্টার,	পোস্টের,	
sharifpur,	শরীফপুর,	শরিফপুর,	
romjaner,	রোম্জনের,	রমযানের,	
bedanta,	বেদান্ত,	বেদান্ত,	
kod,	কড়,	কোড,	
ishahak,	ইশাহাক,	ইসাহাক,	
teksuser,	টেকসুসের,	টেক্সাসের,	
shahabike,	শাহাবিকে,	সাহাবীকে,	
suraropito,	সুরারোপিত,	সুরারোপিত,	
tasminer,	তাসমিনের,	তাসমিনের,	
seebiai,	সেবিয়াই,	সিবিআই,	
nariderke,	নারীদেরকে,	নারীদেরকে,	
kharavel,	খারাভেল,	খারবেল,	
panthar,	পান্থর,	পন্থার,	
nariderke,	নারীদেরকে,	নারিদেরকে,	
graambasheeo,	গ্রামবাশীও,	গ্রামবাসীও,	
sombhobonaao,	সম্ভবনাও,	সম্ভবনাও,	
kareer,	কারির,	কারীর,	
spredashita,	স্প্রেদাশিতা,	স্প্রেডশীট,	
artore,	আর্তোর,	আর্টরে,	
sampadon,	সম্পাদন,	সম্পাদন,	
bhenicer,	ভেনিকের,	ভেনিসের,	
thyachara,	থ্যাচরা,	থ্যাচার,	
barnis,	ব্রননিস,	বার্নিশ,	
anchalgulir,	অঞ্চলগুলির,	অঞ্চলগুলির,	
ernad,	এরনাদ,	এরনাড,	
sangitanusthane,	সঙ্গীতানুষ্ঠানে,	সঙ্গীতানুষ্ঠানে,	
bosontoke,	বসন্তকে,	বসন্তকে,	
modhumotii,	মধুমতিই,	মধুমতী,	
jhijhi,	ঝিঝি,	ঝিঝি,	
guha,	গুহা,	গোহ,	
transhapharma,	ট্রান্সফর্ম,	ট্রান্সফর্ম,	
temanti,	তেমন্টি,	তেমনটি,	
arsie,	আর্সি,	আরসিএ,	
teoyana,	তেওয়ানা,	তাইওয়ান,	
srisri,	শ্রীশ্রী,	শ্রীশ্রী,	
direqtareta,	ডিরেক্টরেট,	ডিরেক্টরেট,	
cholchhee,	চলচি,	চলছে,	
billaho,	বিল্লাহো,	বিল্লাহ,	
lekhaksattwar,	লেখকসত্ত্বার,	লেখকসত্ত্বার,	
durgotsabe,	দুর্গতৎাবে,	দুর্গোৎসবে,	
ekroop,	একরূপ,	একরূপ,	
dapadpi,	দাপদপি,	দাপাদপি,	
muktijuddhojato,	মুক্তিযুদ্ধায়ত,	মুক্তিযুদ্ধজাত,	
sanghitar,	সংহিতার,	সংহিতার,	
freelancerra,	ফ্রীল্যান্সরা,	ফ্রিল্যান্সাররা,	
milayatane,	মিলায়তানে,	মিলায়তনে,	
nagorikota,	নাগরিকতা,	নাগরিকতা,	
shikshagato,	শিক্ষাত,	শিক্ষাগত,	
courtcaser,	কাউট্ক্সেসের,	কোর্টকেসের,	
karaponner,	কারাপন্নের,	কারাপণ্যের,	
ranangone,	রণাঙ্গনে,	রণাঙ্গনে,	
jipiusamriddha,	জীপিসমুদ্ধ,	জিপিউসমৃদ্ধ,	
srivatsalakshanang,	শ্রীবাস্থক্ষাংাং,	শ্রীবৎসলক্ষণং,	
daktikit,	ডাক্তিকিট,	ডাকটিকিট,	
qrisenta,	ক্রিসেন্টা,	ক্রিসেন্ট,	
shulfate,	শুলফাতে,	সালফেট,	
antorvuktimulak,	আন্তর্ভকুতিকূলক,	অন্তর্ভুক্তিমূলক,	
khappar,	খপপার,	খপ্পর,	
goteehin,	গতিহীন,	গতিহীন,	
votarer,	ভোটারের,	ভোটারের,	
chhanada,	ছানাদা,	ছানাদা,	
bisheshyo,	বিশেষ্য,	বিশেষ্য,	
dijijer,	দিজিজের,	ডিজিজের,	
thare,	তারা,	থরে,	
fitarsaho,	ফিতারসহ,	ফিতরসহ,	
ivil,	ইভিল,	ইভিল,	
ikbaaler,	ইকবালের,	ইকবালের,	
buddhitii,	বুদ্ধিটিই,	বুদ্ধিটিই,	
mitroder,	মিত্রদের,	মিত্রদের,	
akhhunno,	অখুন্ন,	অক্ষুণ্ণ,	
khanabale,	খানাবালে,	খানাবলে,	
aakabar,	আকাবার,	আকাবার,	
hoteltee,	হোটেলটি,	হোটেলটি,	
pratool,	প্রাটুল,	প্রতুল,	
jeher,	জেহের,	জেহের,	
orunima,	ওরুনিমা,	অরুণিমা,	
dabliudabliui,	ডাবলিউডববিউউল,	ডাব্লিউডাব্লিউই,	
prothati,	প্রথাটি,	প্রথাটি,	
pacchi,	পাচচি,	পাচ্ছি,	
neerbachoker,	নের্বাচকের,	নির্বাচকের,	
baikalyo,	বাইকল্য,	বৈকল্য,	
nathivookto,	নাথিভুক্ত,	নথিভুক্ত,	
monur,	মনুর,	মনুর,	
akhandata,	অখণ্ডতা,	অখণ্ডতা,	
gitikobita,	গীতিকবিতা,	গীতিকবিতা,	
reejideencee,	রেজিডিন্টে,	রেসিডেন্স,	
inafarameshana,	ইনাফরেশনে,	ইনফরমেশন,	
aranyani,	অরণ্যনী,	অরণ্যানী,	
chikitshar,	চিকিৎসার,	চিকিত্সার,	
arshie,	আর্শি,	আরসিএ,	
sqirt,	স্কার্ট,	স্কার্ট,	
neshnos,	নেশনোস,	নেশনস,	
eeksapreeshana,	এক্সপ্রীশন,	এক্সপ্রেশন,	
oitijhya,	ঐতিহ্য,	ঐতিহ্য,	
akreetokarjo,	আকৃতকার্য্য,	অকৃতকার্য,	
shuperheiro,	শুপারহিইরোর,	সুপারহিরো,	
survative,	সার্ভটিভ,	সারভেটিভ,	
sharthe,	সার্থে,	স্বার্থে,	
jund,	জান্ড,	জুন্দ,	
atibiplabi,	অতিবিপ্লবি,	অতিবিপ্লবি,	
brittakare,	বৃত্তকারে,	বৃত্তাকারে,	
turkii,	তুরকি,	তুর্কি,	
pravura,	প্রবুরা,	প্রভুরা,	
fand,	ফ্যান্ড,	ফান্ড,	
distance,	ডিসট্যান্স,	ডিসট্যান্স,	
rubala,	রুবালা,	রুবল,	
treebhuj,	ত্রিভূজ,	ত্রিভূজ,	
cheekitsar,	চিকিৎসার,	চিকিত্সার,	
enamela,	এনামেলা,	এনামেল,	
chilona,	চিলোনা,	ছিলনা,	
fake,	ফাক,	ফাকে,	
chhooteete,	ছোটিতে,	ছুটিতে,	
bitertrate,	বিটারট্রেট,	বাইটারট্রেট,	
sealvi,	সিলভি,	সিলভি,	
kingsh,	কিংশ,	কিংস,	
shchalastic,	স্ক্যালাস্টিক,	স্কলাস্টিক,	
saamaanya,	সামন্যা,	সামান্য,	
grotha,	গ্রোথা,	গ্রোথ,	
basab,	বাসাব,	বাসাব,	
tirmijii,	তির্জিমী,	তিরমিজি,	
shcholastic,	স্কোল্যাস্টিক,	স্কলাস্টিক,	
suparichiti,	সুপরিচিতি,	সুপরিচিতি,	
black,	ব্ল্যাক,	ব্ল্যাক,	
shakar,	শাকার,	সকার,	
badaghat,	বাদাঘাট,	বাদাঘাট,	
bhittimul,	ভিত্তিমূল,	ভিত্তিমূল,	
noitik,	নৈটিক,	নৈতিক,	
mentither,	মেনটিটের,	মেনটিথের,	
bitlaser,	বিটলাসের,	বিটলসের,	
turbine,	টারবিনে,	টারবাইন,	
haridware,	হরিদ্বারে,	হরিদ্বারে,	
gingbhalobasen,	গিনগোলাভাসেন,	গিংভালোবাসেন,	
as,	এসই,	অস,	
qirq,	কির্ক,	কার্ক,	
abheedhaneek,	অভিধানিক,	অভিধানিক,	
ashor,	আশোর,	আসর,	
bhandar,	ভান্ডার,	ভাণ্ডার,	
ekirokom,	একিরকম,	একইরকম,	
hosney,	হোসনে,	হোসনে,	
ixprission,	এক্সপ্রিশন,	এক্সপ্রেশন,	
manoharpur,	মনোহারপুর,	মনোহরপুর,	
ostheesandhi,	অস্থিসন্ধি,	অস্থিসন্ধি,	
emarjenshi,	এমারজেনশি,	এমার্জেন্সি,	
abheedhaaneek,	অভিধানিক,	অভিধানিক,	
licensedhari,	লাইসেন্সধারী,	লাইসেন্সধারী,	
shector,	শেক্টর,	সেক্টর,	
madrasi,	মাদ্রাসী,	মাদ্রাজি,	
ceramiksh,	সেরামিক্স,	সিরামিকস,	
argead,	আর্জিড,	আর্জিদ,	
sommotite,	সম্মতিতে,	সম্মতিতে,	
cheento,	চেন্তো,	চিনতো,	
khoka,	খোকা,	খোকা,	
bedantodhormo,	বেদান্তর্ম,	বেদান্তধর্ম,	
khuizza,	খুইজ্জা,	খুইজ্জা,	
qaferderkey,	কাফেরদেরকে,	কাফেরদেরকে,	
deaubande,	দেউউন্্ডে,	দেওবন্দে,	
conservetion,	কনজারভেশন,	কনসারভেশন,	
noditir,	নদীতির,	নদীটির,	
sadeep,	সদীপ,	সদীপ,	
labonaaktotaar,	লবণযাত্তার,	লবণাক্ততার,	
prokolpogulor,	প্রকল্পগুলোর,	প্রকল্পগুলোর,	
byabosthar,	ব্যবস্থার,	ব্যবস্থার,	
euqalyptus,	ইউক্লাল্টিউসা,	ইউক্যালিপ্টাস,	
bheenisa,	ভিনিসা,	ভেনিস,	
slatgulor,	স্ল্যাটগুলোর,	স্ল্যাটগুলোর,	
shikkhakram,	শিক্ষাক্রম,	শিক্ষাক্রম,	
qarlosa,	কারলোসা,	কার্লোস,	
bishaashke,	বিশাশকে,	বিশ্বাসকে,	
mosharroph,	মশার্োপ,	মশাররফ,	
rokibul,	রকিবুল,	রকিবুল,	
vezano,	ভেজানো,	ভেজানো,	
bhugol,	ভুগোল,	ভূগোল,	
sikarer,	সিকারের,	শিকারের,	
rajtontre,	রাজতন্ত্রে,	রাজতন্ত্রে,	
sathik,	সাথিক,	সঠিক,	
manibhaijaner,	মনিভাইজনের,	মণিভাইজানের,	
addhattikotar,	অদ্ধাত্মকতার,	আধ্যাত্মিকতার,	
goolen,	গোলেন,	গুলেন,	
vromonkaley,	ভ্রমণকালে,	ভ্রমণকালে,	
apolokbhabe,	আপলকভাবে,	অপলকভাবে,	
teunar,	তেউনার,	টিউনার,	
oisamoyer,	ঐসময়ের,	ঐসময়ের,	
beetloser,	বিটলসের,	বিটলসের,	
ardasha,	আর্দশ,	আর্দশ,	
gosthike,	গোষ্ঠীকে,	গোষ্ঠীকে,	
koro,	কোরো,	করো,	
teennis,	টেনিস,	টেনিস,	
messengerer,	মেসেঞ্জারের,	মেসেঞ্জারের,	
nagorikra,	নাগোিকরা,	নাগরিকরা,	
gonona,	গনোনা,	গননা,	
kaferderke,	কাফেরদেরকে,	কাফেরদেরকে,	
byaktikegreptar,	ব্যক্তিকেৎবরেপার,	ব্যক্তিকেগ্রেপ্তার,	
female,	ফেমালে,	ফিমেল,	
shucharita,	শুচারিতা,	সুচরিতা,	
krom,	ক্রম,	ক্রম,	
tolemyr,	তোলেমির,	টলেমির,	
dologuloo,	দলগুলো,	দলগুলোও,	
iub,	আইউবি,	আইইউবি,	
dakteekiter,	ডক্তিকিতের,	ডাকটিকিটের,	
songasthatir,	সংস্থাটির,	সংস্থাটির,	
jhalkanite,	ঝালকানিতে,	ঝলকানীতে,	
raagei,	রাগেই,	রাগেই,	
joubankal,	যৌবনকাল,	যৌবনকাল,	
vedanta,	ভেদন্ত,	বেদান্ত,	
ponjikar,	পনজিকার,	পঞ্জিকার,	
raghubar,	রঘঘুর,	রঘুবীর,	
kosambir,	কোসাম্বীর,	কোসাম্বীর,	
proshtutkarok,	প্রশ্তুতকারক,	প্রস্তুতকারক,	
dajjha,	দজঝা,	দাহ্য,	
jahara,	জাহারা,	যাহরা,	
sweety,	স্বিটি,	সুইটি,	
suhayeler,	সুহায়েলের,	সুহায়েলের,	
paikgachha,	পাইকগাছা,	পাইকগাছা,	
osamarik,	ওসামারিক,	অসামরিক,	
lokhindorer,	লোখিন্দরের,	লখিন্দরের,	
miraqela,	মিরাকেলা,	মিরাকেল,	
vesselli,	ভেসেলি,	ভেসেলি,	
mandanda,	মন্দন্ড,	মানদণ্ড,	
lettere,	লেটারে,	লেটারে,	
hood,	হুড,	হুড,	
cholochchitra,	চলচ্চিত্র,	চলচ্চিত্র,	
keuoi,	কেউই,	কেউই,	
kabutorer,	কবুতরের,	কবুতরের,	
ahong,	আহং,	অহং,	
soommita,	সুমিতা,	সুমিতা,	
sombhobonao,	সম্ভবনাও,	সম্ভবনাও,	
duburir,	ডুবুরির,	ডুবুরির,	
chhedon,	ছেদন,	ছেদন,	
ishtone,	ইস্তনে,	স্টোন,	
remacri,	রিমাক্রি,	রেমাক্রী,	
jathartho,	যথার্থ,	যথার্থ,	
taateo,	টাতেও,	তাতেও,	
kinsa,	কিন্স,	কিংস,	
sadadyarao,	সদাদ্যরাও,	সদদ্যরাও,	
kormoke,	কর্মকে,	কর্মকে,	
rajyotiro,	রাজ্যটিরও,	রাজ্যটিরও,	
ooipokar,	আউপকার,	উইপোকার,	
grontho,	গ্রন্থ,	গ্রন্থ,	
pathkrom,	পাঠক্রম,	পাঠক্রম,	
dhalur,	ধালুর,	ঢালুর,	
homsher,	হোমশের,	হোমসের,	
graambasi,	গ্রামবাসী,	গ্রামবাসী,	
suisharke,	সুইশরকে,	সুইশারকে,	
bhorkendra,	ভোরকেন্দ্র,	ভরকেন্দ্র,	
salmaner,	সালমানের,	সালমানের,	
udbhaboni,	উদ্ভাবনী,	উদ্ভাবনী,	
prachando,	প্রচাঁদ,	প্রচণ্ড,	
adhikartai,	অধিকারটাই,	অধিকর্তাই,	
taroni,	তারণী,	তরণী,	
dibya,	দিব্যা,	দিব্যা,	
shakara,	সাকারা,	সাকার,	
neelfamarir,	নেলফামারীর,	নীলফামারীর,	
badhamuktovabe,	বাধামুক্তভাবে,	বাধামুক্তভাবে,	
ansarir,	আনসারীর,	আনসারীর,	
gaj,	গাজ,	গেজ,	
jansha,	জানশা,	জন্স,	
roopdan,	রূপদান,	রুপদান,	
kakhnoba,	কাখবো,	কখনওবা,	
duhsthanostho,	দুঃস্থানস্থ,	দুঃস্থানস্থ,	
moorali,	মোরালী,	মুরলী,	
leaders,	লিডারস,	লিডার্স,	
yak,	যাক,	ইয়াক,	
sithilotar,	শিথিলতার,	শিথিলতার,	
khabarsoho,	খাবারসহ,	খাবারসহ,	
huqa,	হুকা,	হুক,	
byomkesh,	ব্যামকেশ,	ব্যোমকেশ,	
madhoori,	মধূরী,	মাধুরী,	
mulyabriddhikale,	মূল্যবৃদ্ধিকালে,	মূল্যবৃদ্ধিকালে,	
sten,	স্টেন,	স্টেন,	
karmake,	কারমেকে,	কর্মকে,	
veemsen,	ভিমসেন,	ভীমসেন,	
koruna,	কোরুনা,	করুণা,	
lebina,	লেবিনা,	লেবিনা,	
deenes,	ডেনেস,	দীনেশ,	
atarkitey,	অতর্কিতে,	অতর্কিতে,	
chitronattakar,	চিত্রনাট্যাকার,	চিত্রনাট্যকার,	
phising,	ফিসিং,	ফিসিং,	
premoronge,	প্রেমরঙ্গে,	প্রেমরঙে,	
patininda,	পাতিন্দা,	পতিনিন্দ,	
impaction,	ইম্প্যাকশন,	ইমপ্যাকশন,	
dhauto,	ধৌত,	ধৌত,	
ronangane,	রোনাঙ্গনে,	রণাঙ্গনে,	
scoore,	স্কোর,	স্কোর,	
shten,	স্টেন,	স্টেন,	
balithubar,	বলিথবার,	বালিথুবার,	
cinematographar,	সিনেমাট্টোগ্রাফার,	সিনেমাটোগ্রাফার,	
caroline,	ক্যারোলাইন,	ক্যরোলিন,	
noitikota,	নৈতিকতা,	নৈতিকতা,	
bonnopran,	বন্যপ্রাণ,	বন্যপ্রাণ,	
alumni,	আলুমনি,	অ্যালমনি,	
siddhanter,	সিদ্ধান্তের,	সিদ্ধান্তের,	
proboleme,	প্রবলেমে,	প্রবলেমে,	
elaakaati,	এলাকাকি,	এলাকাটি,	
nathivukta,	নথিভুক্ত,	নথিভুক্ত,	
planeti,	প্লানেতি,	প্লেনটি,	
orthobochorke,	অর্থবছরকে,	অর্থবছরকে,	
avetar,	আভেতার,	অবতার,	
eporjonto,	এপরজন্ত,	এপর্যন্ত,	
rajpur,	রাজপুর,	রাজপুর,	
suiti,	সুইটি,	সুইটি,	
marmaraa,	মারমারা,	মারমারা,	
swartho,	স্বার্থ,	স্বার্থ,	
pitiler,	পিতিলের,	পিটিলের,	
zaire,	জায়ের,	জাইরে,	
ekbai,	একবাই,	একবাই,	
foks,	ফক্স,	ফক্স,	
maudelder,	মডডেলদের,	মডেলদের,	
bidyadanke,	বিদ্যাদানকে,	বিদ্যাদানকে,	
prokalpagulo,	প্রকালপগুলো,	প্রকল্পগুলো,	
nanabornobishishto,	নানাবর্ণবিশিষ্ট,	নানাবর্ণবিশিষ্ট,	
riazuddin,	রিয়াজউদ্দিন,	রিয়াজউদ্দীন,	
maley,	মালি,	মালে,	
byaktigotovabeo,	ব্যক্তিগতভাবেও,	ব্যাক্তিগতভাবেও,	
tunaita,	টুনাইটা,	টুনাইট,	
jerusalemer,	জেরুসালেমের,	জেরুজালেমের,	
wilderske,	উইলডার্সকে,	উইল্ডার্সকে,	
sohojlovyotar,	সহজলভোভতার,	সহজলভ্যতার,	
shatokeo,	শাটকেও,	শতকেও,	
koota,	কোট,	কোটা,	
obosore,	অবসরে,	অবসরে,	
golimodhye,	গলিমধ্যে,	গলিমধ্যে,	
zarniz,	জার্নিজ,	জারনিজ,	
addata,	আদ্ডাতা,	আড্ডাটা,	
patrol,	পাত্রল,	পেট্রোল,	
turkyder,	টার্কডার,	তুর্কিদের,	
kanshater,	কানশাতের,	কানসাটের,	
amanisha,	আমানিশা,	অমানিশা,	
shektore,	শেক্তরে,	সেক্টরে,	
saqara,	সাকারা,	সকার,	
rajan,	রাজন,	রাজন,	
klaud,	ক্লাড,	ক্লাউড,	
maktum,	মাকতুম,	মাকতুম,	
moomtaj,	মুমতাজ,	মুমতাজ,	
elakatite,	এলাকাটিতে,	এলাকাটিকে,	
ooipoka,	উউপকা,	উইপোকা,	
manatmulak,	মণতমুলাল,	মানতমূলক,	
mail,	মাইল,	মাইল,	
dhonni,	ধন্নি,	ধন্যি,	
prrajanankaal,	প্রমাণজনকাল,	প্রজননকাল,	
ashamarthita,	আশামার্থিতা,	অসমর্থিত,	
gunje,	গুঞ্জে,	গুঁজে,	
taalaal,	তালাল,	তালাল,	
dormetori,	দরমেতররি,	ডরমিটরি,	
capsule,	ক্যাপসুলে,	ক্যাপ্সুল,	
chorchita,	চর্চিতা,	চর্চিত,	
innahu,	ইনাাহু,	ইন্নাহু,	
madhnagar,	মাধনগর,	মাধনগরের,	
sayanaida,	সায়নদা,	সায়ানাইড,	
laishenshim,	লাইশেনশম,	লাইসেন্সিং,	
aqram,	আকরাম,	আকরাম,	
antercticker,	অ্যান্টারক্টিকের,	অ্যান্টার্কটিকের,	
anchalgoolir,	আঞ্চলগুলির,	অঞ্চলগুলির,	
thechar,	থেচর,	থ্যাচার,	
uter,	ইউটার,	উটের,	
shikara,	শিকারা,	শিকার,	
binee,	বিনী,	বেনি,	
olympic,	অলিম্পিক,	অলিম্পিক,	
chorban,	চোরবান,	চর্বন,	
songbadmadhyame,	সংবাদমাধ্যমে,	সংবাদমাধ্যমে,	
nisader,	নিসাদের,	নিষাদের,	
mitro,	মিত্রো,	মিত্র,	
jaatti,	যাত্তি,	জাতটি,	
monzeele,	মনজিলে,	মঞ্জিলে,	
jaanar,	যানার,	জানার,	
longhan,	লঙ্ঘন,	লংঘন,	
uthaney,	উঠানে,	উঠানে,	
modele,	মডেলে,	মডেলে,	
scholastic,	স্কোলাস্টিক,	স্কলাস্টিক,	
jakso,	জাকসো,	যক্ষ,	
adhunikkaley,	আধুনিককালে,	আধুনিককালে,	
jomjamat,	জম্মাাত,	জমজমাট,	
joubanbatee,	যৌবনবাতি,	যৌবনবতী,	
ukeliptash,	উকেলিপ্তাশ,	ইউক্যালিপ্টাস,	
byomkes,	ব্যামকেস,	ব্যোমকেশ,	
godamjato,	গদামজাত,	গুদামজাত,	
joumana,	জৌমানা,	জুমানা,	
beshyasdone,	বেশ্যাসদনে,	বেশ্যাসদনে,	
swajan,	স্বজন,	স্বজন,	
lutheerana,	লুথিরানা,	লুথেরান,	
ancholsaha,	আঞ্চলসহ,	অঞ্চলসহ,	
nutoner,	নুটনের,	নূতনের,	
antorvukta,	আন্তরভূক্ত,	অন্তর্ভুক্ত,	
mousumeo,	মৌসুমেও,	মৌসুমেও,	
bupher,	বাউফার,	বাফার,	
meropenemer,	মেরোপেনের,	মেরোপেনেমের,	
judge,	জুম্গে,	জাজ,	
baipash,	বাইপাশ,	বাইপাস,	
khitkar,	খিটকার,	ক্ষিতকর,	
falak,	ফালাক,	ফলক,	
jackey,	জ্যাকে,	জকি,	
nodnodeer,	নদ্দীর,	নদনদীর,	
madaspushto,	মাদাসপুষ্ট,	মদদপুষ্ট,	
duiekdiner,	দুই়েকদিনের,	দুইএকদিনের,	
rudroke,	রুদ্রকে,	রুদ্রকে,	
digrir,	ডিগ্রির,	ডিগ্রির,	
probeshan,	প্রবেশন,	প্রবেশন,	
graambaashee,	গ্রামবাশী,	গ্রামবাসী,	
bhalobasar,	ভালোবাসার,	ভালোবাসার,	
safiin,	সাফিন,	সাফিন,	
parqim,	পারকিম,	পার্কিং,	
chargar,	চারগর,	চার্জার,	
ekok,	একক,	একক,	
pustir,	পুস্তির,	পুষ্টির,	
jyesthaa,	জ্যেষ্ঠা,	জ্যেষ্ঠা,	
gaujano,	গৌজানো,	গজানো,	
omeettrakkhor,	অমিত্তাক্ষর,	অমিত্রাক্ষর,	
heerani,	হিরানী,	হিরানি,	
iqbalke,	ইকবালকে,	ইকবালকে,	
labonaktatar,	লবণকাত্তার,	লবণাক্ততার,	
cholochchitraeeo,	চলচ্চিত্রীও,	চলচ্চিত্রেও,	
chomski,	চমস্কি,	চমস্কি,	
bajite,	বাজিতে,	বাজিতে,	
kaley,	কালে,	কালে,	
moushumei,	মৌশুমেই,	মৌসুমেই,	
humira,	হুমিরা,	হুমিরা,	
mookhomaundoler,	মোখোমোন্ডলের,	মুখমণ্ডলের,	
agaldar,	আগলদার,	আগলদার,	
oncholgulir,	অঞ্চলগুলির,	অঞ্চলগুলির,	
aagera,	আগেরা,	আগোরা,	
atmira,	আত্মিরা,	আত্মীরা,	
hydrological,	হাইড্রোলজিক্যাল,	হাইড্রোলজিক্যাল,	
lyaanding,	ল্যান্ডিং,	ল্যান্ডিং,	
kayed,	কায়েদ,	কায়েদ,	
eporzonto,	এপরজন্ত,	এপর্যন্ত,	
groth,	গ্রোথ,	গ্রোথ,	
windows,	উইন্ডওয়াস,	উইন্ডোস,	
aanaan,	আনানান,	আনান,	
borendroke,	বরেন্দ্রকে,	বরেন্দ্রকে,	
uponeeshod,	উপনেশব,	উপনিষদ,	
vabaponno,	ভাবাপন্ন,	ভাবাপন্ন,	
graambaaseeo,	গ্রামবাসিও,	গ্রামবাসীও,	
shaahaabiike,	সাহাবিকে,	সাহাবীকে,	
firoze,	ফিরোজে,	ফিরোজ,	
temonbhabe,	তেমনভাবে,	তেমনভাবে,	
nachar,	নাচার,	নাচার,	
pleta,	প্লেট,	প্লেটো,	
venush,	ভেনুষ,	ভেনাস,	
youth,	যুথ,	ইয়ুথ,	
laesens,	লেইনেস,	লাইসেন্স,	
vaticaner,	ভ্যাটিকানের,	ভ্যাটিকানের,	
prokolpoti,	প্রকল্পটি,	প্রকল্পটি,	
boikalyo,	বৈকল্য,	বৈকল্য,	
protisthan,	প্রতিষ্ঠান,	প্রতিষ্টান,	
chouhate,	চৌহাতে,	চৌহাটে,	
protijogi,	প্রতিযোগী,	প্রতিযোগী,	
vaabnake,	ভাবনাকে,	ভাবনাকে,	
purbanchaler,	পূর্বাঞ্চলের,	পূর্বাঞ্চলের,	
mexicoteo,	মেক্সিকোটেও,	মেক্সিকোতেও,	
qredita,	ক্রেদিতা,	ক্রেডিট,	
mirakela,	মিরাকেলা,	মিরাকেল,	
totokhon,	ততখন,	ততক্ষন,	
shommotir,	সম্মতির,	সম্মতির,	
fasir,	ফাসির,	ফাসীর,	
pare,	পরর,	পাড়ে,	
sportstar,	স্পোর্টস্টার,	স্পোর্টসস্টার,	
jins,	জিনস,	জিন্স,	
ragee,	রাগী,	রাগী,	
bhowanipur,	ভৌবানীপুর,	ভবানীপুর,	
seqtara,	সেক্টর,	সেক্টর,	
ghumachche,	ঘুমাচ্ছে,	ঘুমাচ্ছে,	
flexta,	ফ্লেক্সটা,	ফ্লেক্সটা,	
anichchi,	অনিচ্ছি,	আনিচ্ছি,	
nishad,	নিশদ,	নিষাদ,	
crucer,	ক্রুসের,	ক্রুশের,	
alaoler,	আলালের,	আলাওলের,	
autopromotioner,	অটোপ্রোমশনের,	অটোপ্রমোশনের,	
horiddar,	হরিদ্দার,	হরিদ্বার,	
bibadey,	বিবাদে,	বিবাদে,	
eduardo,	এডুর্য়োডো,	এডুয়ার্দো,	
khalid,	খালিদ,	খালিদ,	
bokul,	বকুল,	বকুল,	
protisthar,	প্রতিষ্ঠার,	প্রতিষ্ঠার,	
bollov,	বলমো,	বল্লভ,	
proo,	প্রো,	প্রো,	
bidghootey,	বিদঘুতে,	বিদঘুটে,	
kaathhaamaandu,	কথথামন্দু,	কাঠমান্ডু,	
shfingtar,	শ্ফিংটার,	স্ফিংটার,	
phiksim,	ফিকসিম,	ফিক্সিং,	
daakten,	ডাকতেন,	ডাকতেন,	
jyaqasana,	জ্যাকাসন,	জ্যাকসন,	
achintyabhedaved,	অচিন্ত্যভেদবেব,	অচিন্ত্যভেদাভেদ,	
daqop,	ডাকোপ,	দাকোপ,	
maradeha,	মারােহ,	মরদেহ,	
navaratri,	নবরত্রী,	নবরাত্রি,	
drishi,	দৃশি,	দৃশ্যই,	
udor,	উদোর,	উদর,	
durgatsob,	দুর্গাৎসব,	দুর্গোৎসব,	
sumi,	সুমি,	সুমি,	
quota,	কুয়াটা,	কোটা,	
prokolpow,	প্রকল্প্,	প্রকল্পও,	
rubidiyaam,	রুবিদিয়াম,	রুবিডিয়াম,	
cocaine,	কোকেনে,	কোকেইন,	
lagche,	লাগছে,	লাগছে,	
karadandey,	কারাদন্দে,	কারাদণ্ডে,	
review,	রিভিউ,	রিভিউও,	
engrejra,	এংরেজরা,	ইংরেজরা,	
zeeland,	জিল্যান্ড,	জিল্যান্ড,	
kormyi,	কর্মই,	কর্মই,	
jhamala,	ঝামালা,	ঝামালা,	
mumtazer,	মুমতাজের,	মুমতাজের,	
sommoteer,	সম্মটির,	সম্মতির,	
moonshi,	মুনশি,	মুন্সি,	
dokaanei,	দোকানেই,	দোকানেই,	
samaveshke,	সমাাশেকে,	সমাবেশকে,	
porizoner,	পরিজনের,	পরিজনের,	
ishter,	ইস্টার,	ইস্টের,	
dharmadasbabu,	ধর্মদাসবাবু,	ধর্মদাসবাবু,	
prakar,	প্রকার,	প্রকার,	
bulichev,	বুলিছেভ,	বুলিচেভ,	
hijri,	হিজরি,	হিজরী,	
madhukori,	মধুকোরি,	মাধুকরী,	
ghenshei,	ঘেনশেই,	ঘেঁষেই,	
dovaar,	দোভার,	ডোভার,	
teoner,	টিওনার,	টিওনার,	
utsahi,	উৎসাহি,	উৎসাহী,	
detik,	দেটিক,	দেতিক,	
fimela,	ফিমেলা,	ফিমেল,	
armstronz,	আর্কস্ট্রোজন,	আর্মস্ট্রং,	
vugoley,	ভুগোলে,	ভূগোলে,	
karam,	কারাম,	কেরাম,	
elakatir,	এলাকাটির,	এলাকাটির,	
touraat,	তৌরা,	তওরাত,	
pujito,	পুজিত,	পুজিত,	
stanahenja,	স্তনাহেজ্জা,	স্টোনহেঞ্জ,	
sarbhaarti,	সারভারটি,	সার্ভারটি,	
asociatis,	এসোক্যাটিস,	এসোসিয়েটস,	
bboponer,	ব্ববনের,	বপনের,	
beatleser,	বিটলেসের,	বিটলসের,	
zommu,	জম্মু,	জম্মু,	
mukhomandaley,	মুখমন্ডলে,	মুখমণ্ডলে,	
bisnoo,	বিষ্ণও,	বিষ্ণু,	
rastagulikeo,	রাস্তাগুলিকেও,	রাস্তাগুলিকেও,	
bikargrasta,	বিকারগ্রাস্তা,	বিকারগ্রস্ত,	
sachetanvabe,	সচেতনভাবে,	সচেতনভাবে,	
makhno,	মাখনো,	মাখনো,	
manab,	মানব,	মানব,	
sthaponagulor,	স্থাপনাগুলোর,	স্থাপনাগুলোর,	
planey,	প্ল্যানে,	প্লেনে,	
mukhmondole,	মুখমন্ডলে,	মুখমণ্ডলে,	
ghatla,	ঘাটলা,	ঘটল,	
fuss,	ফুস্,	ফাস,	
vetrillocuism,	ভেট্রিলললিকোম,	ভেট্রিলোকুইজম,	
swadesh,	স্বদেশ,	স্বদেশ,	
desiseyer,	ডেসিসেয়ার,	ডিজিজের,	
hupile,	হুপিলে,	হুপিলে,	
boudher,	বৌধের,	বৌদ্ধের,	
kathla,	কাথলা,	কাঠলা,	
amiya,	আমিয়া,	অমিয়,	
tep,	টাইপ,	ট্যাপ,	
narsinghomgulor,	নার্সিংহগুলোর,	নার্সিংহোমগুলোর,	
sangkulaan,	সংকুল্ন,	সংকুলান,	
chakrapani,	চক্রপণি,	চক্রপানী,	
juakhelar,	জুয়াখেলার,	জুয়াখেলার,	
niropekshtar,	নিরপেক্ষতার,	নিরপেক্ষতার,	
choukato,	চৌকাতো,	চৌকাত,	
tetela,	তেতেলা,	টাইটেল,	
bodhirota,	বোধিরতা,	বধিরতা,	
chet,	চেত,	চ্যাট,	
sotorkobhabey,	সতর্কভাবে,	সতর্কভাবে,	
shatan,	শাতান,	শয়তান,	
karecho,	কারেছো,	করেছো,	
bouddho,	বৌদ্ধ,	বৌদ্ধ,	
matt,	ম্যাট,	ম্যাট,	
akten,	আকতেন,	অকটেন,	
bee,	বী,	বি,	
irish,	ইরিশ,	আইরিস,	
mausumer,	মৌসুমের,	মৌসুমের,	
dhhaloor,	ঢালুর,	ঢালুর,	
firozaa,	ফিরোজা,	ফিরোজা,	
saver,	স্যাভার,	সেভার,	
gajetted,	গ্যাজেটেড,	গেজেটেড,	
abhidhaner,	অভিধনের,	অভিধানের,	
byapoktor,	ব্যাপক্তর,	ব্যাপকতর,	
nabyata,	নব্যতা,	নাব্যতা,	
reliance,	রিলিয়েন্স,	রিলায়েন্স,	
birishiritey,	বিরিশিরীতে,	বিরিশিরিতে,	
abhidhaaneeck,	অভিধানিক,	অভিধানিক,	
nothiboddho,	নথীবদ্ধ,	নথিবদ্ধ,	
atwabishvashi,	অত্ববিশবাষী,	আত্মবিশ্বাসী,	
morathee,	মোরাথি,	মরাঠি,	
casper,	ক্যাসপার,	ক্যাসপার,	
upbasher,	উপবাশের,	উপবাসের,	
everage,	এভারেজ,	এভারেজ,	
carloos,	কার্লোস,	কার্লোস,	
panchadadu,	পঞ্চদদু,	পঞ্চাদাদু,	
hukar,	হুকার,	হুকার,	
paripakey,	পরিপাকে,	পরিপাকে,	
sahocorje,	সহকর্যে,	সাহচর্যে,	
gajano,	গজনো,	গজানো,	
tahalo,	তাহালো,	তাহলো,	
oxforde,	অক্সফোর্ডে,	অক্সফোর্ডে,	
jibnagore,	জীবনাগরে,	জীবননগর,	
anchalo,	আঞ্চালো,	অঞ্চলও,	
eexpreession,	এক্সপ্রিশন,	এক্সপ্রেশন,	
epiela,	এপিয়াল,	আইপিএল,	
gasthii,	গাস্থিই,	গোষ্ঠীই,	
sangsakti,	সংস্কটি,	সংসক্তি,	
gandagol,	গণ্ডগোল,	গন্ডগোল,	
romnar,	রোমনার,	রমনার,	
chat,	চাত,	চ্যাট,	
dibate,	দিবাতে,	ডিবেট,	
disni,	দিসনি,	ডিজনী,	
duple,	ডুপলে,	ডুপ্লে,	
helloin,	হেলন,	হ্যালোইন,	
gore,	গোর,	গোর,	
ghoorchen,	ঘুরছেন,	ঘুরেছেন,	
jounotar,	যৌনতার,	যৌনতার,	
kings,	কিংস,	কিংস,	
ched,	চেড,	ছেদ,	
kkomandar,	ক্কমন্দর,	কমাণ্ডার,	
icelands,	আইসেল্যান্ডস,	আইসল্যান্ডসহ,	
booksar,	বুক্সার,	বুক্সার,	
kheshar,	খেষার,	খেশার,	
scholarsip,	স্কলারসিপ,	স্কলারশিপ,	
seniar,	সেনিয়ার,	সিনিয়র,	
blasterke,	ব্ল্যাস্টারকে,	ব্লাস্টারকে,	
rakhtokkharone,	রাক্ষতকরণে,	রক্তক্ষরণে,	
shilpojaat,	শিল্পজাত,	শিল্পজাত,	
shoreefpur,	শরীপপুর,	শরিফপুর,	
hosbaleke,	হোসবালেকে,	হোসবালেকে,	
peethey,	পিঠে,	পীঠে,	
asthishondhi,	অস্থিষন্ধী,	অস্থিসন্ধি,	
rodney,	রোডনে,	রেডনি,	
atak,	এতাক,	আটক,	
gondogol,	গণ্ডগোল,	গন্ডগোল,	
pacbar,	পাচবার,	পাঁচবার,	
bohudin,	বহুদিন,	বহুদিন,	
chereche,	চেরেছে,	ছেড়েছে,	
ganochin,	গণোচিন,	গণচীন,	
musabbirul,	মুসবববিরুল,	মুসাব্বিরুল,	
bapokotor,	বাপকতর,	ব্যাপকতর,	
wrighter,	হইইটার,	রাইটের,	
sarjur,	সারজুর,	সরযূর,	
comoros,	কমোরোস,	কোমোরোস,	
philipiner,	ফিলিপিনের,	ফিলিপাইনের,	
atighataner,	অতিঘাননের,	অতিঘটনের,	
madhabi,	মাধাবী,	মাধবী,	
daakticketer,	ডাক্টিকেটের,	ডাকটিকিটের,	
bahati,	বাহাটি,	বাহাতি,	
kantajir,	কান্াজির,	কান্তজির,	
chrystal,	ক্রিস্টাল,	ক্রাইস্টাল,	
yanqee,	যাঙ্কি,	ইয়াংকি,	
oporishodhito,	অপরিষধিত,	অপরিশোধিত,	
nibirbhabe,	নিবির্ভাবে,	নিবিরভাবে,	
shringa,	শ্রিংগা,	শৃঙ্গ,	
valobase,	ভালোবাসে,	ভালোবাসে,	
roy,	রয়ে,	রায়,	
dokaangoolote,	দোকানগুলোতে,	দোকানগুলোতে,	
neelkamal,	নেলকামাল,	নীলকমল,	
pack,	প্ক,	প্ল্যাক,	
harbur,	হারবুর,	হারবার,	
rilayensha,	রিলায়েশন,	রিলায়েন্স,	
dijmarescu,	ডিজমারসেকু,	দিজমার্সাকু,	
braqe,	ব্রেক,	ব্রেক,	
supplenza,	সাপ্লেঞ্জা,	সাপলেঞ্জা,	
bujhechhila,	বুঝেছিলা,	বুঝেছিল,	
atmiyasulabh,	আত্মীয়সুলভ,	আত্মীয়সুলভ,	
soketgulor,	সকেটগুলোর,	সকেটগুলোর,	
bhuushito,	ভুশিত,	ভূষিত,	
mooney,	মুনে,	মুনে,	
farid,	ফরিদ,	ফরিদ,	
pettern,	পেটার্ন,	প্যাটার্ন,	
chhooti,	ছোটি,	ছুটি,	
balatarin,	বালাতারীন,	বালাতারিয়ান,	
ghotolen,	ঘটকেন,	ঘটলেন,	
jamarate,	জামারাতে,	জামারাতে,	
nisshongotake,	নিঃশঙ্গতাকে,	নিঃসঙ্গতাকে,	
ispredseet,	ইসপ্রেডিসেট,	স্প্রেডশীট,	
baire,	বেই়ের,	বাইরে,	
bolbo,	বলবো,	বলবো,	
jaubankal,	যৌবনকাল,	যৌবনকাল,	
quartar,	কোয়ারটার,	কোয়ার্টার,	
uddhrita,	উদ্ধৃত,	উদ্ধৃত,	
mahakabi,	মহাকাবী,	মহাকবি,	
nadike,	নাদিকে,	নদীকে,	
calabe,	কালাবে,	চালাবে,	
durgotshob,	দুর্গটবৎ,	দুর্গোৎসব,	
rca,	আইসিএরএ,	আরসিএ,	
vagni,	ভাগ্নি,	ভগ্নী,	
ssahocorze,	সহহকরাজে,	সাহচর্যে,	
laaisensh,	লেইসেনস,	লাইসেন্স,	
hariner,	হরিণের,	হরিণের,	
seekkharthirao,	শিক্ষার্থীরাও,	শিক্ষার্থীরাও,	
breel,	ব্রিল,	ব্রিল,	
teemothy,	তীমথটি,	টিমোথি,	
yaak,	যাক,	ইয়াক,	
rushod,	রুশদ,	রুশদ,	
maner,	মানের,	মানে,	
seekkhokbrindo,	শেক্ষকবৃন্দ,	শিক্ষকবৃন্দ,	
bojiye,	বজিয়ে,	বজিয়ে,	
shanno,	শান্নো,	সান্নো,	
hansasya,	হনসসস্য,	হংসস্য,	
beekaargrasta,	বিকারগ্রস্তা,	বিকারগ্রস্ত,	
gardeen,	গার্ডিন,	গার্ডেন,	
sikkhokder,	শিক্ষকদের,	শিক্ষকদের,	
gonjona,	গন্জনা,	গঞ্জনা,	
shoori,	শুরি,	সুরি,	
headquartus,	হেডকোর্টাস,	হেডকোয়ার্টাস,	
dewaben,	দেওয়াবেন,	দেওয়াবেন,	
swairacharibirodhi,	স্বৈরাচারবিরোধী,	স্বৈরাচারীবিরোধী,	
daap,	দাপ,	ড্যাপ,	
rajtantro,	রাজতন্ত্র,	রাজতন্ত্র,	
bhangchur,	ভংংচুর,	ভাংচুর,	
thyachar,	থ্যাচর,	থ্যাচার,	
antarvuktimulak,	আন্তর্ভুক্তিমূলক,	অন্তর্ভুক্তিমূলক,	
nibondhocheler,	নিবন্ধচেলের,	নিবন্ধছেলের,	
anyarup,	অন্যরূপ,	অন্যরূপ,	
suhasini,	সুহাসিনী,	সুহাসিনী,	
varote,	ভারোতে,	ভারতে,	
krisenter,	ক্রিসেন্টের,	ক্রিসেন্টের,	
danab,	দানাব,	দানব,	
chupani,	চুপাণী,	চুপানি,	
simantarkkhibahinir,	সীমান্তকরবাহিকহিনীর,	সীমান্তরক্ষীবাহিনীর,	
somraatder,	সম্রাটদের,	সম্রাটদের,	
monzooshree,	মন্জৌশরী,	মঞ্জুশ্রী,	
rudrasagar,	রুদ্রসাগর,	রুদ্রসাগরের,	
chheher,	ছেহের,	ছেহের,	
kram,	ক্রম,	ক্রম,	
byatari,	ব্যাটারি,	ব্যাটারী,	
gaddaafee,	গাদ্দাফী,	গাদ্দাফী,	
baharamporer,	বাহারামপরের,	বহরমপুরের,	
babona,	বাবনা,	বাবনা,	
chikitsar,	চিকিৎসার,	চিকিত্সার,	
dooburira,	ডুবুরিরা,	ডুবুরিরা,	
podotyagsongkranto,	পদত্যাগসংক্রান্ত,	পদত্যাগসংক্রান্ত,	
airish,	আইরিস,	আইরিস,	
gratha,	গ্রাথা,	গ্রোথ,	
kormoi,	কর্মই,	কর্মই,	
angshogrohon,	অংশগ্রহণ,	অংশগ্রহন,	
bairer,	বাইরের,	বাইরের,	
kramp,	ক্রাম্প,	ক্র্যাম্প,	
parther,	পার্থের,	পার্থের,	
baibasthaar,	বৈবস্থার,	ব্যবস্থার,	
heepatitis,	হিপাটিটিস,	হেপাটাইটিস,	
nimnosakkharkari,	নিম্নসাক্ষাকারী,	নিম্নস্বাক্ষরকারী,	
abdan,	আব্দান,	আব্দান,	
ghumachhe,	ঘুমাচ্ছে,	ঘুমাচ্ছে,	
bhabanir,	ভবনীর,	ভবানীর,	
modyer,	মদ্যের,	মদ্যের,	
mukherjee,	মুখেরজি,	মুখার্জী,	
vittimul,	ভিত্তিমূল,	ভিত্তিমূল,	
tuleche,	তুলেছে,	তুলেছে,	
ghomta,	ঘোমটা,	ঘোমটা,	
ganochien,	গণছিয়েন,	গণচীন,	
maunchostho,	মঞ্চস্থ,	মঞ্চস্থ,	
nirgomon,	নির্গমন,	নির্গমন,	
abhidhaanic,	অভিধানিক,	অভিধানিক,	
panda,	পাণ্ডা,	পান্ডে,	
suchonakal,	সূচনাকাল,	সূচনাকাল,	
fokskon,	ফকস্কন,	ফক্সকন,	
pyore,	প্যরে,	পিওর,	
bisheshshyo,	বিশ্ষেষ্য,	বিশেষ্য,	
pabo,	পাবো,	পাব,	
chaloke,	চালোকে,	চালকে,	
shchalastik,	স্চলসাত্তিক,	স্কলাস্টিক,	
pretty,	প্রেটি,	প্রিটি,	
jini,	জিনি,	যিনি,	
bossonte,	বসন্তে,	বসন্তে,	
ramonar,	রামনার,	রমনার,	
qaferder,	কাফার্ডার,	কাফেরদের,	
dakten,	ডাকতেন,	ডাকতেন,	
samanwitovabe,	সমননবিতভাবে,	সমন্বিতভাবে,	
baptics,	ব্যাপটিকস,	ব্যাপটিকস,	
societyke,	সজিটেকে,	সোসাইটিকে,	
kushakhali,	কুশাখালি,	কুশাখালি,	
hunine,	হুনিন,	হুনাইন,	
bhiktara,	ভিকটারা,	ভিক্টর,	
seconder,	সেকন্ডের,	সেকেন্ডের,	
karore,	কারোরে,	কারোর,	
sharif,	শারিফ,	শরিফ,	
peengna,	পেংনা,	পিংনা,	
sqolastiq,	স্কোলোস্টিক,	স্কলাস্টিক,	
rasunkunchi,	রসুনকুঞ্চি,	রসুনকুঁচি,	
oncholke,	অঞ্চকে,	অঞ্চলকে,	
balatkar,	বালাতকর,	বলাৎকার,	
saarbhaarti,	সারভারটি,	সার্ভারটি,	
paste,	পাস্তে,	পেষ্ট,	
manjushri,	মঞ্জুশ্রী,	মঞ্জুশ্রী,	
niketaner,	নিকেতানের,	নিকেতনের,	
tatey,	টাটে,	তাতে,	
proshadhoner,	প্রশাধনের,	প্রসাধনের,	
baarnish,	বার্নিশ,	বার্নিশ,	
grootha,	গ্রথথা,	গ্রোথ,	
ghoor,	ঘুর,	ঘুর,	
prokolpotike,	প্রকল্পটিকে,	প্রকল্পটিকে,	
ganesh,	গণেশ,	গণেশ,	
sangharshik,	সংঘর্ষিক,	সাংঘর্ষিক,	
pratisthasaho,	প্রতিস্থাসহ,	প্রতিষ্ঠাসহ,	
pet,	পেট,	পেত,	
elakatay,	এলাকাতায়,	এলাকাতে,	
bhageri,	ভাগেরী,	ভাগেরই,	
shamshere,	শমশেরে,	শমসের,	
cholocchitrer,	চলচ্চিত্রের,	চলচ্চিত্রের,	
purple,	পার্পল,	পার্পেল,	
pharmesigulote,	ফার্মেসিগুলোতে,	ফার্মেসীগুলোতে,	
pancbaar,	প্যাঙ্কবার,	পাঁচবার,	
bardhitansh,	বার্ধিত্বাস,	বর্ধিতাংশ,	
difinishian,	ডিফিশিনাইন,	ডেফিনেশন,	
geographics,	জিওগ্রাফিক্স,	জিওগ্রাফিকস,	
purbancoler,	পূর্বাঙ্কলের,	পূর্বাঞ্চলের,	
habol,	হাবল,	হাবোল,	
ceramiker,	সেরামিকের,	সিরামিকের,	
sarboporee,	সর্বপরী,	সর্বোপরী,	
enjineers,	এনজিনিরিস,	ইঞ্জিনিয়ার্স,	
bagicha,	বাগিচা,	বাগিচা,	
emerjency,	এমেরজেন্সি,	এমার্জেন্সি,	
nartana,	নার্তানা,	নর্টন,	
amiretus,	অমিরিটাস,	এমিরেটাস,	
bbiswasho,	ব্বিব্যাশও,	বিশ্বাসও,	
bbiswashke,	ব্বিব্যাসকে,	বিশ্বাসকে,	
vortuki,	ভর্টুকি,	ভর্তুকি,	
poripakey,	পরিপাকে,	পরিপাকে,	
cooda,	কোডা,	কোডা,	
ramnathbabur,	রামনাথবাবুর,	রামনাথবাবুর,	
eupheike,	ইউফিইকে,	ইউফেইকে,	
zerusalemer,	জেরুসালেমের,	জেরুজালেমের,	
install,	ইন্সট্যাল,	ইন্সটল,	
kourabe,	কৌরবে,	কৌরবে,	
mozdoor,	মজদুর,	মজদুর,	
zubokra,	যুবকরা,	যুবকরা,	
shitei,	শিতেই,	শীতেই,	
chhutee,	ছুটি,	ছুটি,	
granthatyke,	গ্র্যানথটটিকে,	গ্রন্থটিকে,	
dwibidho,	দ্বিবিধো,	দ্বিবিধ,	
karmosansthan,	কর্মসংস্থান,	কর্মসংস্থান,	
karmoi,	কার্মই,	কর্মই,	
duryogamoyee,	দুর্যোগময়ী,	দুর্যোগময়ী,	
durotamo,	দূরতম,	দূরতম,	
hizriite,	হিজরিতে,	হিজরীতে,	
bufer,	বাফার,	বাফার,	
pyor,	প্যার,	পিওর,	
emarjensi,	এমারজেনসি,	এমার্জেন্সি,	
footbalarer,	ফুটবালারের,	ফুটবলারের,	
chire,	চিরে,	চিরে,	
bahjya,	বাহ্জ্যা,	বাহ্য,	
yuroo,	যুবু,	ইউরো,	
graambasio,	গ্রামবাসিও,	গ্রামবাসীও,	
oncolsoho,	অঙ্চলসহ,	অঞ্চলসহ,	
tomader,	তোমাদের,	তোমাদের,	
boshoborty,	বোবর্টটি,	বশবর্তী,	
gostigulo,	গোস্তিগুলো,	গোষ্ঠীগুলো,	
antorbhuktimulak,	আন্তর্ভক্তিকূলাক,	অন্তর্ভুক্তিমূলক,	
yaq,	কাক,	ইয়াক,	
bejiye,	বেজিয়ে,	বেজিয়ে,	
breakthrough,	ব্রেকথররোগ,	ব্রেকথ্রু,	
safin,	সাফিন,	সাফিন,	
dubaate,	দুবাতে,	ডুবাতে,	
chalachchitroke,	চলচ্চিত্রকে,	চলচ্চিত্রকে,	
sip,	সিপ,	শিপ,	
upobaasee,	উপবাসী,	উপবাসী,	
satarkabhabey,	সতর্কভাবে,	সতর্কভাবে,	
neemeetto,	নিমেত্ত,	নিমিত্ত,	
aachhis,	আছিস,	আছিস,	
samany,	সামানি,	সামান্য,	
jonoikaa,	জনয়কা,	জনৈকা,	
taranee,	তারানী,	তরণী,	
awrbit,	আওরবিট,	অরবিট,	
atmabishvashi,	আত্মবিশশবাষী,	আত্মবিশ্বাসী,	
spredsheet,	স্প্রেডশিট,	স্প্রেডশীট,	
ancholgoolote,	অঞ্চলগুলোতে,	অঞ্চলগুলোতে,	
protizogii,	প্রতিযোগী,	প্রতিযোগী,	
chhutochhooti,	ছুটোছুটি,	ছুটোছুটি,	
shrabastee,	শ্রাবস্তি,	শ্রাবস্তী,	
ingrejra,	ইংরেজরা,	ইংরেজরা,	
niroja,	নিরোজা,	নিরোজা,	
daacktickete,	ড্যাকটিকটে,	ডাকটিকিটে,	
informetion,	ইনফরমেশন,	ইনফরমেশন,	
tottorat,	টোট্টোরাট,	তওরাত,	
ajeejer,	আজিজের,	আজিজের,	
santaa,	সান্তা,	সান্তা,	
brindabane,	বৃন্দাবনে,	বৃন্দাবনে,	
unchiyechilo,	উঁচিয়েছিল,	উঁচিয়েছিল,	
kharar,	খারার,	খরার,	
spancer,	স্প্যান্সের,	স্পেন্সার,	
palteche,	পালতেছে,	পাল্টেছে,	
pleena,	প্লেনা,	প্লেন,	
chaiten,	চৈতেন,	চাইতেন,	
ponera,	পনেরা,	পনের,	
rakkhandurga,	রক্ষণদূর্গ,	রক্ষণদুর্গ,	
neerbahi,	নির্বাহী,	নির্বাহি,	
ovidhanik,	অভিধানিক,	অভিধানিক,	
saom,	সাওম,	সাওম,	
uthhaane,	উঠানে,	উঠানে,	
overholing,	ওভারহ্লিং,	ওভারহোলিং,	
carlos,	কার্লোস,	কার্লোস,	
zoubankal,	যৌবনকাল,	যৌবনকাল,	
sectore,	সেক্টোর,	সেক্টরে,	
hisabagyan,	হিসাবাগ্ন,	হিসাবজ্ঞান,	
jiland,	জিল্যান্ড,	জিল্যান্ড,	
nichols,	নিকোলস,	নিকলস,	
punorabortonte,	পুনরারতনান্তে,	পুনরাবর্তন্তে,	
venus,	ভেনুস,	ভেনাস,	
aamoode,	আমোদে,	আমুদে,	
ingrezeeteo,	ইংরেজিতেও,	ইংরেজিতেও,	
hadisti,	হাদিস্টি,	হাদিসটি,	
neutrinoo,	নিউট্রিনুও,	নিউট্রিনো,	
parikhar,	পারিখার,	পরিখার,	
chirantan,	চিরান্তন,	চিরন্তন,	
suparahiro,	সুপাহারীরও,	সুপারহিরো,	
prottokkhovabe,	প্রত্যক্ষবাবে,	প্রত্যক্ষভাবে,	
tuni,	টুনী,	টুনি,	
ghurte,	ঘুরতে,	ঘুরতে,	
protul,	প্রতুল,	প্রতুল,	
gabeshonar,	গবেশনার,	গবেষনার,	
taitela,	টাইতেলা,	টাইটেল,	
lubitz,	লিউবিকজ,	লুবিৎজ,	
colgirl,	কলগির্ল,	কলগার্ল,	
narbur,	নরবুর,	নরবুর,	
votar,	ভোটার,	ভোটার,	
safiha,	সাফিহা,	সাফিহা,	
oboshore,	অবশরে,	অবসরে,	
firozapure,	ফিরোজপুরে,	ফিরোজাপুরে,	
gronther,	গ্রোন্থার,	গ্রন্থের,	
nagorikra,	নাগোিকরা,	নাগরিকেরা,	
commissionvogider,	কমিশনসন্গীদের,	কমিশনভোগীদের,	
ujobekeestan,	উজোবেকবিস্তান,	উজবেকিস্তান,	
sahittopritite,	সাহিত্যপৃতিতে,	সাহিত্যপ্রীতিতে,	
shikh,	শিখ,	শিখ,	
bharpur,	ভারপুর,	ভরপুর,	
said,	সাইদ,	সাইদ,	
query,	কোয়েরী,	কোয়েরি,	
mukhomandaler,	মুখমন্ডলের,	মুখমণ্ডলের,	
shasonamoleri,	শাসনামোলেরই,	শাসনামলেরই,	
uparzoner,	উপারজনের,	উপার্জনের,	
khiladirao,	খিলাদীরাও,	খিলাড়িরাও,	
souripurang,	সৌরীপূর্ঙং,	সৌরিপুরং,	
orbit,	অরবিট,	অরবিট,	
shilpajata,	শিল্পজতা,	শিল্পজাত,	
ebham,	ইভাম,	ইভিএম,	
drissoke,	দ্রিস্কে,	দৃশ্যকে,	
notikotar,	নতিকতার,	নৈতিকতার,	
obhijojan,	অভিযোজন,	অভিযোজন,	
aborto,	আবর্ত,	আবর্ত,	
ganohotyake,	গণহত্যাকে,	গণহত্যাকে,	
phiksa,	ফিকসা,	ফিক্স,	
ganonanatto,	গণনানাত্ব,	গণনাট্য,	
bonke,	বনকে,	বনকে,	
tookrokey,	টুক্রকে,	টুকরোকে,	
samajikotar,	সমাজিকতার,	সামাজিকতার,	
degreeo,	ডিগরিও,	ডিগ্রিও,	
pyatarne,	প্যাটার্নে,	প্যাটার্নে,	
janosamaj,	জনসমাজ,	জনসমাজ,	
charukala,	চরকুলা,	চারুকলা,	
nick,	নিক,	নিক্,	
canservatian,	ক্যানফেরেশন,	কনসারভেশন,	
naagaalyand,	নাগল্যান্ড,	নাগাল্যান্ড,	
yuro,	যুউরো,	ইউরো,	
chhon,	ছন,	ছোঁ,	
nichupattir,	নিচুপত্তির,	নিচুপট্টির,	
prothar,	প্রথার,	প্রথার,	
shingping,	শিংপিং,	শিংপিং,	
protijogiitamulok,	প্রতিযোগিতামূলক,	প্রতিযোগীতামূলক,	
soundarja,	সৌন্দর্য্য,	সৌর্ন্দয্য,	
postac,	পোস্টাক,	পোস্টকে,	
ajibon,	জজিবন,	আজীবন,	
bonbhumi,	বনভুমি,	বনভূমি,	
antarctica,	অ্যান্টার্কটিকা,	অ্যান্টার্কটিকার,	
bizito,	বিজিত,	বিজিত,	
bethikata,	বেথিকাটা,	বেঠিকতা,	
faase,	ফাসে,	ফাঁসে,	
dhadhiye,	ধধিয়ে,	ধাধিয়ে,	
darji,	দার্জি,	দরজি,	
ancholgoolir,	অঞ্চলগুলির,	অঞ্চলগুলির,	
supreetira,	সুপ্রীতিরা,	সুপ্রীতিরা,	
jansa,	জানসা,	জন্স,	
jonee,	জনি,	জনি,	
chandil,	চানদিল,	চান্ডিল,	
aairish,	আইরিশ,	আইরিস,	
bihar,	বিহার,	বিহার,	
boiragirhat,	বৈরাগীরহাট,	বৈরাগিরহাট,	
ganosachetanata,	গণসচেতনাটা,	গণসচেতনতা,	
jounatar,	যৌনতার,	যৌনতার,	
soource,	সৌরের,	সোর্স,	
chhutir,	ছুটির,	ছুটির,	
gaje,	গাজে,	গেজ,	
habathu,	হাবাথু,	হাবাথু,	
brittakarey,	বৃত্তকারে,	বৃত্তাকারে,	
deefinision,	ডিফিনিয়ন,	ডেফিনেশন,	
byaboharkarike,	ব্যবহারকারীকে,	ব্যবহারকারীকে,	
chaaktir,	চাকটির,	চাকতির,	
gagee,	গাগি,	গেজ,	
bhenus,	ভেনুস,	ভেনাস,	
suraaropito,	সুরারপিত,	সুরারোপিত,	
pakhtunistan,	পাখতুন্তানন,	পাখতুনিস্তান,	
ghamta,	ঘামটা,	ঘোমটা,	
concerter,	কনসার্টের,	কানসাটের,	
hijrite,	হিজরিতে,	হিজরীতে,	
elbamtite,	এলবামটিতে,	এলবামটিতে,	
eigulor,	এইগুলোর,	এইগুলোর,	
mohajot,	মহাজত,	মহাজোট,	
pushtee,	পুষ্টি,	পুষ্টি,	
jotharthovabey,	যথার্থভাবে,	যথার্থভাবে,	
upbrazillian,	আপপ্রালালানিয়ান,	আপব্রাজিলিয়ান,	
korley,	করলেই,	করলে,	
capshule,	ক্যাপশুলে,	ক্যাপসুল,	
cholochchitratike,	চলচ্চিত্রটিকে,	চলচ্চিত্রটিকে,	
alexanderke,	আলেক্সান্ডারকে,	আলেকজান্ডারকে,	
dosha,	দোশা,	দোসা,	
pratishthanik,	প্রতিষ্ঠানিক,	প্রাতিষ্ঠানিক,	
shansthaner,	শান্স্থানের,	সংস্থানের,	
mette,	মেত্তে,	ম্যাট,	
victor,	ভিক্টর,	ভিক্টর,	
sokkhomotabriddhi,	সক্ষমতাত্রবদ্ধি,	সক্ষমতাবৃদ্ধি,	
indro,	ইন্দ্রো,	ইন্দ্র,	
porinoti,	পরিণতি,	পরিণতি,	
utsahamulak,	উৎসামহলক,	উৎসাহমূলক,	
sangbadmadhyomgulote,	সংবাদমাধ্যমগুলোতে,	সংবাদমাধ্যমগুলোতে,	
baman,	বামান,	বামন,	
shuchonakal,	শুচনাকাল,	সূচনাকাল,	
nogore,	নগরে,	নগরে,	
licencer,	লাইসেন্সের,	লাইসেন্সের,	
dhangsantup,	ধ্বংসন্তপ,	ধ্বংসন্তুপ,	
lutharan,	লুথারন,	লুথেরান,	
aditisaha,	আদিতিসহ,	অদিতিসহ,	
militarir,	মিলিতারীর,	মিলিটারির,	
aireshe,	আইরেশে,	আইরেসে,	
darjiling,	দার্জিলিং,	দার্জিলিং,	
onkush,	অঙ্কুষ,	অংকুশ,	
scuvi,	স্কিভি,	স্কুভি,	
sutir,	সুতীর,	সুতির,	
aaireshe,	আইয়েশে,	আইরেসে,	
soomitrar,	সুমিত্রার,	সুমিত্রার,	
hena,	হেনা,	হেনা,	
chintamani,	চিন্তামণি,	চিন্তামনি,	
kobulennechha,	কবুলেননেছা,	কবুলেন্নেছা,	
toroonraa,	তর্ণরা,	তরুণরা,	
terlarang,	তেরলারং,	তেরলারং,	
qarqa,	কার্ক,	কার্ক,	
bharotchilo,	ভারতচিল,	ভারতছিল,	
shatoke,	শাটোকে,	শতকে,	
sinakey,	সিনাকে,	সিনাকে,	
jahangirbad,	জাহাঙ্গীরবাদ,	জাহাঙ্গীরবাদ,	
plate,	প্লেট,	প্লেট,	
daaradaa,	দরদা,	দারদা,	
doltyagi,	দলত্যাগী,	দলত্যাগী,	
adbhanced,	অ্যাডভ্যান্ড,	অ্যাডভান্সড,	
himchi,	হিমচি,	হিমচি,	
satan,	সাতান,	শয়তান,	
edaningkale,	এডানিঙ্গলে,	ইদানীংকালে,	
steeit,	স্টিইট,	স্টেইট,	
peerry,	পারি,	পেরি,	
chikittsar,	চিকিৎসার,	চিকিত্সার,	
tarkareer,	তারকারীর,	তরকারীর,	
shekarmani,	শেকরমানি,	শেকরমানি,	
ghoomato,	ঘুমত,	ঘুমাতো,	
lyaataa,	ল্যাটা,	ল্যাটা,	
dhamshrenite,	ধামশ্রেণীতে,	ধামশ্রেণীতে,	
stana,	স্তানা,	স্টোন,	
torkarir,	তর্ারির,	তরকারীর,	
uporoshtho,	উপরস্থ,	উপরস্থ,	
audioguloke,	অডিওগুলোকে,	অডিওগুলোকে,	
taap,	টাঁ,	ট্যাপ,	
parjotaker,	পার্যটাকের,	পর্যটকের,	
pluck,	প্লাক,	প্ল্যাক,	
brahmanera,	ব্রাহ্মণেরা,	ব্রাহ্মণেরা,	
pachak,	পাচাক,	পাচক,	
soinyo,	সৈন্য,	সৈন্য,	
chal,	চাল,	চাল,	
byepass,	ব্রাপস্,	বাইপাস,	
cheess,	চেস,	চেস,	
bisheshshyer,	বিশ্ষেষ্যের,	বিশেষ্যের,	
niketon,	নিকেতন,	নিকেতন,	
nanir,	নানির,	নানীর,	
salphat,	সালফাট,	সালফেট,	
graambaaseeder,	গ্রামবিসদের,	গ্রামবাসীদের,	
aamor,	আমোর,	আমর,	
dhaleshwari,	ধলেশ্বরী,	ধলেশ্বরী,	
dhormoprobortokder,	ধর্মপ্রবর্তদের,	ধর্মপ্রবর্তকদের,	
aembed,	এম্বেড,	এম্বেড,	
somonwitobhabey,	সমন্বিতভাবে,	সমন্বিতভাবে,	
asif,	আসিফ,	আসিফ,	
khalidke,	খালিদকে,	খালিদকে,	
kiandi,	কিয়ান্দি,	ক্যান্ডি,	
rilayensa,	রিলায়েনস,	রিলায়েন্স,	
kale,	কাল,	কালে,	
hoonayin,	হোনাইন,	হুনাইন,	
bishnu,	বিষ্ণু,	বিষ্ণু,	
ghumachchila,	ঘুমাচ্ছিলা,	ঘুমাচ্ছিল,	
eukalyptus,	ইউক্লাল্টিউাস,	ইউক্যালিপ্টাস,	
sobche,	সব্চে,	সবচে,	
parqa,	পারকা,	পার্ক,	
hoondayi,	হুউন্দেই,	হুন্দাই,	
dorgaaho,	দর্গাহো,	দরগাহ,	
paner,	পানের,	পানের,	
kaathhmaandute,	কথথমন্ডুতে,	কাঠমান্ডুতে,	
shurugulo,	শুরুগুলো,	শুরুগুলো,	
achintopurer,	অচিন্তপুরের,	অচিন্তপুরের,	
tikto,	তিক্ত,	তিক্ত,	
banshite,	বাঁশীতে,	বাঁশিতে,	
lambaate,	ল্যাম্বেট,	লম্বাটে,	
gej,	গেজ,	গেজ,	
diiptii,	দিপটিই,	ডেপুটি,	
spashtotai,	স্পষ্টতাই,	স্পষ্টতই,	
poschime,	পশ্চিমে,	পশ্চিমে,	
fevarite,	ফেবারিতে,	ফেভারিট,	
chalochchitraeei,	চলচ্চিত্রারই,	চলচ্চিত্রেই,	
chakti,	চাকতি,	চাকতি,	
ekoghore,	একঘরে,	একঘরে,	
kaloniir,	কালনীর,	কালনীর,	
kantojir,	কান্তজির,	কান্তজির,	
ciima,	সিইমা,	সীমা,	
satarkokari,	সতর্ককারী,	সতর্ককারী,	
biplabeer,	বিপ্লবীর,	বিপ্লবীর,	
anutpadanshil,	অনুতপাধনশীল,	অনুৎপাদনশীল,	
nariider,	নারীদের,	নারীদের,	
eshiyetika,	এশিয়েটিক,	এশিয়াটিক,	
laaisens,	লেইসেন্স,	লাইসেন্স,	
brookoleen,	ব্রুকোলিন,	ব্রুকলিন,	
accountdharira,	একাউন্তধারীরা,	একাউন্টধারীরা,	
chirontan,	চিরনন্তান,	চিরন্তন,	
steen,	স্তিন,	স্টেন,	
graambaaseer,	গ্রামবাসীর,	গ্রামবাসীর,	
ashociatesh,	অ্যাসোিিতেস,	এসোসিয়েটস,	
booponer,	বপরনের,	বপনের,	
probolshoktio,	প্রবলশক্তিও,	প্রবলশক্তিও,	
asovarno,	আসভারণ,	অসবর্ণ,	
balaruma,	বালারুমা,	বলরুম,	
skirt,	স্কির্ট,	স্কার্ট,	
dhyana,	ধ্যানা,	ধ্যান,	
oswasteekor,	অস্বাস্তিকর,	অস্বস্তিকর,	
chittronatyokar,	চিত্রনাট্যটার,	চিত্রনাট্যকার,	
asiatic,	অ্যাসিয়েটিক,	এশিয়াটিক,	
soheensotar,	সহীনসতার,	সহিংসতার,	
dayitta,	দায়িত্ব,	দায়িত্ব,	
aatmobishwasi,	আত্মবিশ্বাসী,	আত্মবিশ্বাসী,	
majlishpur,	মজলিশপুর,	মজলিশপুর,	
besirvagei,	বেসিরভাগেই,	বেশিরভাগেই,	
himsrot,	হিমস্রোট,	হিমস্রোত,	
firth,	ফিরছ,	ফার্থ,	
niphelheim,	নাইফেলাইম,	নিফেলহেইম,	
dharabahikbhabe,	ধারাবাহিকভাবে,	ধারাবাহিকভাবে,	
debate,	দেবাতে,	ডিবেট,	
jolrang,	জোলরাং,	জলরঙ,	
annorup,	অন্নরূপ,	অন্যরূপ,	
hitlere,	হিটলারে,	হিটলারে,	
karuna,	করুনা,	করুণা,	
murali,	মুরালি,	মুরলী,	
byaboharkareer,	ব্যবহারকারীর,	ব্যবহারকারীর,	
chhuteete,	ছুটিতে,	ছুটিতে,	
paroner,	পারণের,	পারণের,	
murad,	মুরাদ,	মুরাদ,	
ujbekistaner,	উজবেকসিত্তানের,	উজবেকিস্তানের,	
dabarer,	দাবারের,	দাবারের,	
shandra,	শান্দ্রা,	শান্দ্রার,	
reetesh,	রীতেশ,	রিতেশ,	
durarohini,	দুরারোহিনী,	দুরারোহিণী,	
afrazuler,	আফরাজুলের,	আফরাজুলের,	
zeebonto,	জীবন্ত,	জীবন্ত,	
inziniyarsa,	ইনজিনজির্স,	ইঞ্জিনিয়ার্স,	
bbiswash,	ব্বিব্বাশ,	বিশ্বাস,	
antarctika,	আন্টার্কটিকা,	অ্যান্টার্কটিকা,	
bandi,	বন্দি,	বন্দী,	
ganaparibahan,	গণপরিবহণ,	গণপরিবহন,	
nobotom,	নবতম,	নবতম,	
prachirer,	প্রাচীরের,	প্রাচিরের,	
kooshumba,	কোষুম্ব,	কুশুম্বা,	
khamotagulor,	ক্ষমতাগুলোর,	ক্ষমতাগুলোর,	
madhabike,	মাধাবিকে,	মাধবীকে,	
vins,	ভিনস,	ভিন্স,	
direectoratee,	ডিরিক্টরিটে,	ডিরেক্টরেট,	
sanaktokaran,	সনস্কটররান,	সনাক্তকরণ,	
bibechyo,	বিবেচ্য,	বিবেচ্য,	
harza,	হারজা,	হার্জ,	
ankanshilpe,	অঙ্কনশিল্পে,	অঙ্কনশিল্পে,	
utshahomulok,	উৎসাহমূলক,	উৎসাহমূলক,	
probondhobhittik,	প্রবন্ধভিত্তিক,	প্রবন্ধভিত্তিক,	
mirina,	মিরিনা,	মিরিনা,	
kichudinpar,	কিছুদ্িপর,	কিছুদিনপর,	
breq,	ব্রেক,	ব্রেক,	
brojomohun,	ব্রজমোহন,	ব্রোজোমোহন,	
badargaji,	বদরগাজি,	বদরগাজী,	
evereste,	ইভারেস্টে,	এভারেস্টে,	
natshi,	নাতশি,	নাত্সি,	
jeshh,	জেশে,	জেস,	
queri,	কোয়েরি,	কোয়েরি,	
shakankti,	শাকাঙ্কটি,	শকাঙ্কটি,	
suraaropeeto,	সুরারপপিত,	সুরারোপিত,	
toching,	টোচিং,	টোচিং,	
chalochchitreei,	চলচ্চিত্রী,	চলচ্চিত্রেই,	
debholopar,	ডেভোলপার,	ডেভলপার,	
matrirup,	মাতৃরূপ,	মাতৃরূপ,	
vaphara,	ভাফার,	বাফার,	
dimbacriti,	ডিম্বাক্রিটি,	ডিম্বাকৃতি,	
sompadonkaree,	সম্পাদনকারী,	সম্পাদনকারী,	
hundai,	হুন্ডাই,	হুন্দাই,	
prokolpogulikei,	প্রকল্পগুলিকেই,	প্রকল্পগুলিকেই,	
orgho,	অর্ঘ,	অর্ঘ্য,	
rajashri,	রাজশ্রী,	রাজশ্রী,	
iksaprishana,	ইক্সপ্রিষণ,	এক্সপ্রেশন,	
onucheeder,	অনুচিদের,	অনুচ্ছেদের,	
bishasey,	বিশাসে,	বিশ্বাসে,	
janagononar,	জানাসননার,	জনগণনার,	
samyuktha,	সম্যুক্থ,	সামিউক্তা,	
dalip,	দালিপ,	দালিপ,	
uthe,	উঠে,	উঠে,	
adhyatmik,	আধ্যাত্মিক,	আধ্যাত্মিক,	
daakteekite,	ডাকটিকিতে,	ডাকটিকিটে,	
magar,	মাগার,	মাগার,	
grooth,	গ্রথথ,	গ্রোথ,	
zoojyota,	যজ্যটা,	যোজ্যতা,	
bisshonath,	বিশ্বনাথ,	বিশ্বনাথ,	
naneer,	নানীর,	নানীর,	
harbare,	হারবারে,	হারবারে,	
gavaskar,	গাভাসকার,	গাভাস্কার,	
abhidhanick,	অভিধানিক,	অভিধানিক,	
samanyai,	সামন্যই,	সামান্যই,	
eura,	ইউরা,	ইউরো,	
pratisthanik,	প্রতিষ্ঠানিক,	প্রাতিষ্ঠানিক,	
bhogno,	ভোগনো,	ভগ্ন,	
cbi,	সিবিআই,	সিবিআই,	
bhittiti,	ভিত্তিটি,	ভিত্তিটি,	
choshon,	চোষণ,	চোষণ,	
arekdol,	আরেকদল,	আরেকদল,	
naazi,	নাজি,	নাত্সি,	
bosonte,	বসন্তে,	বসন্তে,	
ekbakke,	একবাককে,	একবাক্যে,	
maritimer,	মারিটিমের,	মেরিটাইমের,	
pothon,	পথন,	পঠন,	
parkin,	পারকিন,	পার্কিং,	
alpo,	আলপো,	অল্প,	
aairees,	আইরিস,	আইরিস,	
infarmatian,	ইনফারমেশন,	ইনফরমেশন,	
boiporiityen,	বৈপরিত্যেন,	বৈপরীত্যেন,	
orthanitike,	অর্থানীতিকে,	অর্থনীতিকে,	
tecno,	টেকনো,	টেকনো,	
projanankal,	প্রজানঙ্কল,	প্রজননকাল,	
mast,	মস্ত,	মাস্ত,	
pranidero,	প্রাণীদেরও,	প্রানীদেরও,	
dipon,	ডিপন,	দীপন,	
kloud,	ক্লুড,	ক্লাউড,	
kushumba,	কুশুম্ব,	কুশুম্বা,	
arke,	আরকে,	আরকে,	
katbe,	কাটবে,	কাটবে,	
gazipur,	গাজিপুর,	গাজিপুর,	
sarajibonbyapi,	সারাজীবন্যাপী,	সারাজীবনব্যাপী,	
atorkitey,	অতরকিতে,	অতর্কিতে,	
bhabatarini,	ভবতররিণী,	ভবতারিণী,	
bidhirnityang,	বিধির্ন্ত্যাং,	বিধির্নিত্যং,	
ucchosito,	উচ্চসিত,	উচ্ছসিত,	
gorrer,	গোরের,	গোরের,	
gaziipur,	গাজিপুর,	গাজীপুর,	
palbongsher,	পালবংশের,	পালবংশের,	
ramzaner,	রামজানের,	রমযানের,	
mukhabandha,	মুখবন্ধা,	মুখবন্ধ,	
swasthohinotay,	স্বাস্থ্যহীনতায়,	স্বাস্থ্যহীনতায়,	
torutoler,	তরুতলের,	তরুতলের,	
vaisoho,	ভাইসহ,	ভাইসহ,	
pooshteer,	পুস্টির,	পুষ্টির,	
saifai,	সাইফাই,	সাইফাই,	
shikshagata,	শিক্ষাগত,	শিক্ষাগত,	
dep,	ডিপ,	ডেপ,	
residence,	রেসিডেন্স,	রেসিডেন্স,	
gazetted,	গ্যাজেট্ড,	গেজেটেড,	
heavy,	হিভী,	হেভি,	
pujit,	পুজিত,	পুজিত,	
mulor,	মুলোর,	মুলোর,	
drissoteer,	দৃষ্যটির,	দৃশ্যটির,	
tigmanshu,	তিগমানশু,	তিগ্মাংশু,	
bibader,	বিবাদের,	বিবাদের,	
koyekbare,	কয়েকবারে,	কয়েকবারে,	
ummool,	উম্মুল,	উম্মুল,	
vobani,	ভোবানি,	ভবানী,	
shrimoti,	শ্রীমোতি,	শ্রীমতি,	
ponchashjon,	পঞ্চাশজন,	পঞ্চাশজন,	
daaun,	দাউন,	ডাউন,	
moshahidur,	মশাহীদুর,	মোশাহিদুর,	
nikate,	নিকাতে,	নিকটে,	
konistho,	কনিষ্ঠ,	কনিষ্ঠ,	
chhutochhuti,	ছুটোছুটি,	ছুটোছুটি,	
rakshanbhag,	রক্ষণভাগ,	রক্ষণভাগ,	
ansareer,	আনসারীর,	আনসারীর,	
niutrino,	নিউট্রিনো,	নিউট্রিনো,	
kuthibarike,	কুশিবারীকে,	কুঠিবাড়ীকে,	
vugorvey,	ভুগরভে,	ভূগর্ভে,	
nirvachokder,	নির্ভাচকদের,	নির্বাচকদের,	
matthews,	ম্যাচেভস,	ম্যাথিউস,	
avidur,	আভিদুর,	আভিদুর,	
salapheeta,	স্যালিফি,	সালফেট,	
aviyojan,	অভিযোজন,	অভিযোজন,	
gandhikey,	গাঁধিকে,	গান্ধীকে,	
lutherana,	লুথেরানা,	লুথেরান,	
with,	যুট,	ভিত,	
shabkam,	শবকাম,	শবকাম,	
deil,	ডীয়,	ডেইল,	
boshoborti,	বশবর্তী,	বশবর্তী,	
purushika,	পুরুষিকা,	পুরুষিকা,	
horippur,	হরিপপুর,	হরিপুর,	
vault,	ভেল্ট,	ভল্ট,	
aakik,	আকিক,	আকিক,	
meloonborrone,	মেলনবর্ণনে,	মেলবোর্নে,	
baibosthaar,	বৈবস্থার,	ব্যবস্থার,	
byaboharkari,	ব্যবহারকারী,	ব্যবহারকারী,	
gyandas,	জ্ঞানদাস,	জ্ঞানদাস,	
tookrote,	টুক্রতে,	টুকরোতে,	
chikkingsasoho,	চিক্কিংসহ,	চিকিংসাসহ,	
chalachchitrer,	চলচ্চিত্রের,	চলচ্চিত্রের,	
dhache,	ধাচে,	ধাঁচে,	
patjata,	পাটজাতা,	পাটজাত,	
sambhabonao,	সম্ভাবনাও,	সম্ভবনাও,	
dei,	দীই,	দিই,	
parishram,	পরিশ্রম,	পরিশ্রম,	
nodimatrik,	নদীমাত্রীক,	নদীমাতৃক,	
idipasha,	এডিপসা,	ইডিপাস,	
sorano,	সোরানো,	সরানো,	
prokar,	প্রকার,	প্রকার,	
codee,	কডি,	কোডে,	
bohoodin,	বহদিন,	বহুদিন,	
protectionism,	প্রটেকশনিিমম,	প্রোটেকশনিজম,	
madrasake,	মাদ্রাসাকে,	মাদ্রাসাকে,	
apad,	আপাদ,	আপদ,	
ashirbadatri,	আশীর্বাদতররী,	আশীর্বাদাত্রী,	
aashanka,	আশঙ্কা,	আশংকা,	
chetanagoto,	চেতানাগত,	চেতনাগত,	
narsaari,	নারসারি,	নার্সারি,	
acrolect,	অ্যাক্রোলেক্ট,	অ্যাক্রোলেক্ট,	
bii,	বিআই,	বি,	
miraclee,	মিরাকলি,	মিরাকেল,	
sthapona,	স্থাপনা,	স্থাপনা,	
dholeshwari,	ধলেশ্বরী,	ধলেশ্বরী,	
jegulur,	জেগুলুর,	যেগুলুর,	
dalee,	দালী,	ডালে,	
parisankhanbid,	পরিসংখ্বনবিদ,	পরিসংখ্যানবিদ,	
onupater,	অনুপাতের,	অনুপাতের,	
chaalaabi,	চালাবী,	চালাবে,	
thandabhabe,	ঠান্ডাভাবে,	ঠাণ্ডাভাবে,	
cloring,	ক্লোরিং,	ক্লোরিং,	
chinito,	চিনিত,	চিনতো,	
generalissimo,	জেনারালিসজিম,	জেনারেলিসিমো,	
osoborno,	অসরর্ন,	অসবর্ণ,	
rajbandi,	রাজবন্দি,	রাজবন্দী,	
basermick,	বেসেরমিক,	বেসারমিক,	
ruby,	রুবী,	রুবী,	
sabrakamer,	সাবরাকমের,	সবরকমের,	
kaash,	কাশ,	কাস,	
keu,	কেউ,	কেউ,	
zakharovar,	যাখারোভার,	জাখারোভার,	
amarjito,	অমর্জিত,	অমার্জিত,	
mandarbani,	মান্দারবানি,	মন্দারবাণী,	
mukhyo,	মুখ্য,	মুখ্য,	
abodamaner,	অবদামনের,	অবদমনের,	
plainey,	প্লেইনি,	প্লেনে,	
qor,	কোে,	কর,	
paab,	পাব,	পাব,	
gobeshana,	গবেষণা,	গবেষনা,	
drissogulo,	দৃষ্ণগুলো,	দৃশ্যগুলো,	
pracharanamulak,	প্রচারণামূলক,	প্রচারণামূলক,	
manob,	মানব,	মানব,	
grushko,	গ্রুষকো,	গ্রুশকো,	
taatey,	টাটে,	তাতে,	
abhidhaaner,	অভিধানের,	অভিধানের,	
phiqsa,	ফিকস,	ফিক্স,	
nehle,	নেহলে,	নেহলে,	
vodqa,	ভোডকা,	ভদকা,	
motke,	মতকে,	মতকে,	
shourshe,	শৌর্শে,	সোর্স,	
sharansthal,	শরনস্থল,	শরণস্থল,	
protishtan,	প্রতিষ্টান,	প্রতিষ্টান,	
grambaseer,	গ্রামবাসির,	গ্রামবাসীর,	
protyokkhovabey,	প্রত্যক্ষবাবে,	প্রত্যক্ষভাবে,	
nirabota,	নিরাবতা,	নিরবতা,	
shahanara,	শাহানারা,	শাহানারা,	
horidbar,	হরিদবার,	হরিদ্বার,	
madhuree,	মধুরী,	মাধুরী,	
horiddare,	হরিদদরাে,	হরিদ্বারে,	
highcommissionay,	হাইকোম্সিনে,	হাইকমিশনে,	
shudden,	শুদ্দেন,	সাডেন,	
grahoksebai,	গ্রাহকবেবাই,	গ্রাহকসেবায়,	
umb,	ইউএমবি,	ইউএমবি,	
horipur,	হরিপুর,	হরিপুর,	
sumita,	সুমিতা,	সুমিতা,	
goshthiti,	গোষ্ঠিটি,	গোষ্ঠীটি,	
gatibege,	গতিবেগে,	গতিবেগে,	
veniser,	ভেনিসের,	ভেনিসের,	
abti,	আব্টি,	আবতি,	
oitijje,	ঐতিজ্যে,	ঐতিহ্যে,	
parshwer,	পার্শ্বের,	পার্শ্বের,	
ispreedshiit,	ইসপ্রিদিশিত,	স্প্রেডশীট,	
patengar,	পাটেঙ্গার,	পতেঙ্গার,	
ghatiti,	ঘাটিটি,	ঘাঁটিটি,	
eenameela,	ইনোমিলা,	এনামেল,	
venuser,	ভেনুসের,	ভেনাসের,	
durbhagya,	দুর্ভাগ্য,	দূর্ভাগ্য,	
associatis,	অ্যাসোক্যাইটাসিস,	এসোসিয়েটস,	
postay,	পোস্টে,	পোস্টে,	
gara,	গ্যারা,	গোর,	
satyaky,	সত্যকি,	সাত্যকি,	
shringey,	শ্রিজে,	শৃঙ্গে,	
gronthowo,	গ্রন্থথয,	গ্রন্থও,	
jhonkar,	ঝোঁকার,	ঝঙ্কার,	
japanostho,	জাপানস্থ,	জাপানস্থ,	
mesenjarer,	মেসেঞ্জরের,	মেসেঞ্জারের,	
laga,	লাগা,	লগ,	
elgoridom,	এলজোরিদম,	এলগরিদম,	
noiteekotar,	নৈতিকতার,	নৈতিকতার,	
kuronir,	কুরোনির,	কুরনীর,	
fotanor,	ফটানোর,	ফোটানোর,	
bachai,	বাচাই,	বাছাই,	
kade,	কাদে,	কোড,	
kani,	কানী,	কানি,	
plasse,	প্লাসে,	প্লাসে,	
jani,	জানি,	জনি,	
definition,	ডিফিনিশন,	ডেফিনেশন,	
gandhike,	গাঁধীকে,	গান্ধীকে,	
srk,	এসআরসি,	শাহরুখ,	
faltu,	ফাল্টু,	ফালতু,	
shrabostee,	শ্রাবস্তি,	শ্রাবস্তী,	
okritokarjo,	অক্রিকরাগ্য,	অকৃতকার্য,	
khilaphat,	খিলাফত,	খিলাফত,	
laaz,	লাজ,	লাজ,	
bunot,	বুনোট,	বুনট,	
obosan,	অবসান,	অবসান,	
caramiks,	ক্যারামিকস,	সিরামিকস,	
dobhara,	ডোধারা,	ডোভার,	
milekhanek,	মিলেখানেক,	মাইলখানেক,	
kirti,	কীরটি,	কীর্তি,	
elakaatite,	এলাকাটিতে,	এলাকাটিকে,	
gotirodh,	গতিরোধ,	গতিরোধ,	
jeshtha,	যশশথা,	জ্যেষ্ঠা,	
orbeet,	অরবিত,	অরবিট,	
jorury,	জরিরি,	জরূরী,	
assaciates,	অ্যাসাকিসেস,	এসোসিয়েটস,	
laiseensim,	লেইসিনিম,	লাইসেন্সিং,	
remacry,	রিম্যাক্রি,	রেমাক্রী,	
protishta,	প্রতিষ্টা,	প্রতিষ্টা,	
kotibondhe,	কতিবন্ধে,	কটিবন্ধে,	
kayartara,	কয়ারটর,	কোয়ার্টার,	
quata,	কুয়াতা,	কোটা,	
horash,	হরাশ,	হোরাস,	
sangasthagulo,	সংস্থাগুলো,	সংস্থাগুলো,	
myathiou,	ম্যাথিউ,	ম্যাথিউ,	
zonsa,	জোন্সা,	জোন্স,	
shekarone,	শেকারনে,	সেকারণে,	
mukhbondho,	মুখবন্ধ,	মুখবন্ধ,	
nirarthak,	নিরার্থক,	নিরর্থক,	
golghare,	গোলঘরে,	গোলঘরে,	
sallallahu,	সাল্লাল্লাহু,	সল্লাল্লাহু,	
harees,	হরেস,	হ্যারিস,	
ramantika,	রামন্তিকা,	রোমান্টিক,	
ajijer,	আজিজের,	আজিজের,	
ganoparibahaner,	গণপরিবাহণের,	গণপরিবহনের,	
vitti,	ভিত্তি,	ভিত্তিই,	
andra,	আন্দ্রা,	আন্ড্রা,	
mane,	মানে,	মানে,	
koyeeri,	কয়েরি,	কোয়েরি,	
kalirkhal,	কালিরখাল,	কালিরখাল,	
mumtajer,	মুমতাজের,	মুমতাজের,	
chalochchitro,	চালচ্ছিত্র,	চলচ্চিত্র,	
tukrote,	টুকরোতে,	টুকরোতে,	
baarbadoj,	বারবাদজ,	বার্বাডোজ,	
priseflex,	প্রিসেফকেক্স,	প্রাইজফ্লেক্স,	
elakaai,	এলাকাই,	এলাকাই,	
neemitte,	নিমিত্তে,	নিমিত্তে,	
chalochchitrei,	চলচ্চিত্রেই,	চলচ্চিত্রেই,	
favorite,	ফ্যাভরিতে,	ফেভারিট,	
ikboler,	ইকবলের,	ইকবলের,	
mashtarsha,	মাষ্টার্শ,	মাস্টার্স,	
elakasoho,	এলাকাসহ,	এলাকাসহ,	
karmokarke,	কারমককারকে,	কর্মকারকে,	
aansaareer,	আনসারীর,	আনসারীর,	
basaake,	বাসাকে,	বাসাকে,	
sommotitey,	সম্মতিতে,	সম্মতিতে,	
mononiitoder,	মনোনিতদের,	মনোনীতদের,	
minilosar,	মিনিলোসার,	মিনিলোসার,	
aarke,	আরকে,	আরকে,	
digreeke,	ডিগ্রিকে,	ডিগ্রিকে,	
somosto,	সমস্ত,	সমস্ত,	
alonkaran,	অলনকরণ,	অলঙ্করণ,	
saoum,	সাওয়াম,	সাওম,	
soleel,	সোলিল,	সলিল,	
sthapanagulo,	স্থাপনাগুলো,	স্থাপনাগুলো,	
iling,	ইলিং,	ইলিং,	
tata,	টাট,	তাতা,	
latsaheb,	লাতসাহেব,	লাটসাহেব,	
johny,	জোনি,	জনি,	
bagdadii,	বাগদাদী,	বাগদাদী,	
pillai,	পিল্লাই,	পিল্লাই,	
bodhirta,	বোধিরটা,	বধিরতা,	
mesenjjar,	মেসেঞ্জার,	মেসেঞ্জার,	
vejjanno,	ভেজ্জান্ন,	ভেজানো,	
siddhante,	সিদ্ধন্তে,	সিদ্ধান্তে,	
gazeetteed,	গ্যাজেটিড,	গেজেটেড,	
orthanitir,	অর্থানীতির,	অর্থনীতির,	
abhirupbabuke,	অভিরূপবাবুকে,	অভিরূপবাবুকে,	
byke,	বিআইক,	বাইক,	
basaalt,	বেসাল্ট,	ব্যাসল্ট,	
elakaasoho,	এলাকাসহ,	এলাকাসহ,	
sausagee,	সৌসাগী,	সসেজ,	
bhutbhut,	ভূটভূট,	ভুটভুট,	
asamanyo,	অসমান্য,	অসামান্য,	
prity,	প্রিটি,	প্রিটি,	
shishu,	শিশু,	শিশু,	
kobutorer,	কবুতরের,	কবুতরের,	
shnaipara,	স্নাইপার,	স্নাইপার,	
nomo,	নোমো,	নমো,	
bharatey,	ভারতে,	ভারতে,	
oshtader,	ওষ্টাদের,	ওস্তাদের,	
nirbaaho,	নির্বাহও,	নির্বাহ,	
uddhritir,	উদ্ধৃতির,	উদ্ধৃতির,	
feemalee,	ফেমালি,	ফিমেল,	
senabahinikey,	সেনাবাহিনীকে,	সেনাবাহিনীকে,	
chetanagato,	চেতনাগত,	চেতনাগত,	
besirbhaagi,	বেসিরভাগী,	বেশিরভাগই,	
dip,	ডিপ,	দীপ,	
prakalpatike,	প্রকল্পটিকে,	প্রকল্পটিকে,	
chakradhare,	চক্রধরে,	চক্রধরে,	
cantan,	ক্যান্টান,	ক্যান্টন,	
susamo,	সুসোমো,	সুসম,	
lungiti,	লুঙ্গিটি,	লুঙ্গিটি,	
samajikatar,	সমাজিকতার,	সামাজিকতার,	
rachonakal,	রচনাকাল,	রচনাকাল,	
tophaat,	তোফাত,	তফাৎ,	
abhiyojan,	অভিযোজন,	অভিযোজন,	
graambaasheeo,	গ্রামবশীও,	গ্রামবাসীও,	
mojlish,	মজলিশ,	মজলিশ,	
qara,	কারা,	কর,	
aansareer,	আনসারীর,	আনসারীর,	
upobashii,	উপবাশী,	উপবাসী,	
engrejer,	এংরেজের,	ইংরেজের,	
akhandota,	অখণ্ডতা,	অখণ্ডতা,	
shekender,	শেকেন্দের,	সেকেন্ডের,	
digree,	ডিগ্রি,	ডিগ্রি,	
bhittitei,	ভিত্তিতেই,	ভিত্তিতেই,	
tintikey,	তিনটিকে,	তিনটিকে,	
poorohitra,	পুরহিত্রা,	পুরোহিতরা,	
dacope,	ডাকোপ,	দাকোপ,	
monir,	মনির,	মনির,	
battery,	ব্যাটার,	ব্যাটারী,	
dinifitian,	ডিনিফিশন,	ডেফিনেশন,	
fising,	ফিসিং,	ফিসিং,	
manushti,	মানুষ্টি,	মানুষটি,	
marketin,	মার্কেটিন,	মার্কেটিং,	
directorate,	ডিরেক্টরেট,	ডিরেক্টরেট,	
maarmaader,	মারমাদের,	মারমাদের,	
tigmanshu,	তিগমানশু,	তিগমংশু,	
taronee,	তরণী,	তরণী,	
karpeter,	কারপেটের,	কার্পেটের,	
gronthoti,	গ্রন্থটি,	গ্রন্থটি,	
byabaharkarike,	ব্যবহারকারীকে,	ব্যবহারকারীকে,	
shniper,	শ্নিপের,	স্নাইপার,	
swastir,	স্বস্তির,	স্বস্তির,	
hoil,	হইল,	হইল,	
horeepur,	হরিপুর,	হরিপুর,	
corymb,	কর্মিব,	করিম,	
sadeena,	সাদিনা,	সাডেন,	
machgulo,	মাছগুলো,	মাছগুলো,	
dombhoke,	দম্ভকে,	দম্ভকে,	
jatinkey,	জাতিনকে,	যতীনকে,	
kash,	কাশ,	কাস,	
gondhe,	গন্ধে,	গন্ধে,	
steena,	স্তিন,	স্টেন,	
konflict,	কনফ্লিক্ট,	কনফ্লিক্ট,	
akkaas,	আক্কাস,	আককাস,	
benojir,	বেনজির,	বেনজীর,	
agomoney,	আগমনে,	আগমনে,	
serology,	সেরোলজি,	সেরোলজি,	
taigara,	টাইগারা,	টাইগার,	
jeebanjapon,	জীবনজনপন,	জীবনযাপন,	
rohosyoti,	রহস্যতি,	রহস্যটি,	
bisshasyi,	বিশ্বাস্,	বিশ্বাসই,	
rahshahi,	রাহশাহি,	রাহশাহী,	
hevy,	হেভি,	হেভি,	
ramchander,	রামচন্দের,	রামচন্দরের,	
jyesttha,	জ্যেষ্টি,	জ্যেষ্ঠা,	
salchak,	সালচক,	সালচাক,	
siddhantoo,	সিদ্ধান্ত,	সিদ্ধান্তও,	
ministara,	মিনিস্তারা,	মিনিস্টার,	
oitijjo,	ঐতিহ্য,	ঐতিহ্য,	
providere,	প্রভীদেরে,	প্রভাইডারে,	
hindutirtha,	হিন্দুতীর্থ,	হিন্দুতীর্থ,	
siqhar,	সিখার,	শিকার,	
konisttha,	কনিষ্টা,	কনিষ্ঠ,	
hepatetisa,	হেপাটেটিসা,	হেপাটাইটিস,	
laiseensee,	লেইসিন্সি,	লাইসেন্স,	
smarok,	স্মরক,	স্মারক,	
chalochchitraeer,	চলচ্চিত্রারীর,	চলচ্চিত্রের,	
bone,	বনে,	বনে,	
monohputo,	মনোপূত,	মনঃপুত,	
holdim,	হোল্ডিম,	হোল্ডিং,	
prosadhani,	প্রসাধানী,	প্রসাধনী,	
mangolic,	ম্যানগোলিক,	মাঙ্গলিক,	
kyathlik,	ক্যাথলিক,	ক্যাথলিক,	
karaa,	কারা,	কারো,	
jeten,	জেতেন,	জেতেন,	
daybhager,	দায়ভাগের,	দায়ভাগের,	
byaboharkariyi,	ব্যবহারকারী,	ব্যবহারকারীই,	
poriharsoho,	পরিহারসহ,	পরিহারসহ,	
degree,	ডিগ্রি,	ডিগ্রি,	
valobasen,	ভালোবাসেন,	ভালোবাসেন,	
orhan,	ওরহান,	ওরহান,	
hol,	হোল,	হোল,	
carlo,	কার্লো,	কার্লো,	
graminphonor,	গ্রামিনফোনোর,	গ্রামীণফোনর,	
osthishondhi,	অস্থিশন্ধি,	অস্থিসন্ধি,	
sonaktokaran,	সোনাক্তকরণ,	সনাক্তকরণ,	
jesh,	জেশ,	জেস,	
mukharji,	মুখর্জি,	মুখার্জী,	
lotharan,	লোথারন,	লুথেরান,	
eoki,	এইকি,	এওকি,	
armashtram,	আর্মাষ্ট্রম,	আর্মস্ট্রং,	
kichutei,	কিছুতেই,	কিছুতেই,	
edseler,	এডসেলের,	এডসেলের,	
recondishon,	রেকন্ডিশন,	রিকন্ডিশন,	
karecho,	কারেছো,	করেছ,	
paira,	পিইই়ার,	পাইরা,	
seshardhe,	শেষার্ধে,	শেষার্ধে,	
renoo,	রেনো,	রেনো,	
osamanno,	অসমান্য,	অসামান্য,	
prosadhoner,	প্রসাধনের,	প্রসাধনের,	
relance,	রিলেন্স,	রিলায়েন্স,	
krisenta,	ক্রিসেন্টা,	ক্রিসেন্ট,	
oncholeo,	অঞ্চলেও,	অঞ্চলেও,	
zohns,	জনস্,	জন্স,	
turkeyder,	তুরকেদের,	তুর্কিদের,	
lahano,	লাহানো,	লাহানো,	
bisnukey,	বিস্নুকে,	বিষ্ণুকে,	
fasi,	ফাসি,	ফাঁসী,	
jalarong,	জালারাং,	জলরঙ,	
nirmankaaj,	নির্মানকাজ,	নির্মাণকাজ,	
dhangsachchi,	ধাবংসচ্ছি,	ধ্বংসাচ্ছি,	
parka,	পারকা,	পার্ক,	
saifullahil,	সাইফুল্লাহিল,	সাইফুল্লাহিল,	
motabolombira,	মতাবলম্বীরা,	মতাবলম্বীরা,	
aalkaatra,	অলকাত্র,	আলকাতরা,	
uindos,	উইননদ,	উইন্ডোস,	
kanuner,	কানুনের,	কানুনের,	
poribahokotto,	পরিবাহকত্ব,	পরিবাহকত্ব,	
mythological,	মিথলজিকাল,	মাইথলজিকাল,	
torkarite,	তর্কারিতে,	তরকারিতে,	
masjidtir,	মাসজিদটির,	মসজিদটির,	
mandope,	ম্যান্ডপে,	মন্ডপে,	
waal,	ভেয়াল,	উল,	
indrakanan,	ইন্দ্রকানন,	ইন্দ্রকানন,	
pharanyeta,	ফরণ্যেত,	ফরম্যাট,	
gobeshonar,	গবেষণার,	গবেষনার,	
lishenshe,	লিশেন্সে,	লাইসেন্স,	
shhow,	শোভ,	শো,	
deputy,	ডিপুটি,	ডেপুটি,	
gaaddafee,	গাদ্দাফী,	গাদ্দাফী,	
majdur,	মাজদুর,	মজদুর,	
shangsthatikey,	সাংস্থাটিকে,	সংস্থাটিকে,	
guzon,	গুজন,	গুজব,	
sithilota,	সিথিলতা,	শিথিলতা,	
daktickete,	ড্যাকটিকেতে,	ডাকটিকিটে,	
shukraanoo,	শুক্রানৌ,	শুক্রানু,	
drabyatah,	দ্রব্যাতঃ,	দ্রব্যতঃ,	
saralya,	সরল্যা,	সারল্য,	
dienes,	ডায়েনিস,	ডিএনএস,	
aporishodhito,	অপরিষধিত,	অপরিশোধিত,	
ekshoti,	একশতি,	একশোটি,	
maadla,	মাদলা,	মাদলা,	
bohudeen,	বহুদীন,	বহুদিন,	
phartha,	ফার্া,	ফার্থ,	
futote,	ফুটোতে,	ফুটোতে,	
peterke,	পেটারকে,	পিটারকে,	
kathmandute,	কাঠমণ্ডুতে,	কাঠমান্ডুতে,	
rajtantrey,	রাজতন্ত্রে,	রাজতন্ত্রে,	
paadee,	পদি,	পাড়ে,	
protijogiider,	প্রতিযোগীদের,	প্রতিযোগীদের,	
munsi,	মুনসি,	মুন্সী,	
kode,	কোদ,	কোড,	
muhuriganj,	মুহুরীগঞ্জ,	মুহুরীগঞ্জ,	
saramukhe,	সারামুখে,	সারামুখে,	
karmazog,	কার্মযোগ,	কর্মযোগ,	
beshirbhaagei,	বেশীরভাগেই,	বেশিরভাগেই,	
jacksoner,	জ্যাকসনের,	জ্যাকসনের,	
hock,	হকক,	হুক,	
kholdhular,	খোলধুলার,	খোলধূলার,	
krus,	ক্রুস,	ক্রুশ,	
ghuznavi,	ঘুজনাভি,	গজনভি,	
chhuteer,	ছুটির,	ছুটির,	
gopalrao,	গোপালরাও,	গোপালরাও,	
baieq,	বেইইক,	বাইক,	
gaphiloti,	গ্যাফিলোটি,	গাফিলতি,	
bhagnekeo,	ভাগনেজেও,	ভাগ্নেকেও,	
eshtoniya,	এস্তনিয়া,	এস্তোনিয়া,	
pleto,	প্লেটো,	প্লেটো,	
sorting,	সর্টিং,	সর্টিং,	
bhangle,	ভাঙ্গলে,	ভাঙলে,	
byabosthar,	ব্যবস্থার,	ব্যাবস্থার,	
pingna,	পিংনা,	পিংনা,	
amarika,	আমারিকা,	আমেরিকা,	
bosturoi,	বস্তুরই,	বস্তুরই,	
kleentoner,	ক্লিনেননের,	ক্লিনটনের,	
ceramicsh,	সেরামিকস,	সিরামিকস,	
shektor,	শেখতোর,	সেক্টর,	
saabyastha,	সব্যস্থ,	সাব্যস্থ,	
metrikoleshana,	মেত্রিকলেশনা,	মেট্রিকোলেশন,	
sohinsotar,	সহহিনসতার,	সহিংসতার,	
bisheshya,	বিশেষ্য,	বিশেষ্য,	
kuttake,	কুট্টাকে,	কুত্তাকে,	
hamburgey,	হ্যামবার্গে,	হামবুর্গে,	
bashoborty,	বাশবর্তী,	বশবর্তী,	
jandrel,	জান্দ্রেল,	জাঁদরেল,	
edipass,	এডিপ্স,	ইডিপাস,	
fatakesto,	ফাটাকেস্তো,	ফাটাকেষ্ট,	
huka,	হুকা,	হুক,	
shommotite,	সম্মতিতে,	সম্মতিতে,	
average,	এভারেজ,	এভারেজ,	
chalai,	চালাই,	চালাবে,	
setike,	সেটিকে,	সেটিকে,	
babare,	বাবারে,	বাবারে,	
mercial,	মার্সিয়াল,	মার্শিয়াল,	
taims,	টেইমস,	টাইমস্,	
ponchaashjon,	পঞ্চাশজন,	পঞ্চাশজন,	
panchashjan,	পঞ্চশজন,	পঞ্চাশজন,	
baaik,	বাইক,	বাইক,	
jakatke,	জাকাতকে,	যাকাতকে,	
barrageke,	বার্াজেকে,	ব্যারেজকে,	
eesa,	আইএসএ,	আইএএস,	
sharoker,	শারকের,	স্মারকের,	
ghamtaa,	ঘামটা,	ঘোমটা,	
muradkey,	মুরাদকে,	মুরাদকে,	
deelibhara,	ডেলিভারা,	ডেলিভার,	
loombinee,	লুমবিনি,	লুম্বিনী,	
taderek,	তাদেরেক,	তাদেরেক,	
dormitory,	ডর্মিটরি,	ডরমিটরি,	
cheerokoomari,	চিরকৌমারী,	চিরকুমারী,	
harbore,	হারবরে,	হারবারে,	
fastag,	ফাস্টাগ,	ফ্যাসট্যাগ,	
sontoshpur,	সন্তোষপুর,	সন্তোষপুর,	
ishton,	ইস্তন,	স্টোন,	
alexandar,	আলেক্সান্ডার,	আলেকজান্ডার,	
salsa,	সালসা,	সালসা,	
sylvi,	সিলভি,	সিলভি,	
doneta,	ডোনেটা,	ডোনাট,	
siddharther,	সিদ্ধার্থের,	সিদ্ধার্থের,	
argho,	অর্ঘ,	অর্ঘ্য,	
saarbharti,	সারভারটি,	সার্ভারটি,	
rejidens,	রেজিডেনস,	রেসিডেন্স,	
fansi,	ফানসি,	ফাঁসী,	
laesensh,	লেইসেনস,	লাইসেন্স,	
bhujangta,	ভুজংটা,	ভুজঙ্গটা,	
uchchotara,	উচ্চতারা,	উচ্চতর,	
jamanataswarup,	জনমকাস্বরূপ,	জামানতস্বরূপ,	
promodwara,	প্রমোদ্বারা,	প্রমদ্বারা,	
jor,	জোয়,	জ্বর,	
anektai,	অনেকটাই,	অনেকটাই,	
mmehonoti,	ম্মেহনতি,	মেহনতি,	
directarate,	ডাইরেক্টরেট,	ডিরেক্টরেট,	
arthonitir,	অর্থনীটির,	অর্থনীতির,	
hugheke,	হুগেকে,	হিউজকে,	
kaamij,	কমিজ,	কামিজ,	
ajibooner,	অজিবুনের,	আজীবনের,	
shajano,	শাজানো,	সাজানো,	
kadakhonchar,	কাদাখোঁচার,	কাদাখোঁচার,	
mukhamandoler,	মুখমন্ডলের,	মুখমণ্ডলের,	
doorger,	ডুর্গের,	দুর্গের,	
deares,	ডিয়ার্স,	ডিআরএস,	
fakhrul,	ফখরুল,	ফাখরুল,	
armeeniyana,	আরমিনিয়ান,	আর্মেনিয়ান,	
ateetkaale,	অতীতকালে,	অতীতকালে,	
cheekitshar,	চিকিৎ্ার,	চিকিত্সার,	
phood,	ফুড,	ফুড,	
saqara,	সাকারা,	সাকার,	
siraju,	সিরাজু,	সিরাজু,	
proteemake,	প্রতিমাকে,	প্রতিমাকে,	
dolu,	দলু,	ডলু,	
bosantake,	বসন্তাকে,	বসন্তকে,	
beauby,	বিউবি,	বিউবি,	
ghoshito,	ঘোষিত,	ঘোষিত,	
dera,	ডিরা,	ডেরা,	
oncholtee,	অঞ্চলটি,	অঞ্চলটি,	
ghatleo,	ঘাটলেও,	ঘটলেও,	
janghu,	জঙ্ঘু,	জঙ্ঘু,	
rashider,	রশিদের,	রশিদের,	
ghomtaa,	ঘোমটা,	ঘোমটা,	
spredashiita,	স্প্রেণাশীতা,	স্প্রেডশীট,	
orrgho,	অর্ঘ,	অর্ঘ্য,	
rohinibabu,	রোহিনিবাবু,	রোহিনীবাবু,	
injiniyarim,	ইঞজিনিয়ারিম,	ইঞ্জিনিয়ারিং,	
hank,	হাঁক,	হাঙ্ক,	
saria,	সরিয়া,	সরিয়া,	
udyem,	উদ্যেম,	উদ্যেম,	
jhumjhumita,	ঝুমঝুমিতা,	ঝুমঝুমিটা,	
bakhyateet,	বাখ্যাটিত,	ব্যাখ্যাতীত,	
langhangulir,	লঙ্ঘনগুলির,	লঙ্ঘনগুলির,	
prosadhaner,	প্রসাধনের,	প্রসাধনের,	
madrasa,	মাদ্রাসা,	মাদ্রাসা,	
neshnosh,	নেশনোষ,	নেশনস,	
kanar,	কানার,	কণার,	
cn,	সিএনএ,	সিএন,	
graambashee,	গ্রামবেশী,	গ্রামবাসী,	
encidablu,	এনসিডাবলু,	এনসিডাব্লু,	
teter,	টেটের,	টেটের,	
arthurer,	আর্থুরের,	আর্থারের,	
shansthagulo,	শান্স্থগুলো,	সংস্থাগুলো,	
brekethru,	ব্রেকেট্রু,	ব্রেকথ্রু,	
pooshti,	পুষ্টি,	পুষ্টি,	
akkheperi,	অক্ষেপেরই,	আক্ষেপেরই,	
girilal,	গিরিলাল,	গিরিলাল,	
bhramarotsab,	ভ্রমরোত্সব,	ভ্রমরোৎসব,	
prime,	প্রাইম,	প্রাইম,	
bodhir,	বোধীর,	বধির,	
akpashe,	আকপাশে,	একপাশে,	
milton,	মিলটন,	মিলটন,	
bajpa,	বাজপা,	বাজপা,	
jommu,	জম্মু,	জম্মু,	
toptoshele,	তপ্তশেলে,	তপ্তশেলে,	
esasiyetasa,	এসাসিয়েটস,	এসোসিয়েটস,	
hastantar,	হস্তান্তর,	হস্তান্তর,	
samaptir,	সামাপ্তির,	সমাপ্তির,	
myat,	ম্যাট,	ম্যাট,	
bikargrosto,	বিকারগ্রস্ত,	বিকারগ্রস্ত,	
bhagno,	ভাগনো,	ভগ্ন,	
baffer,	ব্যাফার,	বাফার,	
asaktibandhan,	অসক্তিবন্ধন,	আসক্তিবন্ধন,	
israelbahini,	ইসরাালবাহিনী,	ইস্রায়েলবাহিনী,	
bosante,	বসান্তে,	বসন্তে,	
anubhutimalar,	অনুভূতিমোলার,	অনুভূতিমালার,	
khelechen,	খেলেছেন,	খেলেছেন,	
tarunra,	তরুণরা,	তরুণরা,	
bostubad,	বস্তুবাদ,	বস্তুবাদ,	
idyi,	ইদ্যি,	আইডিই,	
aaziz,	আজিজ,	আজিজ,	
elaaka,	এলাকা,	এলাকা,	
mercedes,	মার্েড,	মার্সেডেস,	
landin,	ল্যান্ডিন,	ল্যান্ডিং,	
murader,	মুরাদের,	মুরাদের,	
dibi,	দিবি,	দিবি,	
shikhaboudi,	শিখববৌড়ি,	শিখাবৌদি,	
kraim,	ক্রেম,	ক্রাইম,	
mosjidtir,	মসজিদটির,	মসজিদটির,	
toxoid,	টক্সডয়েড,	টক্সয়েড,	
istoone,	ইস্তুন,	স্টোন,	
snehban,	স্নেহবান,	স্নেহবান,	
marpit,	মারপিট,	মারপিট,	
jatinke,	জাতিনকে,	যতীনকে,	
sucre,	সুক্রে,	সাকার,	
uddharkarmirai,	উদ্ধারকর্মীরাই,	উদ্ধারকর্মীরাই,	
prothakey,	প্রথাকে,	প্রথাকে,	
aalaa,	আলা,	আলা,	
palashir,	পলাশির,	পলাশীর,	
mohammadi,	মোহম্মদি,	মুহাম্মদী,	
mastarsa,	মস্তরাস্,	মাস্টার্স,	
manush,	মানুষ,	মানুষ,	
kindom,	কিন্দম,	কিংডম,	
uparjoner,	উপার্জনের,	উপার্জনের,	
rajtontro,	রাজতন্ত্র,	রাজতন্ত্র,	
motkey,	মোককে,	মতকে,	
palkee,	পালকি,	পাল্কি,	
dara,	দারা,	দারা,	
adhyattikota,	আধ্যাত্মিকতা,	আধ্যাত্মিকতা,	
phutbolarder,	ফুটবলারদের,	ফুটবলারদের,	
torabganj,	তোরাগঞঞ্জ,	তোরাবগঞ্জ,	
oxfordey,	অক্সফোর্ডে,	অক্সফোর্ডে,	
dumaa,	ডুমা,	দুমা,	
chhuti,	ছুটি,	ছুটি,	
shiqara,	শিকারা,	শিকার,	
cheef,	চেফ,	শেফ,	
biplobi,	বিপ্লবি,	বিপ্লবী,	
difinision,	ডিফিনিশন,	ডেফিনেশন,	
dwipke,	দ্বীপকে,	দ্বীপকে,	
bibecchyo,	বিবেচ্ছ,	বিবেচ্য,	
kaansaat,	কানসাত,	কানসাট,	
louhojato,	লৌহযাত,	লৌহজাত,	
drissogulote,	দৃষ্ণগুলোতে,	দৃশ্যগুলোতে,	
qlauda,	ক্লাউদা,	ক্লাউড,	
rajshri,	রাজশ্রী,	রাজশ্রী,	
bhenkates,	ভেঙ্কটেস,	ভেঙ্কটেশ,	
attacharito,	অট্টাচারিত,	অত্যাচারিত,	
ancholsomuho,	আঞ্চসলমূহ,	অঞ্চলসমূহ,	
mag,	মাগ,	এমএজি,	
tukrowti,	টুকরোটটি,	টুকরোটি,	
binakar,	বিনাকার,	বিনাকার,	
niemond,	নাইমন্ড,	নিমন্ড,	
khelaphate,	খেলাফাতে,	খেলাফতে,	
pyaleshtainer,	প্যালেশন্টাইর,	প্যালেস্টাইনের,	
veenis,	ভেনিস,	ভেনিস,	
matis,	মাতিস,	ম্যাটিস,	
societykey,	সোজিটেইকে,	সোসাইটিকে,	
byabaharkaree,	ব্যবহারকারী,	ব্যবহারকারী,	
amudey,	আমুদে,	আমুদে,	
antennal,	আন্তেননাল,	অ্যান্টেনাল,	
lendol,	লেন্ডল,	লেন্ডল,	
codeti,	কোডেটি,	কোডটি,	
shikkhadikkhay,	শিক্ষাদিক্ষায়,	শিক্ষাদিক্ষায়,	
patishapta,	পাটিশাপ্ত,	পাটিসাপটা,	
hool,	হুল,	হুল,	
dokkhinangsho,	দক্ষিণাংশ,	দক্ষিণাংশ,	
sookumari,	ওুকুমারী,	সুকুমারী,	
lutharen,	লুথারেন,	লুথেরান,	
seekkhaou,	শিক্ষাওু,	শিক্ষাও,	
ashok,	অশোক,	আশোক,	
edmiral,	এদমিরাল,	এডমিরাল,	
dhormokorme,	ধর্মকর্মে,	ধর্মকর্মে,	
elahabade,	এলাহাবাদে,	এলাহাবাদে,	
kazianis,	কাজিয়ানীস,	কাজানিস,	
hosto,	হস্ত,	হস্ত,	
taunship,	টাউনশিপ,	টাউনশিপ,	
nagorikke,	নাগরিককে,	নাগরিককে,	
masjidke,	মাসজিদকে,	মসজিদকে,	
hooq,	হুক,	হুক,	
thailandshoho,	থাইলান্দসহ,	থাইল্যান্ডসহ,	
landing,	ল্যান্ডিং,	ল্যান্ডিং,	
atmobonchito,	আত্মবঞ্চিত,	আত্মবঞ্চিত,	
basakey,	বাসাকে,	বাসাকে,	
ovarview,	ওভারভিউ,	ওভারভিউ,	
alaul,	আলাউল,	আলাওল,	
ajeem,	অ্যাজিম,	আজিম,	
samajeek,	সমজিক,	সামাজিক,	
reshmirekha,	রেশমিরেখা,	রেশমীরেখা,	
elaakate,	এলাকাতে,	এলাকাতে,	
avinetar,	অভিনেতার,	অভিনেতার,	
songasthaner,	সংস্থানের,	সংস্থানের,	
talaa,	তালা,	তালা,	
greenald,	গ্রিনল্ড,	গ্রিনল্ড,	
shasyadi,	শস্যাদি,	শস্যাদি,	
debeting,	ডেবেটিং,	ডিবেটিং,	
dakope,	ডাকোপ,	দাকোপ,	
horas,	হোরাস,	হোরাস,	
laatimer,	লাটিমের,	লাটিমের,	
anisa,	আনিসা,	আনিস,	
sukumaree,	সুকুমারী,	সুকুমারী,	
mumtaz,	মুমতাজ,	মুমতাজ,	
govindarajan,	গোবিন্দরাজন,	গোবিন্দরাজন,	
harja,	হারজা,	হার্জ,	
talgachh,	তালগাছ,	তালগাছ,	
serveray,	সার্ভারে,	সার্ভারে,	
kaalaam,	কালাম,	কালাম,	
flux,	ফ্লাক্স,	ফ্লাস্ক,	
chhootochhuti,	ছটটচুটি,	ছুটোছুটি,	
durtomo,	দুর্তম,	দূরতম,	
bipajjanak,	বিপাজনজক,	বিপজ্জনক,	
sikarder,	সিকারদের,	শিকারদের,	
dooburir,	দবুরির,	ডুবুরির,	
medilek,	মেডিলেক,	মেডিলেক,	
marathi,	মারাথি,	মরাঠি,	
jubokti,	যুবক্তি,	যুবকটি,	
mulbhitti,	মূলভিট্টি,	মূলভিত্তি,	
rabo,	রাবো,	রব,	
dolphiny,	ডলফিনি,	ডলফিনি,	
rajnaiteek,	রাজনৈতিক,	রাজনৈতীক,	
furio,	ফুরিও,	ফুরিও,	
santoshpore,	সন্তোষপরে,	সন্তোষপুর,	
flirt,	ফ্লার্ট,	ফ্লার্ট,	
dankaan,	দানকান,	ডানকান,	
bhejaano,	ভেজানও,	ভেজানো,	
aprasangikbhabei,	অপ্রসংগীদভাবেই,	অপ্রাসঙ্গিকভাবেই,	
expreshshion,	এক্সপ্রেশন,	এক্সপ্রেশন,	
asantosh,	অসন্তোষ,	অসন্তোষ,	
robot,	রোবট,	রোবোট,	
augustine,	অগাস্টিন,	অগাস্টিন,	
cheentaikaree,	চিন্তইকারী,	ছিনতাইকারী,	
pyetarna,	প্তেরাণ,	প্যাটার্ন,	
sadbi,	সাদবি,	সাধ্বী,	
ekekrokom,	একেককোম,	একেকরকম,	
bowie,	বোয়ে,	বওই,	
rajotta,	রাজত্বা,	রাজত্ব,	
treend,	ট্রিন্ড,	ট্রেন্ড,	
sector,	সেক্টর,	সেক্টর,	
saptahokal,	সপ্তাখোলা,	সপ্তাহকাল,	
ashankai,	অশঙ্কাই,	আশঙ্কাই,	
dinara,	দিনারা,	ডিনার,	
laishensha,	লৈশেন্স,	লাইসেন্স,	
ashanka,	আশাঙ্কা,	আশংকা,	
ekbakye,	একবাক্্,	একবাক্যে,	
amittrakkhor,	অমিত্যাক্ষর,	অমিত্রাক্ষর,	
vabnakey,	ভাবনাকে,	ভাবনাকে,	
bane,	ব্যান,	বনে,	
kalenga,	কালেঙ্গা,	কালেঙ্গা,	
laaisheesh,	লইশীস,	লাইসেন্স,	
songkulan,	সংকুল্ন,	সংকুলান,	
shite,	সিটে,	শীতে,	
bouddha,	বৌদ্ধ,	বৌদ্ধ,	
swarther,	স্বর্থের,	স্বার্থের,	
jitpur,	জিতপুর,	জিতপুরের,	
rinattak,	ঋণতাত্মক,	ঋনাত্মক,	
beam,	বিএইএম,	বিম,	
roktokhoron,	রক্তকরষণ,	রক্তক্ষরণের,	
mekong,	মেকং,	মেকং,	
nirvachaker,	নির্ভাচকের,	নির্বাচকের,	
segular,	সেগুলার,	সেগুলোর,	
bojhey,	বঝেয়,	বোঝে,	
farna,	ফারান,	ফার্ন,	
raia,	রাইয়া,	রায়,	
azimpur,	আজিমপুর,	আজিমপুর,	
superheroo,	সুপারহিরুও,	সুপারহিরো,	
jinsa,	জিনসা,	জিন্স,	
aarik,	আরিক,	আরিক,	
prithibir,	পৃথিবীর,	পৃথবীর,	
nodiiteyi,	নদীতেয়ে,	নদীতেই,	
orthoneeti,	অর্থনীতি,	অর্থনীতির,	
distibutor,	ডিস্টিবুটর,	ডিস্টিবিউটারের,	
monzushree,	মন্জুষ্রী,	মঞ্জুশ্রী,	
sonaicha,	সোনাইচা,	সোনাইচা,	
deciliter,	ডেসিলিটার,	ডেসিলিটার,	
grambaasheeo,	গ্রামবাশিও,	গ্রামবাসীও,	
blacq,	ব্ল্যাক,	ব্ল্যাক,	
erokomer,	এরকমের,	এরকমের,	
attorkite,	আট্রটটিতে,	অতর্কিতে,	
buth,	বুথ,	বুথ,	
choson,	চোসন,	চোষণ,	
shoreefer,	শরীফের,	শরিফের,	
alaol,	আলাউল,	আলাওল,	
meloonborroner,	মেলনবর্ণনের,	মেলবোর্নের,	
byboshthar,	বিশ্বথ্রার,	ব্যাবস্থার,	
rakkhanvag,	রক্ষণভাগ,	রক্ষণভাগ,	
fishing,	ফিশিং,	ফিসিং,	
muradke,	মুরাদকে,	মুরাদকে,	
shikshakrom,	শিক্ষাক্রম,	শিক্ষাক্রম,	
ghoomachhe,	ঘুমাচেছে,	ঘুমাচ্ছে,	
bondiira,	বন্দিয়ারা,	বন্দীরা,	
nabatarange,	নবতরঙ্গে,	নবতরঙ্গে,	
bujhtepari,	বুঝতেপারী,	বুঝতেপারি,	
alpakichudin,	আল্পকিলুধীন,	অল্পকিছুদিন,	
suparharo,	সুপাহারোর,	সুপারহিরো,	
cuti,	কুতী,	কিউটি,	
akkhunno,	অক্ষুন্ন,	অক্ষুণ্ণ,	
monjooshree,	মঞ্জুষ্বী,	মঞ্জুশ্রী,	
amor,	অমর,	আমর,	
pinglateo,	পিংলাতেও,	পিংলাতেও,	
asovyo,	আসভ্য,	অসভ্য,	
pathanirdeshona,	পাঠানির্ধেশনা,	পথনির্দেশনা,	
swadhinotatukui,	স্বাধীনতাটুকুই,	স্বাধীনতাটুকুই,	
uddhritto,	উদ্ধৃত্ব,	উদ্ধৃত,	
shommoteer,	সম্মতির,	সম্মতির,	
uddhrito,	উদ্ধৃত,	উদ্ধৃত,	
mahasava,	মহাসাভা,	মহাসভা,	
chaalkee,	চালক,	চালকে,	
muhurtati,	মুহূর্তটি,	মুহুর্তটি,	
croak,	ক্রোক,	ক্রোক,	
ul,	উউ,	উল,	
uporitaley,	উপরিতালে,	উপরিতলে,	
mohit,	মোহিত,	মুহিত,	
oichchheek,	ঐচ্ছিক,	ঐচ্ছিক,	
superheiroo,	সুপারহিউরও,	সুপারহিরো,	
emargency,	এমারজেন্সি,	এমার্জেন্সি,	
phaltu,	ফালতু,	ফালতু,	
naazee,	নাজি,	নাত্সি,	
rohasyer,	রহস্যের,	রহস্যের,	
alkatra,	অলকাত্র,	আলকাতরা,	
shaater,	সাটের,	শ্যুটার,	
nothivukta,	নথিভুক্ত,	নথিভুক্ত,	
konroop,	কন্রপ,	কোনরূপ,	
cholochchitrer,	চলচ্চিত্রের,	চলচ্চিত্রের,	
dekhso,	দেখসো,	দেখসো,	
starker,	স্টার্কের,	স্টার্কের,	
nili,	নীলি,	নিলি,	
blacker,	ব্ল্যাকের,	ব্ল্যাকের,	
palta,	পাল্টা,	পালটা,	
pinogbagke,	পিনোগবাগকে,	পিনগবাগকে,	
sahapathike,	সহপাঠিকে,	সহপাঠীকে,	
silabhara,	সিলাভারা,	সিলভার,	
uposhthit,	উপস্থিত,	উপস্থিত,	
scholars,	স্কলার্স,	স্কলার্স,	
mathews,	ম্যাথেয়,	ম্যাথিউস,	
plusey,	প্লাসে,	প্লাসে,	
aizulke,	আইজুলকে,	আইজুলকে,	
chitlar,	চিতলার,	চিতলার,	
malinga,	মালিঙ্গা,	মালিংগা,	
masjidti,	মাসজিদটি,	মসজিদটি,	
eshtonia,	এস্টনিয়া,	এস্তোনিয়া,	
shardotsobei,	শার্দোৎসবেই,	শারদোৎসবেই,	
licensin,	লাইসেনসিন,	লাইসেন্সিং,	
suiza,	সুইজা,	সুইজা,	
kruser,	ক্রুসের,	ক্রুশের,	
baganoto,	বাগানোত,	বাগানত,	
sooya,	সুয়া,	সোয়া,	
kogake,	কোগাকে,	কোগাকে,	
khoakshir,	খোয়াকশির,	খোয়াক্ষীর,	
mmadhuri,	ম্মাধুরী,	মাধুরী,	
karadando,	কারাদান্দে,	কারাদণ্ড,	
jones,	জোনেস,	জোন্স,	
shhikara,	শিকারা,	শিকার,	
kaalengaa,	কালেঙ্গা,	কালেঙ্গা,	
abheedhanik,	অভিধানিক,	অভিধানিক,	
site,	সিতে,	সিটে,	
aasar,	আসার,	আসর,	
nirbachokder,	নির্বাচকদের,	নির্বাচকদের,	
shiropar,	শিরোপার,	শিরোপার,	
nosihote,	নসীহতে,	নসিহতে,	
felto,	ফেল্টো,	ফেলত,	
venice,	ভেনিক,	ভেনিস,	
sqalastiqa,	স্ক্যালস্টিকা,	স্কলাস্টিক,	
tukroti,	টুকরোটি,	টুকরোটি,	
shahoshikatar,	শহশীকতার,	সাহসিকতার,	
ralf,	রালফফ,	রালফ,	
fongli,	ফংলি,	ফংলি,	
awatar,	আওয়াতার,	অবতার,	
registrikrito,	রেজিস্ট্রিৃত,	রেজিস্ট্রীকৃত,	
satarkabhabe,	সতর্কভাবে,	সতর্কভাবে,	
nischoy,	নিশ্চই,	নিশ্চয়,	
prasadhani,	প্রসাধানী,	প্রসাধনী,	
cheerontan,	চেরোন্তান,	চিরন্তন,	
vishnuu,	বিষ্ণুই,	বিষ্ণু,	
byabaharkareederke,	ব্যবহারকারীদেরকে,	ব্যবহারকারীদেরকে,	
bhupal,	ভূপাল,	ভূপাল,	
rijoor,	রিজৌর,	রিজুর,	
pranibigyani,	প্রাণীবিজ্ঞানী,	প্রাণীবিজ্ঞানী,	
sofie,	সোফি,	সোফি,	
showtey,	সত্যে,	শোতে,	
mach,	মাচ,	মাছ,	
restuarant,	রেস্টুরেন্ট,	রেষ্টুরেন্ট,	
phokser,	ফকসের,	ফক্সের,	
kalkarkhana,	কলকরখানা,	কলকারখানা,	
sheekar,	শিকার,	শিকার,	
chalaabi,	চালাবী,	চালাবে,	
tiunara,	টিউনারা,	টিউনার,	
meridiane,	মেরিডিয়ানে,	মেরিডিয়ানে,	
mandape,	মান্ডাপে,	মন্ডপে,	
jati,	জাতি,	যাতি,	
eucalyptus,	ইউক্লাপ্টিস,	ইউক্যালিপ্টাস,	
rohosyo,	রহস্য,	রহস্য,	
kormokarer,	কর্মকারের,	কর্মকারের,	
kk,	কে,	কেকে,	
nothibhukta,	নথিভুক্ত,	নথিভুক্ত,	
daaktikit,	ডাক্তিকিট,	ডাকটিকিট,	
hypar,	হিপার,	হাইপার,	
mile,	মিলে,	মিলে,	
ahmed,	আহমেদ,	আহামদ,	
bm,	বিএম,	বিএম,	
duio,	দুইও,	দুইও,	
shikhbe,	শিখবে,	শিখবে,	
rajyabhogi,	রাজ্যভোগী,	রাজ্যভোগী,	
brail,	ব্রেইল,	ব্রেইল,	
mukhomandoler,	মুখমন্ডলের,	মুখমণ্ডলের,	
oikhan,	ওইখান,	ঐখান,	
ispredsheet,	ইসপ্রেদশিত,	স্প্রেডশীট,	
adhunikkale,	আধুনিককালে,	আধুনিককালে,	
nirgamon,	নির্গামন,	নির্গমন,	
geejeeteeda,	জিজেটিদ,	গেজেটেড,	
granada,	গ্র্নাডা,	গ্র্যানাডা,	
bishshaasho,	বিশ্বাশ,	বিশ্বাসও,	
sqalarashipa,	স্কলরাশিপ,	স্কলারশিপ,	
angsogrohone,	আংশগ্রহণে,	অংশগ্রহনের,	
eesosiyeetasa,	ইসজিিয়েটাস,	এসোসিয়েটস,	
baju,	বাজু,	বাজু,	
bhyatikaner,	ভ্যাটিকানের,	ভ্যাটিকানের,	
path,	পাত,	পাথ,	
sayatana,	সাইতানা,	শয়তান,	
khargosher,	খারগোের,	খরগোসের,	
jibanto,	জীবন্ত,	জীবন্ত,	
kadam,	কাদম,	কদম,	
oncholshomuher,	অঞ্চলসমূহের,	অঞ্চলসমূহের,	
dojo,	ডোজো,	ডোজো,	
tarkale,	তারকালে,	তারকালে,	
proshikkhane,	প্রশিক্ষণে,	প্রশিক্ষণে,	
teenisa,	তীনিসা,	টেনিস,	
joones,	জুনেস,	জোন্স,	
shibraj,	শিবরাজ,	শিবরাজ,	
sampadoner,	সম্পাদনের,	সম্পাদনের,	
churger,	চুর্গের,	চার্জের,	
suri,	সুরী,	সুরি,	
akai,	অকাই,	একাই,	
giitikobita,	গীতিককিবা,	গীতিকবিতা,	
bojhao,	বোঝাও,	বোঝাও,	
noiteek,	নৈতিক,	নৈতিক,	
bopoon,	বপউন,	বপন,	
sarsa,	সারসা,	সোর্স,	
kalnir,	কালনির,	কালনীর,	
sarder,	সারদের,	সরদার,	
bishshasho,	বিশ্বশস,	বিশ্বাসও,	
chasee,	চাসি,	চেস,	
doorotaumo,	দূরতূম,	দূরতম,	
rokkhonabekkhoner,	রক্ষণাবেক্ষণের,	রক্ষণাবেক্ষণের,	
vince,	ভিনকে,	ভিন্স,	
manushe,	মানুষে,	মানুষে,	
spredasita,	স্প্রেডাসিতা,	স্প্রেডশীট,	
falasrutite,	ফলস্রুটিতে,	ফলশ্রুতিতে,	
heteler,	হেটেলের,	হেটেলের,	
oojbekistan,	ওজবেকিস্তান,	উজবেকিস্তান,	
gujab,	গুজাব,	গুজব,	
arashie,	আরাশি,	আরসিএ,	
aakaabaar,	আকাবার,	আকাবার,	
niropekkho,	নিরপেক্ষ,	নিরপেক্ষ,	
thakeni,	থাকেনি,	থাকেনি,	
kormokarke,	কর্মকারকে,	কর্মকারকে,	
abanishankar,	অবনিশঙকর,	অবনিশংকর,	
taufik,	তৌফিক,	তৌফিক,	
domonmulok,	দমনমূলক,	দমনমূলক,	
qonflict,	কনফ্লিক্ট,	কনফ্লিক্ট,	
pader,	পাদের,	প্যাডের,	
heelser,	হীলসের,	হিলসের,	
abosan,	অবসান,	অবসান,	
cholchhe,	চলছে,	চলছে,	
naraphoka,	নারাফোকা,	নরফোক,	
tinage,	তিনেগে,	টিনেজ,	
samley,	সামলে,	সামলে,	
fibergulote,	ফাইবারগুলোতে,	ফাইবারগুলোতে,	
arthonitite,	অর্থনীতিতে,	অর্থনীতিতে,	
aakkaash,	আককাশ,	আককাস,	
rojapalaner,	রোজাপালনের,	রোজাপালনের,	
maudelgulo,	মাউডেলগুলো,	মডেলগুলো,	
goora,	ঘোরা,	গোর,	
bolvodro,	বলভোদ্র,	বলভদ্র,	
musalmanderke,	মুসলমানদেরকে,	মুসলমানদেরকে,	
dipke,	ডিপকে,	দ্বীপকে,	
grambaashi,	গ্রামবাশী,	গ্রামবাসী,	
bosano,	বসানো,	বসানো,	
nothibhukteer,	নথিভুক্তির,	নথিভুক্তির,	
rudiger,	রুডিগের,	রুদিগের,	
dianes,	ডায়ানেস,	ডিএনএস,	
siddhantei,	সিদ্ধান্তেই,	সিদ্ধান্তেই,	
yatharthabhabe,	যথার্থভাবে,	যথার্থভাবে,	
institutione,	ইনষ্টিটিউশনে,	ইনস্টিটিউশনে,	
sangosrobomukto,	সংস্রবমকমু্ত,	সংস্রবমুক্ত,	
fanse,	ফাযান্সে,	ফাঁসে,	
mehsus,	মেহসুস,	মেহসুস,	
protijogii,	প্রতিযোগী,	প্রতিযোগী,	
bolatkar,	বোলাতকার,	বলাৎকার,	
kormopontha,	কর্মপন্থা,	কর্মপন্থা,	
pratijogira,	প্রতিযোগীরা,	প্রতিযোগীরা,	
teentir,	তীনটির,	তিনটির,	
khuliechilam,	খুলিয়েছিলাম,	খুলিয়েছিলাম,	
balokarak,	বালোকারক,	বলকারক,	
ghetu,	ঘেটু,	ঘেটু,	
lambi,	লাম্বি,	লম্বি,	
agomone,	আগমনে,	আগমনে,	
bhebechili,	ভেবেছিলি,	ভেবেছিলি,	
jonoshongjog,	জনশঙ্গগ,	জনসংযোগ,	
chhayi,	ছায়,	ছাই,	
semai,	সেমাই,	সেমাই,	
aajeej,	অজিজ,	আজিজ,	
angibhutovabe,	অঙ্গিভূতভাবে,	অঙ্গীভূতভাবে,	
shariba,	শারিবা,	শরিবা,	
mulyayonsapekkhe,	মূল্যান্যসমেষ্বে,	মূল্যায়নসাপেক্ষে,	
hurricane,	হুরিকানে,	হ্যারিকেন,	
dhaanche,	ধনচে,	ধাঁচে,	
rakhete,	রাখেতে,	রাখেতে,	
unchuporjayer,	উঁচুপর্যায়ের,	উঁচুপর্যায়ের,	
remission,	রেমিশন,	রিমিশন,	
melbourner,	মেলবোর্নের,	মেলবোর্নের,	
rananganey,	রণনঙ্গনে,	রণাঙ্গনে,	
shikkhartheerao,	শিক্ষার্থীরাও,	শিক্ষার্থীরাও,	
krimlin,	ক্রিমলিন,	ক্রিমলিন,	
katiusha,	কাটিউস,	কাতিউশা,	
jaunotar,	যৌনতার,	যৌনতার,	
norfolk,	নরফলক,	নরফোক,	
bade,	বাদে,	বাদে,	
gajiipur,	গাজিপুর,	গাজীপুর,	
agora,	আগোরা,	আগোরা,	
prajanankal,	প্রজানঙ্কল,	প্রজননকাল,	
prakare,	প্রকারে,	প্রকারে,	
azin,	আজিন,	আজিন,	
jarmaniteo,	জারমানিতেও,	জার্মানিতেও,	
oxite,	অক্সিতে,	অক্সাইট,	
dajhyo,	দাঝ্য,	দাহ্য,	
janmat,	জানমত,	জন্মাত,	
faskari,	ফাস্কারি,	ফাঁসকারী,	
bondira,	বন্দিরা,	বন্দীরা,	
protiakromonei,	প্রতিয়ক্রমণেই,	প্রতিআক্রমণেই,	
weenis,	উইনিস,	ভেনিস,	
gyada,	জ্যাদা,	গ্যাদা,	
scholarship,	স্কলারশিপ,	স্কলারশিপ,	
gudamjat,	গুদামজাত,	গুদামজাত,	
manbe,	মানবে,	মানবে,	
iraner,	ইরানের,	ইরানের,	
bhramapraban,	ভ্রমপ্রবণ,	ভ্রমপ্রবণ,	
eokee,	ইয়ক,	এওকি,	
dibug,	দিবুগ,	ডিবাগ,	
poderthobid,	পদের্থবিদ,	পদার্থবিদ,	
marri,	মারি,	ম্যারি,	
swatantrata,	স্বাতন্ত্র্যটা,	স্বতন্ত্রতা,	
bossoben,	বসবেন,	বসবেন,	
qanasarabheshana,	কননার্ভেশন,	কনসারভেশন,	
mulvitti,	মুলভিটি,	মূলভিত্তি,	
koordider,	কোর্ডিদের,	কুর্দিদের,	
fooloo,	ফুলো,	পোলো,	
bage,	ব্জ,	বাগে,	
poripaker,	পরিপাকের,	পরিপাকের,	
rekhapat,	রেখাপাট,	রেখাপাত,	
drishyogulotey,	দৃশ্যগুলোতে,	দৃশ্যগুলোতে,	
udvaboney,	উদ্ভাবনে,	উদ্ভাবনে,	
saainyo,	সৈন্য,	সৈন্য,	
somsher,	সম্ষের,	সমশের,	
tecnokret,	টেকনরক্ট,	টেকনোক্র্যাট,	
parikha,	পারিখা,	পরিখার,	
hossne,	হোস্নে,	হোসনে,	
choritrotakeo,	চরিত্রটাকেও,	চরিত্রটাকেও,	
kagbeni,	কাগবেনি,	কাগবেনি,	
soolke,	শুলকে,	শুল্কে,	
harishankar,	হরিশনকর,	হরিশংকর,	
jolaatonko,	জলাাতনকও,	জলাতঙ্ক,	
otyacharer,	অত্যাচরের,	অত্যাচারের,	
diznee,	ডিজনি,	ডিজনী,	
shithilata,	শিথিলতা,	শিথিলতা,	
brindaboney,	বৃন্দাবনে,	বৃন্দাবনে,	
vabuk,	ভাবুক,	ভাবুক,	
peeth,	পিঠ,	পীঠ,	
shrichaitanyadev,	শ্রীচৈতন্যবাস,	শ্রীচৈতন্যদেব,	
sahajlabhbhotar,	সহজলভোবভাতার,	সহজলভ্যতার,	
bandhan,	বাঁধান,	বাঁধন,	
kathghera,	কাঠঘেরা,	কাঠঘেরা,	
ghurechen,	ঘুরেছেন,	ঘুরেছেন,	
bhabaponno,	ভাবাপন্ন,	ভাবাপন্ন,	
choddo,	চোদ্দো,	চোদ্দো,	
dharavassokar,	ধারাভাস্যকার,	ধারাভাষ্যকার,	
kraanti,	ক্রান্টি,	ক্রান্তি,	
poschimey,	পশ্চিমে,	পশ্চিমে,	
chirkut,	চিরকুট,	চিরকুট,	
romantik,	রোম্যান্টিক,	রোমান্টিক,	
bijepi,	বিজেপি,	বিজেপি,	
umedpoor,	উমেদপুর,	উমেদপুর,	
supparak,	সুপারা,	সুপ্পারক,	
siramikasa,	সিরামিকাসা,	সিরামিকস,	
teamothy,	টিমথি,	টিমোথি,	
sift,	সিফট,	শিফট,	
perri,	পেরি,	পেরি,	
gorjon,	গর্জন,	গর্জন,	
blogarra,	ব্লগাররা,	ব্লগাররা,	
dweepgoolotey,	দ্বীপগৌলতে,	দ্বীপগুলোতে,	
pragreesa,	প্রগৃসি,	প্রগ্রেস,	
toki,	টিকি,	তকি,	
nirgoon,	নির্গুন,	নির্গুণ,	
sbaajan,	সোবজজন,	স্বজন,	
footballerra,	ফুটবলাররা,	ফুটবলাররা,	
musolmanera,	মুসলমানেরা,	মুসলমানেরা,	
vandar,	ভান্ডার,	ভাণ্ডার,	
kinenni,	কিনেননি,	কিনেননি,	
sawam,	সাওয়াম,	সাওম,	
anchalei,	অঞ্চলেই,	অঞ্চলেই,	
tukroke,	টুকরোকে,	টুকরোকে,	
dantahin,	দন্তাহীন,	দন্তহীন,	
heawy,	হইভি,	হেভি,	
aasirbaad,	অসীরবাদ,	আশির্বাদ,	
rohasyati,	রোহাস্যটি,	রহস্যটি,	
assexe,	অ্যাসেক্সে,	অ্যাসেক্সে,	
timoothi,	তিমোথি,	টিমোথি,	
sahojlovyotar,	সহজলভোভয়তার,	সহজলভ্যতার,	
hosne,	হোসনে,	হোসনে,	
shikkharrthirao,	শিক্ষার্থীরাও,	শিক্ষার্থীরাও,	
byabaharkareer,	ব্যবহারকারীর,	ব্যবহারকারীর,	
dreeshtiheen,	দৃষ্টিহীন,	দৃষ্টিহীন,	
muktilav,	মুক্তিলাভ,	মুক্তিলাভ,	
freekeh,	ফ্রিকেহ,	ফ্রিকেহ,	
ganjana,	গঞ্জনা,	গঞ্জনা,	
mozlis,	মজলিস,	মজলিশ,	
boner,	বনের,	বনের,	
