bhramapraban,	ভ্রমপ্রবণ,	ভ্রমপ্রবণ,	
rajashri,	রাজশশ্রী,	রাজশ্রী,	
browser,	ব্রুসার,	ব্রাউজার,	
shangkalonti,	সংকলান্তি,	সংকলনটি,	
senabahinikey,	সেনাবাহিনীকে,	সেনাবাহিনীকে,	
dalip,	ড্যালিপ,	দালিপ,	
mehsus,	মেহসুস,	মেহসুস,	
osthishondhi,	অস্থিনন্ধি,	অস্থিসন্ধি,	
catholicbad,	ক্যাথলিব্ড,	ক্যাথলিকবাদ,	
elbamtite,	এলবামটিতে,	এলবামটিতে,	
macbeth,	ম্যাকবেথ,	ম্যাকবেথ,	
dobhaar,	দোভার,	ডোভার,	
raghubar,	রঘুবার,	রঘুবীর,	
patishapta,	পাটিসপ্ত,	পাটিসাপটা,	
aairees,	আইরিস,	আইরিস,	
kampita,	কম্পিটা,	কম্পিত,	
mandope,	মন্দপে,	মন্ডপে,	
ooporoshtho,	অপরশশ্,	উপরস্থ,	
maner,	মানের,	মানে,	
whole,	শোলে,	হোল,	
dabliudabliui,	ডাব্লিউদুলি,	ডাব্লিউডাব্লিউই,	
sten,	স্টেন,	স্টেন,	
beatleser,	বিটলসের,	বিটলসের,	
koomarir,	কোমারির,	কুমারীর,	
dharabahikbhabe,	ধারাবাহিকভাবে,	ধারাবাহিকভাবে,	
sahajlabhbhotar,	সহজলভাবতার,	সহজলভ্যতার,	
shainyader,	শৈন্যদের,	সৈন্যদের,	
jemy,	জেমি,	জেমি,	
tanu,	তানু,	তনু,	
meghacchonno,	মেঘচঙ্কন্,	মেঘাচ্ছন্ন,	
volivoler,	ভলিভভলের,	ভলিভলের,	
dhanak,	ধনক,	ধানক,	
bishshaasho,	বিশ্ষষ,	বিশ্বাসও,	
sikkhakromer,	শিক্ষাক্রমের,	শিক্ষাক্রমের,	
bakhyateet,	বাখ্যাতিত,	ব্যাখ্যাতীত,	
cxt,	সিসিটিএসটি,	সিএক্সটি,	
niphelheim,	নিফেলহাইম,	নিফেলহেইম,	
sylvi,	সিলভি,	সিলভি,	
asommoti,	অসম্মতি,	অসম্মতি,	
brittakare,	বৃত্তকারে,	বৃত্তাকারে,	
ddheela,	ঢেল,	ঢিলা,	
blasterke,	ব্লাস্টারকে,	ব্লাস্টারকে,	
nirmankarmisaha,	নির্মাণকর্মীসহ,	নির্মাণকর্মীসহ,	
hisabagyan,	হিসাবজ্ঞান,	হিসাবজ্ঞান,	
phartha,	ফারথা,	ফার্থ,	
kaloniir,	কালোনির,	কালনীর,	
parqim,	পারকিম,	পার্কিং,	
vool,	ভুল,	উল,	
abosare,	অবসরে,	অবসরে,	
elaakate,	এলাকাতে,	এলাকাতে,	
barder,	বার্দের,	বার্ডের,	
prachirer,	প্রাচীরের,	প্রাচিরের,	
chalachchitra,	চলচ্চিত্র,	চলচ্চিত্র,	
inziniyarsa,	ইনজিজিনারসা,	ইঞ্জিনিয়ার্স,	
superheroo,	সুপারহিরোও,	সুপারহিরো,	
templet,	টেম্পলেট,	টেম্পলেট,	
onshogrohoner,	অংশগ্রহণের,	অংশগ্রহনের,	
kayartara,	কায়ারততরা,	কোয়ার্টার,	
bandhano,	বন্ধানো,	বাঁধানো,	
khagen,	খাগেন,	খগেন,	
philipiner,	ফিলিপিনের,	ফিলিপাইনের,	
blacq,	বিএলকে,	ব্ল্যাক,	
backflipe,	ব্যাকফ্লাপে,	ব্যাকফ্লিপে,	
orthoneeti,	অর্থনীতি,	অর্থনীতির,	
ancholtike,	অঞ্চলটিকে,	অঞ্চলটিকে,	
bangladesh,	বাংলাদেশ,	বঙ্গালাদেস,	
liedtke,	লিডকেটকে,	লইডটক,	
pujito,	পুজিত,	পুজিত,	
rubidiyaam,	রুবিদিয়াম,	রুবিডিয়াম,	
satarkabhabe,	সতরকাভাবে,	সতর্কভাবে,	
nyeta,	ন্যেট,	ম্যাট,	
graambaashio,	গ্রামবাশিও,	গ্রামবাসীও,	
sooya,	সুয়,	সোয়া,	
megacaldera,	মেগাক্লাডার,	মেগাক্যাল্ডেরা,	
land,	ল্যান্ড,	ল্যান্ড,	
reejideencee,	রিজাডিনিিসিস,	রেসিডেন্স,	
sobrakomer,	সভ্রাকমের,	সবরকমের,	
saseza,	সাসেজা,	সসেজ,	
duryogamoyee,	দুর্যোগময়ী,	দুর্যোগময়ী,	
parishram,	পরিশ্রম,	পরিশ্রম,	
kareer,	কারির,	কারীর,	
shringey,	শ্রিঞ্জে,	শৃঙ্গে,	
dharabahikotitey,	ধারাবাহিকতিতে,	ধারাবাহিকটিতে,	
procharjontrogulo,	প্রচারযন্ত্রগুলো,	প্রচারযন্ত্রগুলো,	
uddhrita,	উদ্ধৃত,	উদ্ধৃত,	
sharansthal,	শারানস্থল,	শরণস্থল,	
orrgho,	অর্ঘ,	অর্ঘ্য,	
pettern,	পেটার্ন,	প্যাটার্ন,	
torutoler,	তরুতলের,	তরুতলের,	
jounotar,	যৌনতার,	যৌনতার,	
romnar,	রোমনার,	রমনার,	
fooloo,	ফুলো,	পোলো,	
hafsa,	হাফসা,	হাফসা,	
maley,	মালি,	মালে,	
gejeted,	জেজেটেড,	গেজেটেড,	
toki,	তকি,	তকি,	
teman,	তেমান,	তেমন,	
gara,	গ্রা,	গোর,	
khonjena,	খোঁজেনা,	খোঁজেনা,	
vejjanno,	ভেজ্যান্ন,	ভেজানো,	
korimkey,	করিমকে,	করিমকে,	
bike,	বিকে,	বাইক,	
gafeeloti,	গাফেলোটি,	গাফিলতি,	
srisri,	শ্রীশ্রি,	শ্রীশ্রী,	
sahozlabhbhatar,	সহজলভাবতার,	সহজলভ্যতার,	
kantajir,	কান্তাজির,	কান্তজির,	
nirikhe,	নিরিখে,	নিরিখ,	
sarjur,	সারজুর,	সরযূর,	
uponishad,	উপনিষাদ,	উপনিষদ,	
balaruma,	বালারুমা,	বলরুম,	
ekghore,	একঘরে,	একঘরে,	
modhyekar,	মধ্যেকার,	মধ্যেকার,	
chaloke,	চালোকে,	চালকে,	
farna,	ফর্না,	ফার্ন,	
esasiyetasa,	এসাসিয়েসা,	এসোসিয়েটস,	
kottar,	কোত্তার,	কট্টর,	
ahalya,	আহালয়,	অহল্যা,	
chalochchitraeeo,	চলচ্চিত্রায়ওও,	চলচ্চিত্রেও,	
votarer,	ভোটারের,	ভোটারের,	
drissoteer,	দৃষ্টতীর,	দৃশ্যটির,	
jini,	জিনি,	যিনি,	
disni,	ডিসনি,	ডিজনী,	
lakkhero,	লক্ষেরও,	লক্ষেরও,	
hafej,	হাফেজ,	হাফেয,	
magar,	মাগার,	মাগার,	
jonoshongjog,	জনশঙ্যগ,	জনসংযোগ,	
samanwitovabe,	সমানবিতভাবে,	সমন্বিতভাবে,	
onchalti,	অনচ্লাটি,	অঞ্চলটি,	
sahittopritite,	সাহিত্যপ্রীতিতে,	সাহিত্যপ্রীতিতে,	
licenshe,	লাইসনন্স,	লাইসেন্স,	
ayantarqatiqa,	অয়ন্তরকারিকা,	অ্যান্টার্কটিকা,	
utshahomulok,	উৎসাহমূলক,	উৎসাহমূলক,	
danakana,	দনকানা,	ডানকান,	
tecno,	টেকনো,	টেকনো,	
narsinghomgulor,	নার্সিংহগমুলোর,	নার্সিংহোমগুলোর,	
soori,	সুরী,	সুরি,	
panchbar,	পাঁচবার,	পাঁচবার,	
oitijjo,	ঐতিহ্য,	ঐতিহ্য,	
tanshree,	তনশ্রী,	তানশ্রী,	
susamo,	সুসামো,	সুসম,	
mirakela,	মীরাকেলা,	মিরাকেল,	
michhilti,	মিছিল্তি,	মিছিলটি,	
patrol,	পাত্রল,	পেট্রোল,	
bhowanipur,	ভোয়ানুপুর,	ভবানীপুর,	
kada,	কাদা,	কোডা,	
poripake,	পরিপাকে,	পরিপাকে,	
nirvaha,	নির্ভাহ,	নির্বাহ,	
kantojir,	কান্তোজীর,	কান্তজির,	
confliqt,	কনফ্লিক্ট,	কনফ্লিক্ট,	
paste,	পাস্তে,	পেষ্ট,	
digri,	ডিগ্রি,	ডিগ্রি,	
pancbaar,	প্যান্ডবার,	পাঁচবার,	
byaboharkariyi,	ব্যবহারকারীয়,	ব্যবহারকারীই,	
europia,	ইউরোপিয়া,	ইউরোপিয়া,	
ardasha,	আর্দশা,	আর্দশ,	
desiseyer,	ড্যাসিয়াফের,	ডিজিজের,	
taap,	তাঁপ,	ট্যাপ,	
drishyogulotey,	দৃশ্যগুলোতে,	দৃশ্যগুলোতে,	
uponeeshod,	উপনীশোদ,	উপনিষদ,	
elaaka,	এলাকা,	এলাকা,	
times,	টিমেস,	টাইমস্,	
vogiroth,	ভোগিরথ,	ভগীরথ,	
manush,	মানুষ,	মানুষ,	
eura,	ইউরা,	ইউরো,	
gavaskar,	গাভাস্কারের,	গাভাস্কার,	
roy,	রয়,	রায়,	
evaner,	ইভানের,	ইভানের,	
kommandar,	কম্মান্দার,	কমাণ্ডার,	
vesselli,	ভেসেলি,	ভেসেলি,	
jibonnogor,	জীবনগরগর,	জীবননগর,	
crime,	ক্রাইম,	ক্রাইম,	
seekkharthirao,	শিক্ষার্থীরাও,	শিক্ষার্থীরাও,	
munsi,	মুনসি,	মুন্সী,	
murad,	মুরাদ,	মুরাদ,	
khelechen,	খেলেছেন,	খেলেছেন,	
hitokor,	হিটকর,	হিতকর,	
dito,	দিতো,	দিতো,	
saurce,	সারেস,	সোর্স,	
deepan,	দীপান,	দীপন,	
braqe,	ব্রাকে,	ব্রেক,	
mumtaj,	মুমতাজ,	মুমতাজ,	
phutbolarder,	ফুটবলারদের,	ফুটবলারদের,	
atighataner,	অতিঘাটনের,	অতিঘটনের,	
ardasho,	আর্দশো,	আর্দশ,	
laaisheesh,	লৈশীশ,	লাইসেন্স,	
joubanbatee,	যৌবনবাতী,	যৌবনবতী,	
bsnleu,	বিএসএেে,	বিএসএনএলইইউ,	
plasse,	প্লাসে,	প্লাসে,	
pooshteer,	পুষ্টির,	পুষ্টির,	
amiya,	আমিয়া,	অমিয়,	
greep,	গ্রীপ,	গ্রিপ,	
prakalpoguli,	প্রকল্পগুলি,	প্রকল্পগুলি,	
chouhate,	চৌহাতে,	চৌহাটে,	
sompadon,	সম্পাদন,	সম্পাদন,	
badaghat,	বাদাঘাট,	বাদাঘাট,	
dweepgoolotey,	দ্বীপগুলোতে,	দ্বীপগুলোতে,	
nirbaho,	নির্বাহো,	নির্বাহ,	
abhidhaanick,	অভিধানিক,	অভিধানিক,	
shanno,	শান্নো,	সান্নো,	
townshhip,	তাংশিপ,	টাউনশিপ,	
milayatane,	মিলায়াতানে,	মিলায়তনে,	
beila,	বেইলা,	বেইলা,	
ghurte,	ঘুরতে,	ঘুরতে,	
ramchander,	রামচন্দর,	রামচন্দরের,	
jothartho,	যথার্থ,	যথার্থ,	
podotyagsongkranto,	পদত্যাগসংক্রান্ত,	পদত্যাগসংক্রান্ত,	
noteti,	নটটটি,	নোটটি,	
kadapaker,	কাদাপাকের,	কড়াপাকের,	
nothivukta,	নথিভুক্ত,	নথিভুক্ত,	
grambaashi,	গ্রামবাশী,	গ্রামবাসী,	
kingsh,	কিংস,	কিংস,	
chatrorai,	চাত্রোরাই,	ছাত্ররাই,	
raiji,	রাইজী,	রাইজি,	
judge,	জুগগে,	জাজ,	
avinetar,	অভিনেতার,	অভিনেতার,	
favorite,	ফাভোরিতে,	ফেভারিট,	
jund,	জান্ড,	জুন্দ,	
besur,	বেসুর,	বেসুর,	
scoore,	স্কোর,	স্কোর,	
bondi,	বন্দী,	বন্দী,	
panthar,	পানথার,	পন্থার,	
sithilota,	সিথিলতা,	শিথিলতা,	
video,	ভিদেও,	ভিডিয়োও,	
obharbhiu,	অভরভিউ,	ওভারভিউ,	
platform,	প্ল্যাটফর্ম,	প্লাটফর্ম,	
poorohitder,	পুরহিতদের,	পুরোহিতদের,	
moushum,	মৌশুম,	মৌসুম,	
codeti,	কোডেটি,	কোডটি,	
peeri,	পীরী,	পেরি,	
setikey,	সেতিকে,	সেটিকে,	
marri,	মারি,	ম্যারি,	
ponchasjon,	পঞ্চাসজন,	পঞ্চাশজন,	
rajnikant,	রাজনিকান্ত,	রাজনীকান্ত,	
telakucha,	তেলুকৌচা,	তেলাকুচা,	
tochhnochh,	তচ্ছন,	তছনছ,	
koreempoor,	করিমপুর,	করিমপুর,	
orbeet,	অরবিট,	অরবিট,	
bharotchilo,	ভারতচিল,	ভারতছিল,	
laga,	লাগা,	লগ,	
hijritey,	হিজরিতে,	হিজরীতে,	
dokaangulotey,	দোকানাগুলোতে,	দোকানগুলোতে,	
mahafezkhanar,	মহাফেজখনার,	মহাফেজখানার,	
shikshakbrindo,	শিক্ষাবৃন্দ,	শিক্ষকবৃন্দ,	
manobikotao,	মানবিকতাও,	মানবিকতাও,	
shten,	স্টেন,	স্টেন,	
aakkaash,	আক্কাশ,	আককাস,	
antorbhuktimulak,	অন্তর্ভুকিকমূলক,	অন্তর্ভুক্তিমূলক,	
philo,	ফিলো,	ফিলো,	
duio,	দুইও,	দুইও,	
kanuner,	কানুনের,	কানুনের,	
dhache,	ধাচে,	ধাঁচে,	
parjotaker,	পার্যটাকের,	পর্যটকের,	
pronoti,	প্রণতি,	প্রণতি,	
teemothi,	টিমোথি,	টিমোথি,	
emiratas,	এমিরাতাস,	এমিরেটাস,	
chhintayikari,	ছিন্তাইকারী,	ছিনতাইকারী,	
bahjya,	বাহজ্যা,	বাহ্য,	
keui,	কেউই,	কেউই,	
parkasa,	পারকাসা,	পার্কস,	
serology,	সেরোলজী,	সেরোলজি,	
deilee,	ডেইলি,	ডেইলি,	
tawnship,	তাবশিপ,	টাউনশিপ,	
thechar,	থেচার,	থ্যাচার,	
shurugulo,	শুরুগুলো,	শুরুগুলো,	
shamijir,	শামিজির,	স্বামীজীর,	
orthisoho,	অর্থিসহ,	অর্থিসহ,	
scholarship,	স্কলারশীপ,	স্কলারশিপ,	
shikshakbrinda,	শিক্ষাবৃন্দ,	শিক্ষকবৃন্দ,	
sumeeta,	সুমেতা,	সুমিতা,	
kani,	কানী,	কানি,	
chokhwala,	চোখবাা,	চোখওয়ালা,	
niropekshtar,	নিরপেক্ষতার,	নিরপেক্ষতার,	
soommo,	সুম্মো,	সুমো,	
holuder,	হলুদের,	হলুদের,	
dibi,	দিবি,	দিবি,	
agamane,	আগামানে,	আগমনে,	
direectoratee,	ডিরেকটটরিতা,	ডিরেক্টরেট,	
agora,	আগোরা,	আগোরা,	
planeti,	প্লানাটি,	প্লেনটি,	
khanabale,	খানাবলে,	খানাবলে,	
chirantan,	চিরান্তন,	চিরন্তন,	
ponchaashjon,	পঞ্চাশজন,	পঞ্চাশজন,	
baarnis,	বার্নিস,	বার্নিশ,	
lagche,	লাগছে,	লাগছে,	
heawy,	হেয়ি,	হেভি,	
carbus,	কার্বাস,	কারবাস,	
purbanchaler,	পূর্বাঞ্চলের,	পূর্বাঞ্চলের,	
angsogrohone,	অংশগ্রহণে,	অংশগ্রহনের,	
nirgomon,	নির্গমন,	নির্গমন,	
protinito,	প্রতিনীত,	প্রতিনিত,	
addhattikotar,	আদ্ধাত্বিকতার,	আধ্যাত্মিকতার,	
dakticket,	ডাক্টিকেট,	ডাকটিকিট,	
munim,	মুনিম,	মুনিম,	
gronthoti,	গ্রন্থটি,	গ্রন্থটি,	
chalachchitro,	চলচ্চিত্র,	চলচ্চিত্র,	
gaujano,	গাউজনো,	গজানো,	
saramukhe,	সরমমুখে,	সারামুখে,	
doobate,	দুবাতে,	ডুবাতে,	
antorvuktimulak,	আন্তর্ভুক্তিমূলক,	অন্তর্ভুক্তিমূলক,	
qanasarabheshana,	কাসারানাভাষণ,	কনসারভেশন,	
sampadon,	সম্পাদন,	সম্পাদন,	
jins,	জিনস,	জিন্স,	
rajendracholer,	রাজেন্দ্রহলের,	রাজেন্দ্রচোলের,	
station,	স্টেশন,	ষ্টেশন,	
yura,	যুুরা,	ইউরো,	
erythrian,	এরিথ্রিয়ান,	এরিথ্রিয়ান,	
bhotomulyoke,	ভোটমূল্যকে,	ভোটমূল্যকে,	
hosto,	হস্ত,	হস্ত,	
shasyadi,	শাস্যদি,	শস্যাদি,	
probhritike,	প্রভৃতিকে,	প্রভৃতিকে,	
shiqara,	শিকারা,	শিকার,	
akeeb,	আকীব,	আকিব,	
prity,	প্রাইট,	প্রিটি,	
sanstha,	সানস্থ,	সংস্থা,	
godabari,	গোদাবারী,	গোদাবরী,	
bopoon,	বপূন,	বপন,	
bikretaara,	বিক্রেতারা,	বিক্রেতারা,	
shrabostee,	শ্রাবস্তি,	শ্রাবস্তী,	
tigre,	তিগ্রে,	টাইগার,	
bachhaikrito,	বাছাইকৃত,	বাছাইকৃত,	
conservetion,	কনজারভেশন,	কনসারভেশন,	
tennis,	টেনিস,	টেনিস,	
crashlands,	ক্র্শালব্যান্ডস,	ক্র্যাশল্যান্ডস,	
palkee,	পালকী,	পাল্কি,	
naagaalyand,	নাগালান্ড,	নাগাল্যান্ড,	
sikkhokder,	শিক্ষকদের,	শিক্ষকদের,	
eesa,	ইসা,	আইএএস,	
shapad,	শাপাদ,	শ্বাপদ,	
chittronatyokar,	চিত্রন্যাটকার,	চিত্রনাট্যকার,	
foks,	ফকস,	ফক্স,	
probhuder,	প্রভুদের,	প্রভুদের,	
rokibul,	রকিবুল,	রকিবুল,	
kalkarkhana,	কলকারখানা,	কলকারখানা,	
mukharji,	মুখররি,	মুখার্জী,	
dhani,	ধানি,	ধানি,	
chahidapotrer,	চাহিদাপত্রের,	চাহিদাপত্রের,	
bishesyo,	বিশেষ্য,	বিশেষ্য,	
pratista,	প্রতিস্তা,	প্রতিষ্টা,	
slatgulor,	স্ল্যাগুলোর,	স্ল্যাটগুলোর,	
hughkey,	হাঁকে,	হিউজকে,	
renoo,	রিনো,	রেনো,	
rushod,	রুশদ,	রুশদ,	
gabeshonar,	গবেষণার,	গবেষনার,	
deputi,	ডেপুটি,	ডেপুটি,	
sima,	সিমা,	সীমা,	
jwar,	জ্বার,	জ্বর,	
parswer,	পারস্বির,	পার্শ্বের,	
aasar,	আসার,	আসর,	
toufik,	তৌফিক,	তৌফিক,	
gudamjat,	গুদাজমত,	গুদামজাত,	
nathivukteer,	নাথভুক্তির,	নথিভুক্তির,	
ghomtaa,	ঘোমটা,	ঘোমটা,	
mukhomandaler,	মুখোমণ্ডলের,	মুখমণ্ডলের,	
karore,	কারোর,	কারোর,	
brixfield,	ব্রিস্কফিল্ড,	ব্রিক্সফিল্ড,	
kode,	কোদ,	কোড,	
byabaharkariderke,	ব্যবহারকারীদেরকে,	ব্যবহারকারীদেরকে,	
probeshkari,	প্রবেশকারী,	প্রবেশকারী,	
toufiq,	তৌফিক,	তৌফিক,	
mookhomaundoler,	মূখুমালন্ডের,	মুখমণ্ডলের,	
cloring,	ক্লরিং,	ক্লোরিং,	
choudry,	চাউড্রি,	চৌধুরী,	
bee,	বিয়,	বি,	
karam,	কারম,	কেরাম,	
mukhya,	মুখ্যা,	মুখ্য,	
tukrote,	টুকরতে,	টুকরোতে,	
sohokari,	সহকারী,	সহকারী,	
obosorer,	অবসরের,	অবসরের,	
tomader,	তোমাদের,	তোমাদের,	
carzar,	কার্জার,	চার্জার,	
ekekrokom,	একেককরম,	একেকরকম,	
sallallahu,	সাল্লাল্লাহু,	সল্লাল্লাহু,	
dubaate,	ডুবাতে,	ডুবাতে,	
kruser,	ক্রুসের,	ক্রুশের,	
cena,	সিইন,	সিনা,	
ragee,	রাগী,	রাগী,	
fanse,	ফ্যান্স,	ফাঁসে,	
elahabade,	এলাহাবাদে,	এলাহাবাদে,	
ashamarthita,	আশামার্থিত,	অসমর্থিত,	
seoul,	সিওয়াল,	সোল,	
tistar,	তিস্তার,	তিস্তার,	
protectionism,	প্রটেক্্টিিিজম,	প্রোটেকশনিজম,	
sookkho,	সুক্ষ,	সুক্ষ্ম,	
bim,	বিআইম,	বিম,	
ekbai,	একবাই,	একবাই,	
skirt,	স্কির্ট,	স্কার্ট,	
selim,	সেলিম,	সেলিম,	
bolatkar,	বলাটকার,	বলাৎকার,	
dakope,	ডাকোপে,	দাকোপ,	
iuro,	ইউওরআই,	ইউরো,	
shoori,	শুরী,	সুরি,	
jackey,	জ্যাকে,	জকি,	
maadla,	মাদলা,	মাদলা,	
noiteek,	নৈতিক,	নৈতিক,	
umedpoor,	উমেডপুর,	উমেদপুর,	
yaq,	ইক্যা,	ইয়াক,	
niutrino,	নিউট্রিনো,	নিউট্রিনো,	
rockibul,	রকিবিল,	রকিবুল,	
khargosher,	খারগোশের,	খরগোসের,	
shringge,	শ্রিংগে,	শৃঙ্গে,	
salsa,	সালসা,	সালসা,	
capsul,	ক্যাপসুল,	ক্যাপসুল,	
orthonitir,	অর্থনীতির,	অর্থনীতির,	
upobashii,	উপবাশি,	উপবাসী,	
dembakreeti,	দেম্বাকৃতি,	ডিম্বাকৃতি,	
nehle,	নেহলে,	নেহলে,	
dhamshrenite,	ধম্শ্রীণীতে,	ধামশ্রেণীতে,	
gandagol,	গণ্ডগোল,	গন্ডগোল,	
beekaargrasta,	বিকার্গ্রস্ত,	বিকারগ্রস্ত,	
hoil,	হইল,	হইল,	
navaratri,	নবরত্রী,	নবরাত্রি,	
tiger,	টিজের,	টাইগার,	
prakalpatike,	প্রকল্পটিকে,	প্রকল্পটিকে,	
postac,	পোস্টাক,	পোস্টকে,	
karima,	করিমা,	করিম,	
asovarno,	আসভার্ণ,	অসবর্ণ,	
playtey,	প্লেযাটে,	প্লেটে,	
dufresne,	ডুফ্রেসে,	ডুফরেস্ন,	
rahee,	রাহে,	রাহি,	
ghuznavi,	ঘুজনাভি,	গজনভি,	
bosonte,	বসন্তে,	বসন্তে,	
ganaparibahan,	গণপরিবহহন,	গণপরিবহন,	
samle,	সমলে,	সামলে,	
ajeeboner,	আজিবনের,	আজীবনের,	
shamshernagar,	শমশেরনগর,	শমশেরনগর,	
soinyora,	সৈন্যরা,	সৈন্যরা,	
sainyader,	সৈন্যাদের,	সৈন্যদের,	
shekender,	শেকেন্দার,	সেকেন্ডের,	
soketgulor,	সকেটগুলোর,	সকেটগুলোর,	
foolkopi,	ফুলকপি,	ফুলকপি,	
ved,	ভেড,	বেদ,	
uthhaane,	উঠানে,	উঠানে,	
sikkhagata,	শিক্ষাগত,	শিক্ষাগত,	
dwibidho,	দ্বিবিধো,	দ্বিবিধ,	
konflict,	কনফ্লিক্ট,	কনফ্লিক্ট,	
saazano,	সাজানো,	সাজানো,	
porjotoker,	পর্যটকের,	পর্যটকের,	
difinishion,	ডিফিনিশন,	ডেফিনেশন,	
themekey,	থেমেকে,	থিমকে,	
samashtike,	সমস্থিকে,	সমষ্টিকে,	
indra,	ইন্দ্রার,	ইন্দ্র,	
labonaktatar,	লবণকা্ততার,	লবণাক্ততার,	
aaps,	এএপিএস,	এএপিএস,	
bane,	বানে,	বনে,	
parther,	পার্থার,	পার্থের,	
mahibur,	মহিবুর,	মহিবুর,	
totokhon,	তত্নখন,	ততক্ষন,	
chomski,	চমস্কি,	চমস্কি,	
anubhutimalar,	অনুভূতিমালার,	অনুভূতিমালার,	
plak,	প্লাক,	প্ল্যাক,	
eukalyptus,	ইউক্যালিপেসাস,	ইউক্যালিপ্টাস,	
hadisti,	হাদিস্তি,	হাদিসটি,	
oboshore,	অবশরে,	অবসরে,	
residensa,	রেসিডেন্সা,	রেসিডেন্স,	
asamorik,	অসমরোিক,	অসামরিক,	
prokar,	প্রকার,	প্রকার,	
somraatra,	সম্রাত্র,	সম্রাটরা,	
creshcent,	ক্রেসেেন্ট,	ক্রিসেন্ট,	
catholicder,	ক্যাথলিকদের,	ক্যাথলিকদের,	
salafeta,	সালাফেটা,	সালফেট,	
protizogiita,	প্রতিযোগীতা,	প্রতিযোগীতা,	
mandape,	মণ্ডপে,	মন্ডপে,	
banshite,	বাঁশীতে,	বাঁশিতে,	
sohojlovyotar,	সহজ্ভোব্যতার,	সহজলভ্যতার,	
chitronattakar,	চিত্রনাট্টকার,	চিত্রনাট্যকার,	
rahi,	রাহি,	রাহী,	
okkhorke,	অক্ষরকে,	অক্ষরকে,	
abheedhaaneek,	অভিধানিক,	অভিধানিক,	
kaalengaa,	কালেঙ্গা,	কালেঙ্গা,	
sayanaida,	সায়াননদদা,	সায়ানাইড,	
plator,	প্ল্যাটর,	প্লেটোর,	
sarboshokteeman,	সর্বশক্তিমান,	সর্বশক্তিমান,	
cloudbook,	ক্লাউবকড,	ক্লাউডবুক,	
miley,	মিলে,	মিলে,	
tarunra,	তরুণরা,	তরুণরা,	
vobobibhuti,	বববিভূটি,	ভববিভূতি,	
fuss,	ফুস,	ফাস,	
fasir,	ফাসির,	ফাসীর,	
khaaneker,	খানেকের,	খানেকের,	
review,	রেভিউ,	রিভিউও,	
kumbhalnar,	কুম্ভললনার,	কুম্ভালনার,	
heavy,	হিভি,	হেভি,	
spredshiit,	স্প্রেডিশিট,	স্প্রেডশীট,	
mosjidtir,	মসজিদটির,	মসজিদটির,	
teoyana,	তেওয়াননা,	তাইওয়ান,	
shourshe,	শৌর্শে,	সোর্স,	
wedanta,	ওয়েদান্তা,	বেদান্ত,	
coons,	কুনস,	কুনস,	
homshke,	হোমশকে,	হোমসকে,	
restuarant,	রেস্টুরেয়ান্ট,	রেষ্টুরেন্ট,	
machsoho,	মাছসহ,	মাছসহ,	
shrichaitanyadev,	শ্রীচৈতন্যববে,	শ্রীচৈতন্যদেব,	
phakay,	ফাকায়,	ফাকে,	
karmake,	কারমেক,	কর্মকে,	
dhyanastha,	ধ্যানস্থ,	ধ্যানস্থ,	
phox,	ফক্স,	ফক্স,	
olpo,	অলপপো,	অল্প,	
elakaate,	এলাকাতে,	এলাকাতে,	
deebug,	দীবুগ,	ডিবাগ,	
impaction,	ইম্প্যাকশন,	ইমপ্যাকশন,	
rahimed,	রহিমেদ,	রহিমেদ,	
rajyabhogi,	রাজ্যভোগী,	রাজ্যভোগী,	
srichoitonnodeb,	শ্রীচৈতন্ববে,	শ্রীচৈতন্যদেব,	
jamaanor,	জামানোর,	জমানোর,	
prothati,	প্রথতি,	প্রথাটি,	
aborto,	আবর্ত,	আবর্ত,	
byan,	ব্যান,	ব্যাং,	
bhabanir,	ভবানীর,	ভবানীর,	
shatan,	শততন,	শয়তান,	
notti,	নত্তী,	নোটটি,	
nomo,	নোমো,	নমো,	
akkhunno,	অক্ষুন্য,	অক্ষুণ্ণ,	
brookoleen,	প্রলুকিন,	ব্রুকলিন,	
dolphiny,	ডলমিনি,	ডলফিনি,	
daaktikite,	ডাক্তিকিতে,	ডাকটিকিটে,	
flexta,	ফ্লেক্সটা,	ফ্লেক্সটা,	
manushsoho,	মানুষসহ,	মানুষসহ,	
choddo,	চদ্দ,	চোদ্দো,	
hepatetisa,	হেপাটেটিস্সা,	হেপাটাইটিস,	
hosney,	হোসেনি,	হোসনে,	
istoone,	ইস্টুন,	স্টোন,	
refleks,	রেফ্লেক্স,	রিফ্লেক্স,	
cholochchitra,	চলচ্চিত্র,	চলচ্চিত্র,	
khanonkaj,	খননকজ,	খননকাজ,	
musalmani,	মুসলমানি,	মুসলমানই,	
mokhmoley,	মোখমলে,	মখমলে,	
gandharir,	গান্ধারীর,	গান্ধারীর,	
bisnoo,	বিষ্নও,	বিষ্ণু,	
ghumunoi,	ঘুমুনোই,	ঘুমুনোই,	
chinto,	চিন্তো,	চিনতো,	
aziboner,	আজিবনের,	আজীবনের,	
asamonjasyopurno,	অসামঞ্জস্যপূর্ণ,	অসামঞ্জস্যপূর্ণ,	
sahachke,	সাচাকে,	সাহাচকে,	
kuhelika,	কুহেলিকা,	কুহেলিকা,	
naubom,	নৌবোম,	নবম,	
dorgaaho,	দরগাহো,	দরগাহ,	
churger,	চুর্গার,	চার্জের,	
raagee,	রাগী,	রাগী,	
riphleksa,	রিফলেক্স,	রিফ্লেক্স,	
miraclee,	মিরাকলি,	মিরাকেল,	
chapchap,	চাঁচফাপ,	চাপচাপ,	
aansareer,	আনসারীর,	আনসারীর,	
bohoodin,	বহুদিন,	বহুদিন,	
chorban,	চোরবান,	চর্বন,	
shikh,	শিখ,	শিখ,	
digreeke,	দিগ্রীকে,	ডিগ্রিকে,	
kaferder,	কাফেরদের,	কাফেরদের,	
gaichhe,	গাইছে,	গাইছে,	
nisader,	নিসাদের,	নিষাদের,	
sosoa,	সোোয়,	শশা,	
nanilalke,	নানিলালকে,	ননীলালকে,	
kyathlik,	ক্যাথলিক,	ক্যাথলিক,	
samoshtigato,	সমষ্টিতগত,	সমষ্টিগত,	
nirvachokder,	নির্বাচকদের,	নির্বাচকদের,	
mitroder,	মিত্রদের,	মিত্রদের,	
machhti,	মাছটি,	মাছটি,	
bhangchur,	ভাংচুর,	ভাংচুর,	
detik,	দেতিক,	দেতিক,	
skolarsip,	স্কোলারসিপ,	স্কলারশিপ,	
vushi,	বুশী,	ভুষি,	
sahojatprobritti,	সহযাপ্রবৃত্তিটি,	সহজাতপ্রবৃত্তি,	
pratisthanik,	প্রতিস্থানিক,	প্রাতিষ্ঠানিক,	
deenes,	ডিনেস,	দীনেশ,	
dhauto,	ধাউতো,	ধৌত,	
byaboharkarike,	ব্যবহারকারীকে,	ব্যবহারকারীকে,	
uparjoner,	উপার্যনের,	উপার্জনের,	
mithener,	মিথেনের,	মিথেনের,	
dakter,	ডাক্টার,	ডাকতের,	
konistho,	কনিষ্ঠ,	কনিষ্ঠ,	
torabgonj,	তরাবগঞ্জ,	তোরাবগঞ্জ,	
dai,	দাই,	দিই,	
hertj,	হার্টজ,	হার্জ,	
uporzon,	উপর্জন,	উপার্জন,	
societykey,	সকিটেকে,	সোসাইটিকে,	
nirgamon,	নির্গামন,	নির্গমন,	
bhageri,	ভাগেরি,	ভাগেরই,	
dholeshwari,	ধোলেশ্বরী,	ধলেশ্বরী,	
bharpur,	ভারপুর,	ভরপুর,	
shilpikuler,	শিল্পিকূলের,	শিল্পীকুলের,	
byaktikegreptar,	ব্যাক্তিকেগ্রাপ্তর,	ব্যক্তিকেগ্রেপ্তার,	
uthaney,	উঠানে,	উঠানে,	
pushtee,	পুষ্টি,	পুষ্টি,	
summer,	সামার,	সামার,	
residence,	রেসিডেন্সে,	রেসিডেন্স,	
laesens,	লেইসেন্স,	লাইসেন্স,	
songasthatir,	সংস্থাটির,	সংস্থাটির,	
poripakey,	পরিপাকে,	পরিপাকে,	
bujhtepari,	বুঝতেপারি,	বুঝতেপারি,	
phonekari,	ফোনেকারি,	ফোনকারী,	
elakayi,	এলাকায়ি,	এলাকাই,	
aalkatraa,	আলকাতরা,	আলকাতরা,	
oncolsoho,	অন্কলসহ,	অঞ্চলসহ,	
aarik,	আরিক,	আরিক,	
palta,	পাল্া,	পালটা,	
sabrakamer,	সবরাকামের,	সবরকমের,	
shikare,	শিকারে,	শিকারে,	
tricksguli,	ট্রিকসগুলি,	ট্রিকসগুলি,	
okritokarjo,	অকৃতকার্য,	অকৃতকার্য,	
cholochchitrake,	চলচ্চিত্রাকে,	চলচ্চিত্রকে,	
degreeo,	দিগ্রিও,	ডিগ্রিও,	
bisnuke,	বিস্নুকে,	বিষ্ণুকে,	
nutan,	নুতান,	নূতন,	
ancholgoolote,	অন্চলগুলোতে,	অঞ্চলগুলোতে,	
phood,	ফুড,	ফুড,	
balakarak,	বালাকারক,	বলকারক,	
yuro,	যুুরো,	ইউরো,	
horipur,	হরিপুর,	হরিপুর,	
prokolpogulor,	প্রকল্পগুলোর,	প্রকল্পগুলোর,	
dalnata,	দলনাটা,	ডালনাটা,	
aholya,	অহল্যা,	অহল্যা,	
pitiler,	পিতিলের,	পিটিলের,	
naazee,	নাজ,	নাত্সি,	
mexicoteo,	মেক্সিকোটেও,	মেক্সিকোতেও,	
hepatitis,	হেপাটিটিস,	হেপাটাইটিস,	
lyaandeeng,	ল্যান্ডিং,	ল্যান্ডিং,	
nothibhukta,	নথিভুক্ত,	নথিভুক্ত,	
basab,	বাশাব,	বাসাব,	
batikromi,	বাতিক্রমী,	ব্যতিক্রমী,	
jontrototto,	যন্ত্রতত্ত্ব,	যন্ত্রতত্ত্ব,	
soheensotar,	সহিনসতার,	সহিংসতার,	
toler,	টোলের,	তালের,	
neck,	নেক,	নেক,	
spredashiita,	স্প্রেডশশিত,	স্প্রেডশীট,	
chhaikalo,	ছাইকালো,	ছাইকালো,	
lisense,	লেসেন্সে,	লাইসেন্স,	
hajirhat,	হাজিরহাট,	হাজিরহাট,	
jaanachhe,	জাঁছে,	জানাচ্ছে,	
gorrer,	গোরের,	গোরের,	
stana,	স্তনা,	স্টোন,	
bosoben,	বসবেন,	বসবেন,	
beshirbhaagei,	বেশবিরাগেই,	বেশিরভাগেই,	
pillai,	পিল্লাই,	পিল্লাই,	
daap,	ডাপ,	ড্যাপ,	
suraaropito,	সুরররিপত,	সুরারোপিত,	
oncoltike,	অঙ্কলটিকে,	অঞ্চলটিকে,	
rajtontro,	রাজতন্ত্র,	রাজতন্ত্র,	
mitro,	মিত্রো,	মিত্র,	
kortona,	কর্তনা,	করতনা,	
rushad,	রুশদ,	রুশদ,	
dajjha,	দাজঝা,	দাহ্য,	
indro,	ইন্দ্রো,	ইন্দ্র,	
antennal,	অ্যান্টেনাল,	অ্যান্টেনাল,	
aakabar,	আকাবার,	আকাবার,	
prachando,	প্রচন্দ,	প্রচণ্ড,	
shomostigoto,	শমস্তিগত,	সমষ্টিগত,	
mukhomandaley,	মুখোমণ্ডলে,	মুখমণ্ডলে,	
amar,	আমার,	আমর,	
jahara,	জাহারা,	যাহরা,	
rajnoitik,	রাজৈৈতিক,	রাজনৈতীক,	
sangkulaan,	সংকুলৌন,	সংকুলান,	
makame,	মাকামে,	মাকামে,	
female,	ফেমালে,	ফিমেল,	
oitijhyotike,	ঐতিহ্যটিকে,	ঐতিহ্যটিকে,	
mastarsa,	মস্তরাসা,	মাস্টার্স,	
middleton,	মিডললটন,	মিডলটন,	
hoteltee,	হোটেলটি,	হোটেলটি,	
prashikkhane,	প্রশিক্ষণে,	প্রশিক্ষণে,	
mmadhuri,	মামধুরী,	মাধুরী,	
felto,	ফেলটো,	ফেলত,	
konisttha,	কনিষ্ঠথা,	কনিষ্ঠ,	
oblivion,	অবলিভিওন,	অবলিভিয়ন,	
bahati,	বাহাতি,	বাহাতি,	
eshtoniya,	সষ্তনীয়,	এস্তোনিয়া,	
krimlin,	ক্রিমলিন,	ক্রিমলিন,	
prothar,	প্রথার,	প্রথার,	
booroon,	বূরন,	বোরন,	
arifin,	আরিফিন,	আরিফিন,	
foxer,	ফক্সার,	ফক্সের,	
eekbalke,	একবাকে,	ইকবালকে,	
safin,	সাফিন,	সাফিন,	
harza,	হারজা,	হার্জ,	
remacry,	রিম্যাক্রি,	রেমাক্রী,	
remacri,	রিমাক্রি,	রেমাক্রী,	
ispredseet,	ইসপ্রেদস,	স্প্রেডশীট,	
krom,	ক্রম,	ক্রম,	
gaichey,	গাইছে,	গাইছে,	
thailandshoho,	থাইলান্ডসহ,	থাইল্যান্ডসহ,	
sangbadmadhyome,	সংবাদমাধ্যমে,	সংবাদমাধ্যমে,	
sangaskritipreme,	সংস্কৃতিপ্রেমে,	সংস্কৃতিপ্রেমে,	
qraima,	ক্রাইমা,	ক্রাইম,	
girilal,	গিরিলাল,	গিরিলাল,	
neker,	নেকের,	নেকের,	
paadee,	পাদি,	পাড়ে,	
bodhukeo,	বোধুকেও,	বধুকেও,	
pratiyogitar,	প্রতিযোগিতার,	প্রতিযোগীতার,	
sobchey,	সবছে,	সবচে,	
moorali,	মুরালি,	মুরলী,	
metrikoleshana,	মেট্রিকললেশন,	মেট্রিকোলেশন,	
panda,	প্যান্ডা,	পান্ডে,	
gyada,	জ্ঞাদা,	গ্যাদা,	
pare,	পারে,	পাড়ে,	
naazi,	নাজি,	নাত্সি,	
manoharpur,	মনোহরপুর,	মনোহরপুর,	
himchi,	হিমচি,	হিমচি,	
jitpur,	জিতপুর,	জিতপুরের,	
toptoshele,	তপ্তশেলে,	তপ্তশেলে,	
nanir,	নানির,	নানীর,	
turkii,	তুরকিই,	তুর্কি,	
bite,	বিতে,	বাইট,	
kiuti,	কিউটি,	কিউটি,	
dinar,	দিনার,	ডিনার,	
ujbekistaner,	উজবেকিস্তানের,	উজবেকিস্তানের,	
sarsa,	সারসা,	সোর্স,	
sthaponagulo,	স্থাপনাগুলো,	স্থাপনাগুলো,	
oxforde,	অক্সফোর্ড,	অক্সফোর্ডে,	
baet,	বেইট,	বাইট,	
associatis,	অ্যাসোসেরিটিস,	এসোসিয়েটস,	
gaj,	গ্জ,	গেজ,	
rajshri,	রাজশ্রী,	রাজশ্রী,	
pothnirdeshona,	পথনির্থেরাা,	পথনির্দেশনা,	
grambaasi,	গ্রামবাসী,	গ্রামবাসী,	
asbab,	আসবাব,	আসবাব,	
chinito,	চিনিত,	চিনতো,	
vaabnake,	ভাবনাকে,	ভাবনাকে,	
turky,	টার্কি,	তুর্কি,	
shilver,	শিলভার,	সিলভার,	
bodhirota,	বধিরতা,	বধিরতা,	
arasie,	আরাসি,	আরসিএ,	
byabaharkarike,	ব্যবহারকারীকে,	ব্যবহারকারীকে,	
nadnadeer,	নাদননীর,	নদনদীর,	
rabo,	র্বো,	রব,	
jatinkey,	জাতিনকে,	যতীনকে,	
parshwer,	পারস্বের,	পার্শ্বের,	
bayshorkarikarone,	বাফশারকারিণারে,	বেসরকারিকরণ,	
upacharjo,	উপাচার্য,	উপাচার্য,	
udor,	উদরের,	উদর,	
madhabike,	মাধাবীকে,	মাধবীকে,	
dubureer,	ডুবুরির,	ডুবুরির,	
dipankar,	দীপানকার,	দিপঙ্কর,	
apolokbhabe,	অপলকভাবে,	অপলকভাবে,	
monjurul,	মঞ্জুরুল,	মনজুরুল,	
vugoley,	ভিগোলি,	ভূগোলে,	
bhabanipur,	ভবানীপুর,	ভবানীপুর,	
chereche,	চেরেছে,	ছেড়েছে,	
zozyota,	যজ্যতা,	যোজ্যতা,	
hamburgey,	হ্যামবুর্গে,	হামবুর্গে,	
padee,	পাদি,	পাড়ে,	
kaferderke,	কাফেরদেরকে,	কাফেরদেরকে,	
abdi,	আব্দি,	অব্দি,	
juboksoho,	যুবকসহ,	যুবকসহ,	
shukrabab,	শুক্রবাব,	শুক্রবাব,	
byatikrami,	ব্যতিক্রমী,	ব্যতিক্রমী,	
protul,	প্রতুল,	প্রতুল,	
bhimsenkei,	ভীমসেনকেই,	ভীমসেনকেই,	
shattoki,	শত্টকী,	সাত্যকি,	
ghoomachhilo,	ঘোমাচিল,	ঘুমাচ্ছিল,	
sucre,	সাক্রে,	সাকার,	
bojhey,	বোঝে,	বোঝে,	
motabolombira,	মতাবলম্বীরা,	মতাবলম্বীরা,	
boikolyo,	বৈকল্য,	বৈকল্য,	
bhittiti,	ভিত্তিটি,	ভিত্তিটি,	
pyetarna,	প্যাটার্ন,	প্যাটার্ন,	
shoodhooi,	শুধৌই,	শুধুই,	
aamoode,	আমুদে,	আমুদে,	
monohputo,	মনঃপুত,	মনঃপুত,	
uddharkarmirai,	উদ্ধারকর্মীরাই,	উদ্ধারকর্মীরাই,	
samajikotar,	সামাজিকতার,	সামাজিকতার,	
supreetira,	সুপ্রীতিরা,	সুপ্রীতিরা,	
mandanda,	মন্দনদা,	মানদণ্ড,	
turista,	তুরিস্তা,	টুরিস্ট,	
fimela,	ফিমেলা,	ফিমেল,	
shangkulaan,	সংকুলন,	সংকুলান,	
azin,	আজিন,	আজিন,	
prarthonakokkher,	প্রার্থনাক্ষরের,	প্রার্থনাকক্ষের,	
cholochchitrai,	চলচ্চিত্রই,	চলচ্চিত্রই,	
sanghatakder,	সংহাতকদের,	সংঘটকদের,	
neerbachoker,	নির্বাচকের,	নির্বাচকের,	
khiladirao,	খিলাডিরাও,	খিলাড়িরাও,	
bamon,	বামন,	বামন,	
bokul,	বকুল,	বকুল,	
basakey,	বাসাকে,	বাসাকে,	
dormetori,	ডর্মেতরি,	ডরমিটরি,	
adbhanced,	অ্যাডভান্সড,	অ্যাডভান্সড,	
bondishalatei,	বন্দিশালাতেই,	বন্দিশালাতেই,	
aamontrito,	আমন্ত্রিত,	আমন্ত্রিত,	
deefinition,	ডিফিশন,	ডেফিনেশন,	
faltu,	ফ্যালটু,	ফালতু,	
saver,	সাভের,	সেভার,	
bisheshshyer,	বিশেষ্যের,	বিশেষ্যের,	
khorsed,	খোরসেদ,	খোরশেদ,	
yaak,	ইয্যাক,	ইয়াক,	
neelfamarir,	নিলফাফারীর,	নীলফামারীর,	
jeshh,	যেশ,	জেস,	
shitei,	শিতেই,	শীতেই,	
bollov,	বললভ,	বল্লভ,	
afzol,	আফজোল,	আফজল,	
turkyder,	টার্কিদের,	তুর্কিদের,	
sadadyarao,	সদাদ্যারাও,	সদদ্যরাও,	
bhardwaj,	ভর্দ্বজ,	ভরদ্বাজ,	
bulan,	বুলান,	বুলান,	
ghoshanapatratio,	ঘোষণাপত্রটিও,	ঘোষণাপত্রটিও,	
songasthatike,	সংস্থাঠীকে,	সংস্থাটিকে,	
mawdeel,	মাদডিল,	মডেল,	
panchashjon,	পঞ্চাশোজন,	পঞ্চাশজন,	
hisaber,	হিসাবের,	হিসাবের,	
kodorer,	কদরের,	কদরের,	
kadam,	কাদম,	কদম,	
ganoporibahoner,	গণপরিবহণের,	গণপরিবহনের,	
kogake,	কোগাকে,	কোগাকে,	
bishshasho,	বিশ্ষাষ,	বিশ্বাসও,	
purohitder,	পুরোহিতদের,	পুরোহিতদের,	
chalachchitrei,	চলচ্চিত্রেই,	চলচ্চিত্রেই,	
cheenja,	চেঞ্জা,	চেঞ্জ,	
besooro,	বেষুরও,	বেসুর,	
madhuree,	মধুরী,	মাধুরী,	
moddhyoshtho,	মধ্যস্থ,	মধ্যস্থ,	
dipke,	ডিপকে,	দ্বীপকে,	
flirt,	ফ্লিরট,	ফ্লার্ট,	
suiza,	সুইজা,	সুইজা,	
ajeem,	আজীম,	আজিম,	
teennis,	টেনিস,	টেনিস,	
graambasheeo,	গ্রামবাশীও,	গ্রামবাসীও,	
kobutorer,	কবুতরের,	কবুতরের,	
osomorthito,	অসমর্থিত,	অসমর্থিত,	
gajetted,	গ্যাজেটেড,	গেজেটেড,	
kade,	কাদে,	কোড,	
dheke,	ধেকে,	ঢেকে,	
binakar,	বিনাকার,	বিনাকার,	
utkhaat,	উৎক্ষাত,	উত্খাত,	
mashtarsha,	মাষ্টার্ষ,	মাস্টার্স,	
pinglateo,	পিংলাতেও,	পিংলাতেও,	
jhanjra,	ঝাঁজরা,	ঝাঁজরা,	
tep,	টেপ,	ট্যাপ,	
rezidence,	রিজাদিন্স,	রেসিডেন্স,	
alaul,	আলাউল,	আলাওল,	
sexperter,	সেক্সপারটার,	সেক্সপার্টের,	
jaistho,	জয়স্থ,	জ্যৈষ্ঠ,	
kotibondhe,	কতিবন্ধে,	কটিবন্ধে,	
byathapather,	ব্যথাপথের,	ব্যথাপথের,	
alexandar,	আলেক্সান্দার,	আলেকজান্ডার,	
chaudhurio,	চৌধুরিও,	চৌধুরীও,	
fitarsaho,	ফিতারসহ,	ফিতরসহ,	
generalissimo,	জেনারালাসিমিি,	জেনারেলিসিমো,	
shhikara,	শিকারা,	শিকার,	
stonehenje,	স্টোনহেঞ্জে,	স্টোনহেঞ্জ,	
sakshatkarer,	সক্ষাতকরের,	সাক্ষাৎকারের,	
orunima,	অরুণিমা,	অরুণিমা,	
sahojlovyotar,	সহজোভ্বলতার,	সহজলভ্যতার,	
dalee,	ডালি,	ডালে,	
poste,	পস্তে,	পোষ্টে,	
bhenise,	ভেনিসে,	ভেনিসে,	
swadesh,	স্বদেশ,	স্বদেশ,	
pradoshik,	প্রাদশিক,	প্রাদশিক,	
jaandrel,	জাঁদ্রেল,	জাঁদরেল,	
gasthi,	গাস্থি,	গোষ্ঠী,	
aro,	আরো,	আরও,	
dharmantor,	ধর্মন্তর,	ধর্মান্তর,	
kuldip,	কুলদীপ,	কুলদীপ,	
shikkhadikkhay,	শিক্ষাদ্ধাখ্য,	শিক্ষাদিক্ষায়,	
societyke,	সকিয়টিকে,	সোসাইটিকে,	
bashoborty,	বাশবর্তি,	বশবর্তী,	
bolechile,	বলেছিলে,	বলেছিলে,	
aaeerese,	আইরেসেস,	আইরেসে,	
chat,	চাত,	চ্যাট,	
paab,	পাব,	পাব,	
taufik,	তাইজিক,	তৌফিক,	
vittiteo,	ভিত্তিতেও,	ভিত্তিতেও,	
weelcomee,	ভিলকোমি,	ওয়েলকাম,	
foxcon,	ফক্সনোন,	ফক্সকন,	
thakeni,	থাকেনি,	থাকেনি,	
torabganj,	তোরাগঞ্জ,	তোরাবগঞ্জ,	
proshtotto,	প্রশ্তত্ত,	প্রস্ত্তত,	
dristiheen,	দৃষ্টিহীন,	দৃষ্টিহীন,	
orhan,	অরহান,	ওরহান,	
sambatsarkal,	সম্বাৎ্ররাাল,	সম্বৎসরকাল,	
rachonakal,	রচনাকাল,	রচনাকাল,	
nariderke,	নারীদেরকে,	নারিদেরকে,	
ceramiker,	সেরামিকের,	সিরামিকের,	
keyu,	কেয়ু,	কেউ,	
ahalyar,	আহাল্যার,	অহল্যার,	
sommotite,	সম্মতিতে,	সম্মতিতে,	
ghurechen,	ঘুরেছেন,	ঘুরেছেন,	
peerry,	পীররি,	পেরি,	
hydrological,	হাইড্রোলজিক্যাল,	হাইড্রোলজিক্যাল,	
jinsa,	জিনসা,	জিন্স,	
achintyabhedaved,	অচিন্ত্যদেবভাদ,	অচিন্ত্যভেদাভেদ,	
nibondhocheler,	নিবন্ধচেলের,	নিবন্ধছেলের,	
vortuki,	ভর্ুকি,	ভর্তুকি,	
madhuri,	মাধুরি,	মাধুরী,	
oxite,	অক্সিতে,	অক্সাইট,	
overholing,	ওভারহলিং,	ওভারহোলিং,	
podarthobidder,	পদার্থবিদদের,	পদার্থবিদদের,	
lutheerana,	লুঠিরানা,	লুথেরান,	
aflatoxin,	আফ্লাতক্সিন,	আ্যফ্ল্যাটক্সিন,	
shingping,	সিংপিং,	শিংপিং,	
bosturoi,	বস্তুরই,	বস্তুরই,	
samaptir,	সমাপ্তির,	সমাপ্তির,	
naitikatavodh,	নৈতিকতাবোধ,	নৈতিকতাবোধ,	
jarmaniteo,	জারমানিতেও,	জার্মানিতেও,	
rakhtokkharone,	রাহতকখারণে,	রক্তক্ষরণে,	
tottorat,	তত্তরবাত,	তওরাত,	
nirbaahe,	নির্বাহে,	নির্বাহে,	
porirshoder,	পরির্ধদের,	পরির্ষদের,	
prime,	প্রাইম,	প্রাইম,	
kuresher,	কুরেশের,	কুরেশের,	
orbit,	অরবিট,	অরবিট,	
ummool,	উম্মুল,	উম্মুল,	
koruna,	করুুনা,	করুণা,	
notey,	নটে,	নোটে,	
ekoirokom,	একরুকম,	একইরকম,	
upbasher,	উপবাশের,	উপবাসের,	
baptics,	ব্যাপটিক্স,	ব্যাপটিকস,	
iub,	আউইইবি,	আইইউবি,	
laicenshe,	লাইসেন্স,	লাইসেন্স,	
atmabishvashi,	আত্মবিশাবশষ,	আত্মবিশ্বাসী,	
khoor,	খোর,	ক্ষুর,	
monur,	মনুর,	মনুর,	
zerusalem,	জেরুসালেম,	জেরুসালেম,	
torunra,	তরুণরা,	তরুণরা,	
booponer,	বূপনের,	বপনের,	
bohudin,	বহুদিন,	বহুদিন,	
grauth,	গ্রাউথ,	গ্রোথ,	
fastag,	ফাস্তাগ,	ফ্যাসট্যাগ,	
songrahak,	সংগ্রহক,	সংগ্রাহক,	
sudrishya,	সুদৃশ্য,	সুদৃশ্য,	
chanoo,	চানুও,	চানু,	
kormyi,	কর্ম্,	কর্মই,	
jamkaalo,	জামকালো,	জমকালো,	
ghotol,	ঘটল,	ঘটল,	
dharmiyabhabei,	ধর্মিয়ভাবেই,	ধর্মীয়ভাবেই,	
show,	শূউ,	শো,	
rejidens,	রেজিডেন্স,	রেসিডেন্স,	
mmehonoti,	ম্মেহনোটি,	মেহনতি,	
pujit,	পুজিৎ,	পুজিত,	
bolbo,	বলবো,	বলবো,	
olympik,	অলিম্পিক,	অলিম্পিক,	
seramiks,	সেরামিক্স,	সিরামিকস,	
booksar,	বুকসার,	বুক্সার,	
siqh,	সিক,	শিখ,	
nilkuthir,	নীলকুঠির,	নীলকুঠির,	
peri,	পেরী,	পেরি,	
anchalgulir,	অঞ্চলগুলির,	অঞ্চলগুলির,	
sures,	সুরেস,	সুরেশ,	
lirikti,	লিরিকটি,	লিরিকটি,	
mahasava,	মহাসভা,	মহাসভা,	
engrezder,	এনগ্রেজদের,	ইংরেজদের,	
pretti,	প্রেত্তি,	প্রিটি,	
wodka,	ওয়াকা,	ভদকা,	
byboshthar,	বিবশ্থর,	ব্যাবস্থার,	
pranibigyani,	প্রাণিবিজ্ঞানী,	প্রাণীবিজ্ঞানী,	
protizogii,	প্রতিযোগী,	প্রতিযোগী,	
difinishian,	ডিফিনিশিয়ান,	ডেফিনেশন,	
groundta,	গ্রুন্ডটা,	গ্রাউন্ডটা,	
elaakati,	এলাকাটি,	এলাকাটি,	
goolen,	গুলেন,	গুলেন,	
inphormeshon,	ইনফর্মেশন,	ইনফরমেশন,	
prangulo,	প্রাণগুলো,	প্রানগুলো,	
juktarashtrasaha,	যুক্তার্ষ্্রসহ,	যুক্তরাষ্ট্রসহ,	
plato,	প্লাটো,	প্লেটো,	
rohinibabu,	রোহিনীবাবু,	রোহিনীবাবু,	
songkolonti,	সংকলননটি,	সংকলনটি,	
mumtaz,	মুমতাজ,	মুমতাজ,	
bandi,	বন্দী,	বন্দী,	
enginiiring,	ইঞ্জিনিরিং,	ইঞ্জিনিয়ারিং,	
grambaasheeo,	গ্রামবাশিও,	গ্রামবাসীও,	
batikromee,	বাতিক্রমী,	ব্যতিক্রমী,	
barack,	বারাক,	বারাক,	
shomser,	শমসের,	সমশের,	
megh,	মেঘ,	মেঘ,	
hood,	হুড,	হুড,	
gazeetteed,	গ্যাজিট্,	গেজেটেড,	
elakasoho,	এলাকাসহ,	এলাকাসহ,	
baganoto,	বাগানোটো,	বাগানত,	
cholochchitratike,	চলচ্চিত্রাটিকে,	চলচ্চিত্রটিকে,	
paner,	পানের,	পানের,	
songkoloney,	সংকোলনে,	সংকলনে,	
footballerra,	ফুটবলরেররা,	ফুটবলাররা,	
akar,	আকার,	একার,	
mulbhitti,	মুলভিত্তি,	মূলভিত্তি,	
path,	পাথ,	পাথ,	
homeser,	হোমেসের,	হোমসের,	
avidur,	আভিদুর,	আভিদুর,	
jyaqasana,	জ্যাকাসন,	জ্যাকসন,	
hool,	হুল,	হুল,	
marketin,	মার্কেটিন,	মার্কেটিং,	
ramantic,	র্যামান্টিক,	রোমান্টিক,	
baharamporer,	বহহরমাপরের,	বহরমপুরের,	
gonohotyakey,	গণহত্যাকে,	গণহত্যাকে,	
karecho,	করেছো,	করেছো,	
meshenjar,	মেশেঞ্জার,	মেসেঞ্জার,	
kajangale,	কাজঙ্গলে,	কজঙ্গলে,	
elaakaate,	এলাকাতে,	এলাকাতে,	
humner,	হাম্নার,	হামনার,	
nottee,	নট্,	নোটটি,	
kazianis,	কাজিয়ানিস,	কাজানিস,	
bajpa,	বাজপা,	বাজপা,	
caramiks,	ক্যারামিক্স,	সিরামিকস,	
chandrima,	চন্দ্রিমা,	চন্দ্রিমা,	
saatzoner,	সাতজনের,	সাতজনের,	
shniper,	শ্নিপের,	স্নাইপার,	
abheedhaneek,	অভিধানিক,	অভিধানিক,	
tintir,	তিনটির,	তিনটির,	
hizrite,	হিজরিতে,	হিজরীতে,	
mumtajer,	মুমতাজের,	মুমতাজের,	
ponchashjon,	পঞ্চাশজন,	পঞ্চাশজন,	
maaktoome,	মাকততে,	মাকতুম,	
maila,	মাইলা,	মাইল,	
dhhaloor,	ঢালৌর,	ঢালুর,	
somraat,	সমররাত,	সম্রাট,	
phutanta,	ফুটান্তা,	ফুটন্ত,	
mutar,	মুতার,	মুতার,	
atibiplabi,	অতিবিপ্লাবী,	অতিবিপ্লবি,	
gasthii,	গাস্থি,	গোষ্ঠীই,	
machkabar,	মাচকাবার,	মাচকাবার,	
khelaphate,	খেলাফাতে,	খেলাফতে,	
raia,	রায়,	রায়,	
chikkingsasoho,	চিক্সিংলাসহ,	চিকিংসাসহ,	
chhooti,	ছুটি,	ছুটি,	
bedantodhormo,	বেদান্তরর্ম,	বেদান্তধর্ম,	
bairer,	বেইরের,	বাইরের,	
patjata,	পাটজাতা,	পাটজাত,	
hazat,	হাজাত,	হজত,	
baipash,	বাইপাশ,	বাইপাস,	
bejiye,	বেজিয়ে,	বেজিয়ে,	
vromonkaley,	ব্রমণকালে,	ভ্রমণকালে,	
sheets,	শিউটস,	শীটস,	
taunsheep,	তাউনশীপ,	টাউনশিপ,	
zeeland,	জিল্যান্ড,	জিল্যান্ড,	
drabyatah,	দ্রব্যতাঃ,	দ্রব্যতঃ,	
safiin,	সাফিন,	সাফিন,	
kheylechen,	খেয়েলেছেন,	খেলেছেন,	
nuhas,	নুহাস,	নুহাশ,	
ruby,	রুবি,	রুবী,	
marathi,	মারাথি,	মরাঠি,	
morodeho,	মরদেহো,	মরদেহ,	
sookumari,	সুকুমারি,	সুকুমারী,	
janagononar,	জনগোননর,	জনগণনার,	
aashtikotaa,	আষ্ঠিকতা,	আস্তিকতা,	
saabyastha,	সবব্যস্থ,	সাব্যস্থ,	
pharn,	ফার্ন,	ফার্ন,	
hattey,	হ্যাটে,	হাঁটতে,	
shakar,	শাকার,	সকার,	
aniyantrita,	অনিয়ন্ত্রিত,	অনিয়ন্ত্রিত,	
towraat,	তূররাত,	তওরাত,	
horiddar,	হরিদদার,	হরিদ্বার,	
oitijjha,	ঐতিহ্য,	ঐতিহ্য,	
ajij,	অজিজ,	আজিজ,	
vagini,	ভাগিনি,	ভগিনী,	
zakharovar,	যাখারভার,	জাখারোভার,	
ahmed,	আহমেদ,	আহামদ,	
debdebyr,	দেবদেববর,	দেবদেবীর,	
silabhara,	সিলাভারা,	সিলভার,	
probhur,	প্রভুর,	প্রভুর,	
asabhya,	অসভ্য,	অসভ্য,	
asthishondhi,	অস্থিনন্ধি,	অস্থিসন্ধি,	
bodna,	বদনা,	বদনা,	
jalarong,	জ্বারালং,	জলরঙ,	
serveray,	সার্ভারা,	সার্ভারে,	
gejetade,	জেজেটেড,	গেজেটেড,	
semai,	সেমাই,	সেমাই,	
armshtronj,	আর্বশ্র্রজং,	আর্মস্ট্রং,	
baasaate,	বাসাতে,	বাসাতে,	
vvimsenn,	ভিভিসমেন,	ভীমসেন,	
welaqama,	ওয়েলাকমা,	ওয়েলকাম,	
chyeta,	চ্যাট,	চ্যাট,	
boner,	বনের,	বনের,	
tokeo,	তোকেও,	টোকেও,	
siddharther,	সিদ্ধার্থের,	সিদ্ধার্থের,	
bipradas,	বিপ্রদাস,	বিপ্রদাস,	
bhenicer,	ভেনিসার,	ভেনিসের,	
farhetin,	ফারহেতিন,	ফারহেতিন,	
rubidium,	রুবিডিয়াম,	রুবিডিয়াম,	
aalaa,	আলা,	আলা,	
maudelgulo,	মাউদেলগুলো,	মডেলগুলো,	
nathibhuktir,	নথিভুক্তির,	নথিভুক্তির,	
pratiyogita,	প্রতিযোগিত,	প্রতিযোগীতা,	
niropekkho,	নিরপপক্ষ,	নিরপেক্ষ,	
mukhomandoler,	মুখমমণ্ডলের,	মুখমণ্ডলের,	
mag,	ম্যাগ,	এমএজি,	
distance,	ডিসট্যান্স,	ডিসট্যান্স,	
zaire,	জেরে,	জাইরে,	
eduardo,	এডুর্যা,	এডুয়ার্দো,	
baaik,	বাইক,	বাইক,	
shakankti,	শাঙ্কটনটি,	শকাঙ্কটি,	
corsin,	কর্সিন,	করসিন,	
muradke,	মুরাদকে,	মুরাদকে,	
rifleksa,	রিফলেক্স,	রিফ্লেক্স,	
metropolitan,	মেট্রোপলিটান,	মেট্রোপলিটন,	
teunar,	টেউনার,	টিউনার,	
sampadoner,	সম্পাদনের,	সম্পাদনের,	
boudher,	বুয়ের,	বৌদ্ধের,	
waal,	ওয়াল,	উল,	
granthatyke,	গ্রান্থাত্বকে,	গ্রন্থটিকে,	
kandy,	কান্ডি,	ক্যান্ডি,	
sqalarashipa,	স্কলারাীশ,	স্কলারশিপ,	
arsie,	আরসি,	আরসিএ,	
bhaisaho,	ভাইসহ,	ভাইসহ,	
bishasey,	বিশাসে,	বিশ্বাসে,	
soomita,	সুমিতা,	সুমিতা,	
eokee,	ইয়াকি,	এওকি,	
dushtogone,	দুষ্টগণে,	দুষ্টগণে,	
parinati,	পরিণাটি,	পরিণতি,	
vabuk,	ভাবুক,	ভাবুক,	
aditisaha,	আদিতিসহ,	অদিতিসহ,	
install,	ইনস্টাল,	ইন্সটল,	
tokee,	টকই,	তকি,	
tyap,	ত্যাপ,	ট্যাপ,	
karmakarke,	করমাকারকে,	কর্মকারকে,	
gandogol,	গণ্ডগোল,	গন্ডগোল,	
masjidke,	মাসজিদকে,	মসজিদকে,	
sethai,	সেথাই,	সেথাই,	
daqop,	ডাকোপ,	দাকোপ,	
kormokarer,	কর্মকারের,	কর্মকারের,	
jaunotar,	যৌনতার,	যৌনতার,	
brake,	ব্রাকে,	ব্রেক,	
niknayman,	নিকনায়াফন,	নিকনেইমান,	
cheerokoomari,	চীরকরমারি,	চিরকুমারী,	
mangolic,	ম্যাঙ্গোলিক,	মাঙ্গলিক,	
mesenjjar,	মেসেনজার,	মেসেঞ্জার,	
youth,	রুত,	ইয়ুথ,	
akhhunno,	আখুষ্ণ,	অক্ষুণ্ণ,	
minishtarer,	মিনিষ্টারের,	মিনিস্টারের,	
bishwasho,	বিশ্বাষ,	বিশ্বাসও,	
korimpur,	করিমপুর,	করিমপুর,	
kidambi,	কিদামবি,	কিদম্বি,	
madaspushto,	মাদাসুুষ্ট,	মদদপুষ্ট,	
chintamani,	চিন্তামানি,	চিন্তামনি,	
providere,	প্রভিডেরে,	প্রভাইডারে,	
cheekitshar,	চিকিৎসার,	চিকিত্সার,	
sweety,	স্বী,	সুইটি,	
cheento,	চিন্তো,	চিনতো,	
sthaponagulor,	স্থাপনাগুলোর,	স্থাপনাগুলোর,	
dapadpi,	দপাদপী,	দাপাদপি,	
shho,	শো,	শো,	
orgho,	অর্ঘ,	অর্ঘ্য,	
shringgo,	শ্রিংগ্য,	শৃঙ্গ,	
chalachchitrer,	চলচ্চিত্রের,	চলচ্চিত্রের,	
streegon,	স্ত্রীগণ,	স্ত্রীগণ,	
fastara,	ফাস্তারা,	ফস্টার,	
heepatitis,	হিপাটিটিস,	হেপাটাইটিস,	
contemporary,	কন্টেমপারা,	কন্টেম্পোরারি,	
postay,	পোস্টাই,	পোস্টে,	
damakalkarmirao,	দমকলকর্মীরাও,	দমকলকর্মীরাও,	
koota,	কোটা,	কোটা,	
bibecchyo,	বিবেচক্য,	বিবেচ্য,	
adhunikkale,	আধুনিকাকলে,	আধুনিককালে,	
doorger,	ডুর্গার,	দুর্গের,	
jubokti,	যুবক্তি,	যুবকটি,	
arthanitike,	অর্থানীতিকে,	অর্থনীতিকে,	
byabosthar,	ব্যবস্থার,	ব্যাবস্থার,	
karlei,	কারলী,	করলেই,	
lokhindorer,	লোখিন্দরের,	লখিন্দরের,	
manushe,	মানুষে,	মানুষে,	
cholochchitrer,	চলচ্চিত্রের,	চলচ্চিত্রের,	
mercedes,	মার্সেডস,	মার্সেডেস,	
hooq,	হুক,	হুক,	
jandrel,	জান্দ্রেল,	জাঁদরেল,	
pray,	প্রায়,	প্রায়,	
rajbandir,	রাজবন্দির,	রাজবন্দীর,	
injiniyarim,	ইঞ্জিনাইয়ামির,	ইঞ্জিনিয়ারিং,	
sikha,	সিখা,	শিখ,	
biphal,	বিফল,	বিফল,	
nederlande,	নেডারল্যান্ডে,	নেদারল্যান্ডে,	
taderek,	তাদেরেক,	তাদেরেক,	
bhandar,	ভান্ডার,	ভাণ্ডার,	
pakhtunistan,	পাখতুুনিত্তান,	পাখতুনিস্তান,	
kagbeni,	কাগবেনি,	কাগবেনি,	
aembed,	এম্বেড,	এম্বেড,	
niroja,	নিরোজা,	নিরোজা,	
komanera,	কমনেরা,	কমানেরা,	
phormat,	ফোর্মাত,	ফরম্যাট,	
bhagnekeo,	ভাগনেকেও,	ভাগ্নেকেও,	
kamla,	কামলা,	কামলা,	
carloos,	কারলুস,	কার্লোস,	
omkar,	ওমকার,	ওঙ্কার,	
lotharan,	লোথারন,	লুথেরান,	
ovidhaner,	অভিধানের,	অভিধানের,	
abarte,	আবারতে,	আবর্তে,	
shrabasti,	শ্রাবস্তি,	শ্রাবস্তী,	
chikitshar,	চিকিৎশার,	চিকিত্সার,	
khilaphat,	খিলাফাত,	খিলাফত,	
mojdur,	মজদুর,	মজদুর,	
horeepur,	হরিপুর,	হরিপুর,	
aarmstrong,	আর্স্্ট্রনং,	আর্মস্ট্রং,	
jamseder,	জামসেদের,	জামসেদের,	
biswashi,	বিশ্বাসী,	বিশ্বাসই,	
societytey,	সকিয়েটে,	সোসাইটিতে,	
borendroke,	বরেন্দ্রকে,	বরেন্দ্রকে,	
baieq,	বাইেক,	বাইক,	
pacbar,	পাকবার,	পাঁচবার,	
nirmol,	নির্মল,	নির্মল,	
hol,	হোল,	হোল,	
pustir,	পুস্তির,	পুষ্টির,	
nimitte,	নিমিত্তে,	নিমিত্তে,	
bisshas,	বিশ্বাস,	বিশ্বাস,	
sedikei,	সেদিকেই,	সেদিকেই,	
annimated,	অ্যানিমেটেড,	এনিমেটেড,	
nischitobhabe,	নিশ্চিতভাবে,	নিশ্চিতভাবে,	
madhoboir,	মাধবরীর,	মাধবীর,	
byabosthar,	ব্যবস্থার,	ব্যবস্থার,	
nirmolotaa,	নির্মলতা,	নির্মলতা,	
segulo,	সেগুলো,	সেগুলো,	
spashtotai,	স্পষ্টতাই,	স্পষ্টতই,	
dharavahik,	ধারাভাহিক,	ধারাবাহিক,	
rohasyer,	রহাস্যের,	রহস্যের,	
laatimer,	লাতিমের,	লাটিমের,	
mulvitti,	মুলভিটটি,	মূলভিত্তি,	
chhadura,	ছদুরা,	ছাদুরা,	
abhiyojan,	অভিযোযান,	অভিযোজন,	
mankisundar,	মা্কিসুন্দর,	মানকিসুন্দর,	
upobaashee,	উপবাী,	উপবাসী,	
chhuteer,	ছুটের,	ছুটির,	
ghomta,	ঘোমটা,	ঘোমটা,	
juakhelar,	জুয়াখেলার,	জুয়াখেলার,	
breq,	ব্রেক,	ব্রেক,	
trenda,	ট্রেন্ডা,	ট্রেন্ড,	
mulor,	মুলোর,	মুলোর,	
sazanor,	সাজানোর,	সাজানোর,	
karaponner,	কারাপন্নের,	কারাপণ্যের,	
bonke,	বনকে,	বনকে,	
gingbhalobasen,	গিংভালাবাসন,	গিংভালোবাসেন,	
krechi,	ক্রেছি,	করেছি,	
ashankai,	আশানকাই,	আশঙ্কাই,	
jommu,	জম্মু,	জম্মু,	
salchak,	সালচক,	সালচাক,	
everage,	এভারেজ,	এভারেজ,	
everestey,	ইভারেস্টে,	এভারেস্টে,	
konar,	কোনার,	কণার,	
taler,	তালের,	তালের,	
jhumjhumita,	ঝুমঝুমািত,	ঝুমঝুমিটা,	
gajiipur,	গজীজপুর,	গাজীপুর,	
dekhso,	দেখসো,	দেখসো,	
planey,	প্লেনি,	প্লেনে,	
orthobochorke,	অর্থবছরকে,	অর্থবছরকে,	
ray,	রায়,	রায়,	
meropenemer,	মারেপেনেমের,	মেরোপেনেমের,	
cuti,	কুটি,	কিউটি,	
damodar,	দমোদার,	দামদর,	
oyebjin,	ওয়েজবিন,	ওয়েবজিন,	
elgoridom,	এলগোরিমম,	এলগরিদম,	
neshadrabyer,	নেশাদ্রব্যের,	নেশাদ্রব্যের,	
elakatay,	এলাকাতায়,	এলাকাতে,	
cinemapremider,	সিনেমাপ্রেমীদের,	সিনেমাপ্রেমীদের,	
bikargrasta,	বিকারগ্রস্ত,	বিকারগ্রস্ত,	
ispredsheet,	ইসপ্রেদ্শিট,	স্প্রেডশীট,	
safiha,	সফিহা,	সাফিহা,	
songbadmadhyame,	সংবাদমাধ্যমে,	সংবাদমাধ্যমে,	
proo,	প্রো,	প্রো,	
sommoteer,	সম্মতির,	সম্মতির,	
oxfordey,	অক্সফোর্ডে,	অক্সফোর্ডে,	
latsaheb,	লাতসাহেব,	লাটসাহেব,	
nazranar,	নাজরানার,	নাজরানার,	
bardhitansh,	বার্ধিতানশ,	বর্ধিতাংশ,	
meloonborroner,	মেলোর্ভরনের,	মেলবোর্নের,	
jegulur,	যেগুলুর,	যেগুলুর,	
saptahokal,	সপ্তাকহল,	সপ্তাহকাল,	
riazuddin,	রিয়াজুদ্দিন,	রিয়াজউদ্দীন,	
chirkoot,	চিরকৌট,	চিরকুট,	
probondhobhittik,	প্রবন্ধভিত্তিক,	প্রবন্ধভিত্তিক,	
chemjong,	চেমজং,	চেমজং,	
fokskon,	ফকস্কন,	ফক্সকন,	
nirvachaker,	নির্বাচাকের,	নির্বাচকের,	
plaiin,	প্লেইন,	প্লেন,	
byaboharkarir,	ব্যবহারকারীর,	ব্যবহারকারীর,	
vaphara,	ভাফারা,	বাফার,	
paikgachha,	পাইকগাছা,	পাইকগাছা,	
moshzidtike,	মশ্যিদিতকে,	মসজিদটিকে,	
lahano,	লাহানো,	লাহানো,	
sursur,	সুরসুর,	সুরসুর,	
laesensh,	লেসেন্স,	লাইসেন্স,	
juktorashtreo,	যুক্তরাষ্ট্রেও,	যুক্তরাষ্ট্রেও,	
uter,	ইউটের,	উটের,	
setike,	সেতিকে,	সেটিকে,	
taalaal,	টলাল,	তালাল,	
senabahinio,	সেনাবাহিনীনো,	সেনাবাহিনীও,	
kei,	কেই,	কেই,	
boikalyo,	বৈকল্য,	বৈকল্য,	
rata,	রাতা,	রত,	
patengar,	পাটেঙ্গার,	পতেঙ্গার,	
shabkam,	শবকাম,	শবকাম,	
langhoner,	লঙ্ঘনের,	লংঘনের,	
lutharen,	লুথারেন,	লুথেরান,	
chamski,	স্যামস্কি,	চমস্কি,	
wishnu,	উইন্নু,	বিষ্ণু,	
badhamuktovabe,	বাধামুক্তভাবে,	বাধামুক্তভাবে,	
bongshokey,	বংশকে,	বংশকে,	
nischoy,	নিশ্চয়,	নিশ্চয়,	
bbiswasho,	ব্বিস্বাশ,	বিশ্বাসও,	
sumoo,	সুমো,	সুমো,	
armeenian,	আরমিিনিয়ান,	আর্মেনিয়ান,	
krema,	ক্রেমা,	ক্রাইম,	
transform,	ট্রান্সফর্ম,	ট্রান্সফর্ম,	
dayitta,	দায়িত্ব,	দায়িত্ব,	
suchanakal,	সূচনাকাল,	সূচনাকাল,	
monzooshree,	মঞ্জর্ষী,	মঞ্জুশ্রী,	
janoganonar,	জনগোননর,	জনগণনার,	
somonnitobhabe,	সমন্নিভাবে,	সমন্বিতভাবে,	
feroza,	ফেরোজা,	ফিরোজা,	
durgatsabe,	দুর্গাতবাবে,	দুর্গোৎসবে,	
mohit,	মহিত,	মুহিত,	
myat,	মায়িট,	ম্যাট,	
balabhadra,	বলভভদরা,	বলভদ্র,	
pyaleshtainer,	প্লায়েশশাইনের,	প্যালেস্টাইনের,	
durgotsabe,	দুর্গোৎসবে,	দুর্গোৎসবে,	
teter,	টেটের,	টেটের,	
valobasen,	ভালোবাসেন,	ভালোবাসেন,	
chire,	চিরে,	চিরে,	
habathu,	হাবথু,	হাবাথু,	
halding,	হালডিং,	হোল্ডিং,	
nutoner,	নিটনের,	নূতনের,	
bizito,	বিজিত,	বিজিত,	
kkhur,	ক্খুর,	ক্ষুর,	
jotinkey,	জটিনকে,	যতীনকে,	
ujobekeestaner,	উজবেক্তিসানের,	উজবেকিস্তানের,	
laaisens,	লাইসেন্স,	লাইসেন্স,	
bisshasi,	বিশ্বাসী,	বিশ্বাসী,	
naneer,	ননীর,	নানীর,	
srivatsalakshanang,	শ্রীবাৎসলক্ষণং,	শ্রীবৎসলক্ষণং,	
sthapanagulor,	স্থাপানাগুলোর,	স্থাপনাগুলোর,	
aakaabaar,	আকাবার,	আকাবার,	
nabatarange,	নবতরঙ্গে,	নবতরঙ্গে,	
digree,	দিগ্রী,	ডিগ্রি,	
karu,	কারু,	কারু,	
cinematographar,	সিনেমেপোগ্রাফার,	সিনেমাটোগ্রাফার,	
teoner,	টিওনার,	টিওনার,	
mukhoshdharir,	মুখোষধারীর,	মুখোশধারীর,	
mozlis,	মজলিস,	মজলিশ,	
toroonraa,	তরনররা,	তরুণরা,	
planea,	প্ল্যানে,	প্লেনে,	
aziza,	আজীজা,	আজিজা,	
mitrer,	মিত্রের,	মিত্রের,	
shef,	শেফ,	শেফ,	
teentir,	টেনটির,	তিনটির,	
shilbar,	শীলবার,	সিলভার,	
shaddhi,	শাদ্ধি,	সাধ্বী,	
gratha,	গ্রাথ,	গ্রোথ,	
pharanyeta,	ফারানিয়া,	ফরম্যাট,	
prosadhani,	প্রসাধনী,	প্রসাধনী,	
jolrang,	জলরাং,	জলরঙ,	
thandabhabe,	থান্ডভাবে,	ঠাণ্ডাভাবে,	
hojurer,	হজুরের,	হজুরের,	
akhandota,	অখণ্ডটা,	অখণ্ডতা,	
soleel,	সোলিল,	সলিল,	
as,	এসএস,	অস,	
kanar,	কানার,	কণার,	
swartho,	স্বার্থ,	স্বার্থ,	
choshon,	চোষণ,	চোষণ,	
rajtantra,	রাজতন্ত্র,	রাজতন্ত্র,	
firoza,	ফিরোজা,	ফিরোজা,	
patigoniter,	পাটিগণিতের,	পাটিগণিতের,	
prakar,	প্রকার,	প্রকার,	
ingrejra,	ইংরেজরা,	ইংরেজরা,	
hajeerhatt,	হাজিরহাট,	হাজিরহাট,	
ekatto,	একাত্ত,	একাত্ব,	
kkomandar,	ক্কমান্দার,	কমাণ্ডার,	
vault,	ভাউলট,	ভল্ট,	
lavta,	লেভটা,	লাভটা,	
amittrakkhor,	অমিত্রাক্ষর,	অমিত্রাক্ষর,	
dovaar,	দোভার,	ডোভার,	
elakatike,	এলাকাটিকে,	এলাকাটিকে,	
brahmanera,	ব্রাহ্মণেরা,	ব্রাহ্মণেরা,	
bondhukey,	বন্ধুকে,	বন্ধুকে,	
munshiji,	মুন্সিজি,	মুনশীজি,	
abti,	আবতি,	আবতি,	
naabyota,	নব্যতা,	নাব্যতা,	
bhenasha,	ভেনাশা,	ভেনাস,	
pluck,	প্লাক,	প্ল্যাক,	
masjidsaho,	মাসিদসহ,	মসজিদসহ,	
dologuloo,	দলোগুলো,	দলগুলোও,	
meloonborrone,	মেলোর্ভরনে,	মেলবোর্নে,	
jaanar,	জানার,	জানার,	
satjaner,	সাতজানের,	সাতজনের,	
standards,	স্ট্যান্ডার্ডসহ,	স্টান্ডার্ডস,	
muktilav,	মুক্তিলাভ,	মুক্তিলাভ,	
haris,	হারিস,	হ্যারিস,	
chiraharit,	চিরাহারিত,	চিরহরিৎ,	
robot,	রোবট,	রোবোট,	
deefinishion,	ডিফিনিশন,	ডেফিনেশন,	
anchalei,	আঞ্চলেই,	অঞ্চলেই,	
chhutochhooti,	ছুটোছটি,	ছুটোছুটি,	
spredsheet,	স্প্রেডশিট,	স্প্রেডশীট,	
gandhikey,	গ্যান্ধিকে,	গান্ধীকে,	
shekarmani,	শেকররমণি,	শেকরমানি,	
graambasider,	গ্রামবাসীদের,	গ্রামবাসীদের,	
remission,	রিমিশন,	রিমিশন,	
freekeh,	ফ্রিকেহ,	ফ্রিকেহ,	
horidbar,	হরিদবার,	হরিদ্বার,	
ponthaar,	পণ্থার,	পন্থার,	
rananganey,	রণাঙ্গনে,	রণাঙ্গনে,	
johor,	জহর,	জহর,	
jatinke,	জাতিনকে,	যতীনকে,	
bonshi,	বনশী,	বংশী,	
emargency,	ইমারজেন্সি,	এমার্জেন্সি,	
antarctika,	আন্ট্রাক্িকা,	অ্যান্টার্কটিকা,	
thabai,	থাবাই,	থাবাই,	
kobulennechha,	কবুলেন্েছা,	কবুলেন্নেছা,	
aarke,	আরকে,	আরকে,	
awatar,	আওয়াতার,	অবতার,	
shikkhartheerao,	শিক্ষার্থীরাও,	শিক্ষার্থীরাও,	
cathalic,	ক্যাথালিক,	ক্যাথলিক,	
bii,	বিইই,	বি,	
akkharkey,	অক্ষরকে,	অক্ষরকে,	
commissionvogider,	কমিশনারভোগের,	কমিশনভোগীদের,	
licensin,	লাইসেন্সিন,	লাইসেন্সিং,	
uthe,	উঠে,	উঠে,	
dhormokorme,	ধর্মকর্মে,	ধর্মকর্মে,	
artherer,	আর্থরের,	আর্থারের,	
masjidtir,	মাসজিদটির,	মসজিদটির,	
nischitvabe,	নিশ্চিতভাবে,	নিশ্চিতভাবে,	
nagorikke,	নাগরিককে,	নাগরিককে,	
nirbachakder,	নির্বাচকদের,	নির্বাচকদের,	
aireshe,	আইরেসে,	আইরেসে,	
iksaprishana,	ইক্সপিরিশন,	এক্সপ্রেশন,	
bondira,	বন্ডিরা,	বন্দীরা,	
sheetke,	শিককে,	শীতকে,	
rakhete,	রাখেতে,	রাখেতে,	
ansareer,	অনসরীরী,	আনসারীর,	
akai,	আকাই,	একাই,	
mojlish,	মজ্লীশ,	মজলিশ,	
seqtara,	সেক্টার,	সেক্টর,	
recondishon,	রেকোনিডসন,	রিকন্ডিশন,	
cholocchitrer,	চলচচিত্রের,	চলচ্চিত্রের,	
lishenshe,	লিসেন্সে,	লাইসেন্স,	
totokson,	ততকসন,	ততক্ষন,	
somratra,	সম্ার্তা,	সম্রাটরা,	
byaboharkarie,	ব্যবহারকারী,	ব্যবহারকারীই,	
kanasarabhesana,	কাসাসররীভানা,	কনসারভেশন,	
kharavel,	খরােভেল,	খারবেল,	
tatey,	টাতে,	তাতে,	
tinhazar,	তিনহাজার,	তিনহাজার,	
paira,	পাইরা,	পাইরা,	
rudroke,	রুদ্রকে,	রুদ্রকে,	
sharifpur,	শরিফপুর,	শরিফপুর,	
sausage,	সাজাগে,	সসেজ,	
aalkaatra,	আলকাত্রা,	আলকাতরা,	
reflex,	রিফ্লেক্স,	রিফ্লেক্স,	
debdebier,	দেবদেবিয়ের,	দেবদেবীর,	
prokalpagulo,	প্রকল্পগুলো,	প্রকল্পগুলো,	
shiulijhra,	শিউলিররা,	শিউলিঝরা,	
shhashtra,	শাষ্ট্র,	শাস্ত্র,	
dara,	দারা,	দারা,	
rakhtokkharoner,	রা্তক্ষরণের,	রক্তক্ষরণের,	
kaash,	কাশ,	কাস,	
bisheshya,	বিশেষ্য,	বিশেষ্য,	
daacktickete,	ডাযকটিকটেে,	ডাকটিকিটে,	
ajuhath,	অযুহাথ,	অজুহাত,	
samanyai,	সামান্যই,	সামান্যই,	
taholo,	তাহল,	তাহলো,	
icelands,	আইসেল্যাড্স,	আইসল্যান্ডসহ,	
bhagno,	ভাগ্ন,	ভগ্ন,	
sumitrar,	সুমিত্রার,	সুমিত্রার,	
maktum,	মককতুম,	মাকতুম,	
teta,	টেট,	টেটা,	
scuvi,	স্কুভি,	স্কুভি,	
anchalo,	আঞ্চলো,	অঞ্চলও,	
chintakarma,	চিন্তাকর্ম,	চিন্তাকর্ম,	
ganochin,	গণোচিন,	গণচীন,	
ingrezeeteo,	ইংরেজিওতেও,	ইংরেজিতেও,	
champa,	চম্পা,	চাঁপা,	
sanghitar,	সংহিতার,	সংহিতার,	
vezano,	ভেজানো,	ভেজানো,	
jiland,	জিল্ন্দ,	জিল্যান্ড,	
basaalt,	বাসাল্ট,	ব্যাসল্ট,	
dhanijomite,	ধনিজমিতে,	ধানিজমিতে,	
urey,	উরে,	ইউরি,	
drissoke,	দৃশ্ককে,	দৃশ্যকে,	
himsrot,	হিমস্রোট,	হিমস্রোত,	
esprito,	এসপ্রিট,	এস্পিরিটো,	
blacker,	ব্ল্যাকার,	ব্ল্যাকের,	
daaradaa,	দারাদা,	দারদা,	
dimbacriti,	ডিম্বাক্রিটি,	ডিম্বাকৃতি,	
saria,	সারিয়া,	সরিয়া,	
dhangsantup,	ধ্বংসন্তুপ,	ধ্বংসন্তুপ,	
jeelyaand,	জীল্যান্ড,	জিল্যান্ড,	
mohammadi,	মোহাম্মদি,	মুহাম্মদী,	
turkeyder,	টুর্কিদের,	তুর্কিদের,	
sheekar,	শীকার,	শিকার,	
hijri,	হিজরি,	হিজরী,	
seshardhe,	শেষার্ধে,	শেষার্ধে,	
sobrakamer,	সভর্কামের,	সবরকমের,	
birishiritey,	বিরিশিরিতে,	বিরিশিরিতে,	
myari,	ম্যারি,	ম্যারি,	
prottokkhovabe,	প্রত্যক্ষভাবে,	প্রত্যক্ষভাবে,	
ostheesandhi,	অস্থেসান্ধি,	অস্থিসন্ধি,	
sealvi,	সিলভি,	সিলভি,	
korley,	করলে,	করলে,	
cholochchitraeeo,	চলচ্চিত্রায়ওও,	চলচ্চিত্রেও,	
udbhaboni,	উদ্ভাবণী,	উদ্ভাবনী,	
gopalrao,	গোপাররাও,	গোপালরাও,	
mathieu,	ম্যাথিয়ু,	ম্যাথিউ,	
shandra,	শান্দ্রার,	শান্দ্রার,	
bhebechili,	ভেবেছিলি,	ভেবেছিলি,	
poripaker,	পরিপাকের,	পরিপাকের,	
chenza,	চেনজা,	চেঞ্জ,	
rakkhanvag,	রক্ষণভাগ,	রক্ষণভাগ,	
akreetokarjo,	অক্রিতাকর্য,	অকৃতকার্য,	
sollallhu,	সল্লাল্লুহ,	সল্লাল্লাহু,	
langhangulir,	লঙ্ঘাঙ্গুলীর,	লঙ্ঘনগুলির,	
hugeke,	হুগেকে,	হিউজকে,	
engrejra,	এনগ্রেজরা,	ইংরেজরা,	
armeeniyana,	আরমিনিনয়,	আর্মেনিয়ান,	
indrakanan,	ইন্দ্রককনান,	ইন্দ্রকানন,	
uporitale,	উপরিতালে,	উপরিতলে,	
hul,	হুল,	হুল,	
direqtareta,	ডিরেক্টরেটা,	ডিরেক্টরেট,	
abheedhanik,	অভিধানিক,	অভিধানিক,	
si,	সিয়,	এসআই,	
masto,	মাস্টো,	মাস্ত,	
audiotike,	অডিআইটিকে,	অডিওটিকে,	
poderthobid,	পোডারথ্বিদ,	পদার্থবিদ,	
neemeette,	নিমিটিত,	নিমিত্তে,	
danaqana,	দনকানা,	ডানকান,	
abdoone,	আব্দোনে,	আবদুন,	
abodamaner,	অবদামনের,	অবদমনের,	
tooku,	তুকু,	টুকু,	
spredashita,	স্প্রেডাশিত,	স্প্রেডশীট,	
tasminer,	তাসমিনের,	তাসমিনের,	
pabo,	পাবো,	পাব,	
teestar,	টেস্টার,	তিস্তার,	
jansha,	জানশা,	জন্স,	
devolapar,	ডেভোলাপার,	ডেভলপার,	
dienes,	ডায়েনিস,	ডিএনএস,	
scholastik,	স্কলাস্িক,	স্কলাস্টিক,	
aajeej,	আজীজ,	আজিজ,	
brittakarey,	বৃত্তকারে,	বৃত্তাকারে,	
karmosansthan,	কর্মসস্থান,	কর্মসংস্থান,	
shektore,	শেকততরে,	সেক্টরে,	
simons,	সিমনস,	সিমন্স,	
kanader,	কানাদের,	কণাদের,	
nirbahey,	নির্বাহে,	নির্বাহে,	
bornolikhon,	বর্ণলিখন,	বর্ণলিখন,	
jorury,	জরুরী,	জরূরী,	
daltagi,	ডালতাগি,	দলত্যাগী,	
mette,	মেট্টে,	ম্যাট,	
shatoke,	শতকে,	শতকে,	
poschimey,	পশ্চিমে,	পশ্চিমে,	
senabahineekey,	সেনাবাহনীকেই,	সেনাবাহিনীকে,	
pratijogitamulak,	প্রতিযোগিতামূলক,	প্রতিযোগীতামূলক,	
rajpur,	রাজপুর,	রাজপুর,	
survative,	সারভাইভি,	সারভেটিভ,	
primoo,	প্রাইমো,	প্রিমো,	
bajhyo,	বাঝ্য,	বাহ্য,	
sompadonkaree,	সম্পাদনকারী,	সম্পাদনকারী,	
neermol,	নির্মল,	নির্মল,	
meghachchanno,	মেঘচ্ছন্ন,	মেঘাচ্ছন্ন,	
jhonkar,	ঝোঁকার,	ঝঙ্কার,	
huk,	হ্যাক,	হুক,	
kayed,	কায়েদ,	কায়েদ,	
agomoney,	অ্যাগমনে,	আগমনে,	
konnoder,	কন্যদের,	কন্যদের,	
hari,	হারি,	হরি,	
daaun,	দাউন,	ডাউন,	
ahong,	আহং,	অহং,	
bhujangta,	ভূজঙ্গতা,	ভুজঙ্গটা,	
firozaa,	ফিরোজা,	ফিরোজা,	
jonosomaj,	জনসমাজ,	জনসমাজ,	
jibanto,	জীবন্ত,	জীবন্ত,	
bodhir,	বধির,	বধির,	
parijaner,	পারিজানের,	পরিজনের,	
ap,	অপ,	আপ,	
asantosh,	অসা্তোষ,	অসন্তোষ,	
choukato,	চৌকাটো,	চৌকাত,	
rena,	রেনা,	রেনো,	
kathla,	কাতলা,	কাঠলা,	
sausagee,	সৌজগী,	সসেজ,	
shishupalgarh,	শিশুপালগর,	শিশুপালগড়ে,	
soommita,	সুম্তিতা,	সুমিতা,	
moreecha,	মরেছা,	মরিচা,	
matrirup,	মাতৃরূপ,	মাতৃরূপ,	
chaiten,	চাইতেন,	চাইতেন,	
asiatic,	অসিয়াটিক,	এশিয়াটিক,	
daayitto,	দায়িত্ব,	দায়িত্ব,	
horidwar,	হরিদ্বার,	হরিদ্বার,	
directorate,	ডারেক্টরাট,	ডিরেক্টরেট,	
baipass,	বাইপাস,	বাইপাস,	
meridiane,	মিরিডিয়ান,	মেরিডিয়ানে,	
diniphition,	ডিনিফিশন,	ডেফিনেশন,	
gloria,	গ্লোরিয়া,	গ্লোরিয়া,	
mookhomandoler,	মূখমা্নলের,	মুখমণ্ডলের,	
poddhotitei,	পদ্ধতিতেই,	পদ্ধতিতেই,	
mase,	মাসে,	মাসে,	
black,	ব্ল্যাক,	ব্ল্যাক,	
dharabahiktite,	ধারাবাহিকটিতে,	ধারাবাহিকটিতে,	
adhyattikota,	আধ্যাত্মিকতা,	আধ্যাত্মিকতা,	
chaaktir,	চাক্তির,	চাকতির,	
ajibon,	আজিবন,	আজীবন,	
promodwara,	প্রমোদবরা,	প্রমদ্বারা,	
andon,	আন্দন,	আন্দোন,	
shpredshiit,	স্প্রেশিটি,	স্প্রেডশীট,	
sheshardhe,	শেষার্ধে,	শেষার্ধে,	
dokaanei,	দোকানেই,	দোকানেই,	
dormroome,	ডরমমরোম,	ডর্মরুমে,	
ingreziteo,	ইংরেজিতেও,	ইংরেজিতেও,	
krusher,	ক্রুশের,	ক্রুশের,	
onkush,	অঙ্কুশ,	অংকুশ,	
harees,	হরিস,	হ্যারিস,	
saamaanya,	সামান্য,	সামান্য,	
bhabaaponno,	ভাবপপন্ন,	ভাবাপন্ন,	
vandar,	ভান্ডার,	ভাণ্ডার,	
shift,	শিফ্ট,	শিফট,	
arthonitite,	অর্থনীতিতে,	অর্থনীতিতে,	
dhadhiye,	ধাধিয়ে,	ধাধিয়ে,	
choudhurike,	চৌধুরীকে,	চৌধুরীকে,	
teliha,	তেলিহা,	তেলিহা,	
uporitoler,	উপরিতলের,	উপরিতলের,	
greenald,	গ্রিনাল্ড,	গ্রিনল্ড,	
debate,	দেবাতে,	ডিবেট,	
rakkhandurga,	রক্ষণদুর্গা,	রক্ষণদুর্গ,	
tigmanshu,	টিগমানশু,	তিগমংশু,	
chhayi,	ছায়ি,	ছাই,	
taffsherer,	তফরশেরের,	তাফসীরের,	
monjooshree,	মঞ্জশ্রী,	মঞ্জুশ্রী,	
jens,	জেনস,	জিন্স,	
samratder,	সম্রাতদের,	সম্রাটদের,	
headquartus,	হেডকুরফ্রাস,	হেডকোয়ার্টাস,	
taims,	টাইমস,	টাইমস্,	
graambaaseer,	গ্রমব্বীর,	গ্রামবাসীর,	
shakara,	শাকারা,	সাকার,	
dreeshtiheen,	দৃষ্টিহীন,	দৃষ্টিহীন,	
aranyani,	অরণ্যনি,	অরণ্যানী,	
sachetanvabe,	সচেতনাভাবে,	সচেতনভাবে,	
mah,	মাহ,	মাহে,	
kourabe,	উৌরাবে,	কৌরবে,	
bhalobaas,	ভালোবাস,	ভালোবাসা,	
anhu,	আনহু,	আনহু,	
qrisenta,	ক্রিসেন্টা,	ক্রিসেন্ট,	
lendal,	লেন্ডাল,	লেন্ডল,	
existing,	এক্সিসটিং,	এক্সিসটিং,	
sayatana,	সায়াতনা,	শয়তান,	
foloshrutite,	ফলরশ্ুটিতে,	ফলশ্রুতিতে,	
peethey,	পিথি,	পীঠে,	
noitikota,	নৈতিকতা,	নৈতিকতা,	
bisshaskey,	বিশ্বাসকে,	বিশ্বাসকে,	
rotheen,	রথীন,	রথীন,	
ramolino,	রামোলিনো,	রামোলিনো,	
rijoor,	ঋিওর,	রিজুর,	
nirikho,	নিরিখো,	নিরিখ,	
dadar,	দাদার,	দাদার,	
ramachandranke,	রামাচন্দ্রনকে,	রামাচন্দ্রনকে,	
poschime,	পশ্চিমে,	পশ্চিমে,	
romarder,	রোমার্ডের,	রোমারদের,	
fansi,	ফ্যানসি,	ফাঁসী,	
gotihin,	গতিহীন,	গতিহীন,	
onucheeder,	অনুচেদীর,	অনুচ্ছেদের,	
maail,	মেয়ল,	মাইল,	
swasthohinotay,	স্বাস্থ্যহীনতায়,	স্বাস্থ্যহীনতায়,	
bouddha,	বৌদ্ধ,	বৌদ্ধ,	
jolrong,	জলরং,	জলরঙ,	
dharmadasbabu,	ধর্মদাসবাবু,	ধর্মদাসবাবু,	
andamana,	আন্দামানা,	আন্দামান,	
gaphiloti,	গাপিলোটি,	গাফিলতি,	
achintopurer,	অচিন্তপুরের,	অচিন্তপুরের,	
markeetim,	মার্কিটিম,	মার্কেটিং,	
dhanche,	ধাঁচে,	ধাঁচে,	
daktikit,	ডাক্তিকিট,	ডাকটিকিট,	
rodney,	রডনে,	রেডনি,	
sip,	সিপ,	শিপ,	
ponero,	পনেরও,	পনের,	
nakkal,	নক্কল,	নক্কল,	
gujab,	গুজাব,	গুজব,	
firoze,	ফিরোজ,	ফিরোজ,	
aholyar,	অহল্যার,	অহল্যার,	
titarer,	তিতারের,	তিতারের,	
sponsorshipe,	স্পন্সরশিপে,	স্পন্সরশীপে,	
jonomukhi,	জনমুখী,	জনমুখী,	
suraaropeeto,	সুরররীপত,	সুরারোপিত,	
seconder,	সেকন্ডার,	সেকেন্ডের,	
lyaanding,	ল্যান্ডিং,	ল্যান্ডিং,	
sangkoolan,	সংকূলন,	সংকুলান,	
saqara,	সাকারা,	সাকার,	
akkaas,	আককাস,	আককাস,	
bapokotor,	বাপককতর,	ব্যাপকতর,	
bidghootey,	বিদ্ঘটে,	বিদঘুটে,	
aosafur,	আওসাফুর,	আওশাফুর,	
boshoborti,	বশরবতী,	বশবর্তী,	
addata,	আদ্যাটা,	আড্ডাটা,	
nogore,	নগরে,	নগরে,	
vittio,	ভিত্তিও,	ভিত্তিও,	
sudrissho,	সুদ্রিশ,	সুদৃশ্য,	
graambaaseeo,	গ্রামবাসীও,	গ্রামবাসীও,	
bipti,	বিপ্টি,	বিপ্তি,	
karecho,	করেছো,	করেছ,	
sangbadmadhyamgulote,	সংবাদমাধ্যমগুলোতে,	সংবাদমাধ্যমগুলোতে,	
geejeeteeda,	গীজটিদে,	গেজেটেড,	
mahbunur,	মাহবুনুর,	মাহবুনুর,	
smarok,	স্মরোক,	স্মারক,	
registrikrito,	রেজিস্ট্রিক,	রেজিস্ট্রীকৃত,	
bongsho,	বংশো,	বংশ,	
shikkharrthirao,	শিক্ষার্থীররাও,	শিক্ষার্থীরাও,	
toranganj,	তরঙ্গঞ্জ,	তোরাবগঞ্জ,	
ramnathbabur,	রামনাথবাবুর,	রামনাথবাবুর,	
gananatyo,	গণনায্য,	গণনাট্য,	
manohputa,	মনঃপুতা,	মনঃপুত,	
uparzoner,	উপার্জনের,	উপার্জনের,	
sharif,	শারিফ,	শরিফ,	
militaryr,	মিলিটারির,	মিলিটারির,	
byaktigotovabeo,	ব্যক্তিগতভাবেও,	ব্যাক্তিগতভাবেও,	
myathiou,	ম্যাথিও,	ম্যাথিউ,	
abikaul,	আবিকাল,	অবিকল,	
saralya,	সারালয়,	সারল্য,	
pratishthanik,	প্রতিষ্ঠানিক,	প্রাতিষ্ঠানিক,	
mimgulor,	মিমগুলোর,	মিমগুলোর,	
madhabi,	মাধাবি,	মাধবী,	
hariner,	হরিণের,	হরিণের,	
ranangane,	রানাঙ্গনে,	রণাঙ্গনে,	
subader,	সুবাদের,	সুবাদে,	
logic,	লজিক,	লজিক,	
porbotmala,	পর্বতমালা,	পর্বতমালা,	
qaro,	কারো,	কারো,	
taroni,	তারণী,	তরণী,	
mekon,	মেকন,	মেকং,	
hillse,	হিলসে,	হিলসে,	
rohosyoti,	রহস্যতি,	রহস্যটি,	
sthapanar,	স্থাপনার,	স্থাপনার,	
majdur,	মাজদুর,	মজদুর,	
soundarja,	সৌন্দর্য্য,	সৌর্ন্দয্য,	
antarbhutto,	অন্তর্ভূত্ত,	অন্তর্ভুক্ত,	
kathghera,	কাঘঘেরা,	কাঠঘেরা,	
neelkamal,	নিলকামাল,	নীলকমল,	
hert,	হার্ট,	হার্ট,	
shangsthatikey,	শাংস্ষাটিকে,	সংস্থাটিকে,	
popke,	পোপকে,	পোপকে,	
mujuru,	মুজুরু,	মুজুরু,	
taranee,	তারানী,	তরণী,	
poriskoron,	পরিস্করণ,	পরিষ্করণ,	
patochitra,	পাটচিত্র,	পটচিত্র,	
somabeshti,	সমাবেশটি,	সমাবেশটি,	
quata,	কোয়াতা,	কোটা,	
shahurgulor,	শহুরগুলোর,	শহুরগুলোর,	
ship,	শিপ,	শিপ,	
niemond,	নিমন্ড,	নিমন্ড,	
kormokarke,	কর্মকারকে,	কর্মকারকে,	
protisthar,	প্রতিষ্ঠার,	প্রতিষ্ঠার,	
khalidkay,	খালিকদা,	খালিদকে,	
postar,	পোস্টার,	পোস্টের,	
dinara,	দিনারা,	ডিনার,	
domonmulok,	দমনমূলক,	দমনমূলক,	
metropalitana,	মেট্রোপলিটান,	মেট্রোপলিটন,	
hizriite,	হিজরিতে,	হিজরীতে,	
hyaloyin,	হ্যালইন,	হ্যালোইন,	
ashor,	আ্বোর,	আসর,	
kalnir,	কালনির,	কালনীর,	
fongli,	ফোংলি,	ফংলি,	
dikpal,	ডিকপাল,	দিকপাল,	
codee,	কোডি,	কোডে,	
bodhirta,	বোধীরটা,	বধিরতা,	
alaol,	অলাউল,	আলাওল,	
alaoler,	অলালের,	আলাওলের,	
rajotta,	রাজত্ব,	রাজত্ব,	
kaathhmaandute,	কাঠমান্ডুতে,	কাঠমান্ডুতে,	
shansthagulo,	শান্সাথগুলো,	সংস্থাগুলো,	
capshule,	ক্যাপশুলে,	ক্যাপসুল,	
utpotti,	উৎপট্টি,	উতপত্তি,	
atmira,	আতমিরা,	আত্মীরা,	
raagei,	রাগেই,	রাগেই,	
asociatis,	অ্যাসোকাইটিস,	এসোসিয়েটস,	
dada,	দাদা,	দাদা,	
baman,	বামান,	বামন,	
lat,	ল্যাট,	লাট,	
dhojovongo,	ধ্যাভঙ্গ,	ধ্বজভঙ্গ,	
jani,	জানি,	জনি,	
ayumi,	আয়ুমী,	আয়ুমি,	
ramantika,	রাম্নটিকা,	রোমান্টিক,	
infarmatian,	ইনফরমেশন,	ইনফরমেশন,	
larson,	লারসন,	লারসন,	
protyokkhovabey,	প্রত্যক্ষভাবে,	প্রত্যক্ষভাবে,	
caroline,	ক্যারোলিন,	ক্যরোলিন,	
falak,	ফালাক,	ফলক,	
grushko,	গ্রুশকো,	গ্রুশকো,	
mekapgulo,	মেকাপগুলো,	মেকআপগুলো,	
munjur,	মুঞ্জুর,	মুনজুর,	
kooshumba,	কুশুম্ব,	কুশুম্বা,	
bairey,	বায়েরে,	বাইরে,	
patininda,	পতিিনিন্দ,	পতিনিন্দ,	
thaii,	তাইই,	থাই,	
chalaabi,	চালাবী,	চালাবে,	
ashociatesh,	আশোচিভেষ,	এসোসিয়েটস,	
qaferderkey,	কাফেরদেরকে,	কাফেরদেরকে,	
mile,	মিলে,	মিলে,	
acrolect,	অ্যাক্রোলেক্ট,	অ্যাক্রোলেক্ট,	
obosore,	অবসরে,	অবসরে,	
brekthrough,	ব্রুথক্রেঘ,	ব্রেকথ্রু,	
ganoporibahon,	গণপরিবহহন,	গণপরিবহন,	
janosamaj,	জনসমাজ,	জনসমাজ,	
teemothy,	টিমোথি,	টিমোথি,	
pulivendla,	পুলিভেন্ডলা,	পুলিভেন্ডলা,	
odeb,	ওদেব,	ওদেব,	
kormoi,	কর্মই,	কর্মই,	
ghatiti,	ঘটিটি,	ঘাঁটিটি,	
kirke,	কিরকে,	কিরকে,	
chowdhurir,	চৌধুরীর,	চৌধুরীর,	
hoteltite,	হোটেলটিতে,	হোটেলটিতে,	
milea,	মিলেয়া,	মাইলে,	
temonvabe,	টেমনভাবে,	তেমনভাবে,	
talgachh,	তালগাছ,	তালগাছ,	
nirdesika,	নির্দেসিকা,	নির্দেশিকা,	
ekroop,	একরূপ,	একরূপ,	
basermick,	বেসারমিক,	বেসারমিক,	
akpaase,	অকযাপফেস,	একপাশে,	
chhooteer,	ছুটির,	ছুটির,	
xpose,	এক্সোস,	এক্সপোজ,	
deobonde,	দেওবন্দে,	দেওবন্দে,	
avisongson,	আভিসংসন,	অভিশংসন,	
grambaashio,	গ্রামবাশিও,	গ্রামবাসীও,	
dacope,	ড্কোপ,	দাকোপ,	
suparharo,	সুপরহারও,	সুপারহিরো,	
madhoori,	মধুরী,	মাধুরী,	
dhhaabi,	ঢাবি,	ঢাবি,	
byaptikaler,	ব্যাপ্তিকালের,	ব্যাপ্তিকালের,	
militarir,	মিলিতারির,	মিলিটারির,	
jomjamat,	জমজামত,	জমজমাট,	
laat,	লাট,	লাট,	
blogarra,	ব্লোগাররা,	ব্লগাররা,	
registaner,	রেজিস্টানের,	রেগিস্তানের,	
probeshan,	প্রবেশন,	প্রবেশন,	
gostigulo,	গোস্টিগুলো,	গোষ্ঠীগুলো,	
munot,	মুনোট,	মুনোট,	
abhidhaanic,	অভিধানিক,	অভিধানিক,	
panchasjan,	পঞ্চাসন,	পঞ্চাশজন,	
hypar,	হিপার,	হাইপার,	
monchosthol,	মঞ্চশ্লল,	মঞ্চস্থল,	
antorvukta,	আন্তর্ভুক্ত,	অন্তর্ভুক্ত,	
falasrutite,	ফালাস্ুরিতে,	ফলশ্রুতিতে,	
bedanta,	বেদান্তা,	বেদান্ত,	
helly,	হেলি,	হিলি,	
charban,	চরবান,	চর্বন,	
somoibo,	সময়ব,	সমৈব,	
hijrite,	হিজরিতে,	হিজরীতে,	
hughes,	হুঘেস,	হিউজেস,	
beetloser,	বিটলসের,	বিটলসের,	
probolshoktio,	প্রবলশক্তিও,	প্রবলশক্তিও,	
dakten,	ডাকততেন,	ডাকতেন,	
nationalser,	নেটসনালসের,	ন্যাশনালসের,	
ceramicsh,	সেরামিক্স,	সিরামিকস,	
jamjomat,	জামজমাত,	জমজমাট,	
aizulke,	আইজুলকে,	আইজুলকে,	
ase,	আসে,	আসে,	
aachhis,	আছিস,	আছিস,	
sorsa,	সোরসা,	সোর্স,	
nagorikra,	নাগরিকরা,	নাগরিকরা,	
prijon,	প্রিজন,	প্রিজন,	
onupater,	অনুপাতের,	অনুপাতের,	
irish,	ইরিশ,	আইরিস,	
rastagulikeo,	রাস্তাগুলিকেও,	রাস্তাগুলিকেও,	
besirvagei,	বেস্রীভাগেই,	বেশিরভাগেই,	
jesh,	জেস,	জেস,	
chikittsar,	চিকিত্তাসর,	চিকিত্সার,	
upobaasee,	উপবাসী,	উপবাসী,	
dokan,	দোকান,	দোকান,	
shuri,	শুরী,	সুরি,	
kuronir,	কুরনীর,	কুরনীর,	
thanvi,	থানভি,	থানভী,	
borlen,	বোরলেন,	বরলেন,	
poriikkhateo,	পরীক্ষাতেও,	পরীক্ষাতেও,	
bhoolapuka,	ভোলাওপুকা,	ভোলাপুক,	
emarjensi,	এমারজেন্সি,	এমার্জেন্সি,	
unchuporjayer,	উঁচুপর্যায়ের,	উঁচুপর্যায়ের,	
olympicer,	অলিম্পিসের,	অলিম্পিকের,	
shfingtar,	সফিংটার,	স্ফিংটার,	
nabatamo,	নবতমম,	নবতম,	
bayii,	বাইয়ি,	বাঈ,	
ivil,	আইভিল,	ইভিল,	
ratishilatai,	রতিশিলাটাই,	রতিশীলতায়,	
niketon,	নিকেটন,	নিকেতন,	
iraner,	ইরানের,	ইরানের,	
gronthowo,	গ্রন্থভৌ,	গ্রন্থও,	
lajik,	লাজিক,	লজিক,	
bosano,	বোসানো,	বসানো,	
vange,	ভাঙ্গে,	ভাঙ্গে,	
bibechyo,	বিবেচ্য,	বিবেচ্য,	
nowel,	নওয়েল,	নভেল,	
ruptan,	রূপ্তান,	রূপটান,	
chhootochhuti,	ছুটুচুটি,	ছুটোছুটি,	
manjushri,	মঞ্জুশরী,	মঞ্জুশ্রী,	
garora,	গারোরা,	গারোরা,	
muktijuddhojato,	মুক্তিযুদ্ধকতা,	মুক্তিযুদ্ধজাত,	
atwabishvashi,	অত্ববিশোষা,	আত্মবিশ্বাসী,	
chalake,	চালাকে,	চালকে,	
matorom,	মাতোম,	মাতরম,	
sift,	সিফটট,	শিফট,	
poddhotiteyi,	পদ্ধতিতেই,	পদ্ধতিতেই,	
taunasipa,	তৌনসিপা,	টাউনশিপ,	
meshmeshya,	মেশমেশ্য,	মেশহমেশহিইয়া,	
agaldar,	আগাদর,	আগলদার,	
scholastic,	স্কোলাসটিক,	স্কলাস্টিক,	
airish,	আইরিশ,	আইরিস,	
boiporiityen,	বৈপরিয়িতেন,	বৈপরীত্যেন,	
krus,	ক্রুস,	ক্রুশ,	
shishu,	শিশু,	শিশু,	
shommotir,	সম্মটির,	সম্মতির,	
lobbytey,	লবিিটে,	লবিতে,	
pathanatak,	পাঠানাটক,	পথনাটক,	
saras,	সারাস,	সরস,	
parikha,	পরিখ,	পরিখার,	
qonfliqt,	কনফ্লিক্ট,	কনফ্লিক্ট,	
bhaandar,	ভান্ডার,	ভাণ্ডার,	
nanabornobishishto,	নানাবর্ণবিশিষ্ট,	নানাবর্ণবিশিষ্ট,	
kram,	ক্রম,	ক্রম,	
prithibir,	পৃথিবীর,	পৃথবীর,	
saraiki,	সারাইকী,	সরাইকি,	
jaubankal,	যৌবনকল,	যৌবনকাল,	
prabhritite,	প্রভৃতিতে,	প্রভৃতিতে,	
tuni,	তুনি,	টুনি,	
pranidero,	প্রাণীদেরও,	প্রানীদেরও,	
debeting,	দেবেতিং,	ডিবেটিং,	
alraji,	আলরাজি,	আলরাজী,	
timathi,	টিমাথি,	টিমোথি,	
bhogiroth,	ভোগীরথ,	ভগীরথ,	
osommotite,	অসম্মতিতে,	অসম্মতি,	
jeher,	জেহের,	জেহের,	
ebhara,	এভারা,	এভার,	
iling,	ইলিং,	ইলিং,	
alankorana,	আলনকারনা,	অলঙ্করণ,	
bhutbhut,	ভূটভূত,	ভুটভুট,	
nirmolota,	নির্মলতা,	নির্মলতা,	
dojo,	দজো,	ডোজো,	
arke,	আরকে,	আরকে,	
cooda,	কোডা,	কোডা,	
samaveshke,	সমাভেষকে,	সমাবেশকে,	
dharmee,	ধর্মী,	ধর্মী,	
gate,	গাট,	গ্যেটে,	
shoreefer,	শরীফর,	শরিফের,	
rupert,	রুপার্ট,	রুপার্ট,	
dhaleshorii,	ধলেশরী,	ধলেশ্বরী,	
sossar,	সোসার,	সকার,	
anchalgoolir,	অঞ্চলগুলির,	অঞ্চলগুলির,	
lutharan,	লুথারান,	লুথেরান,	
dorneca,	ডর্নেকা,	ডরনেকা,	
digrir,	ডিগ্রির,	ডিগ্রির,	
samajikatar,	সমাজিকতার,	সামাজিকতার,	
dhos,	ধ্যাস,	ধস,	
nikote,	নিকোতে,	নিকটে,	
oncholgulir,	অঞ্চলগুলির,	অঞ্চলগুলির,	
shotodha,	শতধা,	শতধা,	
kakhnoba,	কাখনবা,	কখনওবা,	
chalachchitroke,	চলচ্চিত্রকে,	চলচ্চিত্রকে,	
shikkharthirao,	শিক্ষার্থীরাও,	শিক্ষার্থীরাও,	
prasadhoner,	প্রাাধনের,	প্রসাধনের,	
ekla,	একলা,	একলা,	
daybhager,	দয়াভাগের,	দায়ভাগের,	
esoosiyetasa,	এনোসিয়েটসস,	এসোসিয়েটস,	
durgatsober,	দুর্গাতবের,	দুর্গোৎসবে,	
nibirbhabe,	নিবীরভাবে,	নিবিরভাবে,	
landey,	ল্যান্ডে,	ল্যান্ডে,	
nirgaman,	নির্গমন,	নির্গমন,	
jacksonke,	জ্কাসনকে,	জ্যাকসনকে,	
dijmarescu,	দিজমেরাসকু,	দিজমার্সাকু,	
apad,	অপাদ,	আপদ,	
chhuteete,	ছুটিতে,	ছুটিতে,	
siddhanter,	সিদ্ধান্তের,	সিদ্ধান্তের,	
kaia,	কাইয়া,	কায়া,	
taigara,	টাইগারা,	টাইগার,	
temonbhabe,	তেমনভাবে,	তেমনভাবে,	
ixprission,	এক্সপ্রিশন,	এক্সপ্রেশন,	
qarpeta,	কারপেটা,	কার্পেট,	
bedey,	বেদে,	বেদে,	
balatkar,	বালাতকর,	বলাৎকার,	
harbore,	হারবোরে,	হারবারে,	
ukeliptash,	উকিলপিপাাশ,	ইউক্যালিপ্টাস,	
shansthaner,	শানস্থানের,	সংস্থানের,	
footbalarer,	ফুটবলারের,	ফুটবলারের,	
jerusalema,	জেরুসালেমা,	জেরুসালেম,	
valobase,	ভালোবাসে,	ভালোবাসে,	
chetanagoto,	চেতনাগত,	চেতনাগত,	
cheess,	চিস,	চেস,	
bhabarlaler,	ভাবারলালের,	ভবরলালের,	
louhojato,	লৌহজাত,	লৌহজাত,	
highcommissionay,	হাইকমমসিসনা,	হাইকমিশনে,	
kekru,	কেকরু,	কেকরু,	
lyataa,	ল্যাট,	ল্যাটা,	
dep,	ডিপ,	ডেপ,	
pleena,	প্লিন,	প্লেন,	
rca,	আরএসকা,	আরসিএ,	
licencedhari,	লাইসেন্ডধারী,	লাইসেন্সধারী,	
tecnokret,	টেকনোক্রেট,	টেকনোক্র্যাট,	
hames,	হেমস,	হোমস,	
timoothi,	তিমোথু,	টিমোথি,	
gondogol,	গণ্ডগোল,	গন্ডগোল,	
sharthe,	শার্থে,	স্বার্থে,	
dera,	দেরা,	ডেরা,	
songasthaner,	সংস্থানের,	সংস্থানের,	
poriharsoho,	পরিহারসহ,	পরিহারসহ,	
corymb,	করিইব্ব,	করিম,	
shikshakrom,	শিক্ষাক্রম,	শিক্ষাক্রম,	
balokarak,	বালকারক,	বলকারক,	
ghotleyo,	ঘটলেও,	ঘটলেও,	
miitar,	মিতার,	মিত্র,	
gunje,	গুঞ্জে,	গুঁজে,	
chandil,	চণ্ডিল,	চান্ডিল,	
upobasee,	উপবাসী,	উপবাসী,	
spenser,	স্পেন্সের,	স্পেন্সার,	
gardeen,	গার্দিন,	গার্ডেন,	
brittakar,	বৃত্তকার,	বৃত্তাকার,	
tachnach,	তাচনাচ,	তছনছ,	
faaj,	ফাজ,	ফাজ,	
temone,	তেমনে,	তেমনই,	
qarqa,	কররকা,	কার্ক,	
mele,	মেলি,	মাইল,	
tolemyr,	টোলেমির,	টলেমির,	
bagicha,	বাগিচা,	বাগিচা,	
informetion,	ইনফর্েশন,	ইনফরমেশন,	
phutonta,	ফুটন্টা,	ফুটন্ত,	
kichutei,	কিছুতেই,	কিছুতেই,	
huqa,	হুক,	হুক,	
udvabani,	উদ্ভাবনি,	উদ্ভাবনী,	
longhan,	লঙ্ঘান,	লংঘন,	
vushito,	বুশীত,	ভূষিত,	
holding,	হোলডিং,	হোল্ডিং,	
argho,	অর্ঘ,	অর্ঘ্য,	
flux,	ফ্লাক্স,	ফ্লাস্ক,	
utsahi,	উৎসহী,	উৎসাহী,	
sikkharrtheerao,	শিক্ষার্থীরারাও,	শিক্ষার্থীরাও,	
punosthaner,	পুনস্থানের,	পুনঃস্থানের,	
vodqa,	ভোডকা,	ভদকা,	
hupile,	হুপিলে,	হুপিলে,	
tophaat,	তোফাত,	তফাৎ,	
tinage,	তিনাজে,	টিনেজ,	
gyandaas,	জ্ঞানদাস,	জ্ঞানদাস,	
sadeep,	সাদীপ,	সদীপ,	
adhunikkaley,	আধুনিকাকলে,	আধুনিককালে,	
palteche,	পাল্টেছে,	পাল্টেছে,	
chakurijibirao,	চাকুরীজীবীরাও,	চাকুরীজীবীরাও,	
oswastikor,	অস্বাস্তিকর,	অস্বস্তিকর,	
shangsthaner,	শাংস্থানের,	সংস্থানের,	
gaje,	গেজ,	গেজ,	
krush,	ক্রুশ,	ক্রুশ,	
ganohotyake,	গণহত্যাকে,	গণহত্যাকে,	
manir,	মানির,	মনির,	
transhapharma,	ট্রান্শার্মা,	ট্রান্সফর্ম,	
paripakey,	পারিপাকে,	পরিপাকে,	
ekok,	একক,	একক,	
jati,	জাতি,	যাতি,	
sanaktakaran,	সনক্তকরণ,	সনাক্তকরণ,	
difinisian,	ডিফিনিসিয়ান,	ডেফিনেশন,	
kurdider,	কুরদদিদের,	কুর্দিদের,	
jatotaa,	যাততা,	যতোটা,	
anyarup,	অন্যরূপ,	অন্যরূপ,	
adhyatmikata,	আধ্যাত্মিকতা,	আধ্যাত্মিকতা,	
rudrasagar,	রুদ্রসাগর,	রুদ্রসাগরের,	
tiuning,	টিউনিং,	টিউনিং,	
madrasake,	মাদ্রাসাকে,	মাদ্রাসাকে,	
kinenni,	কিনেননি,	কিনেননি,	
senior,	সেনিওর,	সিনিয়র,	
vaisoho,	ভাইসহ,	ভাইসহ,	
qulim,	কুলিম,	কুলিং,	
moshahidur,	মোশাহিদুর,	মোশাহিদুর,	
natshi,	নাটশি,	নাত্সি,	
niharkantibabu,	নীহারকান্তবাবু,	নিহারকান্তিবাবু,	
udyem,	উদ্যেম,	উদ্যেম,	
konroop,	কনরূপ,	কোনরূপ,	
muradpur,	মুরাদপুর,	মুরাদপুর,	
lampot,	লম্পট,	লম্পট,	
perry,	পেরি,	পেরি,	
gorjon,	গর্যন,	গর্জন,	
shommoteer,	সম্মতির,	সম্মতির,	
oshtader,	অষ্টাদের,	ওস্তাদের,	
ghoomachhe,	ঘোমচছছে,	ঘুমাচ্ছে,	
shhepha,	শেফা,	শেফ,	
milekhanek,	মিলেখানেক,	মাইলখানেক,	
durgotshob,	দুর্গোৎভব,	দুর্গোৎসব,	
afrazuler,	আফরাজুলের,	আফরাজুলের,	
chopol,	চপোল,	চপল,	
taateo,	তাঁতেও,	তাতেও,	
bhushito,	ভুষিত,	ভূষিত,	
goora,	গুরা,	গোর,	
bhadaka,	ভাদাকা,	ভদকা,	
steen,	স্টীন,	স্টেন,	
graambaashee,	গ্রামবাশী,	গ্রামবাসী,	
uttor,	উত্তর,	উওর,	
forma,	ফরমা,	ফর্মা,	
pingna,	পিংংা,	পিংনা,	
manabmaner,	মানবমনের,	মানবমনের,	
shahabike,	শাহাবীকে,	সাহাবীকে,	
superheiroo,	সুপারহিরোও,	সুপারহিরো,	
dantahin,	দন্তাহীন,	দন্তহীন,	
anichchi,	অনিচ্ছি,	আনিচ্ছি,	
nothivookta,	নথিভক্ত,	নথিভুক্ত,	
nirbachokder,	নির্বাচকদের,	নির্বাচকদের,	
zoubankal,	যৌবনকাল,	যৌবনকাল,	
bagdad,	বাগডাদ,	বাগদাদে,	
steeit,	স্টিট,	স্টেইট,	
shloker,	শ্লোকের,	শ্লোকের,	
barrageke,	বারাগেকে,	ব্যারেজকে,	
khali,	খালি,	খালি,	
prarthitao,	প্রার্থীতাও,	প্রার্থীতাও,	
dhanyi,	ধনই,	ধন্যি,	
shoriph,	শরিফ,	শরিফ,	
sarbhare,	সারভারে,	সার্ভারে,	
mitrata,	মিত্রতা,	মিত্রতা,	
binee,	বিনই,	বেনি,	
jontrangshogulor,	যন্ত্রাংশগুলোর,	যন্ত্রাংশগুলোর,	
ched,	চেদ,	ছেদ,	
nothiboddho,	নথিবদ্ধ,	নথিবদ্ধ,	
daltyagi,	দা্ত্যাগী,	দলত্যাগী,	
shasankarta,	শাসনকর্তা,	শাসনকর্তা,	
remakri,	রিমাক্রি,	রেমাক্রী,	
manushgulor,	মানুষগুলোর,	মানুষগুলোর,	
folleni,	ফলেনি,	ফলেনি,	
sikkhakbrinda,	শিক্ষাবৃন্দ,	শিক্ষকবৃন্দ,	
uchchotara,	উচ্চতারা,	উচ্চতর,	
nabbata,	নব্বতা,	নাব্যতা,	
dola,	দোলা,	দলা,	
saifai,	সাইফাই,	সাইফাই,	
deep,	দীপ,	দীপ,	
dumaa,	ডুমা,	দুমা,	
bheenisa,	ভীনিসা,	ভেনিস,	
graambasio,	গ্রামবাসিও,	গ্রামবাসীও,	
aprasangikbhabei,	অপ্রসংগীকভাবেই,	অপ্রাসঙ্গিকভাবেই,	
otyacharer,	অত্যাচারের,	অত্যাচারের,	
pragreesa,	প্রাগ্রিসা,	প্রগ্রেস,	
sushposhtolikhito,	সুষ্পস্থলিিত,	সুষ্পষ্টলিখিত,	
maudelder,	মাউদেলদের,	মডেলদের,	
jolaatonko,	জলাাতকনো,	জলাতঙ্ক,	
kiandi,	কিয়ান্দি,	ক্যান্ডি,	
ghotolen,	ঘটলেন,	ঘটলেন,	
ekspression,	এক্সপ্রেশন,	এক্সপ্রেশন,	
vugorvey,	ভুগর্ভে,	ভূগর্ভে,	
suisharke,	সুইশারকে,	সুইশারকে,	
choopi,	চুপি,	চুপি,	
ciima,	সিয়ামা,	সীমা,	
dhaleshwari,	ধলেশ্বরী,	ধলেশ্বরী,	
dibate,	দিবাতে,	ডিবেট,	
brindabane,	বৃন্দাবানে,	বৃন্দাবনে,	
bisheshshyo,	বিশেষ্য,	বিশেষ্য,	
geja,	গেজা,	গেজ,	
agomone,	আগোমোন,	আগমনে,	
dupleks,	ডুপ্লেক্স,	ডুপ্লে,	
reshidensha,	রেশিডেনশা,	রেসিডেন্স,	
auttacharer,	অট্টাচারের,	অত্যাচারের,	
jetam,	জেতম,	যেতাম,	
bangobandhu,	বঙ্গবন্ধুই,	বঙ্গবন্ধু,	
tonoo,	তনো,	তনু,	
capsule,	ক্যাপসুল,	ক্যাপ্সুল,	
khudrokar,	ক্ষুদ্রকর,	ক্ষুদ্রকার,	
chetanagato,	চেতনাগত,	চেতনাগত,	
chikitsar,	চিকিৎসার,	চিকিত্সার,	
bhabaponno,	ভাবাপন্ন,	ভাবাপন্ন,	
naraphoka,	নাফারোকা,	নরফোক,	
mulyayonsapekkhe,	মূল্যায়সানরচ্ষে,	মূল্যায়নসাপেক্ষে,	
turbine,	টারবাইন,	টারবাইন,	
gobeshana,	গবেষণা,	গবেষনা,	
musallati,	মুসল্লতি,	মুসল্লাটি,	
obdi,	ওব্ি,	অব্দি,	
euqalyptus,	ইউক্যাপিলাস,	ইউক্যালিপ্টাস,	
qyapasula,	ক্যাপাসুলা,	ক্যাপসুল,	
ateetkale,	আতিককালে,	অতীতকালে,	
laishenshim,	লুশশনিিি,	লাইসেন্সিং,	
shahidputra,	শহিদপুত্র,	শহীদপুত্র,	
torkarir,	তরকারির,	তরকারীর,	
progresh,	প্রগ্রেশ,	প্রগ্রেস,	
arthonitir,	অর্থনীতির,	অর্থনীতির,	
neerbahe,	নির্বাহে,	নির্বাহে,	
dibug,	দিবুগ,	ডিবাগ,	
aviyojan,	অভিযোজন,	অভিযোজন,	
phaltu,	ফালটু,	ফালতু,	
bishwaashshoi,	বিশ্বাশশি,	বিশ্বাসই,	
ritesh,	রিতশশ,	রিতেশ,	
bolvodro,	বলভোর্ডো,	বলভদ্র,	
graambaaseeder,	গ্রামবাসীদের,	গ্রামবাসীদের,	
kk,	কেক,	কেকে,	
pleto,	প্লেটো,	প্লেটো,	
ooipoka,	উইপোকা,	উইপোকা,	
marry,	ম্যারি,	ম্যারি,	
eporzonto,	এপর্যন্ত,	এপর্যন্ত,	
doloo,	দলু,	ডলু,	
horas,	হোরাস,	হোরাস,	
taronee,	তরণী,	তরণী,	
change,	চ্য্ঞে,	চেঞ্জ,	
guzon,	গুজন,	গুজব,	
torunderke,	তরুণদারকে,	তরুণদেরকে,	
lungiti,	লুংগিটি,	লুঙ্গিটি,	
dephinishion,	ডেফিনিশন,	ডেফিনেশন,	
dhonni,	ধন্নী,	ধন্যি,	
shtona,	স্তোনা,	স্টোন,	
khalidke,	খালিদকে,	খালিদকে,	
nikela,	নিকেলা,	নিকেল,	
bhittimul,	ভিত্তিমূল,	ভিত্তিমূল,	
gandhiio,	গান্ধীও,	গান্ধীও,	
kompeeto,	কম্পিট,	কম্পিত,	
habsi,	হাবসি,	হাবশী,	
oikhan,	ঐখ়ান,	ঐখান,	
manab,	মানব,	মানব,	
deciliter,	ডিসিলিটার,	ডেসিলিটার,	
pader,	পাডার,	প্যাডের,	
shkalarashhipa,	স্কলাররীশা,	স্কলারশিপ,	
durgatsob,	দুর্গাতব,	দুর্গোৎসব,	
municipal,	মুনিসিপাল,	মিউনিসিপ্যাল,	
jathartho,	যথার্থ,	যথার্থ,	
chhanada,	ছানাডা,	ছানাদা,	
lekhaksattwar,	লেখকসত্ত্বার,	লেখকসত্ত্বার,	
bbiswash,	ব্বিসবাহ,	বিশ্বাস,	
assexe,	অ্যাসেক্সে,	অ্যাসেক্সে,	
rayyalati,	রায়লললটি,	রয়্যালটি,	
bhittow,	ভিট্ট,	ভিত্তিও,	
samajeek,	সমজিক,	সামাজিক,	
fostar,	ফোস্টার,	ফস্টার,	
chalchhe,	চালছে,	চলছে,	
firti,	ফিরটি,	ফিরতি,	
lambaate,	লম্বেে,	লম্বাটে,	
abanishankar,	অবনিশঙ্কর,	অবনিশংকর,	
suparahiro,	সুপরহারীো,	সুপারহিরো,	
ashok,	আশক,	আশোক,	
opohoron,	অপহরণ,	অপহরন,	
ronodeep,	রণদীপ,	রণদীপ,	
conflict,	কনফ্লিক্ট,	কনফ্লিক্ট,	
makhno,	মাখনো,	মাখনো,	
ekbakke,	একবাককে,	একবাক্যে,	
artilary,	আর্তিলারি,	আর্টিলারি,	
govindarajan,	গোবিন্দরাজন,	গোবিন্দরাজন,	
dijijer,	ডিজিজের,	ডিজিজের,	
mataram,	মাতারাম,	মাতরম,	
sombhobonao,	সম্ভবনাও,	সম্ভবনাও,	
siddhante,	সিদ্ধান্তে,	সিদ্ধান্তে,	
chasee,	চেসি,	চেস,	
plainey,	প্লেইনি,	প্লেনে,	
nothivuktir,	নথিভুক্তির,	নথিভুক্তির,	
obhaarbhiu,	অভারভিউ,	ওভারভিউ,	
chilona,	চিলোনা,	ছিলনা,	
mukhyo,	মুখ্য,	মুখ্য,	
phokser,	ফকসের,	ফক্সের,	
angshogrohon,	অংশগ্রহণ,	অংশগ্রহন,	
swostir,	স্বস্তির,	স্বস্তির,	
biplabeer,	বিপ্লবীর,	বিপ্লবীর,	
priseflex,	প্রিফেল্স্ক্,	প্রাইজফ্লেক্স,	
ohalyar,	ওহল্লার,	অহল্যার,	
charpanch,	চরপাঞ্চ,	চারপাঁচ,	
bhabotarini,	ভবতারিণী,	ভবতারিণী,	
chheher,	ছেহের,	ছেহের,	
duhsthanostho,	দুঃস্থানস্থ,	দুঃস্থানস্থ,	
hena,	হেনা,	হেনা,	
emerjency,	ইমিউজ্রেস্,	এমার্জেন্সি,	
darji,	দার্জি,	দরজি,	
horiddare,	হরিদদারে,	হরিদ্বারে,	
noditir,	নদিটির,	নদীটির,	
hoondayi,	হুঁদপায়ি,	হুন্দাই,	
byapoktor,	ব্যাপকক্তর,	ব্যাপকতর,	
kanasarabheeshana,	কাসাসররীনন,	কনসারভেশন,	
hooldim,	হুল্ডিম,	হোল্ডিং,	
satan,	সাতান,	শয়তান,	
breqathru,	ব্রেকথারু,	ব্রেকথ্রু,	
mahakabi,	মহাকাবি,	মহাকবি,	
batsmanei,	ব্যাটম্যান্নে,	ব্যাটসম্যানই,	
oitijje,	ঐতিহ্যে,	ঐতিহ্যে,	
drishyer,	দৃশ্যের,	দৃশ্যের,	
manatmulak,	মানতমূলক,	মানতমূলক,	
rajbandi,	রাজবন্দী,	রাজবন্দী,	
melbourner,	মেলবোর্নের,	মেলবোর্নের,	
francine,	ফ্রানসিন,	ফ্রান্সিন,	
amiretus,	আমিরিতস,	এমিরেটাস,	
degree,	ডিগ্রি,	ডিগ্রি,	
taatey,	তাযাটে,	তাতে,	
disposes,	ডিস্পোস,	ডিসপোজেস,	
wictor,	উইচটোর,	ভিক্টর,	
janghu,	জাংহু,	জঙ্ঘু,	
brojomohun,	ব্রজমহুন,	ব্রোজোমোহন,	
buddhitii,	বুদ্ধিতিই,	বুদ্ধিটিই,	
hank,	হ্যাঙ্ক,	হাঙ্ক,	
shahanara,	শাহানারা,	শাহানারা,	
osoborno,	অসবর্ণ,	অসবর্ণ,	
shringa,	শ্রিংগা,	শৃঙ্গ,	
utsahamulak,	উৎসাহমূলক,	উৎসাহমূলক,	
casper,	ক্যাসপার,	ক্যাসপার,	
kaale,	কালে,	কালে,	
duburir,	ডুবুরির,	ডুবুরির,	
sqolastiq,	স্কোলাসটিক,	স্কলাস্টিক,	
bojhe,	বোঝে,	বোঝে,	
teamothy,	টিমোথি,	টিমোথি,	
awrbit,	অরবাইট,	অরবিট,	
poste,	পস্তে,	পোস্টে,	
bhogno,	ভগ্ন,	ভগ্ন,	
eeksapreeshana,	এক্সপ্রেশিন,	এক্সপ্রেশন,	
treebhuj,	ত্রিভুজ,	ত্রিভূজ,	
koyekbare,	কয়েকবারে,	কয়েকবারে,	
internship,	ইন্টারনশিপ,	ইন্টার্নশিপ,	
ultrasonography,	আল্ট্রোসংগ্রাফি,	আলট্রাসনোগ্রাফিও,	
nodiiteyi,	নদীয়েই,	নদীতেই,	
rahee,	রাহে,	রাহী,	
prokolpotike,	প্রকল্পটিকে,	প্রকল্পটিকে,	
gaandaas,	গান্দাস,	জ্ঞানদাস,	
wrighter,	অৃগ্যার,	রাইটের,	
supparak,	সুপপর্ক,	সুপ্পারক,	
israelbahini,	ইসরায়েলবিহীনি,	ইস্রায়েলবাহিনী,	
eigulor,	এইগুলোর,	এইগুলোর,	
daebug,	ডাইববুগ,	ডিবাগ,	
charukala,	চারুকালা,	চারুকলা,	
toroonra,	তরৌরা,	তরুণরা,	
madhobeer,	মাধবীর,	মাধবীর,	
gamdan,	গামদান,	গামদান,	
gujob,	গুজব,	গুজব,	
carlos,	কারলোস,	কার্লোস,	
dombhoke,	দম্ভকে,	দম্ভকে,	
cocaine,	কোকেইন,	কোকেইন,	
maailkhanek,	মেইলখানেক,	মাইলখানেক,	
jones,	জোনস,	জোন্স,	
bossoben,	বস্বেন,	বসবেন,	
daaktikit,	ডাক্তিকটি,	ডাকটিকিট,	
chalachchitroi,	চলচ্চিত্রই,	চলচ্চিত্রই,	
starker,	স্টারকার,	স্টার্কের,	
aaziz,	আজিজ,	আজিজ,	
labonaaktotaar,	লবণকা্ততর,	লবণাক্ততার,	
fasi,	ফ্যাসি,	ফাঁসী,	
kushumba,	কুশুম্বা,	কুশুম্বা,	
bulichev,	বুলিচেভ,	বুলিচেভ,	
rohosyo,	রহস্য,	রহস্য,	
talgach,	তালগাছ,	তালগাছ,	
purple,	পুরপলে,	পার্পেল,	
jahangirbad,	জাহাঙ্গীরবাদ,	জাহাঙ্গীরবাদ,	
bhenkates,	ভেঙ্কাটস,	ভেঙ্কটেশ,	
uqeliptas,	ইউকিলপিটাস,	ইউক্যালিপ্টাস,	
laaishheshh,	লয়শেষ,	লাইসেন্স,	
nabayug,	নবায়ুগ,	নবযুগ,	
paroner,	প্রণের,	পারণের,	
koordider,	কোরদীদের,	কুর্দিদের,	
bifol,	বিফোল,	বিফল,	
proshtutkarok,	প্রশ্তুতকারক,	প্রস্তুতকারক,	
noditei,	নদিতেই,	নদীতেই,	
dooburir,	দুবুরুর,	ডুবুরির,	
bm,	বিএম,	বিএম,	
sikarer,	সিকারের,	শিকারের,	
kutubuddinke,	কুটুবুদ্দিনকে,	কুতুবুদ্দিনকে,	
manibhaijaner,	মানিভাইজনের,	মণিভাইজানের,	
bostubad,	বস্তুবাদ,	বস্তুবাদ,	
pratijogira,	প্রতিযোগীরা,	প্রতিযোগীরা,	
ispredsiit,	ইস্্রেডিসিট,	স্প্রেডশীট,	
anisa,	আনিসা,	আনিস,	
mathews,	ম্যাথেউস,	ম্যাথিউস,	
qonflict,	কনফ্লিক্ট,	কনফ্লিক্ট,	
biswashi,	বিশ্বাসী,	বিশ্বাসী,	
rachanakal,	রচনাকাল,	রচনাকাল,	
porishongkhanbid,	পরিশংখ্যানবিদ,	পরিসংখ্যানবিদ,	
durotamo,	দুরতমম,	দূরতম,	
chadake,	চড়াকে,	চড়াকে,	
sarbhaarti,	সার্ভারটি,	সার্ভারটি,	
ernad,	এরনাদ,	এরনাড,	
godamjato,	গদাাজামো,	গুদামজাত,	
swadhinotatukui,	স্বাধীনতাটুকুই,	স্বাধীনতাটুকুই,	
echhti,	এচতি,	এছটি,	
mukherjee,	মুখের্জি,	মুখার্জী,	
homsher,	হোমশের,	হোমসের,	
narsaari,	নারসারী,	নার্সারি,	
fulkapi,	ফুলকাপি,	ফুলকপি,	
shikhra,	শিখরা,	শিখরা,	
bikromei,	বিক্রমেই,	বিক্রমেই,	
khuliechilam,	খুলিয়াছিলাম,	খুলিয়েছিলাম,	
gej,	গেজ,	গেজ,	
protijogii,	প্রতিযোগী,	প্রতিযোগী,	
kraim,	ক্রেইম,	ক্রাইম,	
gaddaphii,	গাদ্দাফি,	গাদ্দাফী,	
palbongsher,	পালবংশের,	পালবংশের,	
nagorikota,	নাগোরিকোটা,	নাগরিকতা,	
konorup,	কোনরূপ,	কোনরূপ,	
tirmijii,	তির্মিজি,	তিরমিজি,	
faskari,	ফাসকারী,	ফাঁসকারী,	
narbur,	নারবুর,	নরবুর,	
bitlaser,	বিটলাসের,	বিটলসের,	
elakai,	এলাকাই,	এলাকাই,	
sikara,	সিকারা,	শিকার,	
siddhantoke,	সিদ্ধান্তকে,	সিদ্ধান্তকে,	
shekarone,	শেকারোন,	সেকারণে,	
thare,	থার,	থরে,	
mast,	মসস্ট,	মাস্ত,	
photanor,	ফোটানোর,	ফোটানোর,	
kushakhali,	কুশাখালি,	কুশাখালি,	
manushera,	মানুষেরা,	মানুষেরা,	
terlarang,	টেরেলাং,	তেরলারং,	
proshikkhane,	প্রশিক্ষানে,	প্রশিক্ষণে,	
arshie,	আরশী,	আরসিএ,	
amorendro,	অমরেন্দ্র,	অমরেন্দ্র,	
vaider,	ভাইদের,	ভাইদের,	
ghumachche,	ঘুমাচ্ছে,	ঘুমাচ্ছে,	
pachchi,	পাচ্ছি,	পাচ্ছি,	
satyaky,	সত্যকি,	সাত্যকি,	
hights,	হাইটস,	হাইটস,	
ceramicer,	সেরামিসের,	সিরামিকের,	
redcrosser,	রেডক্রোসের,	রেডক্রসের,	
eshtonia,	সস্তোনিয়া,	এস্তোনিয়া,	
hindutirtha,	হিন্দুতৃর্থ,	হিন্দুতীর্থ,	
goodamjato,	গৌডামাজত,	গুদামজাত,	
cholchhe,	চলছে,	চলছে,	
abadamoner,	অবাদামনের,	অবদমনের,	
sotorkobhabey,	সতর্কভাবে,	সতর্কভাবে,	
bangulzai,	বানগুল্জা,	বঙ্গুলিজাই,	
ronangane,	রোনাঙ্গনে,	রণাঙ্গনে,	
chuti,	চুটি,	ছুটি,	
bhromonkaale,	ভ্রমণকালে,	ভ্রমণকালে,	
laaisensh,	লেইসেন্স,	লাইসেন্স,	
average,	এভারেজ,	এভারেজ,	
uddhritto,	উদ্ধৃত্ত,	উদ্ধৃত,	
diiptii,	দিওপটিই,	ডেপুটি,	
cholechi,	চলেছি,	চলেছি,	
akkheperi,	আক্ষেপেরই,	আক্ষেপেরই,	
prothakey,	প্রথাকে,	প্রথাকে,	
shumo,	শুমো,	সুমো,	
shiropar,	শিরোপার,	শিরোপার,	
suparichiti,	সুপারিচিতি,	সুপরিচিতি,	
oncoleo,	অঙ্কলেও,	অঞ্চলেও,	
shresthoshcho,	শ্রেষ্ঠশ্চ,	শ্রেষ্ঠশ্চ,	
bujhechhila,	বুঝেছিল,	বুঝেছিল,	
balatarin,	বালাতারিন,	বালাতারিয়ান,	
jonesh,	জোনেশ,	জোন্স,	
kichudinpar,	কিছুদিনপর,	কিছুদিনপর,	
omarader,	ওমারাদের,	ওমারাদের,	
kul,	কুল,	কুল,	
gyandas,	জ্ঞানদাস,	জ্ঞানদাস,	
juboke,	যুবকে,	যুবকে,	
dei,	দেই,	দিই,	
zonsa,	জোনসা,	জোন্স,	
pharmesigulote,	ফার্মেসিগুলোতে,	ফার্মেসীগুলোতে,	
gronthao,	গ্রন্থাও,	গ্রন্থও,	
gronther,	গ্রন্থের,	গ্রন্থের,	
bo,	বোই,	বু,	
gonjona,	গন্জনা,	গঞ্জনা,	
sambhabonao,	সম্ভাবনাও,	সম্ভবনাও,	
ishahak,	ইশাহাক,	ইসাহাক,	
enamela,	এনামেলা,	এনামেল,	
niurolaji,	নিউরোলজি,	নিউরোলজি,	
mozdur,	মজদুর,	মজদুর,	
ramzaner,	রামজনের,	রমযানের,	
bandra,	বান্দ্রা,	বন্দীরা,	
bisheshyo,	বিশ্ষুয,	বিশেষ্য,	
uponeesoder,	উপনেসদের,	উপনিষদের,	
diibug,	দিববুগ,	ডিবাগ,	
mercial,	মার্সিয়াল,	মার্শিয়াল,	
leaders,	লিডার্স,	লিডার্স,	
shuchonakal,	শূচনাকাল,	সূচনাকাল,	
grootha,	গ্রুথ,	গ্রোথ,	
edaning,	এডানিং,	ইদানিং,	
konagoolo,	কানাগুলো,	কণাগুলো,	
dighol,	দিঘোল,	দীঘল,	
eevil,	ইইভিল,	ইভিল,	
akhandata,	অখণ্ডটা,	অখণ্ডতা,	
dankaan,	দানকান,	ডানকান,	
proboleme,	প্রবলেমে,	প্রবলেমে,	
bhogni,	ভগ্নি,	ভগ্নী,	
ekbakye,	একবাক্যে,	একবাক্যে,	
dorgah,	দোরগাহ,	দরগাহ,	
yathaarthabhaabe,	রথখথতরভাবে,	যথার্থভাবে,	
husni,	হুসনি,	হুসনি,	
jatata,	জাতাতা,	যতোটা,	
tongaa,	টোনগা,	টোঙ্গা,	
heteler,	হেটেলের,	হেটেলের,	
roktokhoron,	রক্তকরন,	রক্তক্ষরণের,	
prajanankal,	প্রজাননকল,	প্রজননকাল,	
sangram,	সাংরাম,	সঙ্গ্রাম,	
messengerer,	মেসেন্জারের,	মেসেঞ্জারের,	
elakaatite,	এলাকাটিতে,	এলাকাটিকে,	
akatwa,	আকত্ব,	একাত্ব,	
uposhthit,	উপশ্থিত,	উপস্থিত,	
pracharanamulak,	প্রচারণমূলক,	প্রচারণামূলক,	
ponera,	পনেরা,	পনের,	
oichchheek,	ঐচ্চিক,	ঐচ্ছিক,	
collaborators,	কলাবরেটরোস,	কলাবরেটরস,	
grambasheeo,	গ্রামবাশিও,	গ্রামবাসীও,	
sukumaree,	সুকুমারী,	সুকুমারী,	
harbur,	হারবুর,	হারবার,	
byabaharkareer,	ব্যবহারকারীর,	ব্যবহারকারীর,	
scholars,	স্কোলারস,	স্কলার্স,	
danata,	দানাটা,	ডোনাট,	
pet,	পেট,	পেত,	
ovarview,	ওভারভিই,	ওভারভিউ,	
pravura,	প্রভুরা,	প্রভুরা,	
modhumotii,	মধুমতিই,	মধুমতী,	
ancholsomuho,	অঙ্কলসমূহ,	অঞ্চলসমূহ,	
katui,	কাটুই,	কাতুই,	
jonoikaa,	জনৈকা,	জনৈকা,	
bhangle,	ভাঙ্গলে,	ভাঙলে,	
melborrone,	মেলবররনে,	মেলবোর্নে,	
peengna,	পিংগন,	পিংনা,	
vaibon,	ভাইবন,	ভাইবোন,	
deputy,	ডিপাাইটি,	ডেপুটি,	
nepchooner,	নেপচুনের,	নেপচুনের,	
firozapure,	ফিরোজাপুরে,	ফিরোজাপুরে,	
nariderke,	নারীদেরকে,	নারীদেরকে,	
jalbe,	জলবে,	জ্বলবে,	
jonmobhumitir,	জন্মভূমিটির,	জন্মভূমিটির,	
veenish,	ভিনিস,	ভেনিস,	
siima,	সিয়ামা,	সীমা,	
jamanataswarup,	জমানতস্বরূপ,	জামানতস্বরূপ,	
akheli,	আখেলি,	আখেলী,	
pratisthasaho,	প্রতিস্থাসহ,	প্রতিষ্ঠাসহ,	
shaahaabiike,	সাহাবাইকে,	সাহাবীকে,	
kyatagorir,	ক্যাটাগরির,	ক্যাটাগরির,	
chhutochhuti,	ছুটোছুটি,	ছুটোছুটি,	
reetesh,	রিটেশ,	রিতেশ,	
taposgoner,	তাপসগণের,	তাপসগণের,	
srk,	স্র্ক,	শাহরুখ,	
satarkakari,	সতর্ককারী,	সতর্ককারী,	
chaudhuriyo,	চৌধুরিয়ো,	চৌধুরীও,	
protijogiitamulok,	প্রতিযোগিতামূলক,	প্রতিযোগীতামূলক,	
rashedul,	রাশেদুল,	রাশিদুল,	
anandamahale,	আনন্দমহলে,	আনন্দমহলে,	
bonorajite,	বনরাজিতে,	বনরাজিতে,	
turbiner,	টারবাইনের,	টারবাইনের,	
krisenta,	ক্রিসেন্টা,	ক্রিসেন্ট,	
bishaashke,	বিশাশকে,	বিশ্বাসকে,	
bhuushito,	ভুউষিত,	ভূষিত,	
pacchi,	পাচ্চি,	পাচ্ছি,	
kalakushalir,	কলাকুশালীর,	কলাকুশলীর,	
zerusalemer,	জেরুসালেমের,	জেরুজালেমের,	
shalook,	শালুক,	শালুক,	
bowie,	বোবিই,	বওই,	
marpit,	মারপিট,	মারপিট,	
taunship,	তাওশিপ,	টাউনশিপ,	
manushti,	মনুষ্টি,	মানুষটি,	
agomonke,	আগমনকে,	আগমনকে,	
marketing,	মার্কেটিং,	মার্কেটিং,	
soceitytey,	সোচিটিইটে,	সোসাইটিতে,	
bouddho,	বৌদ্ধ,	বৌদ্ধ,	
potka,	পটকা,	পটকা,	
baibosthar,	বৈববস্থর,	ব্যবস্থার,	
proteemake,	প্রতিমাকে,	প্রতিমাকে,	
rahshahi,	রাহশাহী,	রাহশাহী,	
nagarikera,	নাগারিকেরা,	নাগরিকেরা,	
rilayensha,	রিলেয়েনশা,	রিলায়েন্স,	
joumana,	জৌমানা,	জুমানা,	
helloin,	হেলোইন,	হ্যালোইন,	
dwijenbabuder,	দ্বিজেনবাবুদের,	দ্বিজেনবাবুদের,	
hilser,	হিলসের,	হিলসের,	
kanshat,	কাঁশাট,	কানসাট,	
protishtan,	প্রতিষ্টান,	প্রতিষ্টান,	
chhatrodiger,	ছাত্রদিগের,	ছাত্রদিগের,	
modele,	মডেলে,	মডেলে,	
jomoker,	জমকের,	জমকের,	
nirabota,	নিরাবতা,	নিরবতা,	
hakone,	হাকোন,	হাকোনে,	
prasadhoni,	প্রাাধনী,	প্রসাধনী,	
moushumei,	মৌশুমেই,	মৌসুমেই,	
dagmukta,	ডাগমুক্তা,	দাগমুক্ত,	
kalirkhal,	কালীরখাল,	কালিরখাল,	
mmadhukkori,	ম্মাধুকররী,	মাধুকরী,	
bboponer,	ব্বপপের,	বপনের,	
lakshmir,	লক্ষ্মীর,	লক্ষ্মীর,	
dharavahikbhabe,	ধারাভাবিকভাবে,	ধারাবাহিকভাবে,	
tunaita,	তুনাইতা,	টুনাইট,	
battery,	ব্যাটারি,	ব্যাটারী,	
rajtantrey,	রাজতন্ত্রে,	রাজতন্ত্রে,	
mukhomandal,	মুখোমণ্ডল,	মুখমণ্ডল,	
klaud,	ক্লাউড,	ক্লাউড,	
rajotwo,	রাজত্ব,	রাজত্ব,	
laagche,	লাগছে,	লাগছে,	
roopmatro,	রূপমাত্র,	রূপমাত্র,	
aieesha,	আইশা,	আইএএস,	
chhutir,	ছুটির,	ছুটির,	
dolu,	দলু,	ডলু,	
daakten,	ডাঁকেতে,	ডাকতেন,	
saifullahil,	সৈইফুল্লাহ,	সাইফুল্লাহিল,	
kholdhular,	খোলধুলার,	খোলধূলার,	
laiseensee,	লাইসনন্স,	লাইসেন্স,	
oncholsomuho,	অন্চলসমূহ,	অঞ্চলসমূহ,	
bunot,	বুনোট,	বুনট,	
jounatar,	যৌনতার,	যৌনতার,	
eporjonto,	এপর্যন্ত,	এপর্যন্ত,	
laaz,	লাজ,	লাজ,	
asaktibandhan,	অসক্তিবন্ধন,	আসক্তিবন্ধন,	
matis,	মাতিস,	ম্যাটিস,	
sangharshik,	সংঘর্ষিক,	সাংঘর্ষিক,	
janar,	জানার,	জানার,	
zommu,	জোম্ু,	জম্মু,	
birmuktijoddhagan,	বির্মুক্তিদ্ধহগণ,	বীরমুক্তিযোদ্ধাগণ,	
chalochchitrei,	চলচ্চিত্রেই,	চলচ্চিত্রেই,	
jor,	জর,	জ্বর,	
porinoti,	পরিণটি,	পরিণতি,	
baugey,	বাউগে,	বাগে,	
saqara,	সাকারা,	সকার,	
aashanka,	আশানকা,	আশংকা,	
khappar,	খপ্পর,	খপ্পর,	
rajtontre,	রাজতন্ত্রে,	রাজতন্ত্রে,	
vishnuu,	বিষ্ণু,	বিষ্ণু,	
nodimatrik,	নদীমাত্রিক,	নদীমাতৃক,	
shikshagata,	শিক্ষাগত,	শিক্ষাগত,	
scholarsip,	স্কলারিস,	স্কলারশিপ,	
shamshere,	শামশেরে,	শমসের,	
perri,	পেরী,	পেরি,	
abhirupbabuke,	অভিরুপবাবুকে,	অভিরূপবাবুকে,	
milton,	মিলটন,	মিলটন,	
khabarsoho,	খাবারসহ,	খাবারসহ,	
mohajote,	মহাজতে,	মহাজোট,	
phuda,	ফুদা,	ফুড,	
bhiktara,	ভিক্তারা,	ভিক্টর,	
shite,	শিতে,	শীতে,	
inafarameshana,	ইনফফর্মেশন,	ইনফরমেশন,	
siraju,	সিরাজু,	সিরাজু,	
bharatey,	ভারতে,	ভারতে,	
madelim,	মাদেলিম,	মডেলিং,	
suri,	সুরী,	সুরি,	
atmobonchito,	আত্মবঞ্চিত,	আত্মবঞ্চিত,	
gobeshakgon,	গবেষকগণ,	গবেষকগণ,	
rinattak,	ঋণত্তক,	ঋনাত্মক,	
ghenshei,	ঘেঁশেই,	ঘেঁষেই,	
nutunotto,	নুতুনত্ব,	নতুনত্ব,	
kaathhaamaandu,	কাঠামান্নু,	কাঠমান্ডু,	
parisankhanvid,	পরিসংখ্যানবি,	পরিসংখ্যানবিদ,	
promothesh,	প্রমথেছ,	প্রমথেশ,	
lambi,	ল্যামবি,	লম্বি,	
poorohitra,	পুরহীত্রা,	পুরোহিতরা,	
hunine,	হুনাইন,	হুনাইন,	
bamni,	বামনি,	বামনী,	
erokomer,	এরকমের,	এরকমের,	
peterke,	পেটারকে,	পিটারকে,	
deefinision,	ডিফিনিসন,	ডেফিনেশন,	
sofie,	সোফি,	সোফি,	
shrabastee,	শ্রাবস্তি,	শ্রাবস্তী,	
wagadada,	ওয়াগাদাদা,	বাগদাদ,	
jipiusamriddha,	জিপিউসাহুদ্ধ,	জিপিউসমৃদ্ধ,	
jerushalema,	জেরুশালামা,	জেরুসালেম,	
bondiira,	বন্ডিয়ারা,	বন্দীরা,	
fake,	ফাকে,	ফাকে,	
protishta,	প্রতিষ্ট,	প্রতিষ্টা,	
grontho,	গ্রন্থ,	গ্রন্থ,	
tateo,	তাতেও,	তাতেও,	
qirq,	কির্ক,	কার্ক,	
kinsa,	কিনসা,	কিংস,	
taitela,	টাইতেলা,	টাইটেল,	
udbodhaney,	উদ্বোধনে,	উদ্বোধনে,	
vins,	ভিনস,	ভিন্স,	
ajibooner,	অজিবুনের,	আজীবনের,	
karaa,	কারা,	কারো,	
beem,	বিম,	বিম,	
licensedhari,	লাইসেন্সধারী,	লাইসেন্সধারী,	
venisey,	ভেনিসে,	ভেনিসে,	
chaudhurider,	চৌধুরীদের,	চৌধুরীদের,	
akten,	আখতেন,	অকটেন,	
satarkokari,	সতর্ককারী,	সতর্ককারী,	
anusvara,	অনুসবরা,	অনুস্বার,	
directarate,	ডারেক্টরট,	ডিরেক্টরেট,	
prrajanankaal,	প্রজাণণকাল,	প্রজননকাল,	
mausumer,	মউসুমের,	মৌসুমের,	
pothon,	পথন,	পঠন,	
chilahatee,	চিলাহাতি,	চিলাহাটি,	
kiibord,	কিউবোর্ড,	কীবোর্ড,	
tapdei,	তাপদেই,	তাপড়েই,	
emarjenshi,	এমারজেন্শি,	এমার্জেন্সি,	
rohasyati,	রহস্যাি,	রহস্যটি,	
nirmalata,	নির্মলতা,	নির্মলতা,	
huka,	হুকা,	হুক,	
ekatitto,	একাতিত্ব,	একাতিত্ব,	
dhrubaker,	ধ্রুবাকের,	ধ্রুবকের,	
korle,	করলল,	করলে,	
matt,	ম্যাট,	ম্যাট,	
prokolpoti,	প্রকল্পটি,	প্রকল্পটি,	
chupani,	চুপানী,	চুপানি,	
kormopontha,	কর্মপন্থা,	কর্মপন্থা,	
augustine,	অগস্টিন,	অগাস্টিন,	
neshnos,	নেশনন,	নেশনস,	
mitrota,	মিত্রতা,	মিত্রতা,	
arthurer,	অর্থুরের,	আর্থারের,	
kalenga,	কলেঙ্গা,	কালেঙ্গা,	
haridware,	হরিদ্বারে,	হরিদ্বারে,	
ogovir,	ওগভির,	অগভীর,	
harris,	হ্যারিস,	হ্যারিস,	
moresbai,	মোরেসবাই,	মোরেসবাই,	
seebiai,	সিবিয়াই,	সিবিআই,	
saarbhaarti,	সার্ভারটি,	সার্ভারটি,	
nirbahe,	নির্বাহে,	নির্বাহে,	
gandhiir,	গ্নাধ্যির,	গান্ধীর,	
domone,	দমনে,	দমনে,	
ranangone,	রাাঙ্গনে,	রণাঙ্গনে,	
edipass,	এডিপাস,	ইডিপাস,	
karuna,	করুুনা,	করুণা,	
mugdal,	মুগদল,	মুগডাল,	
thyachar,	থ্যাচার,	থ্যাচার,	
vince,	ভিনসে,	ভিন্স,	
drishyogulote,	দৃশ্যগুলোতে,	দৃশ্যগুলোতে,	
angibhutovabe,	অঙ্জিভাতভাবে,	অঙ্গীভূতভাবে,	
suiti,	সুইটি,	সুইটি,	
naabbota,	নাব্যতা,	নাব্যতা,	
kleentoner,	ক্লিন্টনের,	ক্লিনটনের,	
sangbadmadhyomgulote,	সংবাদমাধ্যমগুলোতে,	সংবাদমাধ্যমগুলোতে,	
maunchostho,	মঞ্চস্থ,	মঞ্চস্থ,	
turkamena,	তুর্কমেনা,	তুর্কমেন,	
engrejer,	এংর্জেরের,	ইংরেজের,	
zeebonto,	জীবন্ত,	জীবন্ত,	
nick,	নিক,	নিক্,	
bijepi,	বিজেপি,	বিজেপি,	
engreziteo,	এনগ্রেজিতেও,	ইংরেজিতেও,	
bahubar,	বহুবার,	বহুবার,	
chaalaabi,	চালাবি,	চালাবে,	
madrasa,	মাদ্রাসা,	মাদ্রাসা,	
bulano,	বুলানো,	বুলান,	
bhyatikaner,	ভ্যাটিকানের,	ভ্যাটিকানের,	
bidhirnityang,	বিধিরিন্তাযাং,	বিধির্নিত্যং,	
queri,	কোয়েরি,	কোয়েরি,	
ekjoge,	একযোগে,	একযোগে,	
bosantake,	বসন্তাকে,	বসন্তকে,	
prakalpagulor,	প্রকল্পগুলোর,	প্রকল্পগুলোর,	
gazipur,	গাজীপুর,	গাজিপুর,	
batistambhatike,	বাতিস্তম্ভতীকে,	বাতিস্তম্ভটিকে,	
khitkar,	খিটকার,	ক্ষিতকর,	
nojder,	নজদের,	নজদের,	
asovya,	আসভ্যা,	অসভ্য,	
eshiyetika,	এশিয়েকিকা,	এশিয়াটিক,	
breakthrough,	ব্রেকথ্রযঘ,	ব্রেকথ্রু,	
sokkhomotabriddhi,	সক্ষমতাবৃদ্ধি,	সক্ষমতাবৃদ্ধি,	
atwobishvashi,	অত্ববিশোষা,	আত্মবিশ্বাসী,	
sondhisthaponer,	সন্ধিস্থাপনের,	সন্ধিস্থাপনের,	
pratijogider,	প্রতিযোগীদের,	প্রতিযোগীদের,	
freelancerra,	ফ্রিল্যানসেরা,	ফ্রিল্যান্সাররা,	
shrabosty,	শ্রাবস্তি,	শ্রাবস্তী,	
bhromoner,	ভ্রমণের,	ভ্রমণের,	
dip,	ডিপ,	দীপ,	
dipti,	দিপ্তি,	ডেপুটি,	
dokanei,	দোকানেই,	দোকানেই,	
neutrinoo,	নিউট্রিনোও,	নিউট্রিনো,	
ekhate,	এখাতে,	একহাতে,	
salphat,	স্যালফাট,	সালফেট,	
temanti,	তেমন্টি,	তেমনটি,	
ganosochetonota,	গণসচচেতনা,	গণসচেতনতা,	
tahalo,	তাহালো,	তাহলো,	
votar,	ভোতার,	ভোটার,	
chaalkee,	চালকি,	চালকে,	
baffer,	বাফার,	বাফার,	
ooipokar,	উপাকর,	উইপোকার,	
canflikt,	ক্যানফিল্ট,	কনফ্লিক্ট,	
upobasher,	উপবাসের,	উপবাসের,	
kadakhonchar,	কাদাখোঁচার,	কাদাখোঁচার,	
badargaji,	বদরগাজি,	বদরগাজী,	
jeebanjapon,	জীবাঞ্জপন,	জীবনযাপন,	
adwanced,	অ্যাডবান্সড,	অ্যাডভান্সড,	
madhukori,	মধুকোরি,	মাধুকরী,	
bojiye,	বজিয়ে,	বজিয়ে,	
ekghare,	একঘারে,	একঘরে,	
nishad,	নিষদ,	নিষাদ,	
konoroop,	কোনরূপ,	কোনরূপ,	
ghoomato,	ঘোমাতো,	ঘুমাতো,	
azaan,	আজান,	আজান,	
sobaiderke,	সবাইদেরকে,	সবাইদেরকে,	
ashiatic,	অশযাসাইটিক,	এশিয়াটিক,	
somosto,	সমস্ত,	সমস্ত,	
deenesh,	ডিনেশ,	দীনেশ,	
chirkut,	চিরকুট,	চিরকুট,	
innahu,	ইন্নাহু,	ইন্নাহু,	
gaaddafee,	গাড্ফাফি,	গাদ্দাফী,	
ganaporibahaner,	গণপরিবহণের,	গণপরিবহনের,	
reshmirekha,	রেশমিরেখা,	রেশমীরেখা,	
cheef,	চিফ,	শেফ,	
shlok,	শ্লক,	শ্লোক,	
norpholk,	নরফোলক,	নরফোক,	
senabahineeow,	সেনাবাহিশিক,	সেনাবাহিনীও,	
puding,	পুদিং,	পুডিং,	
mukhamandoler,	মুখমমণ্ডলের,	মুখমণ্ডলের,	
chrystal,	ক্রিস্টেল,	ক্রাইস্টাল,	
suhayeler,	সুহায়েলের,	সুহায়েলের,	
baju,	বজু,	বাজু,	
machgulo,	মাচগুলো,	মাছগুলো,	
shilpajata,	শিল্পজতা,	শিল্পজাত,	
fotanor,	ফোটানোর,	ফোটানোর,	
chakundite,	চাকুন্দিতে,	চাকুন্দিতে,	
besirbhaagi,	বেস্রীভাগী,	বেশিরভাগই,	
protibedokrao,	প্রতিবেদকরাও,	প্রতিবেদকরাও,	
parkin,	পারকিন,	পার্কিং,	
azimpur,	আজিমপুর,	আজিমপুর,	
lyaataa,	ল্যাট,	ল্যাটা,	
golimodhye,	গোলিমধ্যে,	গলিমধ্যে,	
shasonkarta,	শাসনকর্তা,	শাসনকর্তা,	
monzushree,	মঞ্জুশরী,	মঞ্জুশ্রী,	
baire,	বাইরে,	বাইরে,	
ishter,	ইশতার,	ইস্টের,	
jerusalemer,	জেরুসালেমের,	জেরুজালেমের,	
ganjana,	গঞ্জনা,	গঞ্জনা,	
edaningkale,	এডানিংকালে,	ইদানীংকালে,	
chokrantosoho,	চক্রান্তসহ,	চক্রান্তসহ,	
alumni,	আলুমনি,	অ্যালমনি,	
zubokder,	যুবকদের,	যুবকদের,	
rajnaiteek,	রাজনৈতিক,	রাজনৈতীক,	
chalochchitreei,	চলচ্চিত্রেই,	চলচ্চিত্রেই,	
prasadhani,	প্রসাধনী,	প্রসাধনী,	
deputee,	ডিপুইত,	ডেপুটি,	
oitijhya,	ঐতিহ্য,	ঐতিহ্য,	
chitlar,	চিতলার,	চিতলার,	
duuma,	দুমা,	দুমা,	
seo,	সেও,	সেও,	
kaalaam,	কালাম,	কালাম,	
query,	কোয়ারি,	কোয়েরি,	
monir,	মনির,	মনির,	
abosan,	অবসান,	অবসান,	
somoodrotote,	সম্দরত্যতে,	সমুদ্রতটে,	
farid,	ফরিদ,	ফরিদ,	
sqirt,	স্কির্ট,	স্কার্ট,	
gemske,	জেমসসকে,	জেমসকে,	
musabbirul,	মুসাববিরুল,	মুসাব্বিরুল,	
simaa,	সীমায়,	সীমা,	
sheshdinti,	শেষদিনটি,	শেষদিনটি,	
ameettrakkhor,	অমিত্রাক্ষ্বর,	অমিত্রাক্ষর,	
gonesher,	গনেশের,	গণেশের,	
satarkabhabey,	সতরকাভাবে,	সতর্কভাবে,	
baibosthaar,	বৈববস্থার,	ব্যবস্থার,	
gabinius,	গেবিনিয়াস,	গাবিনিআস,	
goteehin,	গতিহীন,	গতিহীন,	
krisenter,	ক্রিসেন্টের,	ক্রিসেন্টের,	
salmanul,	সালমানুল,	সালমানুল,	
liseensee,	লিসিন্স,	লাইসেন্স,	
shucharita,	শুচরিত,	সুচরিতা,	
bhabatarini,	ভবতারিনী,	ভবতারিণী,	
venice,	ভেনিস,	ভেনিস,	
porobortii,	পরবর্তী,	পরর্বতী,	
udbodhani,	উদ্বোধনী,	উদ্বোধনী,	
swastir,	স্বস্তির,	স্বস্তির,	
bangalore,	বাঙ্গালোর,	ব্যাঙ্গালুরে,	
saranor,	সারানোর,	সরানোর,	
boudhher,	বৌধ্ের,	বৌদ্ধের,	
pohnpeic,	পোন্পেক,	ফোনপেইক,	
provritike,	প্রভৃতিকে,	প্রভৃতিকে,	
karir,	কারির,	কারীর,	
kachhakaachhi,	কচাাখাছি,	কাছাকাছি,	
ankanshilpe,	অঙ্কাশিিপ্পে,	অঙ্কনশিল্পে,	
lutherana,	লুথেরানা,	লুথেরান,	
shikara,	শিকারা,	শিকার,	
aabarte,	আবারতে,	আবর্তে,	
dhalur,	ধালুর,	ঢালুর,	
fud,	ফুড,	ফুড,	
carlo,	কার্লো,	কার্লো,	
pisach,	পিসা,	পিশাচ,	
kings,	কিংস,	কিংস,	
shahjapur,	শাহজাপুর,	শাহজাপুর,	
elakatir,	এলাকাটির,	এলাকাটির,	
ceramiksh,	সেরামিক্স,	সিরামিকস,	
katateo,	কাতাতেও,	কাটাতেও,	
ajijer,	অজিজের,	আজিজের,	
protijogiider,	প্রতিযোগীদের,	প্রতিযোগীদের,	
aakik,	আকিক,	আকিক,	
shasankorta,	শাসনকর্তা,	শাসনকর্তা,	
mentither,	মেনটিথের,	মেনটিথের,	
sommotitey,	সম্মতিতে,	সম্মতিতে,	
bhenom,	ভেনম,	ভেনম,	
aqram,	আক্রাম,	আকরাম,	
mach,	মাচ,	মাছ,	
jontropatigulite,	যন্ত্রপাতিগুলিতে,	যন্ত্রপাতিগুলিতে,	
sahozlabhbhotar,	সহজলভভাততর,	সহজলভ্যতার,	
kramp,	ক্রম্প,	ক্র্যাম্প,	
crucer,	ক্রুসের,	ক্রুশের,	
nobotom,	নবতম,	নবতম,	
onurbar,	অনুর্বার,	অনুর্বর,	
kloud,	ক্লাউড,	ক্লাউড,	
sahinsatar,	সাহিনসৎটর,	সহিংসতার,	
brekethru,	ব্রেকেঠরু,	ব্রেকথ্রু,	
koro,	কোরো,	করো,	
sipa,	সিপা,	শিপ,	
muhaiminer,	মুহাইমিনের,	মুহাইমিনের,	
lettar,	লেট্টার,	লেটার,	
plate,	প্ল্যাটে,	প্লেট,	
phareeksa,	ফরিকসস,	ফরেক্স,	
attacharito,	অট্টাচারিত,	অত্যাচারিত,	
bhejaano,	ভেজানো,	ভেজানো,	
biprodas,	বিপ্রদাস,	বিপ্রদাস,	
pleeta,	প্লিটা,	প্লেট,	
ruble,	রাবল,	রুবল,	
brail,	ব্রেইল,	ব্রেইল,	
anyorup,	অন্যরূপ,	অন্যরূপ,	
piulir,	পিউলির,	পিউলির,	
bbiswashke,	ব্বিস্বাসকে,	বিশ্বাসকে,	
spredasita,	স্প্রেডাসিটা,	স্প্রেডশীট,	
shoreefpur,	শরীফপুর,	শরিফপুর,	
jonee,	জনী,	জনি,	
eoki,	ইওকি,	এওকি,	
akmato,	আকমাতো,	একমত,	
hugheke,	হুগেকে,	হিউজকে,	
miraqela,	মীরাকেলা,	মিরাকেল,	
laishensha,	লৈশন্ন,	লাইসেন্স,	
trutimatra,	ত্রুতিমাত্রা,	ত্রুটিমাত্র,	
elakaai,	এলাকাই,	এলাকাই,	
protijogitamulok,	প্রতিযোগিতামূলক,	প্রতিযোগীতামূলক,	
juddhahato,	যুদ্ধহাত,	যুদ্ধাহত,	
kash,	কোশ,	কাস,	
narishwar,	নারীশ্বর,	নারীশ্বরের,	
bojata,	বোজাতা,	বোজাটা,	
japanostho,	জাপানস্থ,	জাপানস্থ,	
oisamoyer,	ঐজনময়ের,	ঐসময়ের,	
chotogolper,	চটগল্পের,	ছোটগল্পের,	
aswasteekor,	অস্বস্তীকর,	অস্বস্তিকর,	
daaoon,	ডাওন,	ডাউন,	
saarbharti,	সারভারটি,	সার্ভারটি,	
venuser,	ভেনুসের,	ভেনাসের,	
talaa,	তালা,	তালা,	
masjidsaha,	মসজিদসহ,	মসজিদসহ,	
peshto,	পেষ্ট,	পেষ্ট,	
nisshongotake,	নিঃস্বনগতকে,	নিঃসঙ্গতাকে,	
vabnakey,	ভবনবাকে,	ভাবনাকে,	
hondooras,	হন্দুরাস,	হন্ডুরাস,	
kanthar,	কাঁথার,	কাঁথার,	
nabotom,	নাবতম,	নবতম,	
morathee,	মরাঠী,	মরাঠি,	
billaho,	বিলালোহ,	বিল্লাহ,	
said,	সাইদ,	সাইদ,	
doltyagi,	দলত্যাগী,	দলত্যাগী,	
epiela,	এপিলা,	আইপিএল,	
atak,	আটাক,	আটক,	
uporitaley,	উপরেতলালে,	উপরিতলে,	
pratool,	প্রাটুল,	প্রতুল,	
udbhabaney,	উদ্ভাবনে,	উদ্ভাবনে,	
jotsna,	জোসস্না,	জ্যোৎস্না,	
abhidhaaner,	অভিধানের,	অভিধানের,	
kale,	কললে,	কালে,	
subade,	সুবাদে,	সুবাদে,	
oncholshomuher,	অঁচ্চবমহূের,	অঞ্চলসমূহের,	
delibhara,	ডেলিভারা,	ডেলিভার,	
lendl,	লেন্ডল,	লেন্ডল,	
kaaferder,	কাফেরদের,	কাফেরদের,	
provur,	প্রভুর,	প্রভুর,	
polashir,	পলাশির,	পলাশীর,	
bornanukrome,	বর্ণানুর্ক্মে,	বর্নানুক্রমে,	
torkareer,	তরকারীর,	তরকারীর,	
soource,	সুলরস্,	সোর্স,	
armstronz,	আর্মস্ট্রোন,	আর্মস্ট্রং,	
karmokarke,	করমমকরকে,	কর্মকারকে,	
soundorjotakei,	সৌন্দর্য্যতাকেই,	সৌন্দর্যটাকেই,	
satarkatar,	সতর্কতার,	সতর্কতার,	
byatari,	ব্যাটারি,	ব্যাটারী,	
sahab,	সাহাব,	সাহাব,	
sarajibonbyapi,	সরোজীববণ্পী,	সারাজীবনব্যাপী,	
panchashjan,	পঞ্চাশান,	পঞ্চাশজন,	
armashtram,	অর্মশ্রাম্,	আর্মস্ট্রং,	
mukhmondole,	মুখমঞ্ডলে,	মুখমণ্ডলে,	
parq,	পার্ক,	পার্ক,	
talaal,	তালাল,	তালাল,	
sorting,	সর্টিং,	সর্টিং,	
bhandti,	ভাণ্ডটি,	ভাণ্ডটি,	
ghoshito,	ঘোষিত,	ঘোষিত,	
manjushree,	মঞ্জুশরী,	মঞ্জুশ্রী,	
amudey,	অমুদে,	আমুদে,	
ashonkai,	আশঙ্কাই,	আশঙ্কাই,	
syfy,	সফফি,	সাইফাই,	
rupantarer,	রূপান্তরের,	রুপান্তরের,	
motke,	মটকে,	মতকে,	
horippur,	হরিপপুর,	হরিপুর,	
elakatite,	এলাকাটিতে,	এলাকাটিকে,	
notikotar,	নতিকতার,	নৈতিকতার,	
vaticaner,	ভ্যাটিকানের,	ভ্যাটিকানের,	
simantarkkhibahinir,	সীমান্তরক্ণবিহীনির,	সীমান্তরক্ষীবাহিনীর,	
baikalyo,	বৈকল্য,	বৈকল্য,	
shem,	শেম,	সেম,	
thyachara,	থ্যাচারা,	থ্যাচার,	
shikhbe,	শিখবে,	শিখবে,	
russad,	রাসদ,	রুশদ,	
phiksim,	ফিকসিম,	ফিক্সিং,	
romantik,	রোমান্তিক,	রোমান্টিক,	
seekkhokbrindo,	শিক্ষকবৃন্দ,	শিক্ষকবৃন্দ,	
sachetonvabe,	সচেতনাভাবে,	সচেতনভাবে,	
cbi,	সিবিআই,	সিবিআই,	
bishnu,	বিষ্ণু,	বিষ্ণু,	
gondhe,	গন্ধে,	গন্ধে,	
songkulan,	সংকুলান,	সংকুলান,	
holdim,	হোল্ডিং,	হোল্ডিং,	
pack,	প্যাক,	প্ল্যাক,	
kuthibarike,	কুঠিবারীকে,	কুঠিবাড়ীকে,	
madrasi,	মাদ্রাসী,	মাদ্রাজি,	
maailey,	মেয়লি,	মাইলে,	
hansasya,	হাঁসস্য,	হংসস্য,	
mozdoor,	মজদুর,	মজদুর,	
tukrowti,	তুকরোতি,	টুকরোটি,	
deool,	দেওল,	দেউল,	
vabaponno,	ভাবাপণ্ন,	ভাবাপন্ন,	
omanisa,	ওমানিসা,	অমানিশা,	
dala,	দালা,	দলা,	
fevarite,	ফেভারিতে,	ফেভারিট,	
nabyata,	নব্যতা,	নাব্যতা,	
amburi,	অম্বুরি,	আম্বুরি,	
abheedhanic,	অভিধানিক,	অভিধানিক,	
sinaake,	সিনাকে,	সিনাকে,	
graambasi,	গ্রামবাসী,	গ্রামবাসী,	
edmeeral,	ইম্িরাল,	এডমিরাল,	
hitlere,	হিটলারে,	হিটলারে,	
chalai,	চালাই,	চালাবে,	
laiseensim,	লাইসসনিিম,	লাইসেন্সিং,	
shtonehenge,	স্টোনহেনজে,	স্টোনহেঞ্জ,	
cn,	সিএসএন,	সিএন,	
shashtra,	শাষ্ট্র,	শাস্ত্র,	
saoum,	সাওয়াম,	সাওম,	
hundai,	হুন্দাই,	হুন্দাই,	
bhugol,	ভূগোল,	ভূগোল,	
kanasharabheshhana,	কনশরভেভাননা,	কনসারভেশন,	
samratra,	সামরাত্র,	সম্রাটরা,	
mangoleek,	মঙ্গলীক,	মাঙ্গলিক,	
nothibhukto,	নথিভুক্ত,	নথিভুক্ত,	
boshoborty,	বশরবত্তি,	বশবর্তী,	
kathmandu,	কাঠমান্ডু,	কাঠমান্ডু,	
shasheja,	শাসেজা,	সসেজ,	
sobche,	সবকছে,	সবচে,	
comoros,	কমোরোস,	কোমোরোস,	
deraa,	ডেরা,	ডেরা,	
oncholke,	অন্চলকে,	অঞ্চলকে,	
dhila,	ধিল,	ঢিলা,	
shamuker,	শামুকের,	শামুকের,	
asif,	আসিফ,	আসিফ,	
teksuser,	টেকসুসের,	টেক্সাসের,	
chopal,	চোপাল,	চপল,	
shuperheiro,	শূপেরহররিও,	সুপারহিরো,	
nirapattamulok,	নিরাপত্তামূলক,	নিরাপত্তামূলক,	
deil,	ডেইল,	ডেইল,	
shudden,	শুদনেন,	সাডেন,	
pyore,	প্রের,	পিওর,	
snehban,	স্নেহবান,	স্নেহবান,	
fatkabazare,	ফাকবাবাজারে,	ফাটকাবাজারে,	
mailkhanek,	মাইলখানেক,	মাইলখানেক,	
bapio,	বাপিও,	বাপিও,	
mulyabriddhikale,	মূল্যবৃদ্ধিকালে,	মূল্যবৃদ্ধিকালে,	
ghatleo,	ঘাটলেও,	ঘটলেও,	
chakradhare,	চক্রধারে,	চক্রধরে,	
khuizza,	খুইজ্জা,	খুইজ্জা,	
sadbi,	সাদবি,	সাধ্বী,	
plusey,	প্লাসে,	প্লাসে,	
nirikh,	নিরিখ,	নিরিখ,	
kuttake,	কুট্টাকে,	কুত্তাকে,	
swatantrata,	স্বতন্ত্র্যতা,	স্বতন্ত্রতা,	
masjidti,	মাসজিদটি,	মসজিদটি,	
tukroti,	তুকররটি,	টুকরোটি,	
abhidhanick,	অভিধানিক,	অভিধানিক,	
tookrokey,	তুকর্কে,	টুকরোকে,	
themeke,	থেমেকে,	থিমকে,	
orthanitike,	অর্থানীতিকে,	অর্থনীতিকে,	
baaiq,	বাইক,	বাইক,	
yuroo,	যুুরো,	ইউরো,	
prakare,	প্রকারে,	প্রকারে,	
habol,	হাবল,	হাবোল,	
rudiger,	রুদিগের,	রুদিগের,	
deares,	ডিয়েরস,	ডিআরএস,	
sbajan,	স্বজন,	স্বজন,	
turisht,	তূরিষ্ট,	টুরিস্ট,	
tyapa,	ট্যাপ,	ট্যাপ,	
guzober,	গুজবের,	গুজবের,	
kamti,	কামটি,	কমতি,	
chhadite,	ছাদিতে,	ছড়িতে,	
nodnodeer,	নদনদীর,	নদনদীর,	
olympic,	অলিম্পিক,	অলিম্পিক,	
naobihar,	নাওবিহার,	নৌবিহার,	
shchalastik,	শ্কলচাস্তিক,	স্কলাস্টিক,	
samyuktha,	সম্যুক্ষ,	সামিউক্তা,	
dhandu,	ধন্দু,	ধন্দু,	
murader,	মুরাদের,	মুরাদের,	
maladabha,	মালাদভ,	মলদোভা,	
bossonte,	বসন্তে,	বসন্তে,	
johny,	জনহি,	জনি,	
quary,	কোয়ারি,	কোয়েরি,	
ghoor,	ঘুর,	ঘুর,	
kisti,	কিস্তি,	কিস্তি,	
vogno,	ভগ্ন,	ভগ্ন,	
nibobondhonkrito,	নিবন্ধনিকৃত,	নিববন্ধনকৃত,	
ucchosito,	উচ্চসিত,	উচ্ছসিত,	
palestine,	প্যালিস্টাইন,	প্যালেস্টাইনে,	
mukhbondho,	মুখবন্ধ,	মুখবন্ধ,	
siddhantei,	সিদ্ধান্তেই,	সিদ্ধান্তেই,	
doorotomo,	দূরতম,	দূরতম,	
dabarer,	দাবারের,	দাবারের,	
asovyo,	আসভ্য,	অসভ্য,	
taufiq,	তাইজিক,	তৌফিক,	
torkarite,	তরকারিতে,	তরকারিতে,	
samany,	স্যামানি,	সামান্য,	
varote,	ভারতে,	ভারতে,	
zarniz,	জার্নিজ,	জারনিজ,	
ghetu,	ঘেটু,	ঘেটু,	
varma,	ভারমা,	ভার্মা,	
elaakaati,	এলাকাটি,	এলাকাটি,	
torunosomriddho,	তরুণসমৃদ্ধ,	তরুণসমৃদ্ধ,	
yucalyptus,	জাকাযালপপাাাস,	ইউক্যালিপ্টাস,	
atarkitey,	আতরকিতে,	অতর্কিতে,	
bbiswashi,	ব্বিসবাসী,	বিশ্বাসই,	
transapharma,	ট্রান্সফররা,	ট্রান্সফর্ম,	
transformaarer,	ট্রান্সফরমারের,	ট্রান্সফরমারের,	
deaubande,	দিউবান্দে,	দেওবন্দে,	
sangasthagulo,	সংস্থাগুলো,	সংস্থাগুলো,	
tikta,	তিকটা,	তিক্ত,	
prokolpogulikei,	প্রকল্পগুলিকেই,	প্রকল্পগুলিকেই,	
bonnopran,	বন্যপ্রাণ,	বন্যপ্রাণ,	
siramikasa,	সিরামিকসসা,	সিরামিকস,	
grambaseer,	গ্রামববাসীর,	গ্রামবাসীর,	
definition,	ডিফিনিশন,	ডেফিনেশন,	
rajtantro,	রাজতন্ত্র,	রাজতন্ত্র,	
rubala,	রুবালা,	রুবল,	
cheentaikaree,	চিন্তাইকারী,	ছিনতাইকারী,	
pooshti,	পুষ্টি,	পুষ্টি,	
hoonayin,	হুনায়িন,	হুনাইন,	
stander,	স্তন্দের,	স্ট্যাণ্ডের,	
bibadey,	বিবাদে,	বিবাদে,	
gore,	গরে,	গোর,	
neemeetto,	নিম্টিক্ত,	নিমিত্ত,	
kathmandute,	কাঠমণ্ডুতে,	কাঠমান্ডুতে,	
barbadoj,	বারবাদজ,	বার্বাডোজ,	
chiroharit,	চিরোহারিত,	চিরহরিৎ,	
with,	উইথ,	ভিত,	
abheedhaaneeck,	অভিধানিক,	অভিধানিক,	
pnouchute,	পৌঁছুতে,	পৌঁছুতে,	
konruup,	কনরুরপপ,	কোনরূপ,	
aamor,	আমার,	আমর,	
modyer,	মুদ্যের,	মদ্যের,	
artore,	আর্তরে,	আর্টরে,	
marmaraa,	মারমারা,	মারমারা,	
armshtrong,	আর্বট্রনং,	আর্মস্ট্রং,	
charger,	চার্জার,	চার্জার,	
bitertrate,	বিটারার্টাটে,	বাইটারট্রেট,	
argead,	আর্জিড,	আর্জিদ,	
nadike,	নাদিকে,	নদীকে,	
aatto,	এ্যাটইটো,	আত্ম,	
chirontan,	চিরন্তন,	চিরন্তন,	
gotirodh,	গতিরোধ,	গতিরোধ,	
ghaghat,	ঘাঘাট,	ঘাঘট,	
parisankhanbid,	পরিসংখ্ানবিদ,	পরিসংখ্যানবিদ,	
souripurang,	সৌরিপূরং,	সৌরিপুরং,	
scorey,	স্কোরে,	স্কোরে,	
hingsar,	হিংসার,	হিংসার,	
edseler,	এডসেলের,	এডসেলের,	
bharotiyotar,	ভারতীয়তার,	ভারতীয়তার,	
gandhariir,	গান্ধারীর,	গান্ধারীর,	
shector,	শেক্টর,	সেক্টর,	
grooth,	গ্রুথ,	গ্রোথ,	
bupher,	বুফের,	বাফার,	
dharavassokar,	ধারাভাসাকর,	ধারাভাষ্যকার,	
jaatti,	যাত্তি,	জাতটি,	
siit,	সিত,	শীত,	
shukraanoo,	শুক্রাৌনো,	শুক্রানু,	
plack,	প্ল্যাক,	প্ল্যাক,	
shikshagato,	শিক্ষাগত,	শিক্ষাগত,	
shrimoti,	শ্রীমতি,	শ্রীমতি,	
fanding,	ফ্যান্ডিং,	ফান্ডিং,	
shiter,	শীতের,	শীতের,	
amontronkarider,	আমন্ত্রণাকারীদের,	আমন্ত্রণকারীদের,	
bishashke,	বিশাশকে,	বিশ্বাসকে,	
gatibege,	গাটিবেগে,	গতিবেগে,	
sikarder,	সিকারদের,	শিকারদের,	
medilek,	মেডিলেক,	মেডিলেক,	
eenameela,	ইনোমিলা,	এনামেল,	
paramartha,	পরমার্থ,	পরমার্থ,	
bone,	বনে,	বনে,	
autopromotioner,	অটোপ্রফেশনের,	অটোপ্রমোশনের,	
bonobhumi,	বনভূমি,	বনভূমি,	
giitikobitar,	গীতটিকিবতার,	গীতিকবিতার,	
dipon,	ডিপন,	দীপন,	
umb,	ইউএমবি,	ইউএমবি,	
azijer,	আজিজের,	আজিজের,	
moonshi,	মুনশি,	মুন্সি,	
rakim,	রকিম,	রাকিম,	
venus,	ভেনিস,	ভেনাস,	
tennys,	টেনিস,	টেনিস,	
taxikeo,	ট্যাক্সিকেও,	ট্যাক্সিকেও,	
kartona,	কারতোনা,	করতনা,	
rajdhani,	রাজধানি,	রাজধানি,	
dakkhinkare,	দক্ষিণকারে,	দক্ষিণকরে,	
jothon,	যথন,	যথন,	
bage,	ব্যাগে,	বাগে,	
goshthiti,	গোষ্ঠিতি,	গোষ্ঠীটি,	
probhura,	প্রভুরা,	প্রভুরা,	
suchonakal,	সূচনাকাল,	সূচনাকাল,	
shudhir,	শুধীর,	শুধীর,	
asaciates,	অ্যাসাটিসিটস,	এসোসিয়েটস,	
tolemy,	টোলেমি,	টলেমির,	
sawam,	সাওয়াম,	সাওম,	
bade,	বায়ে,	বাদে,	
assaciates,	অ্যাসোসিটিস,	এসোসিয়েটস,	
windo,	উইন্ডো,	উইন্ডো,	
bibhinno,	বিভিঙ্ন,	বিভন্ন,	
shahoshikatar,	শহশিকাতার,	সাহসিকতার,	
shikkhakram,	শিক্ষাক্রম,	শিক্ষাক্রম,	
ji,	জিআই,	জি,	
torikher,	তরিখের,	তরিখের,	
yanqee,	য্ককী,	ইয়াংকি,	
behrampurer,	বেহরামপুরের,	বহরমপুরের,	
byomkes,	ব্যামকেস,	ব্যোমকেশ,	
prosadhoni,	প্রসাধনী,	প্রসাধনী,	
pouchute,	পৌছুতে,	পৌঁছুতে,	
chhedon,	ছেদন,	ছেদন,	
otyacharito,	অত্যাচারিত,	অত্যাচারিত,	
antarctica,	আন্ট্রোক্টিকা,	অ্যান্টার্কটিকার,	
cholchhee,	চলচ,	চলছে,	
samajik,	সামাজিক,	সামাজিক,	
windows,	উইন্ডোস,	উইন্ডোস,	
bandhan,	বাঁধন,	বাঁধন,	
sonaicha,	সোনাইযা,	সোনাইচা,	
samley,	সমলি,	সামলে,	
bidyadanke,	বিদ্যাদাঁকে,	বিদ্যাদানকে,	
daqten,	ডাকতেন,	ডাকতেন,	
kayech,	কায়েছ,	কায়েছ,	
wilderske,	উইলডার্সকে,	উইল্ডার্সকে,	
sarollo,	সারোলো,	সারল্য,	
antarctica,	আন্ট্রোক্টিকা,	অ্যান্টার্কটিকা,	
bhramarotsab,	ভ্রমরাৎসব,	ভ্রমরোৎসব,	
jyesttha,	জ্যেষ্ঠম,	জ্যেষ্ঠা,	
chalochchitraeer,	চলচ্চিত্রীর,	চলচ্চিত্রের,	
bonnypran,	বনিপ্রার্ণ,	বন্যপ্রাণ,	
yukeliptash,	যুকেলপিপ্স,	ইউক্যালিপ্টাস,	
khamotagulor,	ক্ষমতাগুলোর,	ক্ষমতাগুলোর,	
seniar,	সেনিয়ার,	সিনিয়র,	
gandhike,	গান্ধীকে,	গান্ধীকে,	
touraat,	তুরয়ত,	তওরাত,	
dormitory,	ডরমিটরি,	ডরমিটরি,	
thaanobhi,	থানোভি,	থানভী,	
kaalki,	কালকি,	কালকি,	
annanere,	আন্নানেরে,	অন্যানেরে,	
osamanno,	অসামান্য,	অসামান্য,	
protistha,	প্রতিষ্ঠা,	প্রতিষ্টা,	
kaatbey,	কাতবে,	কাটবে,	
toching,	টচিং,	টোচিং,	
purushika,	পুরুষিকা,	পুরুষিকা,	
zubokra,	যুবকরা,	যুবকরা,	
sepha,	সেফ,	শেফ,	
protiakromonei,	প্রতিয়কারমণেই,	প্রতিআক্রমণেই,	
jokkher,	যক্ষের,	যক্ষের,	
kaamij,	কামিজ,	কামিজ,	
phiqsa,	ফিকসা,	ফিক্স,	
romancha,	রোমাঞ্চ,	রোমাঞ্চ,	
loombinee,	লুমবিনি,	লুম্বিনী,	
basturoi,	বস্তুরই,	বস্তুরই,	
ongshogrohoner,	অংশগ্রহণের,	অংশগ্রহনের,	
seekkhaou,	শিক্ষা,	শিক্ষাও,	
lettere,	লেটারে,	লেটারে,	
bbosonto,	ব্বসস্ত,	বসন্ত,	
surakarder,	সুরকরদের,	সুরকারদের,	
pratisthanikvabe,	প্রতিস্থানিকভাবে,	প্রাতিষ্ঠানিকভাবে,	
marmader,	মারমাদের,	মারমাদের,	
fakhrul,	ফখরুল,	ফাখরুল,	
heelser,	হেলসের,	হিলসের,	
kabutorer,	কবুতরের,	কবুতরের,	
erajyobasi,	ইরাজ্যবাসী,	এরাজ্যবাসী,	
veemsen,	ভীমসেন,	ভীমসেন,	
anusthane,	অনুষ্ঠানে,	অনুষ্ঠানে,	
distibutor,	ডিস্টিবুটোর,	ডিস্টিবিউটারের,	
bonvumitey,	বনভুমিতে,	বনভূমিতে,	
noitik,	নৈতিক,	নৈতিক,	
bishnoo,	বিষ্ণৌ,	বিষ্ণু,	
nikate,	নিকাতে,	নিকটে,	
sheepha,	শিফা,	শেফ,	
jotota,	যতটা,	যতোটা,	
pariyech,	পরিয়েছ,	পরিয়েছ,	
kortam,	কোরতাম,	করতাম,	
bufer,	বুফার,	বাফার,	
bishwaashshke,	বিশ্বাসশকে,	বিশ্বাসকে,	
chhon,	ছ্ন,	ছোঁ,	
uindoos,	উইনদোস,	উইন্ডোস,	
kurdira,	কুর্ডিরা,	কুর্দিরা,	
ganoparibahaner,	গণপরিবহহনের,	গণপরিবহনের,	
debete,	দেবেতে,	ডিবেট,	
modelkey,	মডেলকে,	মডেলকে,	
audioguloke,	অডিওগুলোকে,	অডিওগুলোকে,	
mochlekha,	মোচলেখা,	মোছলেখা,	
chhuti,	ছুটি,	ছুটি,	
ramonar,	রামনার,	রমনার,	
zesa,	জেসা,	জেস,	
hukar,	হুকার,	হুকার,	
granada,	গ্রেনাডা,	গ্র্যানাডা,	
shektor,	শেক্তর,	সেক্টর,	
graminphonor,	গ্রামিনফোর,	গ্রামীণফোনর,	
adhyatmik,	আধ্যাতম্িক,	আধ্যাত্মিক,	
qyantana,	ক্যান্তনা,	ক্যান্টন,	
seeramiks,	সেরামিক্স,	সিরামিকস,	
rinobodh,	ঋণবোধ,	ঋণবোধ,	
beshakbar,	বেশাকবার,	বেশকবার,	
chal,	চাল,	চাল,	
iqbalke,	ইকবালকে,	ইকবালকে,	
drissogoolote,	ডৃষ্যগতলে,	দৃশ্যগুলোতে,	
gobeshonar,	গবেষণার,	গবেষনার,	
mugdha,	মুগ্ধা,	মুগ্ধ,	
oiteejye,	ঐতিয্যে,	ঐতিহ্যে,	
lagchhe,	লাগছে,	লাগছে,	
segular,	সেগুলার,	সেগুলোর,	
fibergulote,	ফিবারগুলোতে,	ফাইবারগুলোতে,	
maradeha,	মরদাহ,	মরদেহ,	
adorsho,	আদর্শ,	আর্দশ,	
jeebonnogor,	জীবনগরনর,	জীবননগর,	
utpatti,	উৎপট্টি,	উতপত্তি,	
joubankal,	যৌবনকল,	যৌবনকাল,	
glanio,	গ্লানিও,	গ্লানিও,	
ghoorchen,	ঘুরচেন,	ঘুরেছেন,	
weenis,	নেইসিস,	ভেনিস,	
dong,	ডঙ্,	ডং,	
babare,	বাবারে,	বাবারে,	
sangsakti,	সংসক্তি,	সংসক্তি,	
vobani,	ভোবানি,	ভবানী,	
vobanipur,	ভোবানিপুর,	ভবানীপুর,	
deh,	দেহে,	দেহ্,	
monchostho,	মঞ্চশ্থ,	মঞ্চস্থ,	
nichols,	নিকোলস,	নিকলস,	
nodiitei,	নদীইতেই,	নদীতেই,	
kharar,	খররার,	খরার,	
firalem,	ফিরালেম,	ফিরালেম,	
monzeele,	মনজিলে,	মঞ্জিলে,	
oindrila,	ঐন্দ্রিলা,	ঐন্দ্রিলা,	
oncholeo,	অন্চলেও,	অঞ্চলেও,	
moomtaj,	মুমতাজ,	মুমতাজ,	
kindom,	কিন্দম,	কিংডম,	
katbe,	কাতবে,	কাটবে,	
idyi,	ইদি,	আইডিই,	
keuoi,	কেওউই,	কেউই,	
indrani,	ইন্দ্রানী,	ইন্দ্রাণী,	
daakticketer,	ডাক্টিকটের,	ডাকটিকিটের,	
dibya,	দিব্যা,	দিব্যা,	
tuleche,	তুলেছে,	তুলেছে,	
stanahenja,	স্তনাঞ্জেহা,	স্টোনহেঞ্জ,	
ghumachchila,	ঘুমাচ্ছিলা,	ঘুমাচ্ছিল,	
laps,	ল্যাপস,	ল্যাপস,	
langhaner,	লঙ্ঘানের,	লংঘনের,	
karadandey,	কারাদান্দে,	কারাদণ্ডে,	
bokahoke,	বোকাহোকে,	বকাহকে,	
veniser,	ভেনিসের,	ভেনিসের,	
jamarate,	জামারাতে,	জামারাতে,	
aairish,	আইরিস,	আইরিস,	
dhormoprobortokder,	ধর্মপ্রবর্তকদের,	ধর্মপ্রবর্তকদের,	
aansaareer,	আনসারীর,	আনসারীর,	
hetimganje,	হেতিমগঞ্জে,	হেতিমগঞ্জে,	
baait,	বাইত,	বাইট,	
shasonamoleri,	শাসনামলেরই,	শাসনামলেরই,	
nirmankaaj,	নির্মাণকাজ,	নির্মাণকাজ,	
tikto,	তিকতো,	তিক্ত,	
volapuk,	ভোলাপুক,	ভোলাপুক,	
antarvuktimulak,	অন্তর্ভুক্তিমূলক,	অন্তর্ভুক্তিমূলক,	
poscime,	পশ্চিমে,	পশ্চিমে,	
bipajjanak,	বিপাজ্জনক,	বিপজ্জনক,	
shubhag,	শুভাগ,	শুভাগ,	
fand,	ফ্যান্ড,	ফান্ড,	
chandrimaa,	চন্দ্রিমা,	চন্দ্রিমা,	
jeshtha,	য়েশ্ঠ,	জ্যেষ্ঠা,	
atmiyasulabh,	আত্মীয়সূলভ,	আত্মীয়সুলভ,	
jhimochchilo,	ঝিমোচ্ছিল,	ঝিমোচ্ছিলো,	
shhow,	শু,	শো,	
rayyaleti,	রায়েলীটি,	রয়্যালটি,	
highcomissione,	হাইকমোসিনে,	হাইকমিশনে,	
liceensee,	লাইসেন্সি,	লাইসেন্স,	
bhyaatikaner,	ভ্যাটিকানের,	ভ্যাটিকানের,	
sqalastiqa,	স্ক্যালস্কিটা,	স্কলাস্টিক,	
roopdan,	রুপদান,	রুপদান,	
qlauda,	ক্লাডু,	ক্লাউড,	
institutione,	ইন্সটিটুশনে,	ইনস্টিটিউশনে,	
drissogulote,	দৃশ্যগুলোতে,	দৃশ্যগুলোতে,	
houzgulite,	হাউজগুলিতে,	হাউজগুলিতে,	
bouddher,	বৌদ্ধের,	বৌদ্ধের,	
attorkite,	অত্রকীততে,	অতর্কিতে,	
qredita,	ক্রেডিটা,	ক্রেডিট,	
bonvumi,	বনভুমি,	বনভূমি,	
deelibhara,	ডিলিভারা,	ডেলিভার,	
hozot,	হজত,	হজত,	
bonsho,	বনশ,	বংশ,	
ancholsaha,	অঞ্চলসহ,	অঞ্চলসহ,	
nopdnodir,	নপ্নদদির,	নদনদীর,	
manob,	মানব,	মানব,	
kormoke,	কর্মকে,	কর্মকে,	
uzobekeestaan,	উজবেক্সিতান,	উজবেকিস্তান,	
alsaar,	আলসার,	আলসার,	
shit,	শিত,	শীত,	
santoshpore,	সন্তোষপরে,	সন্তোষপুর,	
shunani,	শুনানি,	শুনানী,	
phising,	ফিসিং,	ফিসিং,	
kaleo,	কালেও,	কালেও,	
dibet,	দিবেত,	ডিবেট,	
jerusaleme,	জেরুসালেম,	জেরুসালেমে,	
bhimsen,	ভীমসেন,	ভীমসেন,	
pravritir,	প্রভৃতির,	প্রভৃতির,	
sathik,	সাথিক,	সঠিক,	
itastata,	ইতস্ততা,	ইতস্তত,	
chalochchitrogulor,	চলচ্চিত্রগুলোর,	চলচ্চিত্রগুলোর,	
habshi,	হাবশি,	হাবশী,	
idipasha,	ইডিপপাশা,	ইডিপাস,	
dai,	দাই,	ডে,	
prosadhoner,	প্রসাধনের,	প্রসাধনের,	
bihar,	বিহার,	বিহার,	
sharoker,	শরযকের,	স্মারকের,	
railliner,	রেইলিনের,	রেললাইনের,	
daakteekite,	ডাক্তিকিতে,	ডাকটিকিটে,	
mail,	মাইল,	মাইল,	
poroborti,	পরবর্তী,	পরর্বতী,	
elakatikay,	এলাকাটিকা,	এলাকাটিকে,	
chhutee,	ছুটি,	ছুটি,	
nazad,	নাজাদ,	নজদ,	
nachar,	নাচর,	নাচার,	
eesosiyeetasa,	এসসিয়োস,	এসোসিয়েটস,	
matthews,	ম্যাথথ,	ম্যাথিউস,	
dokaangoolote,	দোকানগুলোতে,	দোকানগুলোতে,	
swairacharibirodhi,	স্বৈরাচরিরোরোধী,	স্বৈরাচারীবিরোধী,	
pakistanira,	পাকিস্তানীরা,	পাকিস্তানীরা,	
neshnosh,	নেশনোচ,	নেশনস,	
enjineers,	এনজিনির,	ইঞ্জিনিয়ার্স,	
title,	টিটল,	টাইটেল,	
chhooteete,	ছটিতে,	ছুটিতে,	
manbe,	মানবে,	মানবে,	
dishani,	দিশানি,	দিশানি,	
shchalastic,	স্কালাস্টিক,	স্কলাস্টিক,	
dinifitian,	ডিনিফাইটিয়ান,	ডেফিনেশন,	
eucalyptus,	ইউঅ্যালিপোাস,	ইউক্যালিপ্টাস,	
oedipus,	ওডডিপাস,	ইডিপাস,	
bhalobasar,	ভালোবাসার,	ভালোবাসার,	
durtomo,	দুর্তম,	দূরতম,	
adarsho,	আদারশ,	আর্দশ,	
thailandsaho,	থাইলান্ডসহ,	থাইল্যান্ডসহ,	
jyesthaa,	জ্যেষ্ঠা,	জ্যেষ্ঠা,	
ashamorthito,	আশামার্থিত,	অসমর্থিত,	
harysoner,	হ্যারিসনের,	হ্যারিসনের,	
minister,	মিনিস্টার,	মিনিস্টার,	
choson,	চসন,	চোষণ,	
karmoi,	কারময়,	কর্মই,	
haripur,	হরিপুর,	হরিপুর,	
sportstar,	স্পোর্টস্টার,	স্পোর্টসস্টার,	
addabaj,	আদযাবাজ,	আড্ডাবাজ,	
courtcaser,	কোর্টক্সের,	কোর্টকেসের,	
eexpreession,	এক্সপ্রিসন,	এক্সপ্রেশন,	
parking,	পারকিং,	পার্কিং,	
bhaangchur,	ভাংচুর,	ভাংচুর,	
chalochchitro,	চলচ্চিত্র,	চলচ্চিত্র,	
bibader,	বিবাদের,	বিবাদের,	
ujobekeestan,	উজবেক্তাসন,	উজবেকিস্তান,	
uparjon,	উপার্যন,	উপার্জন,	
byaboharkareer,	ব্যবহারকারীর,	ব্যবহারকারীর,	
mirina,	মিরিনা,	মিরিনা,	
ispreedshiit,	ইসপ্রিদ্শিত,	স্প্রেডশীট,	
sonaktokaran,	সনাক্তকরণ,	সনাক্তকরণ,	
seguloi,	সেগুলোই,	সেগুলোই,	
dianes,	ডায়ানিস,	ডিএনএস,	
milekhaanek,	মিলেখানেক,	মাইলখানেক,	
tookror,	তুকরর,	টুকরোর,	
shithilata,	শীথিলতা,	শিথিলতা,	
harishankar,	হরিশঙ্করের,	হরিশংকর,	
fol,	ফল,	ফল,	
ponjikar,	পঞ্জিকার,	পঞ্জিকার,	
gosthike,	গোষ্ঠীকে,	গোষ্ঠীকে,	
tenishe,	তেনিশে,	টেনিসে,	
naajii,	নাজি,	নাত্সি,	
raunanganey,	রওনঙ্গণে,	রণাঙ্গনে,	
debholopar,	ডেভোলপার,	ডেভলপার,	
skolastik,	স্কোলাস্কিট,	স্কলাস্টিক,	
dokkhinangsho,	দক্ষিনাংশ,	দক্ষিণাংশ,	
shommotite,	সম্মতিতে,	সম্মতিতে,	
abdan,	আবদান,	আব্দান,	
site,	সিতে,	সিটে,	
ekoghore,	একঘরে,	একঘরে,	
dhangsachchi,	ধ্বংসচ্চি,	ধ্বংসাচ্ছি,	
choritrotakeo,	চরিত্রতাকেও,	চরিত্রটাকেও,	
joones,	জুনেস,	জোন্স,	
ddebet,	ডেবেট,	ডিবেট,	
nirbaaho,	নির্বাহও,	নির্বাহ,	
stoonahenja,	স্টুনহেঞ্জা,	স্টোনহেঞ্জ,	
sahapathike,	সহপাঠিকে,	সহপাঠীকে,	
muchi,	মুচি,	মুচি,	
reliance,	রিলিয়েঞ্স,	রিলায়েন্স,	
bikretara,	বিক্রেতারা,	বিক্রেতারা,	
neemitte,	নিমিত্তে,	নিমিত্তে,	
tahorir,	তাহরীর,	তাহরীর,	
kolkarkhana,	কলকারখানা,	কলকারখানা,	
zerusaleme,	জেরুসালেম,	জেরুসালেমে,	
chaanoo,	চানৌও,	চানু,	
bisnukey,	বিস্নুকে,	বিষ্ণুকে,	
jocqey,	জকক,	জকি,	
daraider,	দারাইদের,	দরাইদের,	
gajano,	গাজানো,	গজানো,	
haitasha,	হাইতাশা,	হাইটস,	
prosadhaner,	প্রসাধনের,	প্রসাধনের,	
puroheetder,	পুরহহিতদের,	পুরোহিতদের,	
udvaboney,	উদ্ভাবনে,	উদ্ভাবনে,	
gonona,	গোনানা,	গননা,	
bandhubhaabaapanna,	বন্ধুভর্পন্ন,	বন্ধুভাবাপন্ন,	
satarka,	সতর্কা,	সতর্ক,	
footbalarra,	ফুটবলরারা,	ফুটবলাররা,	
korush,	করুষ,	ক্রুশ,	
protisthan,	প্রতিষ্ঠান,	প্রতিষ্টান,	
purborekorde,	পূর্বরেকরদে,	পূর্বরেকর্ডে,	
ghamtaa,	ঘামটা,	ঘোমটা,	
utotoro,	উততর,	উততর,	
bbiseshyer,	ব্বিশেষের,	বিশেষ্যের,	
heerani,	হীরানী,	হিরানি,	
orbi,	ওরবি,	ওরবি,	
tarkale,	তরকালে,	তারকালে,	
benojir,	বেনজীর,	বেনজীর,	
thailand,	থেইলান্ড,	থাইল্যান্ড,	
sahittekder,	সাহিত্যকদের,	সাহিত্যেকদের,	
unchiyechilo,	উঁচিয়েছিল,	উঁচিয়েছিল,	
firth,	ফির্থ,	ফার্থ,	
michir,	মিচির,	মিচির,	
beshyasdone,	বেশ্যাসদনে,	বেশ্যাসদনে,	
soinyo,	সৈন্য,	সৈন্য,	
somraatder,	সম্রাটদের,	সম্রাটদের,	
fatakasto,	ফাতাকাস্ত,	ফাটাকেষ্ট,	
qarlosa,	কারলোসা,	কার্লোস,	
ganesh,	গনেশ,	গণেশ,	
maritimer,	মারিটিমের,	মেরিটাইমের,	
tiunara,	তিউনারা,	টিউনার,	
sangkalanti,	সংকলনন্তি,	সংকলনটি,	
chalachchitrotike,	চলচ্চিত্রটিকে,	চলচ্চিত্রটিকে,	
pachak,	পাচাক,	পাচক,	
yatharthabhabe,	মথথররভাবে,	যথার্থভাবে,	
gurmukh,	গুরমুখ,	গুরমুখ,	
bosante,	বোসন্তে,	বসন্তে,	
hossne,	হোসেন,	হোসনে,	
zibonnogor,	জীবনগরনর,	জীবননগর,	
nirbahi,	নির্বাহী,	নির্বাহি,	
peeth,	পিথ,	পীঠ,	
bajite,	বাজিতে,	বাজিতে,	
fatakesto,	ফেটাকস্তো,	ফাটাকেষ্ট,	
bhenus,	ভেনুস,	ভেনাস,	
harasta,	হারাস্টা,	হারাস্তা,	
dwipke,	দ্বীপকে,	দ্বীপকে,	
cheerontan,	চেরনটটান,	চিরন্তন,	
sardar,	সারদার,	সরদার,	
rashider,	রাশীদের,	রশিদের,	
bhikkharthe,	ভিক্ষার্থে,	ভিক্ষার্থে,	
shikhaboudi,	শিখাবৌদি,	শিখাবৌদি,	
landing,	ল্যান্ডিং,	ল্যান্ডিং,	
soorsa,	সূর্শা,	সোর্স,	
suparichito,	সুপারিচিত,	সুপরিচিত,	
nek,	নেক,	নেক,	
banglota,	বাংলোটা,	বাংলোটা,	
somsher,	সম্্ের,	সমশের,	
tata,	তাতা,	তাতা,	
mooney,	মুউন,	মুনে,	
sorano,	সোরানো,	সরানো,	
palashir,	পলাশির,	পলাশীর,	
motkey,	মটকে,	মতকে,	
stagecraft,	স্টেজারফ্রাট,	স্টেজক্রাফট,	
ghumacchilo,	ঘুমাচ্লি,	ঘুমাচ্ছিল,	
alonkaran,	আলোংকরন,	অলঙ্করণ,	
graambashee,	গ্রামবাশী,	গ্রামবাসী,	
bijito,	বিজিত,	বিজিত,	
ebham,	ইভম,	ইভিএম,	
lesense,	লেসেন্স,	লাইসেন্স,	
biplabee,	বিপ্লবী,	বিপ্লবী,	
jewellery,	জেযােলিরি,	জুয়েলারির,	
avetar,	অভিটার,	অবতার,	
akram,	আকরাম,	আকরাম,	
toxoid,	টক্সবেদ,	টক্সয়েড,	
canservatian,	কান্সারবেশন,	কনসারভেশন,	
byaboharkari,	ব্যবহারকারী,	ব্যবহারকারী,	
jamjamat,	জামজামত,	জমজমাট,	
dewaben,	দেওয়াবেন,	দেওয়াবেন,	
nathivookteer,	নথিভক্তির,	নথিভুক্তির,	
borkhastokritora,	বরখাস্তকৃকতা,	বরখাস্তকৃতরা,	
ancholgoolir,	অঞ্চলগুলির,	অঞ্চলগুলির,	
premoronge,	প্রেমরণগে,	প্রেমরঙে,	
siqhar,	সিকার,	শিকার,	
ajuhat,	অজুহাত,	অজুহাত,	
premo,	প্রেমো,	প্রিমো,	
aasirbaad,	আসিরবাদ,	আশির্বাদ,	
sikkharthirao,	শিক্ষার্থীরাও,	শিক্ষার্থীরাও,	
shajano,	শাজানো,	সাজানো,	
suraropito,	সুরারোপিত,	সুরারোপিত,	
keyboarder,	কেব্যার্ডার,	কীবোর্ডের,	
makong,	মাকং,	মেকং,	
uporoshtho,	উপরশ্থ,	উপরস্থ,	
jaruri,	জারুরি,	জরূরী,	
maudelti,	মাউডেলটি,	মডেলটি,	
sarder,	সারদের,	সরদার,	
dosha,	দোশা,	দোসা,	
khoka,	খোকা,	খোকা,	
diznee,	ডিজনি,	ডিজনী,	
bojhaao,	বোঝাও,	বোঝাও,	
purohitra,	পুরোহিত্র,	পুরোহিতরা,	
rakshanbhag,	রক্ষণভাগ,	রক্ষণভাগ,	
gaddaafee,	গাড্ডফী,	গাদ্দাফী,	
siddhantoo,	সিদ্ধান্তৌ,	সিদ্ধান্তও,	
jeten,	জেটেন,	জেতেন,	
andra,	আন্দ্রার,	আন্ড্রা,	
byomkesh,	ব্মককেশ,	ব্যোমকেশ,	
sbaajan,	স্বজান,	স্বজন,	
jibnagore,	জীবনাগরে,	জীবননগর,	
bachai,	বাছাই,	বাছাই,	
bhoutikeshu,	ভৌতিকেশু,	ভৌতিকেষু,	
ostad,	ওস্তাদ,	ওস্তাদ,	
calabe,	ক্যালাবে,	চালাবে,	
rojapalaner,	রোজাপালনের,	রোজাপালনের,	
uddhritir,	উদ্ধৃতির,	উদ্ধৃতির,	
aakkas,	আক্কাস,	আককাস,	
shardotsobei,	শার্দোৎসবেই,	শারদোৎসবেই,	
jakso,	জাকোসো,	যক্ষ,	
militarite,	মিলিটারিতে,	মিলিটারিতে,	
ganokantha,	গণকা্ঠ,	গণকণ্ঠ,	
nibeditar,	নিবেদিতার,	নিবেদিতার,	
stona,	স্তনা,	স্টোন,	
kaande,	কাঁ্ডে,	কাণ্ডে,	
nosihote,	নসিহতে,	নসিহতে,	
shibraj,	শিবরাজ,	শিবরাজ,	
humira,	হুমিরা,	হুমিরা,	
welcome,	ওয়েলকম,	ওয়েলকাম,	
arg,	আর্জ,	আর্গ,	
ovinetar,	অভিনেতার,	অভিনেতার,	
sthapanatir,	স্থাপানাটির,	স্থাপনাটির,	
sahocorje,	সহকর্যে,	সাহচর্যে,	
nothivukto,	নথিভুক্ত,	নথিভুক্ত,	
drissotir,	দৃশতির,	দৃশ্যটির,	
alpa,	আলপা,	অল্প,	
jolbe,	জলবে,	জ্বলবে,	
shatodha,	শাতোধা,	শতধা,	
hurricane,	হুর্িকানে,	হ্যারিকেন,	
directorete,	ডারেক্টরিতে,	ডিরেক্টরেট,	
tantubayer,	তন্তুবায়ের,	তন্তুবায়ের,	
lendol,	লেন্ডল,	লেন্ডল,	
chai,	চাই,	ছাই,	
lagto,	লাগত,	লাগতো,	
armori,	আরমরী,	আরমোরি,	
kinsha,	কিনশা,	কিংস,	
muchlima,	মুছলিমা,	মুছলিমা,	
nagorikkey,	নাগরিককে,	নাগরিককে,	
somonwitobhabey,	সমন্বিতভাবে,	সমন্বিতভাবে,	
mekong,	মেকং,	মেকং,	
america,	আমেরিকা,	আমেরিকা,	
heze,	হেজে,	হেজ,	
ponchaasjon,	পঞ্চাসজন,	পঞ্চাশজন,	
brindaboney,	বৃন্দাবনে,	বৃন্দাবনে,	
karim,	কারিম,	করিম,	
hock,	হক,	হুক,	
projanankal,	প্রজাননকাল,	প্রজননকাল,	
irana,	ইরানা,	ইরান,	
nischitobhave,	নিশ্চিতভাবে,	নিশ্চিতভাবে,	
giitikobita,	গীতিকিববতা,	গীতিকবিতা,	
mardud,	মারদুদ,	মরদুদ,	
mononiitoder,	মনোনীতদের,	মনোনীতদের,	
gitikobita,	গীতিকবিতা,	গীতিকবিতা,	
unitgulo,	ইউনিটগুলো,	ইউনিটগুলো,	
alexanderke,	আলেক্সান্দ্রিকে,	আলেকজান্ডারকে,	
shaater,	সাতের,	শ্যুটার,	
hevy,	হিভি,	হেভি,	
romjaner,	রোমজানের,	রমযানের,	
soolke,	সুলকে,	শুল্কে,	
ovidhanik,	অভিধানিক,	অভিধানিক,	
akhando,	অখণ্ড,	অখন্ড,	
sthapanagulo,	স্থাপানাগুলো,	স্থাপনাগুলো,	
dobhara,	ডোভারা,	ডোভার,	
rajan,	রাজন,	রাজন,	
chakti,	চকক্তি,	চাকতি,	
parabortee,	পরবর্তী,	পরর্বতী,	
panchadadu,	পঞ্চদদদু,	পঞ্চাদাদু,	
chhotogolper,	ছোটগল্পের,	ছোটগল্পের,	
chapal,	চাপাল,	চপল,	
venkates,	ভেঙ্কটেস,	ভেঙ্কটেশ,	
angkita,	অংটিতা,	অঙ্কিতা,	
elaakaa,	এলাকা,	এলাকা,	
ateetkaale,	আতিককালে,	অতীতকালে,	
manober,	মননবের,	মানবের,	
rokkhonabekkhoner,	রক্ষণাবেকানশের,	রক্ষণাবেক্ষণের,	
khaschandpur,	খাসচাঁদপুর,	খাসচাঁদপুর,	
karmojog,	কর্মযোগ,	কর্মযোগ,	
abhidhaner,	অভিধানের,	অভিধানের,	
trabuco,	ট্র্বুকো,	ট্র্যাবুকো,	
korijachilen,	করিযাছিলেন,	করিযাছিলেন,	
hastamathun,	হস্তমাঠুন,	হস্তমথুন,	
vagni,	ভাগ্নি,	ভগ্নী,	
phund,	ফান্ড,	ফান্ড,	
atorkitey,	অতরকিতে,	অতর্কিতে,	
keu,	কেউ,	কেউ,	
janmat,	জা্মত,	জন্মাত,	
byabaharkareederke,	ব্যবহারকারীদেরকে,	ব্যবহারকারীদেরকে,	
pathanirdeshona,	পাঠানির্দেশন,	পথনির্দেশনা,	
chalochchitraeei,	চলচ্চিত্রায়,	চলচ্চিত্রেই,	
bhaibon,	ভাইবন,	ভাইবোন,	
swarther,	স্বার্থের,	স্বার্থের,	
boiragirhat,	বৈরাগিরহাট,	বৈরাগিরহাট,	
anektai,	অনেকটাই,	অনেকটাই,	
hosne,	হোসেন,	হোসনে,	
adhikartai,	অধিকারটাই,	অধিকর্তাই,	
batikromshalee,	বাতীক্রমহল,	ব্যতিক্রমধর্মী,	
ansarir,	আনসারীর,	আনসারীর,	
kailashrao,	কৈলাশ্রারও,	কৈলাশরাও,	
rasunkunchi,	রসুুংচুঁচি,	রসুনকুঁচি,	
nirgoon,	নিরগুঁ,	নির্গুণ,	
dakteekiter,	ডাক্তিকিতের,	ডাকটিকিটের,	
ekirokom,	একিরকম,	একইরকম,	
duiekdiner,	ডুইকেন্ডিনের,	দুইএকদিনের,	
camerapersoner,	ক্যামেরাপররসেের,	ক্যামেরাপার্সনের,	
pyor,	প্রো,	পিওর,	
fishing,	ফিশিং,	ফিসিং,	
logotype,	লোগোটাইপ,	লোগোটাইপ,	
aatmobishwasi,	আত্মবিশ্বাসী,	আত্মবিশ্বাসী,	
qaferder,	কাফেরদের,	কাফেরদের,	
heart,	হার্ট,	হার্ট,	
vabook,	ভববক,	ভাবুক,	
croak,	ক্রোয়াক,	ক্রোক,	
pichte,	পিছতে,	পিছতে,	
drissogulo,	দৃশ্যগুলো,	দৃশ্যগুলো,	
kormobuddhite,	কর্মবুদ্ধিতে,	কর্মবুদ্ধিতে,	
nimnosakkharkari,	নিম্নসস্ক্রকারী,	নিম্নস্বাক্ষরকারী,	
kusumeshu,	কুসুমেশু,	কুসুমেষু,	
buth,	বুথ,	বুথ,	
murali,	মুরালি,	মুরলী,	
onker,	অঙ্কার,	ওঙ্কার,	
lubitz,	লুবিৎজ,	লুবিৎজ,	
akkelpure,	আক্কেলপারে,	আক্কেলপুরে,	
shudhui,	শুধুই,	শুধুই,	
sangitanusthane,	সঙ্গীতানুষ্ঠানে,	সঙ্গীতানুষ্ঠানে,	
grahoksebai,	গ্রাহকসেবাই,	গ্রাহকসেবায়,	
ongkush,	অং্ুংশ,	অংকুশ,	
rajyotiro,	রাজ্যতিরও,	রাজ্যটিরও,	
stoic,	স্টোইএক,	স্টোয়িক,	
minilosar,	মিনিকোসার,	মিনিলোসার,	
bastubad,	বাস্তুবাদ,	বস্তুবাদ,	
chilahaati,	চিলাহাতি,	চিলাহাটি,	
ishton,	ইষ্টন,	স্টোন,	
inapharameshana,	ইনফফরেমনশা,	ইনফরমেশন,	
jakatke,	জাকাতকে,	যাকাতকে,	
chowdhuryke,	চৌধুরীকে,	চৌধুরীকে,	
nazad,	নাজাদ,	নাজাদ,	
ipl,	আইপিএল,	আইপিএল,	
geographics,	জিওগ্রাফিক্স,	জিওগ্রাফিকস,	
karmasampadon,	কর্মসম্পনদন,	কর্মসম্পাদন,	
korkotkraantee,	কর্কটোক্রান্তি,	কর্কটক্রান্তি,	
karadando,	কারাদন্ড,	কারাদণ্ড,	
khude,	খুদে,	ক্ষুদে,	
bohorompurer,	বহরমপুরের,	বহরমপুরের,	
blyaka,	ব্লাইকা,	ব্ল্যাক,	
moshjidke,	মশ্িদকে,	মসজিদকে,	
madraser,	মাদ্রাসের,	মাদ্রাজের,	
madeling,	মেডলিিং,	মডেলিং,	
musolmanera,	মুসলমানেরা,	মুসলমানেরা,	
nathivookto,	নথিভক্ত,	নথিভুক্ত,	
groth,	গ্রোথ,	গ্রোথ,	
shatokeo,	শতকেও,	শতকেও,	
durlabhatwang,	দুর্লাভ্তং,	দুর্লভত্বং,	
babona,	বাবনা,	বাবনা,	
anchalsaho,	অঞ্চলসহ,	অঞ্চলসহ,	
byepass,	ব্যাপিস,	বাইপাস,	
bisshonath,	বিশ্বনাথ,	বিশ্বনাথ,	
shilpojaat,	শিল্পজাত,	শিল্পজাত,	
bosben,	বসবেন,	বসবেন,	
sumita,	সুমিতা,	সুমিতা,	
doula,	দৌলা,	দৌলা,	
teenisa,	টেনিসা,	টেনিস,	
colgirl,	কোজগ্রিল,	কলগার্ল,	
jumlalancer,	জুমলেলান্সের,	জুমলাল্যান্সার,	
tukroke,	তুকরকে,	টুকরোকে,	
dooburira,	দুবুরুরা,	ডুবুরিরা,	
sahooseekotar,	সহঅসিকতার,	সাহসিকতার,	
prokolpow,	প্রকল্পব,	প্রকল্পও,	
quota,	কুওতা,	কোটা,	
muradkey,	মুরাদকে,	মুরাদকে,	
ikbaaler,	ইকবালের,	ইকবালের,	
basaake,	বাসাকে,	বাসাকে,	
abeganuvutir,	আবেগানুভুতির,	আবেগানুভূতির,	
shootar,	শুতার,	শ্যুটার,	
deliver,	ডেলিভার,	ডেলিভার,	
mumtazer,	মুমতাজের,	মুমতাজের,	
supplenza,	সাপ্লমেঞ্জা,	সাপলেঞ্জা,	
cheekitsar,	চিকিৎসার,	চিকিত্সার,	
vitti,	ভিত্তি,	ভিত্তিই,	
krishibigyani,	কৃষিবিজ্ঞানী,	কৃষিবিজ্ঞানী,	
khudhartara,	ক্ষুধারতরা,	ক্ষুধার্তরা,	
batom,	ব্যাটোম,	বাটম,	
zeland,	জালান্ড,	জিল্যান্ড,	
surke,	সুরকে,	সুরকে,	
suporichita,	সুপরিচিত,	সুপরিচিত,	
poketchorder,	পোচেচররদের,	পকেটচরদের,	
relance,	রিল্যান্স,	রিলায়েন্স,	
durarohini,	দুরারোহীনী,	দুরারোহিণী,	
kod,	কোদ,	কোড,	
mosjidsoho,	মসজিদসহ,	মসজিদসহ,	
muhurtati,	মুহুর্তটি,	মুহুর্তটি,	
barnis,	বার্িিস,	বার্নিশ,	
nili,	নিলি,	নিলি,	
graambaasheeo,	গ্রামবাশিও,	গ্রামবাসীও,	
amanisha,	আমানিশা,	অমানিশা,	
grambaaseeder,	গ্রামববীদের,	গ্রামবাসীদের,	
gabhaaskar,	গাভাস্কার,	গাভাস্কার,	
nartana,	নরতানা,	নর্টন,	
onchalgulir,	অঁচালগুলির,	অঞ্চলগুলির,	
oojbekistan,	ওজবেকিত্নান,	উজবেকিস্তান,	
grotha,	গ্রোথা,	গ্রোথ,	
akpashe,	আকপাশে,	একপাশে,	
bhumija,	ভূমিজা,	ভূমিজ,	
vimsen,	ভিমসেন,	ভীমসেন,	
sithilotar,	সিথিলতার,	শিথিলতার,	
durgotsab,	দুর্গোৎসব,	দুর্গোৎসব,	
dekaner,	দেকানের,	দেকানের,	
sthitiko,	স্থিতিকো,	স্থিতিকো,	
goonoman,	গণমমান,	গুণমান,	
kosambir,	কোসাম্বীর,	কোসাম্বীর,	
nichupattir,	নিচুপত্তির,	নিচুপট্টির,	
proshadhoner,	প্রশাধনের,	প্রসাধনের,	
baarnish,	বার্নিশ,	বার্নিশ,	
nilfamarir,	নীলফামারির,	নীলফামারীর,	
laaishenshh,	লয়েশনশ,	লাইসেন্স,	
bojhao,	বোঝাও,	বোঝাও,	
korimer,	করিমের,	করিমের,	
parqa,	পারকা,	পার্ক,	
kraanti,	ক্রান্তি,	ক্রান্তি,	
furio,	ফুরিও,	ফুরিও,	
chakrapani,	চক্রপানি,	চক্রপানী,	
mousumeo,	মৌসুমেও,	মৌসুমেও,	
arashie,	আরাশী,	আরসিএ,	
dajhyo,	দাঝ্য,	দাহ্য,	
debdebie,	দেবদেবী,	দেবদেবী,	
nirobota,	নিরবতা,	নিরবতা,	
dakshinangsho,	দক্ষিণাংশ,	দক্ষিণাংশ,	
kanshater,	কাশশাের,	কানসাটের,	
janamukhi,	জনমুখী,	জনমুখী,	
amor,	আমর,	আমর,	
bagdadii,	বাগদাদি,	বাগদাদী,	
noiteekotar,	নৈতেকতার,	নৈতিকতার,	
sarboporee,	সর্বপরি,	সর্বোপরী,	
mane,	মানে,	মানে,	
itostatah,	ইতস্তাহা,	ইতস্ততঃ,	
ekshoti,	একশতি,	একশোটি,	
lopjonito,	লপজনিত,	লোপজনিত,	
ashirbadatri,	অশির্বাদাত্রী,	আশীর্বাদাত্রী,	
orthanitir,	অর্থানীতির,	অর্থনীতির,	
expreshshion,	এক্সপ্রেশন,	এক্সপ্রেশন,	
tetela,	টেটেলা,	টাইটেল,	
literacy,	লিটারেকি,	লিটারেসি,	
porizoner,	পরিজনের,	পরিজনের,	
jhalkanite,	ঝলকানিতে,	ঝলকানীতে,	
treend,	ট্রিন্ড,	ট্রেন্ড,	
ragei,	রাগেই,	রাগেই,	
ghatla,	ঘাটলা,	ঘটল,	
pleta,	প্লেট,	প্লেটো,	
saainyo,	সাইন্য,	সৈন্য,	
ul,	উল,	উল,	
foreks,	ফোরক্স,	ফরেক্স,	
sanaktokaran,	সনক্তকরণ,	সনাক্তকরণ,	
mausumeo,	মউসুমেও,	মৌসুমেও,	
poribahokotto,	পরিবাহকত্ব,	পরিবাহকত্ব,	
jotharthovabey,	যথার্থবাবে,	যথার্থভাবে,	
soomitrar,	সুমিত্রার,	সুমিত্রার,	
quartar,	কোয়ের্তার,	কোয়ার্টার,	
deeares,	ডিয়েরেস,	ডিআরএস,	
sontoshpur,	সন্তশপুর,	সন্তোষপুর,	
abhijitda,	অভিজিদদা,	অভিজিতদা,	
sectore,	সেক্টরে,	সেক্টরে,	
gaziipur,	গজীজিপুর,	গাজীপুর,	
smarak,	স্মরাক,	স্মারক,	
saalsa,	সালসা,	সালসা,	
aporishodhito,	অপরিশধহিত,	অপরিশোধিত,	
vetrillocuism,	ভেট্রিলালিয়াস,	ভেট্রিলোকুইজম,	
shcholastic,	ষ্কলাস্টিক,	স্কলাস্টিক,	
salmaner,	সালমানের,	সালমানের,	
ganakantha,	গণকান্ঠ,	গণকণ্ঠ,	
baarbadoj,	বারবদোজ,	বার্বাডোজ,	
nathivukta,	নথিভুক্ত,	নথিভুক্ত,	
jaadrel,	যাদেরেল,	জাঁদরেল,	
bishhnu,	বিষ্ণু,	বিষ্ণু,	
mohajot,	মহাজত,	মহাজোট,	
kaley,	কালে,	কালে,	
venush,	ভেনুশ,	ভেনাস,	
kyatgarite,	ক্যাটগারিতে,	ক্যাটগারিতে,	
gobeshokgon,	গবেষকগণ,	গবেষকগণ,	
chongar,	চঙ্গার,	চোঙ্গার,	
nachiketa,	নচিকেতা,	নচিকেতা,	
chikitsanirbhar,	চিকিৎসানির্ভর,	চিকিৎসানির্ভর,	
tigmanshu,	টিগমানশু,	তিগ্মাংশু,	
sulfatee,	সুলফেট,	সালফেট,	
amarjito,	অমর্জিত,	অমার্জিত,	
arekdol,	আরেকদল,	আরেকদল,	
nariider,	নারীদের,	নারীদের,	
byabaharkaree,	ব্যবহারকারী,	ব্যবহারকারী,	
paolasthi,	পাওলস্থি,	পাওলাসথি,	
pinogbagke,	পিনবোগভাগে,	পিনগবাগকে,	
ghotleo,	ঘটলেও,	ঘটলেও,	
santaa,	সান্তা,	সান্তা,	
forex,	ফোরেক্স,	ফরেক্স,	
oswasteekor,	অস্বস্তিকর,	অস্বস্তিকর,	
licencer,	লাইসেন্সের,	লাইসেন্সের,	
tarkareer,	তর্করীর,	তরকারীর,	
salapheeta,	সালফেটি,	সালফেট,	
swajan,	স্বজন,	স্বজন,	
ralf,	রালফ,	রালফ,	
suhasini,	সুহাসিনি,	সুহাসিনী,	
juktorastrer,	যুক্তরাস্ত্রের,	যুক্তরাষ্ট্রের,	
mandondo,	মণ্দন্ড,	মানদণ্ড,	
deejeejer,	ডিজেজীর,	ডিজিজের,	
parikhar,	পারিখর,	পরিখার,	
tookrote,	তুকর্তে,	টুকরোতে,	
abhidhaaneeck,	অভিধানিক,	অভিধানিক,	
dharabahikvabe,	ধারাবাহিকভাবে,	ধারাবাহিকভাবে,	
shroddhabihin,	শ্রদ্ধাবিহীন,	শ্রদ্ধাবিহীন,	
balithubar,	বালিথুবার,	বালিথুবার,	
nothibhukteer,	নথিভুক্তির,	নথিভুক্তির,	
nutaner,	নুতানের,	নূতনের,	
sinakey,	সিনাকে,	সিনাকে,	
pyatarne,	প্যাটার্ন,	প্যাটার্নে,	
ghumachhe,	ঘুমাছে,	ঘুমাচ্ছে,	
modelgulo,	মডেলগুলো,	মডেলগুলো,	
aaireshe,	আইরেশে,	আইরেসে,	
madhnagar,	মধনগর,	মাধনগরের,	
jyaqa,	জ্যাক,	জ্যাক,	
serup,	সেরূপ,	সেরূপ,	
encidablu,	এনসিভাবলু,	এনসিডাব্লু,	
dhyana,	ধ্যান,	ধ্যান,	
kirti,	কীর্তি,	কীর্তি,	
sthapona,	স্থাপনা,	স্থাপনা,	
aanaan,	আনাান,	আনান,	
victor,	ভিক্টর,	ভিক্টর,	
becha,	বেচা,	বেচা,	
omeettrakkhor,	অমিত্রাক্ষর,	অমিত্রাক্ষর,	
chargar,	চরগর,	চার্জার,	
amanisa,	আমানিসা,	অমানিশা,	
sumi,	সুমি,	সুমি,	
byke,	বাইক,	বাইক,	
katiusha,	কাটিউশা,	কাতিউশা,	
uddhrito,	উদ্ধৃত,	উদ্ধৃত,	
gabhaskaar,	গভবসকর,	গাভাস্কার,	
choudhursoho,	চৌধুরসহ,	চৌধুরসহ,	
mythological,	মাথিলজিক্যাল,	মাইথলজিকাল,	
magrey,	ম্যাগ্রি,	ম্যাগ্রে,	
songbadmadhyomer,	সংবাদমাধ্যমের,	সংবাদমাধ্যমের,	
purbancoler,	পূর্বানললের,	পূর্বাঞ্চলের,	
duple,	ডুপল,	ডুপ্লে,	
proteemar,	প্রতিমার,	প্রতিমার,	
palbongser,	পালবংসের,	পালবংশের,	
chandanara,	চন্দনারা,	চন্দনারা,	
hastantar,	হস্তান্তর,	হস্তান্তর,	
sanaktokaron,	সনক্তকরণ,	সনাক্তকরণ,	
chet,	চেট,	চ্যাট,	
ghamta,	ঘামটা,	ঘোমটা,	
danab,	দানাব,	দানব,	
niketaner,	নিকেতানের,	নিকেতনের,	
rilayensa,	রিলেয়েনসা,	রিলায়েন্স,	
oncholshomuh,	অন্চলসমূহ,	অঞ্চলসমূহ,	
protijogi,	প্রতিযোগী,	প্রতিযোগী,	
biplobi,	বিপ্লবী,	বিপ্লবী,	
uindos,	ইউন্দোস,	উইন্ডোস,	
golghare,	গলঘরে,	গোলঘরে,	
anutpadanshil,	অনুতপাদনশীল,	অনুৎপাদনশীল,	
faase,	ফেস,	ফাঁসে,	
oporishodhito,	অপরিশোধিত,	অপরিশোধিত,	
rakkhanbhag,	রক্ষণভাগ,	রক্ষণভাগ,	
jaaygata,	জাজগাতা,	জায়গাটা,	
mandarbani,	মন্দরবাণী,	মন্দারবাণী,	
beauby,	বিউবি,	বিউবি,	
mukhabandha,	মুখবন্ধ,	মুখবন্ধ,	
showtey,	শতউ,	শোতে,	
dorun,	দোরুন,	দরুণ,	
spreadshiit,	স্প্রেডশিিট,	স্প্রেডশীট,	
horash,	হোরাশ,	হোরাস,	
lebina,	লেবিনা,	লেবিনা,	
doorotaumo,	দূরতুমো,	দূরতম,	
mukhobondho,	মুখবন্ধ,	মুখবন্ধ,	
majlishpur,	মজলিশপুর,	মজলিশপুর,	
difinision,	ডিফাইনিসন,	ডেফিনেশন,	
aakaabar,	আকাবার,	আকাবার,	
guha,	গুহা,	গোহ,	
doneta,	ডোনেটা,	ডোনাট,	
cholochchitro,	চলচ্চিত্র,	চলচ্চিত্র,	
schilling,	সিলিল্ং,	শিলিং,	
kheshar,	খেশার,	খেশার,	
gagee,	গাগী,	গেজ,	
sangosrobomukto,	সংস্রভমুক্ত,	সংস্রবমুক্ত,	
nobotomo,	নবতম,	নবতম,	
ala,	আলা,	আলা,	
heena,	হীনা,	হেনা,	
dii,	দিয়ি,	দিই,	
ganonanatto,	গণনানত্ত,	গণনাট্য,	
laishensh,	লেশনেশ,	লাইসেন্স,	
obosan,	অবসান,	অবসান,	
darjiling,	দার্জিলিং,	দার্জিলিং,	
musalmanderke,	মুসলমানদীরকে,	মুসলমানদেরকে,	
plate,	প্ল্যাটে,	প্লেটে,	
dhwajbhango,	ধ্বাবজঙ্গ,	ধ্বজভঙ্গ,	
bhittitei,	ভিত্তিতেই,	ভিত্তিতেই,	
vangley,	ভ্যাংলে,	ভাঙলে,	
hitaishi,	হিতাইশি,	হিতৈষী,	
vedanta,	ভেদান্তা,	বেদান্ত,	
spreedashita,	স্প্রীদাশিত,	স্প্রেডশীট,	
oncholtee,	অনচল্টি,	অঞ্চলটি,	
liaodong,	লিয়াাংং,	লিয়াওদং,	
beam,	বিয়াম,	বিম,	
pathkrom,	পাঠকররম,	পাঠক্রম,	
antercticker,	আন্টার্কটটিকের,	অ্যান্টার্কটিকের,	
chaka,	চাকা,	চাকা,	
soteciety,	সটেসিটি,	সোসাইটিতে,	
karpeter,	কারপেটের,	কার্পেটের,	
malinga,	মালিঙ্গা,	মালিংগা,	
sanghar,	সংহর,	সংহার,	
bonbhumi,	বনভূমি,	বনভূমি,	
shnaipara,	শ্নাইপরা,	স্নাইপার,	
chalochchitreer,	চলচ্চিত্রীর,	চলচ্চিত্রের,	
ukeliptas,	ইউকিলপাইটাস,	ইউক্যালিপ্টাস,	
punorabortonte,	পুনরবর্তন্তে,	পুনরাবর্তন্তে,	
muhuriganj,	মুহুরীগঞ্জ,	মুহুরীগঞ্জ,	
hariken,	হারিকেন,	হ্যারিকেন,	
ghotaibe,	ঘটাইবে,	ঘটাইবে,	
bisshasyi,	বিশ্বাসী,	বিশ্বাসই,	
osthisondhi,	অস্থিসন্ধি,	অস্থিসন্ধি,	
conflikt,	কনফ্লিক্ট,	কনফ্লিক্ট,	
mayily,	মেয়েলি,	মাইলি,	
nirarthak,	নিরার্থক,	নিরর্থক,	
ssahocorze,	স্যাহচর্জে,	সাহচর্যে,	
ganochien,	গানচিয়েন,	গণচীন,	
anagarikra,	অনাগারিকরা,	অনাগরিকরা,	
vittimul,	ভিত্তিমূল,	ভিত্তিমূল,	
osamarik,	ওসামারিক,	অসামরিক,	
bikargrosto,	বিকারগ্রস্ত,	বিকারগ্রস্ত,	
bohudeen,	বহুদীন,	বহুদিন,	
gannaprakasham,	গণ্নাপ্রকাশম,	গন্নাপ্রকাশম,	
khalid,	খালিদ,	খালিদ,	
siddhanto,	সিদ্ধান্ত,	সিদ্ধান্তও,	
sadeena,	সাদেনা,	সাডেন,	
mukhomondoler,	মুখমন্ডলের,	মুখমণ্ডলের,	
magical,	ম্যাজিক্যাল,	ম্যাজিকাল,	
sombhobonaao,	সম্ভবনাও,	সম্ভবনাও,	
bosontokke,	বসন্তককে,	বসন্তকে,	
sohinsotar,	সোহিনসতার,	সহিংসতার,	
rajbondir,	রাজবন্দীর,	রাজবন্দীর,	
neerbahi,	নের্বাহী,	নির্বাহি,	
baibasthaar,	বৈববস্থার,	ব্যবস্থার,	
sangbadmadhyame,	সংবাদমাধ্যমে,	সংবাদমাধ্যমে,	
khoakshir,	খোয়াক্ষির,	খোয়াক্ষীর,	
shulfate,	শুলফেট,	সালফেট,	
ikboler,	ইকবলের,	ইকবলের,	
monroe,	মনরই,	মনেরোর,	
jansa,	জানসা,	জন্স,	
futonta,	ফুটোন্টা,	ফুটন্ত,	
alpo,	অল্পো,	অল্প,	
carlosh,	কার্লোশ,	কার্লোস,	
cs,	সিএসএস,	সিএস,	
joisttho,	জৈশ্ব্থ,	জ্যৈষ্ঠ,	
daktickete,	ডাক্টিকোটে,	ডাকটিকিটে,	
shipley,	শিপলি,	শিপলে,	
bethikata,	বেথিকাটা,	বেঠিকতা,	
jhijhi,	ঝিঝি,	ঝিঝি,	
shorifer,	শরিফার,	শরিফের,	
nagorikderkey,	নাগরিকদেরকে,	নাগরিকদেরকে,	
zohns,	জাহনস্,	জন্স,	
sutir,	সুতির,	সুতির,	
karmazog,	কারমাোগ,	কর্মযোগ,	
drishi,	দৃশী,	দৃশ্যই,	
poscater,	পোস্কেটের,	পশ্চাতের,	
meshintao,	মেশিনটাও,	মেশিনটাও,	
norfolk,	নরফলক,	নরফোক,	
tintikey,	টিনটিকে,	তিনটিকে,	
nagorikra,	নাগরিকরা,	নাগরিকেরা,	
alkatra,	আলকাতরা,	আলকাতরা,	
obhijojan,	অভিযোজন,	অভিযোজন,	
rekhapat,	রেখাপাত,	রেখাপাত,	
deqe,	দেকে,	ডেকে,	
koyeeri,	কইিরি,	কোয়েরি,	
zoojyota,	যৌজ্যতা,	যোজ্যতা,	
veenis,	ভেনিস,	ভেনিস,	
ganosachetanata,	গণসচেতনাতা,	গণসচেতনতা,	
popaike,	পোপাইকে,	পপাইকে,	
aagera,	আগেরা,	আগোরা,	
cantan,	ক্যান্টান,	ক্যান্টন,	
teenej,	তেনেজ,	টিনেজ,	
annorup,	অন্যরূপ,	অন্যরূপ,	
mosharroph,	মোশারফো,	মশাররফ,	
steena,	স্টিন,	স্টেন,	
byabostho,	ব্যবস্থ,	ব্যাবস্থা,	
mesenjarer,	মেেনজেজারের,	মেসেঞ্জারের,	
prodiiper,	প্রদীপের,	প্রদীপের,	
srabosty,	স্রাবস্টি,	শ্রাবস্তী,	
kinto,	কিন্তো,	কিনত,	
ministara,	মিনিস্টরা,	মিনিস্টার,	
parka,	পারকা,	পার্ক,	
evereste,	ইভারেস্টে,	এভারেস্টে,	
elakaasoho,	এলাকাসহ,	এলাকাসহ,	
alpakichudin,	অল্পকিছুড়িন,	অল্পকিছুদিন,	
lyandim,	ল্যান্ডিং,	ল্যান্ডিং,	
futote,	ফুটোতে,	ফুটোতে,	
raiialati,	রাইয়ালটি,	রয়্যালটি,	
ishtone,	ইস্তোন,	স্টোন,	
gazetted,	গ্যাজেটেড,	গেজেটেড,	
phiksa,	ফিকসা,	ফিক্স,	
joki,	জকি,	জকি,	
roopdaan,	রূপডান,	রুপদান,	
feemalee,	ফিমালী,	ফিমেল,	
edmiral,	এডমিরাল,	এডমিরাল,	
bosontoke,	বসন্তকে,	বসন্তকে,	
naper,	নাপের,	ন্যাপের,	
dharavahiker,	ধারাভাহিকের,	ধারাবাহিকের,	
qor,	কোর,	কর,	
jhamala,	ঝামালা,	ঝামালা,	
accountdharira,	একাউন্টধররিরা,	একাউন্টধারীরা,	
shariba,	শরিবা,	শরিবা,	
jeebnagore,	জীবনাগরে,	জীবননগর,	
ajeejer,	আজিজের,	আজিজের,	
saom,	সাওম,	সাওম,	
alimpiqa,	আলিমপিকা,	অলিম্পিক,	
bhorkendra,	ভরকেন্দ্রের,	ভরকেন্দ্র,	
landin,	ল্যান্ডিন,	ল্যান্ডিং,	
durbhagya,	দূর্ভাগ্য,	দূর্ভাগ্য,	
udbhaboney,	উদ্ভাবনে,	উদ্ভাবনে,	
windos,	উইন্দোস,	উইন্ডোস,	
dhaanche,	ধাঁচে,	ধাঁচে,	
vorkendra,	ভর্কেন্দ্র,	ভরকেন্দ্র,	
procharona,	প্রচারণা,	প্রচারণা,	
prapokkey,	প্রাপক্কে,	প্রাপককে,	
spancer,	স্প্যান্সের,	স্পেন্সার,	
eupheike,	ইউফেকেই,	ইউফেইকে,	
harja,	হারজা,	হার্জ,	
pachattar,	পাচাত্তা,	পাচাত্তার,	
kaansaat,	কানসাট,	কানসাট,	
sector,	সেক্টর,	সেক্টর,	
breel,	ব্রিল,	ব্রিল,	
madhumati,	মধুমতি,	মধুমতী,	
madhobi,	মাধবী,	মাধবী,	
kokeyin,	কোকেইন,	কোকেইন,	
bhupal,	ভুপাল,	ভূপাল,	
lidars,	লিডার্স,	লিডার্স,	
marodeho,	মারোদেহো,	মরদেহ,	
maarmaader,	মার্মাদের,	মারমাদের,	
pretty,	প্রিটি,	প্রিটি,	
nyata,	ন্যাট,	ম্যাট,	
qara,	কারা,	কর,	
asamanyo,	অসামান্য,	অসামান্য,	
dipgulote,	দিপগুলোতে,	দ্বীপগুলোতে,	
adorso,	আদরসসো,	আর্দশ,	
harbare,	হরবারে,	হারবারে,	
fiksing,	ফিক্সিং,	ফিক্সিং,	
edic,	এডিক,	এডিক,	
mishal,	মিশাল,	মিশাল,	
donat,	দোনাট,	ডোনাট,	
upbrazillian,	ইপব্রাজিলিয়ান,	আপব্রাজিলিয়ান,	
siitei,	সীতেই,	শীতেই,	
obdee,	অব্দী,	অব্দি,	
koordira,	কোর্ডিরা,	কুর্দিরা,	
dadapur,	দাদাপুর,	দাদাপুর,	
siropa,	সিরোপা,	শিরোপা,	
bbosben,	বিবেসবেন,	বসবেন,	
concerter,	কনসার্টার,	কানসাটের,	
bondhuvabaponyo,	বন্ধুভাবপপন্য,	বন্ধুভাবাপন্ন,	
yak,	যক্,	ইয়াক,	
jacksoner,	জ্কানসের,	জ্যাকসনের,	
zerusalem,	জেরুসালেম,	জেরুজালেম,	
kalki,	কালকি,	কালকি,	
fising,	ফিসিং,	ফিসিং,	
ashanka,	আশানকা,	আশংকা,	
nodimaatrik,	নদিমাত্রিক,	নদীমাতৃক,	
hosbaleke,	হোসবালীকে,	হোসবালেকে,	
amarika,	আমারিকা,	আমেরিকা,	
maryir,	মারিয়ার,	ম্যারির,	
chorchita,	চর্চিতা,	চর্চিত,	
