shucharita,	শুচারিতা,	সুচরিতা,	
volapuk,	ভোলাপুক,	ভোলাপুক,	
stonehenje,	স্তনহেনজজজ,	স্টোনহেঞ্জ,	
daacktickete,	ডাযক্টিকেটে,	ডাকটিকিটে,	
ghoshito,	ঘোষিত,	ঘোষিত,	
indro,	ইন্দ্রো,	ইন্দ্র,	
jaaygata,	যায়গাতা,	জায়গাটা,	
mukharji,	মুখর্জি,	মুখার্জী,	
drissotir,	দৃষ্টতির,	দৃশ্যটির,	
duuma,	দুউমা,	দুমা,	
nathivookto,	নাথিভূক্ত,	নথিভুক্ত,	
osommotite,	অসম্মতিতে,	অসম্মতি,	
rupantarer,	রূপান্তরের,	রুপান্তরের,	
foloshrutite,	ফলশ্রুটিতে,	ফলশ্রুতিতে,	
samanwitovabe,	সমান্তিভাবাবে,	সমন্বিতভাবে,	
benojir,	বেনজির,	বেনজীর,	
rajbandir,	রাজবন্দির,	রাজবন্দীর,	
panda,	পান্ডা,	পান্ডে,	
chhintayikari,	ছিন্তায়কারীর,	ছিনতাইকারী,	
furio,	ফুরিও,	ফুরিও,	
tasminer,	তস্মিনের,	তাসমিনের,	
steen,	স্টিন,	স্টেন,	
masto,	মাস্তো,	মাস্ত,	
samajikatar,	সমজিকতার,	সামাজিকতার,	
moushumei,	মৌশুমেই,	মৌসুমেই,	
procharjontrogulo,	প্রচার্যর্ত্রগুলো,	প্রচারযন্ত্রগুলো,	
spancer,	স্পান্সার,	স্পেন্সার,	
sanstha,	সা্্স্থ,	সংস্থা,	
tarunra,	তারুনরা,	তরুণরা,	
qarpeta,	কারপেটা,	কার্পেট,	
metropalitana,	মেট্রোপালিটাল,	মেট্রোপলিটন,	
dadapur,	দাদাপুর,	দাদাপুর,	
pachchi,	পাচ্ছি,	পাচ্ছি,	
foxcon,	ফক্সকন,	ফক্সকন,	
jeebanjapon,	জীবনজাপন,	জীবনযাপন,	
yura,	যুররা,	ইউরো,	
rajtantrey,	রাজতন্ত্রে,	রাজতন্ত্রে,	
duio,	দুওয়,	দুইও,	
vault,	ভাউল্ট,	ভল্ট,	
baaiq,	বাইক,	বাইক,	
itastata,	ইটাস্টা,	ইতস্তত,	
koreempoor,	করিমপুর,	করিমপুর,	
angsogrohone,	অংসগ্রহণে,	অংশগ্রহনের,	
licenshe,	লিইসেশন,	লাইসেন্স,	
kaatbey,	কাটবে,	কাটবে,	
golghare,	গোলঘরে,	গোলঘরে,	
nojder,	নজদের,	নজদের,	
dadar,	দাদার,	দাদার,	
kyatgarite,	ক্যাটগারিতে,	ক্যাটগারিতে,	
qrisenta,	ক্রিসেন্টা,	ক্রিসেন্ট,	
heteler,	হেটেলের,	হেটেলের,	
chalochchitro,	চালচচ্চিত্র,	চলচ্চিত্র,	
rakhete,	রাখেতে,	রাখেতে,	
podarthobidder,	পদার্থবিদ্দের,	পদার্থবিদদের,	
bishshasho,	বিশ্বাশ,	বিশ্বাসও,	
landin,	ল্যান্ডিন,	ল্যান্ডিং,	
towraat,	টাওরাত,	তওরাত,	
borkhastokritora,	বর্ষাক্তরিত্রা,	বরখাস্তকৃতরা,	
akkharkey,	অক্ষরকে,	অক্ষরকে,	
nobotomo,	নবতম,	নবতম,	
teemothy,	তেমোথি,	টিমোথি,	
choudhurike,	চৌধুরিকে,	চৌধুরীকে,	
kraim,	ক্রাইম,	ক্রাইম,	
booponer,	বুপনের,	বপনের,	
sportstar,	স্পোর্টস্টার,	স্পোর্টসস্টার,	
liaodong,	লিয়াডোং,	লিয়াওদং,	
hariner,	হরিনের,	হরিণের,	
chalachchitroke,	চালাচিচ্ত্রকে,	চলচ্চিত্রকে,	
phood,	ফুড,	ফুড,	
madaspushto,	মাদাসুষ্ঠ,	মদদপুষ্ট,	
shhikara,	শিকারা,	শিকার,	
brittakare,	বৃত্যাকারে,	বৃত্তাকারে,	
chopol,	চপল,	চপল,	
bondishalatei,	বন্দিশালাতেই,	বন্দিশালাতেই,	
satarkokari,	সততরককারী,	সতর্ককারী,	
nazad,	নাজাদ,	নাজাদ,	
roopdaan,	রুপদান,	রুপদান,	
simantarkkhibahinir,	সিমান্ত্রকবিহানির,	সীমান্তরক্ষীবাহিনীর,	
artilary,	আর্টিলারি,	আর্টিলারি,	
bite,	বিতে,	বাইট,	
karu,	কারু,	কারু,	
jomjamat,	জমজামত,	জমজমাট,	
domonmulok,	দমননমূলক,	দমনমূলক,	
ancholgoolote,	অঞ্চলগুলোতে,	অঞ্চলগুলোতে,	
nirbaahe,	নির্বাহে,	নির্বাহে,	
glanio,	গ্লানিও,	গ্লানিও,	
shroddhabihin,	শ্রদ্ধবাহিনীন,	শ্রদ্ধাবিহীন,	
chire,	চিরে,	চিরে,	
daaun,	দাউন,	ডাউন,	
maner,	মেনের,	মানে,	
inphormeshon,	ইনফর্েশন,	ইনফরমেশন,	
torutoler,	তরুতলের,	তরুতলের,	
bbiswash,	বিব্বাসা,	বিশ্বাস,	
nischitobhave,	নিষ্চিতভভাবে,	নিশ্চিতভাবে,	
taap,	তাপ,	ট্যাপ,	
thare,	থারে,	থরে,	
goshthiti,	গোষ্ঠিটি,	গোষ্ঠীটি,	
neerbahi,	নির্বাহী,	নির্বাহি,	
bedanta,	বেদান্ত,	বেদান্ত,	
lobbytey,	লববিটি,	লবিতে,	
bishwaashshoi,	বিশ্বাস্ষই,	বিশ্বাসই,	
bisshaskey,	বিশ্বাক্ে,	বিশ্বাসকে,	
karima,	কারিমা,	করিম,	
keu,	কেউ,	কেউ,	
moshzidtike,	মোস্জিডিটিকে,	মসজিদটিকে,	
fand,	ফান্ড,	ফান্ড,	
esasiyetasa,	এসাসিয়েটসা,	এসোসিয়েটস,	
rojapalaner,	রোজাপালানের,	রোজাপালনের,	
bhogno,	ভগ্ন,	ভগ্ন,	
osthishondhi,	অস্থিনোধ্ধি,	অস্থিসন্ধি,	
mukhamandoler,	মুখামন্ডলের,	মুখমণ্ডলের,	
aranyani,	আরন্যানি,	অরণ্যানী,	
qarqa,	কার্কা,	কার্ক,	
janoganonar,	জানোগননার,	জনগণনার,	
stoic,	স্টিক,	স্টোয়িক,	
laaishheshh,	লাইশেশ,	লাইসেন্স,	
agomonke,	আগমনকে,	আগমনকে,	
bim,	বিএমএ,	বিম,	
upbasher,	উপবাশের,	উপবাসের,	
surke,	সুরকে,	সুরকে,	
meghacchonno,	মেঘাচ্ছনন,	মেঘাচ্ছন্ন,	
gorrer,	গরের,	গোরের,	
uttor,	উত্তর,	উওর,	
engrezder,	এংজার্ডের,	ইংরেজদের,	
uporitale,	উপরিতালে,	উপরিতলে,	
sthapona,	স্থাপোনা,	স্থাপনা,	
olympik,	অলিম্পিক,	অলিম্পিক,	
laesensh,	লেসেন্স,	লাইসেন্স,	
manushsoho,	মানুষসহ,	মানুষসহ,	
halding,	হাল্ডিং,	হোল্ডিং,	
somosto,	সমস্ত,	সমস্ত,	
pyatarne,	প্যাটার্নে,	প্যাটার্নে,	
average,	অ্যাভারাজ,	এভারেজ,	
tophaat,	টোয়াট,	তফাৎ,	
korle,	করলে,	করলে,	
chhon,	ছনন,	ছোঁ,	
torkareer,	তর্কারীর,	তরকারীর,	
windows,	উইন্ডস,	উইন্ডোস,	
modelkey,	মডেলকে,	মডেলকে,	
dokaanei,	ডোকানেই,	দোকানেই,	
nartana,	নার্টানা,	নর্টন,	
logic,	লোজিক,	লজিক,	
ponera,	পোনেরা,	পনের,	
nachar,	নাচর,	নাচার,	
oitijjo,	ঐতিহ্য,	ঐতিহ্য,	
philipiner,	ফিলিপিনের,	ফিলিপাইনের,	
goora,	গুরা,	গোর,	
survative,	সুরভভাটিভ,	সারভেটিভ,	
asaciates,	অসযাসিসিয়েট,	এসোসিয়েটস,	
drishyogulotey,	দৃষ্যগুলোতে,	দৃশ্যগুলোতে,	
miraclee,	মিরাক্লি,	মিরাকেল,	
neshnosh,	নেষ্ণশ,	নেশনস,	
mausumer,	মসুমের,	মৌসুমের,	
samajikotar,	সমজিকতার,	সামাজিকতার,	
bisnoo,	বিসনন,	বিষ্ণু,	
shahurgulor,	শহুরগুলোর,	শহুরগুলোর,	
obosan,	অবসান,	অবসান,	
sheshdinti,	শেষদিন্তি,	শেষদিনটি,	
annanere,	অন্যানেরে,	অন্যানেরে,	
nishad,	নিশাদ,	নিষাদ,	
akpashe,	আক্পাশে,	একপাশে,	
wodka,	ওড়াকা,	ভদকা,	
ganosachetanata,	গণসেচনততা,	গণসচেতনতা,	
mesenjarer,	মেজেঞ্জারের,	মেসেঞ্জারের,	
poderthobid,	পদেরবিিদ,	পদার্থবিদ,	
udbhaboni,	উদ্ভাবনী,	উদ্ভাবনী,	
blacker,	ব্ল্যাকার,	ব্ল্যাকের,	
bhittitei,	ভিত্তিতেই,	ভিত্তিতেই,	
hazat,	হাজাত,	হজত,	
dip,	ডিপ,	দীপ,	
phutanta,	ফুটান্টা,	ফুটন্ত,	
mangolic,	ম্যাংলোকিক,	মাঙ্গলিক,	
graminphonor,	গ্রামিননোোনর,	গ্রামীণফোনর,	
aamoode,	আমোদে,	আমুদে,	
heerani,	হিরানি,	হিরানি,	
patigoniter,	পাটিগনিতের,	পাটিগণিতের,	
lesense,	লেসেন্স,	লাইসেন্স,	
pratisthasaho,	প্রতিস্থাসহ,	প্রতিষ্ঠাসহ,	
chupani,	চুপানি,	চুপানি,	
flirt,	ফ্লার্ট,	ফ্লার্ট,	
difinision,	ডিফিনিনন,	ডেফিনেশন,	
brittakar,	বৃত্যাকার,	বৃত্তাকার,	
shhashtra,	শাষ্ট্র,	শাস্ত্র,	
chikitsanirbhar,	চিকিৎসানির্ভর,	চিকিৎসানির্ভর,	
gaujano,	গৌজানো,	গজানো,	
sift,	সিফট,	শিফট,	
plusey,	প্লুসে,	প্লাসে,	
muhaiminer,	মুহাইমিনের,	মুহাইমিনের,	
chirantan,	চিরান্তান,	চিরন্তন,	
manbe,	মানবে,	মানবে,	
themeke,	থেমেকে,	থিমকে,	
pratista,	প্রতিস্তা,	প্রতিষ্টা,	
jatata,	জাতাটা,	যতোটা,	
lyataa,	ল্যাটা,	ল্যাটা,	
sutir,	সুতির,	সুতির,	
upobaasee,	উপবাসী,	উপবাসী,	
bane,	বানে,	বনে,	
elakatite,	এলাকাটিতে,	এলাকাটিকে,	
horidwar,	হরিদ্বার,	হরিদ্বার,	
bethikata,	বেঠিকাটা,	বেঠিকতা,	
porizoner,	পরিজনের,	পরিজনের,	
sursur,	সুরসুর,	সুরসুর,	
dhyana,	ধ্যানা,	ধ্যান,	
gandhike,	গান্ধিকে,	গান্ধীকে,	
abodamaner,	অবদামানের,	অবদমনের,	
shilver,	শিলভার,	সিলভার,	
projanankal,	প্রজানাকাল,	প্রজননকাল,	
ovidhanik,	অভিধানিক,	অভিধানিক,	
turky,	টার্কি,	তুর্কি,	
jotota,	যোততা,	যতোটা,	
madhuree,	মধুরি,	মাধুরী,	
nirbaaho,	নির্বাহ,	নির্বাহ,	
korijachilen,	করিজাছিলেন,	করিযাছিলেন,	
seekkharthirao,	সিক্ষার্থীরাও,	শিক্ষার্থীরাও,	
sangkoolan,	সংকললান,	সংকুলান,	
gagee,	গ্যাগি,	গেজ,	
everage,	এভারাজে,	এভারেজ,	
alaoler,	আলযাললের,	আলাওলের,	
langhangulir,	লঙ্গানগুলির,	লঙ্ঘনগুলির,	
saramukhe,	সরুমুখে,	সারামুখে,	
sanghitar,	সংহিতার,	সংহিতার,	
bhuushito,	ভূষিত,	ভূষিত,	
sokkhomotabriddhi,	সক্ষ্মতাবৃদ্ধি,	সক্ষমতাবৃদ্ধি,	
bonvumi,	বন্ভুমি,	বনভূমি,	
notti,	নটটি,	নোটটি,	
kanshat,	কাঁশাট,	কানসাট,	
plate,	প্ল্যাটে,	প্লেটে,	
nirabota,	নিরাবতা,	নিরবতা,	
bhramarotsab,	ভ্রামরতসসব,	ভ্রমরোৎসব,	
barbadoj,	বারবাজদ,	বার্বাডোজ,	
protijogiitamulok,	প্রতিযোগিতামিমূলক,	প্রতিযোগীতামূলক,	
karmasampadon,	কর্মসমাপদনন,	কর্মসম্পাদন,	
monchostho,	মন্চষ্ঠ,	মঞ্চস্থ,	
venisey,	ভেনিসে,	ভেনিসে,	
arshie,	আর্শি,	আরসিএ,	
ardasho,	আরদাশো,	আর্দশ,	
atarkitey,	অটারকিতে,	অতর্কিতে,	
armstronz,	আর্মস্ট্রজজজ,	আর্মস্ট্রং,	
azin,	আজিন,	আজিন,	
mozdoor,	মোজদুর,	মজদুর,	
capshule,	ক্যাপশুল,	ক্যাপসুল,	
goteehin,	গতিহীন,	গতিহীন,	
choddo,	চোদ্য,	চোদ্দো,	
vogiroth,	ভোগিরথ,	ভগীরথ,	
rajtontre,	রাজতন্ত্রে,	রাজতন্ত্রে,	
armeeniyana,	অর্মীনীয়া,	আর্মেনিয়ান,	
panchadadu,	পঞ্চদাদু,	পঞ্চাদাদু,	
graambashee,	গ্রামবাশী,	গ্রামবাসী,	
freekeh,	ফ্রিকেহ,	ফ্রিকেহ,	
relance,	রেলান্স,	রিলায়েন্স,	
gara,	গারা,	গোর,	
vishnuu,	বিশ্নু,	বিষ্ণু,	
arthonitite,	অর্থনীতিতে,	অর্থনীতিতে,	
chhedon,	ছেডন,	ছেদন,	
protijogitamulok,	প্রতিযোগিতমমূলক,	প্রতিযোগীতামূলক,	
goodamjato,	গুদাজাতত,	গুদামজাত,	
societyke,	সসিস্টেকে,	সোসাইটিকে,	
bbiswashi,	বিব্বিশা,	বিশ্বাসই,	
probhritike,	প্রভৃতিকে,	প্রভৃতিকে,	
protinito,	প্রতিনিত,	প্রতিনিত,	
brixfield,	ব্রিক্ক্লিয়েড,	ব্রিক্সফিল্ড,	
kaale,	কালে,	কালে,	
themekey,	থেমেকে,	থিমকে,	
elakaasoho,	এলাকাসহ,	এলাকাসহ,	
nirbachokder,	নির্বাচকদের,	নির্বাচকদের,	
jerusalemer,	জেরুসালেমের,	জেরুজালেমের,	
sangbadmadhyomgulote,	সংবাদমধ্যাগগুলোতে,	সংবাদমাধ্যমগুলোতে,	
hindutirtha,	হিন্দুত্রিথথ,	হিন্দুতীর্থ,	
choson,	চোসন,	চোষণ,	
sommotitey,	সম্মতিতে,	সম্মতিতে,	
chirkut,	চিরকুট,	চিরকুট,	
soolke,	সুলকে,	শুল্কে,	
morathee,	মরাথি,	মরাঠি,	
poripaker,	পরিপাকের,	পরিপাকের,	
protishta,	প্রতিষ্টা,	প্রতিষ্টা,	
porbotmala,	পর্বতমালা,	পর্বতমালা,	
heelser,	হেলসের,	হিলসের,	
krema,	ক্রেমা,	ক্রাইম,	
ancholsaha,	অ্ঞহলোলসহ,	অঞ্চলসহ,	
bedantodhormo,	বেদানতধর্ম,	বেদান্তধর্ম,	
nisshongotake,	নিশ্বগঙ্গাকে,	নিঃসঙ্গতাকে,	
jyaqasana,	জ্যাকাসানা,	জ্যাকসন,	
plaiin,	প্লেইন,	প্লেন,	
nirdesika,	নির্দেসিকা,	নির্দেশিকা,	
caroline,	ক্যারোলিন,	ক্যরোলিন,	
vvimsenn,	ভিভমেন্সেন,	ভীমসেন,	
contemporary,	কনটেম্পরারি,	কন্টেম্পোরারি,	
firoze,	ফিরোজে,	ফিরোজ,	
holuder,	হলুদের,	হলুদের,	
guzon,	গুজন,	গুজব,	
gurmukh,	গুরমুখ,	গুরমুখ,	
bhiktara,	ভিক্তারা,	ভিক্টর,	
proshtotto,	প্রশ্তত্ব,	প্রস্ত্তত,	
ghatla,	ঘাটলা,	ঘটল,	
jeshtha,	যেশ্থা,	জ্যেষ্ঠা,	
sarboporee,	সর্বপরী,	সর্বোপরী,	
suhasini,	সুহাসিনী,	সুহাসিনী,	
manushgulor,	মনুষগুলোর,	মানুষগুলোর,	
chakti,	চাকতি,	চাকতি,	
rushad,	রুশাদ,	রুশদ,	
bishnoo,	বিষ্ণ,	বিষ্ণু,	
osamanno,	ওসামান্য,	অসামান্য,	
prakalpoguli,	প্রলাকপগুলি,	প্রকল্পগুলি,	
rohinibabu,	রোহিনিবাবু,	রোহিনীবাবু,	
assexe,	এ্যাসেক্স,	অ্যাসেক্সে,	
toranganj,	তোরাঙ্গঞ্জ,	তোরাবগঞ্জ,	
foreks,	ফরেক্স,	ফরেক্স,	
militaryr,	মিলিটারির,	মিলিটারির,	
dhojovongo,	ধ্বগভঙ্গ,	ধ্বজভঙ্গ,	
atmira,	আত্মিরা,	আত্মীরা,	
bikromei,	বিক্রমেই,	বিক্রমেই,	
sarbhare,	সারভারে,	সার্ভারে,	
qonflict,	কনফ্লিক্ট,	কনফ্লিক্ট,	
chalochchitraeer,	চালচচিত্রীরা,	চলচ্চিত্রের,	
bhalobasar,	ভালোবাসার,	ভালোবাসার,	
dijmarescu,	ডিজমার্স্চ,	দিজমার্সাকু,	
turkii,	টুরকিই,	তুর্কি,	
sadeep,	সদদীপ,	সদীপ,	
noiteekotar,	নৈতিকতার,	নৈতিকতার,	
directorate,	ডিরেক্রেটাট,	ডিরেক্টরেট,	
habshi,	হাবশি,	হাবশী,	
shanno,	শান্ন,	সান্নো,	
shiqara,	শিকারা,	শিকার,	
shatoke,	শতকে,	শতকে,	
lidars,	লিডার্স,	লিডার্স,	
bujhtepari,	বুঝতেপারী,	বুঝতেপারি,	
ongkush,	অঙ্কুশ,	অংকুশ,	
nationalser,	ন্যাটিওনাস্সের,	ন্যাশনালসের,	
sedikei,	সেদিকেই,	সেদিকেই,	
shringa,	শ্রিঙ্গা,	শৃঙ্গ,	
marry,	মার্যার,	ম্যারি,	
uddhritto,	উদ্ধৃত্ত,	উদ্ধৃত,	
dai,	দাইই,	দিই,	
ceramicer,	সারামিকের,	সিরামিকের,	
fishing,	ফিশিং,	ফিসিং,	
kurdira,	কুরদিরা,	কুর্দিরা,	
bhimsen,	ভিমসেন,	ভীমসেন,	
difinishian,	ডিফিনিশিয়ান,	ডেফিনেশন,	
booksar,	বুক্সার,	বুক্সার,	
horash,	হরাশ,	হোরাস,	
janosamaj,	জনসমাজজ,	জনসমাজ,	
esprito,	এস্প্রিত,	এস্পিরিটো,	
cloudbook,	ক্লাউডবক,	ক্লাউডবুক,	
dolphiny,	ডলিনি,	ডলফিনি,	
baptics,	ব্যাপ্টিক্স,	ব্যাপটিকস,	
nirarthak,	নিরার্থক,	নিরর্থক,	
madrasake,	মাদ্রাসকে,	মাদ্রাসাকে,	
soinyo,	সৈন্য,	সৈন্য,	
janar,	জানার,	জানার,	
krisenter,	ক্রিসেন্টার,	ক্রিসেন্টের,	
rajnoitik,	রাজনৈতিক,	রাজনৈতীক,	
bharotchilo,	ভারোচিলল,	ভারতছিল,	
mercedes,	মার্সেসেড,	মার্সেডেস,	
oncholke,	অঞ্চলকে,	অঞ্চলকে,	
abhidhaner,	অভিধানের,	অভিধানের,	
phutbolarder,	ফুটবলল্ডার,	ফুটবলারদের,	
mukhomondoler,	মুখমন্ডলের,	মুখমণ্ডলের,	
milekhanek,	মিলেখানেকে,	মাইলখানেক,	
iraner,	ইরানের,	ইরানের,	
jackey,	জ্যাকে,	জকি,	
bhimsenkei,	ভিমসেনকেই,	ভীমসেনকেই,	
jaunotar,	যৌনতার,	যৌনতার,	
parishram,	পরিশ্রম,	পরিশ্রম,	
sookkho,	সুক্ষ,	সুক্ষ্ম,	
uqeliptas,	উকেলিপ্টাস,	ইউক্যালিপ্টাস,	
eenameela,	ইনামিলা,	এনামেল,	
utotoro,	উততোর,	উততর,	
hastamathun,	হস্তমাথুন,	হস্তমথুন,	
neerbachoker,	নির্বাচকের,	নির্বাচকের,	
byaboharkari,	ব্যবহারকারী,	ব্যবহারকারী,	
prijon,	প্রিজন,	প্রিজন,	
manushera,	মনুষেরা,	মানুষেরা,	
sectore,	সেক্টরে,	সেক্টরে,	
gabinius,	গ্যানিবিউস,	গাবিনিআস,	
ciima,	সিইমা,	সীমা,	
directorete,	ডিরেক্রটেট,	ডিরেক্টরেট,	
byepass,	বেপায়স,	বাইপাস,	
pretti,	প্রেত্তি,	প্রিটি,	
aro,	আরো,	আরও,	
seoul,	সিউউল,	সোল,	
shrabastee,	শ্রাবাস্তি,	শ্রাবস্তী,	
khelaphate,	খেলাফাতে,	খেলাফতে,	
jansha,	জানশা,	জন্স,	
dokaangulotey,	ডোকানগুলোতে,	দোকানগুলোতে,	
bosben,	বসবেন,	বসবেন,	
sithilota,	সিথিলোটা,	শিথিলতা,	
tikta,	টিকটা,	তিক্ত,	
torkarite,	তরকারিতে,	তরকারিতে,	
ghetu,	গেটু,	ঘেটু,	
pravritir,	প্রভৃতির,	প্রভৃতির,	
chokrantosoho,	চক্রান্তসহ,	চক্রান্তসহ,	
qanasarabheshana,	কনসারেশনেশা,	কনসারভেশন,	
baarnis,	ব্যার্নিস,	বার্নিশ,	
uddhrita,	উদ্ধৃতা,	উদ্ধৃত,	
kogake,	কোগাকে,	কোগাকে,	
sthaponagulo,	স্থাপনাগুলো,	স্থাপনাগুলো,	
emargency,	এমারজেন্সি,	এমার্জেন্সি,	
grambaashio,	গ্রামবাশিও,	গ্রামবাসীও,	
khorsed,	খোরসেদ,	খোরশেদ,	
mathews,	মাথেভস,	ম্যাথিউস,	
uporoshtho,	উপরস্থ,	উপরস্থ,	
biplabeer,	বিপ্লববীর,	বিপ্লবীর,	
swastir,	স্বস্তির,	স্বস্তির,	
cxt,	কিএিসিসট,	সিএক্সটি,	
jamjamat,	জমজমাত,	জমজমাট,	
bishasey,	বিশাসে,	বিশ্বাসে,	
himsrot,	হিমস্রোট,	হিমস্রোত,	
harris,	হ্যারিস,	হ্যারিস,	
sangitanusthane,	সঙ্গিতানুষ্ঠানে,	সঙ্গীতানুষ্ঠানে,	
phuda,	ফুড়া,	ফুড,	
rahi,	রহিি,	রাহী,	
tiger,	টিগের,	টাইগার,	
kalakushalir,	কলাকুশলীর,	কলাকুশলীর,	
noditei,	নদীতেই,	নদীতেই,	
siima,	সিইমা,	সীমা,	
makong,	মাকং,	মেকং,	
sthapanagulor,	স্থাপানগগুলোর,	স্থাপনাগুলোর,	
ancholsomuho,	অঞ্চলসমূহ,	অঞ্চলসমূহ,	
kani,	কানি,	কানি,	
abhijitda,	অভিজিদতা,	অভিজিতদা,	
kotibondhe,	কতিবন্ধে,	কটিবন্ধে,	
phiksa,	ফিক্সা,	ফিক্স,	
jalarong,	জ্যালারং,	জলরঙ,	
toptoshele,	তপ্তশেলে,	তপ্তশেলে,	
asbab,	আসবাব,	আসবাব,	
path,	পাথ,	পাথ,	
saalsa,	সালসা,	সালসা,	
harasta,	হারাস্টা,	হারাস্তা,	
ekbakye,	একবাক্যে,	একবাক্যে,	
prosadhani,	প্রসাধানি,	প্রসাধনী,	
uponeesoder,	উপনিসদের,	উপনিষদের,	
lendol,	লেন্ডল,	লেন্ডল,	
prarthonakokkher,	প্রার্থানকাষ্ণের,	প্রার্থনাকক্ষের,	
chilahatee,	চিলাহাটি,	চিলাহাটি,	
chalachchitra,	চলচ্চিত্র,	চলচ্চিত্র,	
baet,	বেয়েট,	বাইট,	
chhadite,	ছাদিতে,	ছড়িতে,	
shaater,	সাতের,	শ্যুটার,	
proshikkhane,	প্রশিক্ষাণে,	প্রশিক্ষণে,	
asovarno,	অসাভার্ন,	অসবর্ণ,	
soinyora,	সৈন্যরা,	সৈন্যরা,	
jacksoner,	জ্যাকসনের,	জ্যাকসনের,	
jeebnagore,	জীবনগরে,	জীবননগর,	
agamane,	আগামানে,	আগমনে,	
nosihote,	নসীহতে,	নসিহতে,	
dapadpi,	দাপাদপি,	দাপাদপি,	
restuarant,	রেস্টুর্যান্ট,	রেষ্টুরেন্ট,	
satjaner,	সতজনের,	সাতজনের,	
oncoltike,	অন্কলটিকে,	অঞ্চলটিকে,	
bangladesh,	বাংলাদেশ,	বঙ্গালাদেস,	
laaishenshh,	লাইশেন্,	লাইসেন্স,	
qyapasula,	ক্যাপাসুলা,	ক্যাপসুল,	
kleentoner,	ক্লিনটনের,	ক্লিনটনের,	
manushti,	মানুষ্টি,	মানুষটি,	
reshidensha,	রেশিদেনশা,	রেসিডেন্স,	
mandanda,	মান্দন্ডা,	মানদণ্ড,	
karmakarke,	কর্মাকারকে,	কর্মকারকে,	
rajbondir,	রাজবন্দির,	রাজবন্দীর,	
mukhya,	মুখ্যা,	মুখ্য,	
photanor,	ফোটানোর,	ফোটানোর,	
shoodhooi,	শুধুই,	শুধুই,	
turista,	টুরিস্টা,	টুরিস্ট,	
torunderke,	তরুণদেরকে,	তরুণদেরকে,	
klaud,	ক্লাউড,	ক্লাউড,	
eucalyptus,	ইউইক্লামাপ্টাস,	ইউক্যালিপ্টাস,	
protiakromonei,	প্রতিয়াক্রমণে,	প্রতিআক্রমণেই,	
tongaa,	টোঙ্গায়,	টোঙ্গা,	
bujhechhila,	বুঝেছিলা,	বুঝেছিল,	
dakten,	ডাক্তেন,	ডাকতেন,	
ritesh,	রিতেশ,	রিতেশ,	
vesselli,	ভেসেলি,	ভেসেলি,	
antarbhutto,	অন্তর্ভূত্ত,	অন্তর্ভুক্ত,	
sangbadmadhyome,	সংবাদমধ্যমে,	সংবাদমাধ্যমে,	
dokanei,	ডোকানেই,	দোকানেই,	
dushtogone,	দুষ্টগণে,	দুষ্টগণে,	
informetion,	ইনফর্েশন,	ইনফরমেশন,	
kiibord,	কিইবর্ড,	কীবোর্ড,	
oboshore,	অশশরে,	অবসরে,	
heze,	হেজে,	হেজ,	
pichte,	পিচতে,	পিছতে,	
khaschandpur,	খাশচা্্পুর,	খাসচাঁদপুর,	
arsie,	আর্সি,	আরসিএ,	
binakar,	বিনাকার,	বিনাকার,	
dakter,	ডাক্তের,	ডাকতের,	
dwijenbabuder,	দ্বিজেনবাবুদের,	দ্বিজেনবাবুদের,	
ishter,	ইস্টার,	ইস্টের,	
mach,	মাচ,	মাছ,	
palashir,	পালাশির,	পলাশীর,	
skirt,	স্কির্ত,	স্কার্ট,	
shasheja,	শাশেজা,	সসেজ,	
bedey,	বেদে,	বেদে,	
existing,	এক্সিটিং,	এক্সিসটিং,	
kade,	কাদে,	কোড,	
mahbunur,	মাহবুনুর,	মাহবুনুর,	
ekok,	একোক,	একক,	
saamaanya,	সামান্য,	সামান্য,	
medilek,	মেডিলেক,	মেডিলেক,	
khalidke,	খালিদকে,	খালিদকে,	
jetam,	জেতাম,	যেতাম,	
amudey,	অমুদে,	আমুদে,	
chhanada,	ছানাদা,	ছানাদা,	
query,	কুয়ারি,	কোয়েরি,	
chouhate,	চৌহাতে,	চৌহাটে,	
everestey,	এভার্সেটি,	এভারেস্টে,	
ponjikar,	পঞ্জিকার,	পঞ্জিকার,	
bandhan,	বানধান,	বাঁধন,	
jati,	জাতি,	যাতি,	
soomita,	সুমিতা,	সুমিতা,	
thyachara,	থ্যাচারা,	থ্যাচার,	
debate,	দেবাতে,	ডিবেট,	
ghoomachhe,	ঘুমাছে,	ঘুমাচ্ছে,	
juboksoho,	যুবকসহ,	যুবকসহ,	
khiladirao,	খিলাদিরাও,	খিলাড়িরাও,	
ansareer,	আনসারীর,	আনসারীর,	
sip,	সিপ,	শিপ,	
oisamoyer,	ঐসমযয়ের,	ঐসময়ের,	
mulbhitti,	মুলভিত্তি,	মূলভিত্তি,	
dormroome,	ডর্মরুমে,	ডর্মরুমে,	
dhanche,	ধাঁচে,	ধাঁচে,	
meshintao,	মেশিন্টাও,	মেশিনটাও,	
reshmirekha,	রেশমীরেখা,	রেশমীরেখা,	
baasaate,	বাসাতে,	বাসাতে,	
vagini,	ভাগিনি,	ভগিনী,	
chaudhurio,	চৌধুরিও,	চৌধুরীও,	
byabaharkarike,	ব্যবহারকারীকে,	ব্যবহারকারীকে,	
chikkingsasoho,	চিক্সিংসহ,	চিকিংসাসহ,	
hosto,	হোস্তো,	হস্ত,	
thabai,	থাবাই,	থাবাই,	
srichoitonnodeb,	শ্রীচহতন্দবেদ,	শ্রীচৈতন্যদেব,	
satyaky,	সত্যক্যি,	সাত্যকি,	
gazetted,	গ্যাজেট্ট,	গেজেটেড,	
rahee,	রাহী,	রাহি,	
segular,	সেগুলার,	সেগুলোর,	
dembakreeti,	দেম্বাকর্তিতি,	ডিম্বাকৃতি,	
jamkaalo,	জামকালো,	জমকালো,	
oncholeo,	অন্চলেও,	অঞ্চলেও,	
nilfamarir,	নীলমারমীর,	নীলফামারীর,	
horipur,	হরিপুর,	হরিপুর,	
elbamtite,	এলবাম্টিতে,	এলবামটিতে,	
ancholtike,	অ্যান্লোটিকে,	অঞ্চলটিকে,	
arthanitike,	অর্থনীতিকে,	অর্থনীতিকে,	
promodwara,	প্রমোদ্বারা,	প্রমদ্বারা,	
balaruma,	বালারুমা,	বলরুম,	
harees,	হারিস,	হ্যারিস,	
bosano,	বসানো,	বসানো,	
oitijje,	ঐতিহ্যে,	ঐতিহ্যে,	
krusher,	ক্রুশের,	ক্রুশের,	
torunra,	তরুনরা,	তরুণরা,	
upobaashee,	উপবাশী,	উপবাসী,	
zeebonto,	জীবন্ত,	জীবন্ত,	
porinoti,	পরিনটি,	পরিণতি,	
nyeta,	নেইটা,	ম্যাট,	
raagei,	রাগেই,	রাগেই,	
orthisoho,	অর্থিসহ,	অর্থিসহ,	
vagni,	ভাগনি,	ভগ্নী,	
edmiral,	এডমিরাল,	এডমিরাল,	
swadhinotatukui,	স্বাধীনতাটুুুই,	স্বাধীনতাটুকুই,	
bulan,	বুলান,	বুলান,	
aanaan,	আনান,	আনান,	
liedtke,	লিইডটকে,	লইডটক,	
hamburgey,	হ্যাম্বগর্গে,	হামবুর্গে,	
adwanced,	অ্যাডব্যান্ড,	অ্যাডভান্সড,	
kormobuddhite,	কর্মবুদ্ধিতে,	কর্মবুদ্ধিতে,	
peeth,	পিথ,	পীঠ,	
drissoke,	দৃশ্যকে,	দৃশ্যকে,	
faase,	ফাযাসে,	ফাঁসে,	
rayyalati,	রায়্যললতি,	রয়্যালটি,	
laaisens,	লাইসেন্স,	লাইসেন্স,	
dipke,	ডিপকে,	দ্বীপকে,	
rushod,	রুশোদ,	রুশদ,	
graambaaseer,	গ্রামবাসীর,	গ্রামবাসীর,	
magrey,	ম্যাগ্রে,	ম্যাগ্রে,	
adhyatmik,	অধ্যাম্তিক,	আধ্যাত্মিক,	
bhardwaj,	ভর্দবাজ,	ভরদ্বাজ,	
aalaa,	আলা,	আলা,	
oindrila,	ঐন্ডিরলা,	ঐন্দ্রিলা,	
shoriph,	শরিফ,	শরিফ,	
toroonra,	তরুনরা,	তরুণরা,	
dokan,	ডোকান,	দোকান,	
balatarin,	বালাটারিন,	বালাতারিয়ান,	
kampita,	কাম্পিতা,	কম্পিত,	
dai,	দাইই,	ডে,	
sikkharthirao,	সিক্ষার্থীরাও,	শিক্ষার্থীরাও,	
bopoon,	বাউন,	বপন,	
parq,	পার্ক,	পার্ক,	
bakhyateet,	বাখ্যাতিত,	ব্যাখ্যাতীত,	
renoo,	রেনু,	রেনো,	
majdur,	মাজদুর,	মজদুর,	
gandhiio,	গান্ধিও,	গান্ধীও,	
jhijhi,	ঝিঝি,	ঝিঝি,	
muktijuddhojato,	মুক্তিযুদ্ধতাও,	মুক্তিযুদ্ধজাত,	
epiela,	এপিয়ালা,	আইপিএল,	
redcrosser,	রেড্রোস্সের,	রেডক্রসের,	
chhotogolper,	ছোটগল্পের,	ছোটগল্পের,	
dinara,	দিনারা,	ডিনার,	
somraat,	সম্রাত,	সম্রাট,	
nagorikkey,	নাগরিককে,	নাগরিককে,	
miraqela,	মিরাকেলা,	মিরাকেল,	
pothnirdeshona,	পথনির্দেশন,	পথনির্দেশনা,	
arthonitir,	অর্থনীতির,	অর্থনীতির,	
ganokantha,	গণকান্থা,	গণকণ্ঠ,	
shudhir,	শুধীর,	শুধীর,	
mitrata,	মিত্রাটা,	মিত্রতা,	
ghoor,	ঘুর,	ঘুর,	
satan,	সাতান,	শয়তান,	
aviyojan,	অভিযোজজন,	অভিযোজন,	
probhuder,	প্রভুদের,	প্রভুদের,	
abosare,	অবসারে,	অবসরে,	
ashanka,	আশাঙ্কা,	আশংকা,	
sallallahu,	সল্লাল্লাহু,	সল্লাল্লাহু,	
sudrissho,	সুদৃশ্য,	সুদৃশ্য,	
amarika,	আমারিকা,	আমেরিকা,	
rajnaiteek,	রাজনৈতিক,	রাজনৈতীক,	
aagera,	আগেরা,	আগোরা,	
pharmesigulote,	ফার্মেসিগুলোতে,	ফার্মেসীগুলোতে,	
chalake,	চালাকে,	চালকে,	
toching,	টোচিং,	টোচিং,	
greenald,	গ্রিনলল্ড,	গ্রিনল্ড,	
bufer,	বাফার,	বাফার,	
bhebechili,	ভেবেছিলি,	ভেবেছিলি,	
becha,	বেচা,	বেচা,	
remission,	রিমিশন,	রিমিশন,	
wagadada,	ওয়াগাড়াড়া,	বাগদাদ,	
sharif,	শারফফ,	শরিফ,	
jaistho,	জাইশ্থ,	জ্যৈষ্ঠ,	
boner,	বনের,	বনের,	
chalachchitrer,	চলচচ্ছিত্রের,	চলচ্চিত্রের,	
taronee,	তারণী,	তরণী,	
venkates,	ভেঙ্কাটস,	ভেঙ্কটেশ,	
metropolitan,	মেট্রোপলিটান,	মেট্রোপলিটন,	
dala,	দালা,	দলা,	
swairacharibirodhi,	স্বারারিবারোধিরি,	স্বৈরাচারীবিরোধী,	
debdebie,	দেবদেবী,	দেবদেবী,	
sten,	স্টেন,	স্টেন,	
nachiketa,	নচিকেটা,	নচিকেতা,	
confliqt,	কনফলিক্ট,	কনফ্লিক্ট,	
nichupattir,	নিচুপত্তির,	নিচুপট্টির,	
institutione,	ইন্সটিটিউশন,	ইনস্টিটিউশনে,	
krus,	ক্রুস,	ক্রুশ,	
pronoti,	প্রোনীতি,	প্রণতি,	
deenesh,	দেনেশ,	দীনেশ,	
touraat,	তৌরাত,	তওরাত,	
madhnagar,	মাধনগর,	মাধনগরের,	
foks,	ফকস,	ফক্স,	
umb,	উমমিবি,	ইউএমবি,	
manush,	মানুশ,	মানুষ,	
transhapharma,	ট্রান্সফর্ম,	ট্রান্সফর্ম,	
byomkes,	ব্যামকেস,	ব্যোমকেশ,	
akkheperi,	আক্ষেপেরই,	আক্ষেপেরই,	
karpeter,	কারপেটের,	কার্পেটের,	
shnaipara,	শ্নাইপারা,	স্নাইপার,	
standards,	স্ট্যানাডার্ডস,	স্টান্ডার্ডস,	
rohosyo,	রোহস্য,	রহস্য,	
bbosben,	ব্বসবেন,	বসবেন,	
miitar,	মিইটার,	মিত্র,	
prosadhoni,	প্রসাধনি,	প্রসাধনী,	
boiragirhat,	বৈরাগিরহাট,	বৈরাগিরহাট,	
damakalkarmirao,	দমকাল্ররিমারও,	দমকলকর্মীরাও,	
mousumeo,	মুউসমূয়,	মৌসুমেও,	
qlauda,	ক্লুডাড়া,	ক্লাউড,	
chaalaabi,	চালাবী,	চালাবে,	
mukherjee,	মুখেরজি,	মুখার্জী,	
chalochchitreei,	চালচ্চিত্রীয়,	চলচ্চিত্রেই,	
ekspression,	এক্সপ্রেশন,	এক্সপ্রেশন,	
madrasi,	মাদ্রাসি,	মাদ্রাজি,	
akai,	আকাই,	একাই,	
grahoksebai,	গ্রহককেবাই,	গ্রাহকসেবায়,	
omkar,	ওমকার,	ওঙ্কার,	
gaziipur,	গাজিইপুর,	গাজীপুর,	
ganesh,	গেনেশ,	গণেশ,	
kobutorer,	কবুতরের,	কবুতরের,	
maudelgulo,	মাডেলগুলো,	মডেলগুলো,	
otyacharito,	অত্যাচারিত,	অত্যাচারিত,	
serveray,	সারভেরা,	সার্ভারে,	
harza,	হারজা,	হার্জ,	
bachhaikrito,	বাছাইকৃত,	বাছাইকৃত,	
timathi,	তিমাথি,	টিমোথি,	
jyesthaa,	জ্যেস্থা,	জ্যেষ্ঠা,	
fansi,	ফ্যানসি,	ফাঁসী,	
pratijogira,	প্রতিযোগিয়ার,	প্রতিযোগীরা,	
supplenza,	সাপ্লেজা,	সাপলেঞ্জা,	
iqbalke,	ইকবলকে,	ইকবালকে,	
brekthrough,	বৃক্তের্ঘু,	ব্রেকথ্রু,	
acrolect,	অ্যাক্রোলেক্ট,	অ্যাক্রোলেক্ট,	
bossonte,	বসন্তে,	বসন্তে,	
shoreefpur,	শরিফপুর,	শরিফপুর,	
homeser,	হোমেসের,	হোমসের,	
jolrang,	জলরাং,	জলরঙ,	
tawnship,	তাউনশিপ,	টাউনশিপ,	
rokibul,	রোকিবুল,	রকিবুল,	
shahanara,	শাহানারা,	শাহানারা,	
farid,	ফারিদ,	ফরিদ,	
nirmolotaa,	নির্মোলতা,	নির্মলতা,	
sharifpur,	শরিফপুরের,	শরিফপুর,	
debeting,	ডেবেটিং,	ডিবেটিং,	
chiroharit,	চিরোহারিত,	চিরহরিৎ,	
karecho,	কারেছো,	করেছ,	
alumni,	আলুমনি,	অ্যালমনি,	
eokee,	ইইকি,	এওকি,	
turkamena,	টুর্কমেনা,	তুর্কমেন,	
lutharen,	লুথারেন,	লুথেরান,	
shilpojaat,	শিল্পজাত,	শিল্পজাত,	
superheroo,	সুপারহহরে,	সুপারহিরো,	
beam,	বিএমএ,	বিম,	
popke,	পোপকে,	পোপকে,	
patrol,	পাযাট্রোল,	পেট্রোল,	
chemjong,	চেমজং,	চেমজং,	
michhilti,	মিছিলটি,	মিছিলটি,	
amarjito,	আমারজিত,	অমার্জিত,	
dubaate,	ডুবাতে,	ডুবাতে,	
chhooti,	ছুটি,	ছুটি,	
ganochien,	গ্যানোচিয়েন,	গণচীন,	
brindaboney,	বৃন্দাবনে,	বৃন্দাবনে,	
laishenshim,	লাইশেন্সম,	লাইসেন্সিং,	
kazianis,	কাজিয়ানিস,	কাজানিস,	
rayyaleti,	রায়্যেলটি,	রয়্যালটি,	
juakhelar,	জুয়াখেলার,	জুয়াখেলার,	
hooq,	হুক,	হুক,	
dhyanastha,	ধ্যানস্থা,	ধ্যানস্থ,	
nanir,	নানির,	নানীর,	
suchanakal,	সুচনাকাল,	সূচনাকাল,	
hijri,	হিজরি,	হিজরী,	
susamo,	সুসামো,	সুসম,	
purbanchaler,	পুরবঞ্চলের,	পূর্বাঞ্চলের,	
ganaporibahaner,	গণপরিবহহনের,	গণপরিবহনের,	
definition,	ডিফিনিশন,	ডেফিনেশন,	
shrabosty,	শ্রাবস্টি,	শ্রাবস্তী,	
remakri,	রিমাক্রি,	রেমাক্রী,	
torikher,	তরিখের,	তরিখের,	
dhani,	ধানি,	ধানি,	
sweety,	স্বিত,	সুইটি,	
zakharovar,	জাখাভোভার,	জাখারোভার,	
ssahocorze,	স্হাহোর্জে,	সাহচর্যে,	
gazeetteed,	গাজিত্তিদ,	গেজেটেড,	
hizriite,	হিজরিইটে,	হিজরীতে,	
shainyader,	শৈন্যাদের,	সৈন্যদের,	
bage,	বাগে,	বাগে,	
quata,	কুয়াতা,	কোটা,	
syfy,	সিফি,	সাইফাই,	
atmiyasulabh,	আত্মিয়সলাভ,	আত্মীয়সুলভ,	
dola,	ডোলা,	দলা,	
edaningkale,	এডানিংলালে,	ইদানীংকালে,	
dagmukta,	দাগমুক্ত,	দাগমুক্ত,	
upobasee,	উপবাসী,	উপবাসী,	
kharar,	খারার,	খরার,	
bibader,	বিবাদের,	বিবাদের,	
pitiler,	পিটিলের,	পিটিলের,	
gandhariir,	গান্ধারির,	গান্ধারীর,	
iuro,	আইআরো,	ইউরো,	
jhanjra,	ঝাঁজরা,	ঝাঁজরা,	
asamanyo,	অসমান্য,	অসামান্য,	
fooloo,	ফুলো,	পোলো,	
bhandar,	ভান্দার,	ভাণ্ডার,	
konar,	কোনার,	কণার,	
quota,	কুওটা,	কোটা,	
nariderke,	নারীদেরকে,	নারীদেরকে,	
sumeeta,	সুমিতা,	সুমিতা,	
providere,	প্রভীদের,	প্রভাইডারে,	
chhooteete,	ছুটিতে,	ছুটিতে,	
auttacharer,	অট্টাচারের,	অত্যাচারের,	
morodeho,	মরদেহো,	মরদেহ,	
parqa,	পার্কা,	পার্ক,	
milekhaanek,	মিলেখানেক,	মাইলখানেক,	
chintamani,	চিন্তামানি,	চিন্তামনি,	
elaakaa,	এলাকা,	এলাকা,	
byaktikegreptar,	ব্যক্তিযেক্রপ্রেটর,	ব্যক্তিকেগ্রেপ্তার,	
graambasio,	গ্রামবাসিও,	গ্রামবাসীও,	
aakaabaar,	আকাবার,	আকাবার,	
ajeem,	আজিম,	আজিম,	
avisongson,	অভিংসসন,	অভিশংসন,	
dooburira,	দুবুরিরা,	ডুবুরিরা,	
achintopurer,	অচিন্তপুরের,	অচিন্তপুরের,	
wishnu,	উইশ্নু,	বিষ্ণু,	
nariider,	নারিইদের,	নারীদের,	
teestar,	তেস্টার,	তিস্তার,	
tenishe,	তেনিশে,	টেনিসে,	
ajeejer,	অজিজের,	আজিজের,	
bairer,	বাইরের,	বাইরের,	
shuchonakal,	শুচনাকাল,	সূচনাকাল,	
moresbai,	মোরেসবাই,	মোরেসবাই,	
chinto,	চিন্ত,	চিনতো,	
hena,	হেনা,	হেনা,	
argho,	আর্ঘ,	অর্ঘ্য,	
venuser,	ভেনুসের,	ভেনাসের,	
sheshardhe,	শেষার্ধে,	শেষার্ধে,	
ponchaasjon,	পঞ্চাজজন,	পঞ্চাশজন,	
siddhanto,	সিদ্ধান্ত,	সিদ্ধান্তও,	
gabhaaskar,	গাভাসকার,	গাভাস্কার,	
onker,	অন্কার,	ওঙ্কার,	
ched,	চেদ,	ছেদ,	
asociatis,	অসযাকিসিটিয়াস,	এসোসিয়েটস,	
maktum,	মাকতুম,	মাকতুম,	
ddebet,	ডিডেবেট,	ডিবেট,	
khuizza,	খুঝজজজা,	খুইজ্জা,	
semai,	সেমাই,	সেমাই,	
tolemy,	টলেমি,	টলেমির,	
vaisoho,	বাইশহ,	ভাইসহ,	
ajibooner,	আজিবনের,	আজীবনের,	
gobeshana,	গোবেশন,	গবেষনা,	
kagbeni,	কাগবেনি,	কাগবেনি,	
nagorikra,	নাগরিকরা,	নাগরিকরা,	
jarmaniteo,	জার্মানিতেও,	জার্মানিতেও,	
hoteltee,	হোটেলটি,	হোটেলটি,	
drishyogulote,	দৃষ্যগুলোতে,	দৃশ্যগুলোতে,	
mankisundar,	মানকিসুন্দর,	মানকিসুন্দর,	
peengna,	পিংনা,	পিংনা,	
dabliudabliui,	ডাব্লিডউলিউলিি,	ডাব্লিউডাব্লিউই,	
samle,	সমলে,	সামলে,	
carloos,	কার্লস,	কার্লোস,	
carlos,	কার্লস,	কার্লোস,	
gitikobita,	গীতিকবিতা,	গীতিকবিতা,	
abhidhaaneeck,	অভিয়ানানিক্ক,	অভিধানিক,	
phiqsa,	ফিক্স,	ফিক্স,	
direqtareta,	ডিরেক্রেটা,	ডিরেক্টরেট,	
shajano,	শাজানো,	সাজানো,	
rajotta,	রাজত্যা,	রাজত্ব,	
maarmaader,	মার্মাদের,	মারমাদের,	
prokolpogulikei,	প্রকল্পগুলিকেই,	প্রকল্পগুলিকেই,	
dada,	ডাডা,	দাদা,	
chapal,	চাপাল,	চপল,	
deciliter,	ডিসিলিলেটের,	ডেসিলিটার,	
mumtaz,	মুমতাজ,	মুমতাজ,	
mutar,	মুতার,	মুতার,	
bouddher,	বৌদ্ধের,	বৌদ্ধের,	
loombinee,	লুমবিনি,	লুম্বিনী,	
alimpiqa,	আলিমপিকা,	অলিম্পিক,	
swarther,	স্বার্থার,	স্বার্থের,	
ghamta,	ঘামটা,	ঘোমটা,	
rajdhani,	রাজধানি,	রাজধানি,	
jhalkanite,	ঝললানানিতে,	ঝলকানীতে,	
himchi,	হিমচি,	হিমচি,	
sangharshik,	সংহর্ষিক,	সাংঘর্ষিক,	
oedipus,	অডিিপুস,	ইডিপাস,	
phund,	ফুন্ড,	ফান্ড,	
bhaandar,	ভান্ডার,	ভাণ্ডার,	
sahooseekotar,	সহসীকতার,	সাহসিকতার,	
provur,	প্রভুর,	প্রভুর,	
siropa,	সিরোপা,	শিরোপা,	
riphleksa,	রিল্েকা,	রিফ্লেক্স,	
blyaka,	ব্ল্যাকা,	ব্ল্যাক,	
hosne,	হোসনে,	হোসনে,	
tolemyr,	তললেম্র,	টলেমির,	
samashtike,	সমা্টিকে,	সমষ্টিকে,	
gaddaphii,	গাদ্যাফি,	গাদ্দাফী,	
reflex,	রেফ্লেক্স,	রিফ্লেক্স,	
brojomohun,	ব্রোজমহুন,	ব্রোজোমোহন,	
boudher,	বৌধের,	বৌদ্ধের,	
sahajlabhbhotar,	সালাযলভভতার,	সহজলভ্যতার,	
chhooteer,	ছুটির,	ছুটির,	
manob,	মানব,	মানব,	
mentither,	মেন্টিথের,	মেনটিথের,	
shakankti,	শককা্টি,	শকাঙ্কটি,	
shalook,	শালুক,	শালুক,	
ahmed,	আহমেদ,	আহামদ,	
bhittow,	ভিত্তভ,	ভিত্তিও,	
uddharkarmirai,	উদ্ধারকর্মীরাই,	উদ্ধারকর্মীরাই,	
phox,	ফক্স,	ফক্স,	
chheher,	ছেহের,	ছেহের,	
edipass,	এডিপাস,	ইডিপাস,	
nathivookteer,	নাথিভুক্তির,	নথিভুক্তির,	
badargaji,	বাদারজাজি,	বদরগাজী,	
bipajjanak,	বিপাজজনক,	বিপজ্জনক,	
drissogulo,	দৃশ্যগুলো,	দৃশ্যগুলো,	
literacy,	লিটারাসি,	লিটারেসি,	
iling,	ইলিং,	ইলিং,	
rudiger,	রুদিগের,	রুদিগের,	
chandrima,	চন্দ্রিমা,	চন্দ্রিমা,	
kiandi,	কিয়ান্ডি,	ক্যান্ডি,	
shkalarashhipa,	শ্কলরাশিপা,	স্কলারশিপ,	
supparak,	সুপ্রাক,	সুপ্পারক,	
oitijhya,	ঐতিহ্যা,	ঐতিহ্য,	
sangasthagulo,	সংস্থাগগুলো,	সংস্থাগুলো,	
rajshri,	রাজশ্রি,	রাজশ্রী,	
somabeshti,	সমাবেষ্টি,	সমাবেশটি,	
machgulo,	মাছগুলো,	মাছগুলো,	
prajanankal,	প্রজানকাল,	প্রজননকাল,	
dharmiyabhabei,	ধর্মিয়ভাবেই,	ধর্মীয়ভাবেই,	
rajyotiro,	রাজ্যতিরও,	রাজ্যটিরও,	
besirvagei,	বেশিরভাজে,	বেশিরভাগেই,	
baman,	বামান,	বামন,	
orbit,	অরবিট,	অরবিট,	
nimitte,	নিমিত্বে,	নিমিত্তে,	
taroni,	তারণী,	তরণী,	
mette,	মেট্টে,	ম্যাট,	
inapharameshana,	ইনার্েশনন,	ইনফরমেশন,	
byabaharkareer,	ব্যবহারকারীর,	ব্যবহারকারীর,	
qredita,	ক্রেডিটা,	ক্রেডিট,	
nirbahe,	নির্বাহে,	নির্বাহে,	
nagorikra,	নাগরিকরা,	নাগরিকেরা,	
fasi,	ফ্যাসি,	ফাঁসী,	
indrakanan,	ইন্দ্রকানন,	ইন্দ্রকানন,	
kayed,	কায়েদ,	কায়েদ,	
eeksapreeshana,	ইক্ষাপ্রেশন,	এক্সপ্রেশন,	
jaadrel,	যাদ্রেল,	জাঁদরেল,	
zubokder,	যুবকদের,	যুবকদের,	
konorup,	কননরূপ,	কোনরূপ,	
dienes,	ডিয়েনস,	ডিএনএস,	
aireshe,	এইরেশে,	আইরেসে,	
vins,	ভিন্স,	ভিন্স,	
dighol,	দিঘল,	দীঘল,	
ujobekeestan,	উজবেক্তাসান,	উজবেকিস্তান,	
antorvukta,	অন্তর্ভুক্ত,	অন্তর্ভুক্ত,	
maadla,	মাডলা,	মাদলা,	
tep,	টেপ,	ট্যাপ,	
madelim,	ম্যাডেলিম,	মডেলিং,	
ekghare,	একঘরে,	একঘরে,	
jahara,	জাহারা,	যাহরা,	
sahapathike,	সহপাথিকে,	সহপাঠীকে,	
elakaatite,	এলাকাটিতে,	এলাকাটিকে,	
ashonkai,	আশঙ্কাই,	আশঙ্কাই,	
chaudhurider,	চৌধুরীদের,	চৌধুরীদের,	
ddheela,	ঢিলা,	ঢিলা,	
beshirbhaagei,	বেশিরভাগেই,	বেশিরভাগেই,	
bee,	বিআই,	বি,	
somoodrotote,	সমুদ্রতে,	সমুদ্রতটে,	
vitti,	ভিট্টি,	ভিত্তিই,	
emarjenshi,	এমারজেনশি,	এমার্জেন্সি,	
kadapaker,	কাদাপাকের,	কড়াপাকের,	
muhuriganj,	মুহুরিগঞ্জ,	মুহুরীগঞ্জ,	
tahalo,	তাহালো,	তাহলো,	
tintir,	টিনটির,	তিনটির,	
bhenus,	ভেনুস,	ভেনাস,	
prokolpow,	প্রকলল্য,	প্রকল্পও,	
bandra,	বান্দ্রা,	বন্দীরা,	
review,	রেভিয়,	রিভিউও,	
juktarashtrasaha,	যুক্তার্তাস্থাস,	যুক্তরাষ্ট্রসহ,	
maudelder,	মডউল্ডের,	মডেলদের,	
pooshteer,	পুষ্টির,	পুষ্টির,	
nottee,	নটটি,	নোটটি,	
byaboharkarike,	ব্যবহারকারীকে,	ব্যবহারকারীকে,	
gunje,	গুঞ্জে,	গুঁজে,	
bagdadii,	বাগদাড়ি,	বাগদাদী,	
aziboner,	আজিবনের,	আজীবনের,	
borendroke,	বরেন্দ্রকে,	বরেন্দ্রকে,	
ashirbadatri,	অশির্বাদত্রী,	আশীর্বাদাত্রী,	
rokkhonabekkhoner,	রক্ষনাকবেষণের,	রক্ষণাবেক্ষণের,	
daaoon,	দাওন,	ডাউন,	
eshtonia,	এস্টোনিয়া,	এস্তোনিয়া,	
dhaanche,	ধাঁচে,	ধাঁচে,	
bayii,	বায়াই,	বাঈ,	
spredsheet,	স্প্রেশিট,	স্প্রেডশীট,	
senabahinio,	সেনাবাহিনীও,	সেনাবাহিনীও,	
soomitrar,	সুমিত্রার,	সুমিত্রার,	
sithilotar,	সিথিলোটার,	শিথিলতার,	
gaaddafee,	গাড্ডাফি,	গাদ্দাফী,	
temanti,	তেমান্টি,	তেমনটি,	
suhayeler,	সুহায়েলের,	সুহায়েলের,	
michir,	মিচির,	মিচির,	
pathkrom,	পাঠ্রকম,	পাঠক্রম,	
akkaas,	আক্কাস,	আককাস,	
browser,	ব্রসসার,	ব্রাউজার,	
shatokeo,	শতকেও,	শতকেও,	
bowie,	বৌভি,	বওই,	
baipass,	বাইপাস,	বাইপাস,	
thyachar,	থ্যাচার,	থ্যাচার,	
paadee,	পাড়ি,	পাড়ে,	
ganochin,	গানোচিন,	গণচীন,	
nariderke,	নারীদেরকে,	নারিদেরকে,	
lyaanding,	ল্যান্ডিং,	ল্যান্ডিং,	
bongshokey,	বংশকে,	বংশকে,	
title,	টিলট,	টাইটেল,	
haripur,	হরিপুর,	হরিপুর,	
bosoben,	বসবেন,	বসবেন,	
navaratri,	নাভারত্রী,	নবরাত্রি,	
obhijojan,	অভিজোজান,	অভিযোজন,	
jyesttha,	জ্যেস্থ্যা,	জ্যেষ্ঠা,	
biplobi,	বিপ্লবি,	বিপ্লবী,	
udbhabaney,	উদ্ভাবানে,	উদ্ভাবনে,	
pray,	প্রায়ে,	প্রায়,	
hugeke,	হুগেকে,	হিউজকে,	
shikhra,	শিখরা,	শিখরা,	
taffsherer,	তফশেরের,	তাফসীরের,	
murad,	মুরাদ,	মুরাদ,	
soketgulor,	সোকেটগুলোর,	সকেটগুলোর,	
thailandshoho,	থাইলানদশশহ,	থাইল্যান্ডসহ,	
boikalyo,	বৈকাল্য,	বৈকল্য,	
atorkitey,	আটরকিতে,	অতর্কিতে,	
tyapa,	ত্যাপা,	ট্যাপ,	
prottokkhovabe,	প্রত্যক্ষভাবে,	প্রত্যক্ষভাবে,	
kamla,	কামলা,	কামলা,	
uparjon,	উপার্জন,	উপার্জন,	
bojhaao,	বোঝাও,	বোঝাও,	
fibergulote,	ফাইবারগুলোতে,	ফাইবারগুলোতে,	
corymb,	করিম্ব,	করিম,	
firozapure,	ফিরোজাপুরে,	ফিরোজাপুরে,	
saoum,	সায়াম,	সাওম,	
chasee,	চাসি,	চেস,	
siddhantoo,	সিদ্ধান্ত,	সিদ্ধান্তও,	
simons,	সিমন্স,	সিমন্স,	
geejeeteeda,	গীজিতেদা,	গেজেটেড,	
suraropito,	সুরারাপিত,	সুরারোপিত,	
modhumotii,	মধুমতিই,	মধুমতী,	
saifullahil,	সাইফুল্লাহলল,	সাইফুল্লাহিল,	
gonesher,	গনেশের,	গণেশের,	
nibobondhonkrito,	নিবন্ধবন্ত্রি,	নিববন্ধনকৃত,	
laga,	লাগা,	লগ,	
protisthan,	প্রতিষ্ঠান,	প্রতিষ্টান,	
farna,	ফরনা,	ফার্ন,	
mumtazer,	মুম্তাজের,	মুমতাজের,	
patengar,	পাটেঙ্গার,	পতেঙ্গার,	
karmoi,	কারমোই,	কর্মই,	
kode,	কোড,	কোড,	
ujobekeestaner,	উজবেক্তাসানের,	উজবেকিস্তানের,	
gajiipur,	গজীইপুর,	গাজীপুর,	
dakope,	ডাকোপে,	দাকোপ,	
ray,	রায়া,	রায়,	
hingsar,	হিংসার,	হিংসার,	
ekekrokom,	একেক্রমক,	একেকরকম,	
gandhikey,	গান্ধিকে,	গান্ধীকে,	
chakradhare,	চাকরাধার,	চক্রধরে,	
jerusalema,	জেরুসেলামা,	জেরুসালেম,	
ummool,	উম্মুল,	উম্মুল,	
motkey,	মোটকে,	মতকে,	
kodorer,	কদরের,	কদরের,	
jommu,	জম্মু,	জম্মু,	
pratijogider,	প্রতিযোগিদের,	প্রতিযোগীদের,	
sawam,	সাওয়াম,	সাওম,	
atmabishvashi,	আত্মবিশ্বাশী,	আত্মবিশ্বাসী,	
murali,	মুরালি,	মুরলী,	
biphal,	বিফাল,	বিফল,	
ruby,	রুবি,	রুবী,	
grambaasheeo,	গ্রামবাশীও,	গ্রামবাসীও,	
shikkharrthirao,	শিক্ষার্থীরাও,	শিক্ষার্থীরাও,	
shariba,	শারিবা,	শরিবা,	
chintakarma,	চিন্তাকর্ম,	চিন্তাকর্ম,	
jokkher,	যক্ষের,	যক্ষের,	
purushika,	পুরুশিকা,	পুরুষিকা,	
norpholk,	নর্ফলক,	নরফোক,	
alsaar,	আলসার,	আলসার,	
ghotleyo,	ঘোলটেও,	ঘটলেও,	
enamela,	এনামেলা,	এনামেল,	
shangsthaner,	শ্ংস্থানের,	সংস্থানের,	
mail,	মাইল,	মাইল,	
bouddho,	বৌদ্ধ,	বৌদ্ধ,	
uporzon,	উপর্জন,	উপার্জন,	
aaps,	আপএসএ,	এএপিএস,	
with,	উইথ,	ভিত,	
militarir,	মিলিটারির,	মিলিটারির,	
naazi,	নাজি,	নাত্সি,	
bodhirota,	বধিরতা,	বধিরতা,	
barnis,	বার্নিস,	বার্নিশ,	
sahittekder,	সাহিত্যদের,	সাহিত্যেকদের,	
suparahiro,	সুপারহিরও,	সুপারহিরো,	
asthishondhi,	অস্থিনসধ্ধি,	অস্থিসন্ধি,	
prasadhoni,	প্রসাধনী,	প্রসাধনী,	
aqram,	আকরাম,	আকরাম,	
ghatiti,	ঘটিটি,	ঘাঁটিটি,	
taims,	টাইম্স,	টাইমস্,	
zoojyota,	জুজ্যতা,	যোজ্যতা,	
sthapanagulo,	স্থাপানগগুলো,	স্থাপনাগুলো,	
khaaneker,	খানেকের,	খানেকের,	
tachnach,	তা্চাচ,	তছনছ,	
senabahinikey,	সেনাবাহিনীকে,	সেনাবাহিনীকে,	
gaichhe,	গাইছে,	গাইছে,	
cholochchitra,	চলচচিত্র,	চলচ্চিত্র,	
deaubande,	ডিউবান্ডে,	দেওবন্দে,	
overholing,	ওভারহোলিং,	ওভারহোলিং,	
dobhaar,	ডভার,	ডোভার,	
khude,	খুদে,	ক্ষুদে,	
notey,	নোটে,	নোটে,	
cheenja,	চিঞ্জা,	চেঞ্জ,	
fuss,	ফুস,	ফাস,	
nazad,	নাজাদ,	নজদ,	
kaaferder,	কাফারদের,	কাফেরদের,	
sikkhakbrinda,	সিক্ষাবৃন্দা,	শিক্ষকবৃন্দ,	
prakare,	প্রাকারে,	প্রকারে,	
shangkulaan,	শাংকুলান,	সংকুলান,	
kadakhonchar,	কাদাখোন্চার,	কাদাখোঁচার,	
rastagulikeo,	রাস্তাগুলিকেও,	রাস্তাগুলিকেও,	
croak,	ক্রোক,	ক্রোক,	
sombhobonaao,	সম্ভবনাও,	সম্ভবনাও,	
wedanta,	বয়েন্টা,	বেদান্ত,	
songkolonti,	সংকলন্তি,	সংকলনটি,	
monir,	মনির,	মনির,	
khitkar,	খিটকার,	ক্ষিতকর,	
sangaskritipreme,	সংস্কৃতির্মিতে,	সংস্কৃতিপ্রেমে,	
lotharan,	লোথারান,	লুথেরান,	
nirgaman,	নির্গামান,	নির্গমন,	
ghotolen,	ঘটলেন,	ঘটলেন,	
nirbahey,	নির্বাহে,	নির্বাহে,	
gaddaafee,	গাদ্ডাফি,	গাদ্দাফী,	
parisankhanbid,	পরিসংখ্বাবিদ,	পরিসংখ্যানবিদ,	
byan,	ব্যান,	ব্যাং,	
rezidence,	রেজিডেন্স,	রেসিডেন্স,	
bifol,	বিফল,	বিফল,	
probeshkari,	প্রবেশকারী,	প্রবেশকারী,	
erythrian,	এরিরিথিয়ার,	এরিথ্রিয়ান,	
diibug,	দিবেগু,	ডিবাগ,	
mathieu,	মাথিয়,	ম্যাথিউ,	
gejeted,	গেজেটেড,	গেজেটেড,	
kanuner,	কানুনের,	কানুনের,	
ashociatesh,	অশয়াকিশেস,	এসোসিয়েটস,	
pratool,	প্রাটুল,	প্রতুল,	
veenis,	ভিনিস,	ভেনিস,	
chowdhurir,	চৌধুরির,	চৌধুরীর,	
heena,	হিনা,	হেনা,	
mandondo,	মান্দন্ড,	মানদণ্ড,	
bharpur,	ভারপুর,	ভরপুর,	
marathi,	মারাথি,	মরাঠি,	
akmato,	আকমাত,	একমত,	
rubala,	রুবালা,	রুবল,	
jothon,	যথন,	যথন,	
tukrote,	টুক্রোতে,	টুকরোতে,	
kormoke,	কর্মকে,	কর্মকে,	
shikshakbrindo,	শিক্ষাবৃন্দ,	শিক্ষকবৃন্দ,	
mooney,	মুনে,	মুনে,	
sarajibonbyapi,	সররজিবনবাপি,	সারাজীবনব্যাপী,	
katateo,	কাটাতেও,	কাটাতেও,	
salchak,	সালচক,	সালচাক,	
saras,	সারাস,	সরস,	
udbhaboney,	উদ্ভাবনে,	উদ্ভাবনে,	
shtonehenge,	স্টনহেন্জে,	স্টোনহেঞ্জ,	
poriikkhateo,	পরিক্ষাতেও,	পরীক্ষাতেও,	
saom,	সাওম,	সাওম,	
stana,	স্টানা,	স্টোন,	
grambaashi,	গ্রামবাশী,	গ্রামবাসী,	
shangsthatikey,	শংস্থাটিকে,	সংস্থাটিকে,	
tunaita,	টুইনাইটা,	টুনাইট,	
prosadhaner,	প্রসাধানের,	প্রসাধনের,	
konruup,	কন্রুয়,	কোনরূপ,	
babare,	বাবারে,	বাবারে,	
porishongkhanbid,	পরিশণখাবিিদ,	পরিসংখ্যানবিদ,	
nibeditar,	নিবেদিতার,	নিবেদিতার,	
macbeth,	ম্যাকবেথ,	ম্যাকবেথ,	
lambaate,	লাম্বাতে,	লম্বাটে,	
ebhara,	এভারা,	এভার,	
parshwer,	পারশ্বের,	পার্শ্বের,	
ernad,	এর্াা,	এরনাড,	
sadeena,	সদদিনা,	সাডেন,	
pleena,	প্লিনা,	প্লেন,	
sofie,	সফি,	সোফি,	
bhejaano,	ভেজানো,	ভেজানো,	
vetrillocuism,	ভেট্রিলোসিমাম,	ভেট্রিলোকুইজম,	
dweepgoolotey,	দ্বীপললগতেই,	দ্বীপগুলোতে,	
shoreefer,	শরেফার,	শরিফের,	
qirq,	কির্ক,	কার্ক,	
rajtontro,	রাজতন্ত্র,	রাজতন্ত্র,	
jansa,	জানসা,	জন্স,	
bipti,	বিপটি,	বিপ্তি,	
shektor,	শেক্তর,	সেক্টর,	
byomkesh,	ব্যমকেষষ,	ব্যোমকেশ,	
heavy,	হিভি,	হেভি,	
teoner,	টেওনের,	টিওনার,	
dhangsantup,	ধ্ংসংস্পু,	ধ্বংসন্তুপ,	
mujuru,	মুজুরু,	মুজুরু,	
rashider,	রাশীদের,	রশিদের,	
dipon,	ডিপন,	দীপন,	
gabhaskaar,	গাভাসকার,	গাভাস্কার,	
chomski,	চমস্কি,	চমস্কি,	
brindabane,	বৃন্দাবানে,	বৃন্দাবনে,	
byaboharkarie,	ব্যবহরাকররি,	ব্যবহারকারীই,	
barrageke,	বারাগেকে,	ব্যারেজকে,	
qaferder,	কাফারদের,	কাফেরদের,	
rakkhanvag,	রক্ষণভভ,	রক্ষণভাগ,	
seniar,	সেনিয়ার,	সিনিয়র,	
saseza,	সাসেজা,	সসেজ,	
grontho,	গ্রন্থ,	গ্রন্থ,	
nogore,	নগরে,	নগরে,	
kuttake,	কুট্টাকে,	কুত্তাকে,	
ganakantha,	গণকন্থ,	গণকণ্ঠ,	
nirgamon,	নির্গামন,	নির্গমন,	
aalkaatra,	আলকাত্র,	আলকাতরা,	
mosjidtir,	মসজিদ্টির,	মসজিদটির,	
mehsus,	মেহসুস,	মেহসুস,	
venush,	ভেনুশ,	ভেনাস,	
domone,	ডমনে,	দমনে,	
chaaktir,	চাক্তির,	চাকতির,	
raiji,	রাইজি,	রাইজি,	
ronodeep,	রোনীদপ,	রণদীপ,	
encidablu,	এন্সিডাবল,	এনসিডাব্লু,	
batikromee,	বাতিকর্মী,	ব্যতিক্রমী,	
mirina,	মিরিনা,	মিরিনা,	
paroner,	প্যারোনের,	পারণের,	
krishibigyani,	কৃষিবিজ্ঞানী,	কৃষিবিজ্ঞানী,	
kanader,	কানাদের,	কণাদের,	
progresh,	প্রগ্রেশ,	প্রগ্রেস,	
swatantrata,	স্বতন্ত্রতা,	স্বতন্ত্রতা,	
pharanyeta,	ফর্যেেটা,	ফরম্যাট,	
saifai,	সাইফাই,	সাইফাই,	
thanvi,	থানভি,	থানভী,	
anutpadanshil,	অনুতপদ্শনীল,	অনুৎপাদনশীল,	
baarbadoj,	বার্বাজদ,	বার্বাডোজ,	
hughes,	হুঘেস,	হিউজেস,	
ekla,	একলা,	একলা,	
subader,	সুবাদের,	সুবাদে,	
hijritey,	হিজরিতে,	হিজরীতে,	
besirbhaagi,	বেশিরভাগী,	বেশিরভাগই,	
chokhwala,	চোখওলাল,	চোখওয়ালা,	
deefinishion,	ডিফিনিশন,	ডেফিনেশন,	
seqtara,	সেক্তারা,	সেক্টর,	
korkotkraantee,	কর্কটরান্তি,	কর্কটক্রান্তি,	
dalip,	দালিপ,	দালিপ,	
onurbar,	অনুর্বার,	অনুর্বর,	
ekjoge,	একযোগে,	একযোগে,	
transformaarer,	ট্রান্সফোর্মার,	ট্রান্সফরমারের,	
hert,	হার্ট,	হার্ট,	
taderek,	তাদেরকে,	তাদেরেক,	
dabarer,	দাবারের,	দাবারের,	
chargar,	চারগার,	চার্জার,	
laishensh,	লাইশেন্,	লাইসেন্স,	
welaqama,	ওয়েলামা,	ওয়েলকাম,	
quary,	কায়ারি,	কোয়েরি,	
shiropar,	শিরোপার,	শিরোপার,	
songkulan,	সংকুলান,	সংকুলান,	
akkelpure,	আক্কেলপুরে,	আক্কেলপুরে,	
asamonjasyopurno,	অসমাঞযসস্যপূর্ণ,	অসামঞ্জস্যপূর্ণ,	
hosbaleke,	হোসবালেকে,	হোসবালেকে,	
hillse,	হিলসে,	হিলসে,	
firozaa,	ফিরোজায়া,	ফিরোজা,	
ghatleo,	ঘাটলও,	ঘটলেও,	
upobasher,	উপবাশের,	উপবাসের,	
pakhtunistan,	পাকটুনিস্তান,	পাখতুনিস্তান,	
dwibidho,	দ্বিদিবোধ,	দ্বিবিধ,	
mirakela,	মিরাকেলা,	মিরাকেল,	
pariyech,	পরিয়েছ,	পরিয়েছ,	
ajuhat,	আজুহাত,	অজুহাত,	
mythological,	মিথোলিজোকাল,	মাইথলজিকাল,	
vittimul,	ভিট্টিমুল,	ভিত্তিমূল,	
vabook,	ভাবক,	ভাবুক,	
oxfordey,	অক্স্োর্ডে,	অক্সফোর্ডে,	
purohitder,	পুরোহিতদের,	পুরোহিতদের,	
protizogii,	প্রতিযোগী,	প্রতিযোগী,	
fimela,	ফিমেলা,	ফিমেল,	
parinati,	পরিনাটি,	পরিণতি,	
elakatir,	এলাকাটির,	এলাকাটির,	
bojhey,	বোঝে,	বোঝে,	
doobate,	দুবাতে,	ডুবাতে,	
uporitoler,	উপরিতলের,	উপরিতলের,	
sqalastiqa,	স্কললস্টিক,	স্কলাস্টিক,	
jins,	জিন্স,	জিন্স,	
vabaponno,	ভাবাপন্ন,	ভাবাপন্ন,	
prakalpagulor,	প্রলালপগুলোর,	প্রকল্পগুলোর,	
kutubuddinke,	কুটুবুদ্দিনকে,	কুতুবুদ্দিনকে,	
champa,	চাম্পা,	চাঁপা,	
nazranar,	নাজরানার,	নাজরানার,	
shahjapur,	শাহজাপুর,	শাহজাপুর,	
paripakey,	পারিপাকে,	পরিপাকে,	
hitokor,	হিতকর,	হিতকর,	
probolshoktio,	প্রবলক্ষিতও,	প্রবলশক্তিও,	
evaner,	ইভানের,	ইভানের,	
nothibhukta,	নথিভুক্ত,	নথিভুক্ত,	
muchi,	মুচি,	মুচি,	
ashamorthito,	অসামর্থিত,	অসমর্থিত,	
mohit,	মহিত,	মুহিত,	
dosha,	দোশা,	দোসা,	
whole,	ওয়েল,	হোল,	
sharthe,	শার্থে,	স্বার্থে,	
fulkapi,	ফুলকাপি,	ফুলকপি,	
bamni,	বামনি,	বামনী,	
slatgulor,	স্ল্যাটগুলোর,	স্ল্যাটগুলোর,	
temonbhabe,	তেমনভাবে,	তেমনভাবে,	
parikhar,	পরিখার,	পরিখার,	
arg,	আর্জ,	আর্গ,	
graambaashee,	গ্রামবাশী,	গ্রামবাসী,	
sausagee,	সৌসজি,	সসেজ,	
bijito,	বিজিত,	বিজিত,	
vobanipur,	ভবনাীপুর,	ভবানীপুর,	
upobashii,	উপবাশিই,	উপবাসী,	
thaanobhi,	থানভভি,	থানভী,	
laishensha,	লাইশেন্স,	লাইসেন্স,	
bolechile,	বলেছিলে,	বলেছিলে,	
addata,	আদ্দাটা,	আড্ডাটা,	
concerter,	কনস্টারের,	কানসাটের,	
byboshthar,	বিবিষ্ঠার,	ব্যাবস্থার,	
thailandsaho,	থাইলানদাসহ,	থাইল্যান্ডসহ,	
jonee,	জনি,	জনি,	
ingrezeeteo,	ইংরেজিতেও,	ইংরেজিতেও,	
dharmadasbabu,	ধর্মদাববাবু,	ধর্মদাসবাবু,	
siddharther,	সিদ্ধার্থের,	সিদ্ধার্থের,	
ganohotyake,	গণহত্যাকে,	গণহত্যাকে,	
soommita,	সুম্িতা,	সুমিতা,	
addabaj,	আদ্দবাজ,	আড্ডাবাজ,	
mesenjjar,	মেজেঞ্জার,	মেসেঞ্জার,	
aansareer,	আনসারীর,	আনসারীর,	
kobulennechha,	কবুলেন্ছেনা,	কবুলেন্নেছা,	
streegon,	স্ট্রীগোন,	স্ত্রীগণ,	
brail,	ব্রেইল,	ব্রেইল,	
sossar,	সোসার,	সকার,	
alpakichudin,	আল্পকিিদুনিন,	অল্পকিছুদিন,	
balabhadra,	বলবা্দর,	বলভদ্র,	
gyandas,	জ্ঞানদাস,	জ্ঞানদাস,	
dibet,	দিবেত,	ডিবেট,	
bhugol,	ভুগোল,	ভূগোল,	
probhura,	প্রভূরা,	প্রভুরা,	
laicenshe,	লেইসেন্স,	লাইসেন্স,	
drabyatah,	দ্রাব্যাতাহ,	দ্রব্যতঃ,	
taxikeo,	ট্যাক্সিকেও,	ট্যাক্সিকেও,	
kuhelika,	কুহেলিকা,	কুহেলিকা,	
transform,	ট্রান্সফোর্ম,	ট্রান্সফর্ম,	
soorsa,	সুর্সা,	সোর্স,	
shrabostee,	শ্রাবস্তি,	শ্রাবস্তী,	
utkhaat,	উৎকাত,	উত্খাত,	
baire,	বাইরে,	বাইরে,	
korimkey,	করিমকে,	করিমকে,	
machsoho,	মাচসহ,	মাছসহ,	
dorun,	দরুন,	দরুণ,	
difinisian,	ডিফিনিসিয়ান,	ডেফিনেশন,	
nederlande,	নেডির্যান্ডে,	নেদারল্যান্ডে,	
mmadhuri,	ম্মাধারী,	মাধুরী,	
mailkhanek,	মৈলখানেক,	মাইলখানেক,	
dajjha,	দাজঝা,	দাহ্য,	
naajii,	নাজিই,	নাত্সি,	
municipal,	মুনিকিপাল,	মিউনিসিপ্যাল,	
ekghore,	একঘরে,	একঘরে,	
samoshtigato,	সমস্থিগগত,	সমষ্টিগত,	
bhagnekeo,	ভাগনেকেও,	ভাগ্নেকেও,	
mardud,	মারদুদ,	মরদুদ,	
oswastikor,	অস্বাস্তকর,	অস্বস্তিকর,	
bishesyo,	বিশেষ্য,	বিশেষ্য,	
scoore,	স্করর,	স্কোর,	
deejeejer,	দীজীজের,	ডিজিজের,	
fising,	ফিসিং,	ফিসিং,	
treend,	ট্রিন্ড,	ট্রেন্ড,	
premo,	প্রেমো,	প্রিমো,	
romnar,	রোমনার,	রমনার,	
muradkey,	মুরাদকে,	মুরাদকে,	
songrahak,	সংগ্রহক,	সংগ্রাহক,	
aakaabar,	আকাবার,	আকাবার,	
zohns,	জোনস,	জন্স,	
chhutochhooti,	ছুটুছোটি,	ছুটোছুটি,	
elakaate,	এলাকাতে,	এলাকাতে,	
shommotir,	শম্মতির,	সম্মতির,	
suri,	সুরি,	সুরি,	
manohputa,	মানোপুতা,	মনঃপুত,	
pacchi,	পাচ্ছি,	পাচ্ছি,	
akhhunno,	আখুন্ন,	অক্ষুণ্ণ,	
chowdhuryke,	চুউধুরিকে,	চৌধুরীকে,	
horas,	হোরাস,	হোরাস,	
protizogiita,	প্রতিযোগিতায়,	প্রতিযোগীতা,	
taalaal,	তালাল,	তালাল,	
kheylechen,	খেলেছেন,	খেলেছেন,	
probeshan,	প্রবেশন,	প্রবেশন,	
dijijer,	দিজিজের,	ডিজিজের,	
myathiou,	ম্যাথিওয়ু,	ম্যাথিউ,	
oncholsomuho,	অঞ্চলমসূহ,	অঞ্চলসমূহ,	
sheepha,	শিফা,	শেফ,	
dhos,	ধোস,	ধস,	
goolen,	গুলেন,	গুলেন,	
sumitrar,	সুমিত্রার,	সুমিত্রার,	
utsahamulak,	উৎসামূলক,	উৎসাহমূলক,	
milton,	মিলটন,	মিলটন,	
korimer,	করিমের,	করিমের,	
bosontokke,	বসন্তকে,	বসন্তকে,	
zerusaleme,	জেরুসালেমে,	জেরুসালেমে,	
ongshogrohoner,	অংশগ্রহণের,	অংশগ্রহনের,	
anusvara,	অনুসভার,	অনুস্বার,	
ganaparibahan,	গণপরীবহন,	গণপরিবহন,	
udor,	উডোর,	উদর,	
shuri,	শুরি,	সুরি,	
jor,	জোর,	জ্বর,	
bsnleu,	বিসনিউল,	বিএসএনএলইইউ,	
mag,	ম্যাগ,	এমএজি,	
mukhobondho,	মুখবন্ধ,	মুখবন্ধ,	
charban,	চরবান,	চর্বন,	
prokolpoti,	প্রকল্পটি,	প্রকল্পটি,	
hood,	হুড,	হুড,	
kourabe,	কৌরাবে,	কৌরবে,	
dhhaloor,	ঢালুর,	ঢালুর,	
nutaner,	নুতানের,	নূতনের,	
laaisensh,	লেইসেন্স,	লাইসেন্স,	
satarkakari,	সতরকাকারী,	সতর্ককারী,	
vaibon,	ভাইবন,	ভাইবোন,	
aasirbaad,	আশ্রববাদ,	আশির্বাদ,	
tinage,	টিনাগে,	টিনেজ,	
dhormokorme,	ধর্মকর্মে,	ধর্মকর্মে,	
telakucha,	তেলাকুচা,	তেলাকুচা,	
nimnosakkharkari,	নিম্নসংকারকারী,	নিম্নস্বাক্ষরকারী,	
sontoshpur,	সন্তশ্পুর,	সন্তোষপুর,	
aajeej,	আজিজ,	আজিজ,	
aziza,	আজিজা,	আজিজা,	
bikretaara,	বিক্রেতারা,	বিক্রেতারা,	
shapad,	শাপাদ,	শ্বাপদ,	
raghubar,	রাঘুবার,	রঘুবীর,	
olympic,	অলিম্পিক,	অলিম্পিক,	
masjidsaha,	মসজিসদহ,	মসজিদসহ,	
gronthowo,	গ্রন্থযয,	গ্রন্থও,	
daktikit,	দাক্তিকিত,	ডাকটিকিট,	
abadamoner,	আবাদামনের,	অবদমনের,	
cholochchitrai,	চলচ্চিত্রই,	চলচ্চিত্রই,	
mononiitoder,	মননিতোদের,	মনোনীতদের,	
abhiyojan,	অভিযযজজন,	অভিযোজন,	
uddhrito,	উদ্ধৃত,	উদ্ধৃত,	
vogno,	ভগ্ন,	ভগ্ন,	
dokkhinangsho,	দক্ষিণাংশ,	দক্ষিণাংশ,	
kathmandu,	কাঠমান্দু,	কাঠমান্ডু,	
sazanor,	সাজানোর,	সাজানোর,	
orthobochorke,	অর্থবরচকে,	অর্থবছরকে,	
armashtram,	আর্মশ্রতম্,	আর্মস্ট্রং,	
shamijir,	শমিজির,	স্বামীজীর,	
xpose,	এক্সপো,	এক্সপোজ,	
jocqey,	জোকে,	জকি,	
puding,	পুডিং,	পুডিং,	
bhyaatikaner,	ভ্যাটিকানের,	ভ্যাটিকানের,	
nehle,	নেহলে,	নেহলে,	
jorury,	জোরুরি,	জরূরী,	
poddhotitei,	পদ্ধতিতেই,	পদ্ধতিতেই,	
keyu,	কেয়ু,	কেউ,	
eigulor,	ইইগুলোর,	এইগুলোর,	
faltu,	ফল্তু,	ফালতু,	
bashoborty,	বাশবর্তি,	বশবর্তী,	
bharotiyotar,	ভারতিয়তার,	ভারতীয়তার,	
sonaicha,	সোনাইচা,	সোনাইচা,	
husni,	হুসনি,	হুসনি,	
ekshoti,	একশটি,	একশোটি,	
sangsakti,	সংসক্তি,	সংসক্তি,	
lakshmir,	লক্ষমীর,	লক্ষ্মীর,	
agomone,	আগমনে,	আগমনে,	
byaboharkarir,	ব্যবহারকারীর,	ব্যবহারকারীর,	
trabuco,	ট্রাযাবুকো,	ট্র্যাবুকো,	
chai,	চাই,	ছাই,	
hondooras,	হন্ডারাস,	হন্ডুরাস,	
jeten,	জেতেন,	জেতেন,	
hitaishi,	হিতাশি,	হিতৈষী,	
anchalgulir,	অঞ্চলগুলির,	অঞ্চলগুলির,	
sharoker,	শারকের,	স্মারকের,	
jhamala,	ঝামালা,	ঝামালা,	
deelibhara,	দীলীভারা,	ডেলিভার,	
bajhyo,	বাঝ্য,	বাহ্য,	
madraser,	মাদ্রাসের,	মাদ্রাজের,	
naazee,	নাজি,	নাত্সি,	
rakshanbhag,	রক্ষণভাগ,	রক্ষণভাগ,	
greep,	গ্রিপ,	গ্রিপ,	
mashtarsha,	মাশতারশা,	মাস্টার্স,	
daap,	দাপ,	ড্যাপ,	
grootha,	গ্রোথা,	গ্রোথ,	
bhabotarini,	ভাবারারিনী,	ভবতারিণী,	
vaider,	ভাইদের,	ভাইদের,	
ashankai,	আশাঙকাই,	আশঙ্কাই,	
taunasipa,	তৌনসিপা,	টাউনশিপ,	
jitpur,	জিতপুর,	জিতপুরের,	
jontrototto,	যন্ত্রতত্ব,	যন্ত্রতত্ত্ব,	
tokee,	টকি,	তকি,	
aholya,	অহল্যা,	অহল্যা,	
rahee,	রাহী,	রাহী,	
kamti,	কামটি,	কমতি,	
bisshas,	বিশ্বাস,	বিশ্বাস,	
ghotleo,	ঘটলেও,	ঘটলেও,	
anichchi,	অনিচ্ছি,	আনিচ্ছি,	
konoroop,	কননরূপ,	কোনরূপ,	
prakalpatike,	প্রলালপিতকে,	প্রকল্পটিকে,	
chadake,	চাদাকে,	চড়াকে,	
sikara,	সিকারা,	শিকার,	
nobotom,	নবতম,	নবতম,	
karim,	কারিম,	করিম,	
neelfamarir,	নীল্লামারীর,	নীলফামারীর,	
torunosomriddho,	তরুণসিমৃদ্ধ,	তরুণসমৃদ্ধ,	
ashok,	আশোক,	আশোক,	
panchasjan,	পঞ্চসজজন,	পঞ্চাশজন,	
antarctika,	অ্যান্টারট্টিকা,	অ্যান্টার্কটিকা,	
eshtoniya,	এস্তনিয়া,	এস্তোনিয়া,	
stoonahenja,	স্তানুহন্জা,	স্টোনহেঞ্জ,	
mausumeo,	মাউসমমেও,	মৌসুমেও,	
grooth,	গ্রুথ,	গ্রোথ,	
gonohotyakey,	গনহতযয়কে,	গণহত্যাকে,	
uter,	উটের,	উটের,	
trutimatra,	ট্রুমিত্রার,	ত্রুটিমাত্র,	
esoosiyetasa,	এসোইসিয়েসা,	এসোসিয়েটস,	
motke,	মোটকে,	মতকে,	
anyarup,	অন্যরূপ,	অন্যরূপ,	
songasthatike,	সং্গাঠ্থাটিকে,	সংস্থাটিকে,	
niketaner,	নিকেটানের,	নিকেতনের,	
ispredseet,	ইস্প্রেসিট,	স্প্রেডশীট,	
dhhaabi,	ঢাবাবি,	ঢাবি,	
hank,	হাঁক,	হাঙ্ক,	
bohudin,	বহুদিন,	বহুদিন,	
selim,	সেলিম,	সেলিম,	
bishwasho,	বিশ্বাশ,	বিশ্বাসও,	
modele,	মোডেলে,	মডেলে,	
elakayi,	এলাকায়ি,	এলাকাই,	
basaake,	বাসাকে,	বাসাকে,	
mookhomaundoler,	মুখমান্ডলের,	মুখমণ্ডলের,	
palbongsher,	পালবংশের,	পালবংশের,	
sarsa,	সর্সা,	সোর্স,	
protijogi,	প্রতিযোগী,	প্রতিযোগী,	
phartha,	ফর্থা,	ফার্থ,	
khanonkaj,	খানকাজ,	খননকাজ,	
rilayensha,	রিলয়েশন,	রিলায়েন্স,	
naabyota,	নাব্যতা,	নাব্যতা,	
shasonamoleri,	শাসনামললেরই,	শাসনামলেরই,	
conflict,	কনফ্লিক্ট,	কনফ্লিক্ট,	
drissogoolote,	দৃশ্যগুলোতে,	দৃশ্যগুলোতে,	
tatey,	তাতে,	তাতে,	
baikalyo,	বাইকাল্য,	বৈকল্য,	
said,	সাইদ,	সাইদ,	
dristiheen,	দৃষ্টিহীন,	দৃষ্টিহীন,	
basab,	বাসাব,	বাসাব,	
kajangale,	কাজাঙ্গলে,	কজঙ্গলে,	
shilpikuler,	শিল্পিকুলের,	শিল্পীকুলের,	
manab,	মানব,	মানব,	
sahachke,	সাচকে,	সাহাচকে,	
nischitobhabe,	নিশ্চিতভাবে,	নিশ্চিতভাবে,	
ase,	এসে,	আসে,	
nabotom,	নাবতম,	নবতম,	
omanisa,	ওমানিসা,	অমানিশা,	
chetanagato,	চেতানগগত,	চেতনাগত,	
nomo,	নোমো,	নমো,	
mosjidsoho,	মসজিদসহ,	মসজিদসহ,	
bejiye,	বেজিয়ে,	বেজিয়ে,	
dong,	ডং,	ডং,	
bahjya,	বাহ্যজ্য,	বাহ্য,	
shishupalgarh,	শিশুপগ্রহ,	শিশুপালগড়ে,	
palta,	পাল্টা,	পালটা,	
romantik,	রোমান্তিক,	রোমান্টিক,	
ohalyar,	ওহাল্যার,	অহল্যার,	
metrikoleshana,	মেত্রোকিশেলনা,	মেট্রিকোলেশন,	
harysoner,	হারিসনের,	হ্যারিসনের,	
seebiai,	সিবিয়া,	সিবিআই,	
sikarer,	সিকারের,	শিকারের,	
tookror,	টুকরর,	টুকরোর,	
marpit,	মার্পিট,	মারপিট,	
sohinsotar,	সহিনসতার,	সহিংসতার,	
degree,	ডাগ্রি,	ডিগ্রি,	
registrikrito,	রেজিস্ট্রিক্ত,	রেজিস্ট্রীকৃত,	
cena,	সেনা,	সিনা,	
debdebyr,	দেবদববীর,	দেবদেবীর,	
dara,	দারা,	দারা,	
bagicha,	বাগিচা,	বাগিচা,	
jeelyaand,	জীল্যাণ্ড,	জিল্যান্ড,	
cathalic,	ক্যাথালিক,	ক্যাথলিক,	
dekhso,	দেখস,	দেখসো,	
cheento,	চিন্তো,	চিনতো,	
bhoutikeshu,	ভৌতিকেশু,	ভৌতিকেষু,	
madrasa,	মাদ্রাসা,	মাদ্রাসা,	
hydrological,	হাইড্রোলিক্যাল,	হাইড্রোলজিক্যাল,	
ashamarthita,	অসামর্থিতা,	অসমর্থিত,	
krisenta,	ক্রিসেন্টা,	ক্রিসেন্ট,	
ghurte,	ঘুর্তে,	ঘুরতে,	
milea,	মিলিয়া,	মাইলে,	
bhenasha,	ভেনাশা,	ভেনাস,	
yuroo,	যুরুও,	ইউরো,	
shrichaitanyadev,	শ্রীচাতনায়েবেদ,	শ্রীচৈতন্যদেব,	
bohorompurer,	বহরমপুরের,	বহরমপুরের,	
batistambhatike,	বাতিস্তভামভিতে,	বাতিস্তম্ভটিকে,	
sombhobonao,	সম্ভবনাও,	সম্ভবনাও,	
ukeliptash,	উকেলিপ্টাস,	ইউক্যালিপ্টাস,	
thailand,	থাইলান্ড,	থাইল্যান্ড,	
nabbata,	নব্বাতা,	নাব্যতা,	
europia,	ইউরোপিয়া,	ইউরোপিয়া,	
chandil,	চান্ডিল,	চান্ডিল,	
dianes,	ডিয়ানেস,	ডিএনএস,	
gajano,	গাজানো,	গজানো,	
jani,	জানি,	জনি,	
mishal,	মিশাল,	মিশাল,	
girilal,	গিরিলাল,	গিরিলাল,	
jwar,	জ্বার,	জ্বর,	
liseensee,	লিসেনসি,	লাইসেন্স,	
ooipokar,	ওপাকার,	উইপোকার,	
kyatagorir,	ক্যাটাগরির,	ক্যাটাগরির,	
koordider,	কর্ডিদের,	কুর্দিদের,	
byaktigotovabeo,	ব্যক্তিতগতভাবেও,	ব্যাক্তিগতভাবেও,	
shomostigoto,	সমস্তিগত,	সমষ্টিগত,	
taholo,	তাহোলো,	তাহলো,	
osoborno,	অসর্ণন,	অসবর্ণ,	
boikolyo,	বৈকল্য,	বৈকল্য,	
poschime,	পশ্চিমে,	পশ্চিমে,	
machkabar,	মাচকাবার,	মাচকাবার,	
rockibul,	রকিবুল,	রকিবুল,	
chiraharit,	চিরাহারিত,	চিরহরিৎ,	
korley,	করলি,	করলে,	
footbalarer,	ফুটবালারের,	ফুটবলারের,	
noitikota,	নৈতিকতা,	নৈতিকতা,	
enginiiring,	এনজিনিরিং,	ইঞ্জিনিয়ারিং,	
nirikh,	নিরিখ,	নিরিখ,	
hepatetisa,	হেপাটিটিসা,	হেপাটাইটিস,	
battery,	ব্যাট্রি,	ব্যাটারী,	
kichutei,	কিছুতেই,	কিছুতেই,	
sumita,	সুমিতা,	সুমিতা,	
gandharir,	গানধারির,	গান্ধারীর,	
madhoboir,	মাধবইর,	মাধবীর,	
pothon,	পথন,	পঠন,	
gej,	গেজ,	গেজ,	
balithubar,	বালিথুবার,	বালিথুবার,	
phising,	ফিসিং,	ফিসিং,	
batikromi,	বাতিকর্মী,	ব্যতিক্রমী,	
apolokbhabe,	অপলকভাবে,	অপলকভাবে,	
kolkarkhana,	কোলকর্ণনা,	কলকারখানা,	
carbus,	কার্বাস,	কারবাস,	
yak,	য্যাক,	ইয়াক,	
manobikotao,	মানবিকতাও,	মানবিকতাও,	
parjotaker,	পার্যতকের,	পর্যটকের,	
kanasharabheshhana,	কনশ্বরেশন,	কনসারভেশন,	
canservatian,	ক্যানাসভারিটিয়াল,	কনসারভেশন,	
turisht,	তুরিশ্ট,	টুরিস্ট,	
arke,	আরকে,	আরকে,	
phonekari,	ফোনেকারি,	ফোনকারী,	
mast,	মাস্ট,	মাস্ত,	
sathik,	সাথিক,	সঠিক,	
moddhyoshtho,	মদ্যস্থ,	মধ্যস্থ,	
kaash,	কাশ,	কাস,	
nikote,	নিকোতে,	নিকটে,	
ishahak,	ইশাহাক,	ইসাহাক,	
hundai,	হুন্ডাই,	হুন্দাই,	
abheedhanic,	অভিনানিক,	অভিধানিক,	
bisheshshyo,	বিশেশ্য,	বিশেষ্য,	
srisri,	শ্রীশ্রি,	শ্রীশ্রী,	
pratisthanik,	প্রতিষ্ঠানিক,	প্রাতিষ্ঠানিক,	
dharabahikotitey,	ধারাবাহিকতিতে,	ধারাবাহিকটিতে,	
rakhtokkharoner,	রাক্তভক্ষণের,	রক্তক্ষরণের,	
lutharan,	লুথারান,	লুথেরান,	
prashikkhane,	প্রশিক্ষণে,	প্রশিক্ষণে,	
olympicer,	অলিমিপিসের,	অলিম্পিকের,	
folleni,	ফলেনি,	ফলেনি,	
srivatsalakshanang,	শ্রীবন্তলকক্ষং,	শ্রীবৎসলক্ষণং,	
souripurang,	সৌরিপূরং,	সৌরিপুরং,	
eduardo,	এডুয়ার্ডো,	এডুয়ার্দো,	
teoyana,	তেওয়ানা,	তাইওয়ান,	
chalachchitro,	চলচ্চিত্র,	চলচ্চিত্র,	
sexperter,	সেক্সপ্রেটের,	সেক্সপার্টের,	
dormetori,	ডর্মেটরি,	ডরমিটরি,	
dakteekiter,	দাক্তিকেতের,	ডাকটিকিটের,	
siitei,	সিইটেই,	শীতেই,	
flexta,	ফ্লেক্সটা,	ফ্লেক্সটা,	
bishaashke,	বিশাশকে,	বিশ্বাসকে,	
shorifer,	শরিফের,	শরিফের,	
deebug,	দীবুগ,	ডিবাগ,	
fud,	ফাদ,	ফুড,	
sahojatprobritti,	সহজাতব্রবৃত্তি,	সহজাতপ্রবৃত্তি,	
gasthii,	গাস্থিই,	গোষ্ঠীই,	
upacharjo,	উপাচর্য,	উপাচার্য,	
taunsheep,	তৌনশিপ,	টাউনশিপ,	
laagche,	লাগছে,	লাগছে,	
arekdol,	আরেকডোল,	আরেকদল,	
chikittsar,	চিকিৎসসতর,	চিকিত্সার,	
jaubankal,	যৌবকান,	যৌবনকাল,	
digreeke,	ডিগ্রিকে,	ডিগ্রিকে,	
tiunara,	টিউনারা,	টিউনার,	
armeenian,	অর্মিনিয়ান,	আর্মেনিয়ান,	
kkhur,	কুশর,	ক্ষুর,	
disni,	ডিসনি,	ডিজনী,	
atak,	আতাক,	আটক,	
gaandaas,	গান্দাস,	জ্ঞানদাস,	
manabmaner,	মানমবানের,	মানবমনের,	
shingping,	শিংিংপিং,	শিংপিং,	
nagorikderkey,	নাগরিকদেরকে,	নাগরিকদেরকে,	
purbancoler,	পুর্বান্সলোর,	পূর্বাঞ্চলের,	
seeramiks,	সিরামিকস,	সিরামিকস,	
ramzaner,	রামজানের,	রমযানের,	
nathivukteer,	নাথিভুক্তির,	নথিভুক্তির,	
raunanganey,	রাননগন্ডে,	রণাঙ্গনে,	
brittakarey,	বৃত্যাকারে,	বৃত্তাকারে,	
sudrishya,	সুদৃশ্য,	সুদৃশ্য,	
maailey,	মাইলে,	মাইলে,	
billaho,	বিল্লাহ,	বিল্লাহ,	
baait,	বাইট,	বাইট,	
nowel,	নওউল,	নভেল,	
agora,	আগোরা,	আগোরা,	
tuleche,	তুলেছে,	তুলেছে,	
elaakaate,	এলাকাটে,	এলাকাতে,	
gingbhalobasen,	গিংভাবলসানে,	গিংভালোবাসেন,	
bondhukey,	বন্ধুকে,	বন্ধুকে,	
toroonraa,	তরনরা,	তরুণরা,	
giitikobita,	গীতিকিবিতা,	গীতিকবিতা,	
huka,	হুকা,	হুক,	
beshyasdone,	বেশ্যাসন্দে,	বেশ্যাসদনে,	
kaalengaa,	কালেঙ্গা,	কালেঙ্গা,	
shiter,	শিতের,	শীতের,	
ajijer,	আজিজের,	আজিজের,	
planey,	প্লানে,	প্লেনে,	
bonke,	বংকে,	বনকে,	
america,	আমেরিকা,	আমেরিকা,	
dibug,	দিবুগ,	ডিবাগ,	
distibutor,	ডিস্টিবুরু,	ডিস্টিবিউটারের,	
madhumati,	মধুমাি,	মধুমতী,	
associatis,	অ্যাসোকিসিয়াস,	এসোসিয়েটস,	
basturoi,	বাস্তুরই,	বস্তুরই,	
drishyer,	দৃশ্যের,	দৃশ্যের,	
prapokkey,	প্রাপককে,	প্রাপককে,	
sahozlabhbhotar,	সহলজভভভতার,	সহজলভ্যতার,	
munsi,	মুনসি,	মুন্সী,	
porobortii,	পরবর্তই,	পরর্বতী,	
dalnata,	দলনাটা,	ডালনাটা,	
bishwaashshke,	বিশ্বাশ্ষকে,	বিশ্বাসকে,	
charukala,	চরুকালা,	চারুকলা,	
maryir,	মারিয়ার,	ম্যারির,	
residence,	রেসিডেন্স,	রেসিডেন্স,	
dheke,	ধেকে,	ঢেকে,	
elgoridom,	এলগোরিোড,	এলগরিদম,	
sobrakomer,	সব্রাকমের,	সবরকমের,	
shef,	শেফ,	শেফ,	
trenda,	ট্রেন্ডা,	ট্রেন্ড,	
debete,	দেবেতে,	ডিবেট,	
hugheke,	হুঘেকে,	হিউজকে,	
moshahidur,	মোহাহিদুর,	মোশাহিদুর,	
cholochchitrer,	চলচচিত্রের,	চলচ্চিত্রের,	
shchalastic,	স্চালাস্টিক,	স্কলাস্টিক,	
beetloser,	বিটলোসের,	বিটলসের,	
maaktoome,	মাক্তমু,	মাকতুম,	
licencer,	লাইস্স্যানের,	লাইসেন্সের,	
capsule,	ক্যাপসুল,	ক্যাপ্সুল,	
poscime,	পশ্সিম,	পশ্চিমে,	
iksaprishana,	ইক্ষাপৃষণ,	এক্সপ্রেশন,	
pohnpeic,	পো্পনিক,	ফোনপেইক,	
eexpreession,	ইক্্স্রিশন,	এক্সপ্রেশন,	
koyeeri,	কয়েরী,	কোয়েরি,	
uporitaley,	উপরিতলে,	উপরিতলে,	
karaponner,	কারাপন্নের,	কারাপণ্যের,	
corsin,	কর্সিন,	করসিন,	
pillai,	পিল্লাই,	পিল্লাই,	
nirmalata,	নির্মলতা,	নির্মলতা,	
bhorkendra,	ভর্কেন্দ্র,	ভরকেন্দ্র,	
aborto,	আবর্ত,	আবর্ত,	
hastantar,	হস্তন্তর,	হস্তান্তর,	
neshnos,	নেশনোস,	নেশনস,	
vromonkaley,	ভ্রমণকালে,	ভ্রমণকালে,	
aembed,	আম্বেদ,	এম্বেড,	
courtcaser,	কার্ট্যাসের,	কোর্টকেসের,	
akar,	আকার,	একার,	
dephinishion,	ডিফিনিশন,	ডেফিনেশন,	
chanoo,	চানু,	চানু,	
byabosthar,	ব্যবস্থার,	ব্যাবস্থার,	
bhittimul,	ভিত্তিমূল,	ভিত্তিমূল,	
sayanaida,	সায়ানাইদা,	সায়ানাইড,	
songbadmadhyomer,	সংবাদমধ্যমের,	সংবাদমাধ্যমের,	
satarkabhabey,	সতরাকভাবে,	সতর্কভাবে,	
shektore,	শেক্তরে,	সেক্টরে,	
nagorikke,	নাগরিককে,	নাগরিককে,	
deefinision,	ডিফিনিনন,	ডেফিনেশন,	
bonvumitey,	বনভুমিতে,	বনভূমিতে,	
nothibhukto,	নথিভুক্ত,	নথিভুক্ত,	
jaanachhe,	যানাচে,	জানাচ্ছে,	
heawy,	হিভ,	হেভি,	
supreetira,	সুপ্রিতিরা,	সুপ্রীতিরা,	
inziniyarsa,	ইনজিনিয়ারস,	ইঞ্জিনিয়ার্স,	
pathanirdeshona,	পাঠানিরদেশন,	পথনির্দেশনা,	
aakkas,	আক্কাস,	আককাস,	
akatwa,	আকাত্ব,	একাত্ব,	
veniser,	ভেনিসের,	ভেনিসের,	
rodney,	রোডে,	রেডনি,	
sahinsatar,	সহিনসততার,	সহিংসতার,	
siraju,	সিরাজু,	সিরাজু,	
provritike,	প্রভৃতিকে,	প্রভৃতিকে,	
neermol,	নির্মোল,	নির্মল,	
prakar,	প্রাকার,	প্রকার,	
gaichey,	গাইছে,	গাইছে,	
durgatsober,	দুর্গাতসবের,	দুর্গোৎসবে,	
prangulo,	প্রাঙ্গুলো,	প্রানগুলো,	
mojdur,	মোজদুর,	মজদুর,	
hafsa,	হাফসা,	হাফসা,	
dhauto,	ধৌতো,	ধৌত,	
artore,	আর্তরে,	আর্টরে,	
distance,	ডিস্টান্স,	ডিসট্যান্স,	
sqirt,	স্কির্ট,	স্কার্ট,	
nirmankaaj,	নির্মানজাজ,	নির্মাণকাজ,	
holding,	হোল্ডিং,	হোল্ডিং,	
jolbe,	জলবে,	জ্বলবে,	
meloonborroner,	মেলবববর্ণের,	মেলবোর্নের,	
pretty,	প্রেট্টি,	প্রিটি,	
artherer,	আর্থেরের,	আর্থারের,	
bharatey,	ভারতে,	ভারতে,	
purohitra,	পুরোহিত্র,	পুরোহিতরা,	
messengerer,	মেসেঞ্জারের,	মেসেঞ্জারের,	
camerapersoner,	ক্যামেরাপারসনের,	ক্যামেরাপার্সনের,	
irana,	ইরানা,	ইরান,	
chalchhe,	চালছে,	চলছে,	
mawdeel,	মাউডিল,	মডেল,	
bardhitansh,	বার্ধিতন্ষ,	বর্ধিতাংশ,	
anchalo,	অঞ্চলো,	অঞ্চলও,	
jomoker,	জমকের,	জমকের,	
commissionvogider,	কমিশনিলজদের,	কমিশনভোগীদের,	
bonsho,	বনশ,	বংশ,	
chorchita,	চর্চিতা,	চর্চিত,	
ghoorchen,	ঘরছেন,	ঘুরেছেন,	
mase,	মেস,	মাসে,	
madhabike,	মাধাবিকে,	মাধবীকে,	
shipley,	শিপলে,	শিপলে,	
lisense,	লিইসেন্স,	লাইসেন্স,	
protistha,	প্রতিষ্ঠা,	প্রতিষ্টা,	
aashanka,	আশাঙ্কা,	আশংকা,	
hari,	হারি,	হরি,	
jolaatonko,	জলাতানক,	জলাতঙ্ক,	
boshoborti,	বশবর্তি,	বশবর্তী,	
nischoy,	নিশ্চয়,	নিশ্চয়,	
laiseensim,	লাইসিনিস,	লাইসেন্সিং,	
bheenisa,	ভীনিসা,	ভেনিস,	
aatmobishwasi,	আত্মবিশ্বাসী,	আত্মবিশ্বাসী,	
backflipe,	ব্যাকফলফপপে,	ব্যাকফ্লিপে,	
thaii,	থাইই,	থাই,	
shikshagata,	শিক্ষগত,	শিক্ষাগত,	
hoondayi,	হুন্দায়,	হুন্দাই,	
alexandar,	আলেক্সান্ডার,	আলেকজান্ডার,	
doorotaumo,	দুরতামৌ,	দূরতম,	
daaktikite,	দাক্তিকিতে,	ডাকটিকিটে,	
protishtan,	প্রতিষ্টান,	প্রতিষ্টান,	
ankanshilpe,	অঙ্কানশিল্পে,	অঙ্কনশিল্পে,	
nisader,	নিসাদের,	নিষাদের,	
generalissimo,	জেনারালিসিসম,	জেনারেলিসিমো,	
residensa,	রেসিডেনসা,	রেসিডেন্স,	
dii,	ডিইি,	দিই,	
muhurtati,	মুহুর্তাটি,	মুহুর্তটি,	
upbrazillian,	আপবির্লিয়াল,	আপব্রাজিলিয়ান,	
angkita,	অঙ্কিতা,	অঙ্কিতা,	
sakshatkarer,	সাক্ষাতকরের,	সাক্ষাৎকারের,	
somraatder,	সম্রাদদের,	সম্রাটদের,	
rajbandi,	রাজবন্দি,	রাজবন্দী,	
mukhomandaley,	মুখমোন্ডলে,	মুখমণ্ডলে,	
bornanukrome,	বর্ণানুমকর্মে,	বর্নানুক্রমে,	
manjushri,	মঞ্জুশ্রি,	মঞ্জুশ্রী,	
habsi,	হাবসি,	হাবশী,	
peterke,	পেটারকে,	পিটারকে,	
kantajir,	কান্তাজির,	কান্তজির,	
braqe,	ব্রাকে,	ব্রেক,	
chamski,	চামস্কি,	চমস্কি,	
pratiyogitar,	প্রাতিযোগীতার,	প্রতিযোগীতার,	
birmuktijoddhagan,	বির্মক্তিদ্ধগতাাও,	বীরমুক্তিযোদ্ধাগণ,	
karir,	কারির,	কারীর,	
hisaber,	হিসাবের,	হিসাবের,	
anhu,	আনহু,	আনহু,	
bhabarlaler,	ভবরলললের,	ভবরলালের,	
johor,	জহহর,	জহর,	
boiporiityen,	বৈপরিয়েইন,	বৈপরীত্যেন,	
templet,	টেম্পলেট,	টেম্পলেট,	
shourshe,	শৌর্শে,	সোর্স,	
breel,	ব্রিল,	ব্রিল,	
dojo,	দযজ,	ডোজো,	
cheekitshar,	চিকিৎসার,	চিকিত্সার,	
narsinghomgulor,	নারসিংহমগুলোর,	নার্সিংহোমগুলোর,	
ooipoka,	ওপাকা,	উইপোকা,	
tokeo,	টোকেও,	টোকেও,	
pisach,	পিসাচ,	পিশাচ,	
prasadhoner,	প্রসাধনের,	প্রসাধনের,	
asabhya,	অসা্ভ,	অসভ্য,	
khamotagulor,	ক্ষমতাগুলোর,	ক্ষমতাগুলোর,	
kathla,	কাঠলা,	কাঠলা,	
dipankar,	দীপাঙ্কর,	দিপঙ্কর,	
aporishodhito,	অপরিষধধিত,	অপরিশোধিত,	
moonshi,	মুনশি,	মুন্সি,	
tateo,	তাতেও,	তাতেও,	
koota,	কুটা,	কোটা,	
postar,	পোস্টার,	পোস্টের,	
ukeliptas,	উকেলিপ্টাস,	ইউক্যালিপ্টাস,	
hooldim,	হুল্ডিম,	হোল্ডিং,	
gavaskar,	গাভাসকার,	গাভাস্কার,	
aansaareer,	আনসারীর,	আনসারীর,	
mitrota,	মিত্রোটা,	মিত্রতা,	
summer,	সাম্মার,	সামার,	
konflict,	কোফ্লিক্ট,	কনফ্লিক্ট,	
doorotomo,	দূরতম,	দূরতম,	
mercial,	মার্সিয়াল,	মার্শিয়াল,	
sheets,	শিটস,	শীটস,	
pare,	প্যারে,	পাড়ে,	
amor,	আমোর,	আমর,	
soleel,	সলিল,	সলিল,	
chopal,	চোপাল,	চপল,	
dibate,	দিবাতে,	ডিবেট,	
chakrapani,	চক্রাপনি,	চক্রপানী,	
change,	চাঙ্গে,	চেঞ্জ,	
oshtader,	অষ্টাদের,	ওস্তাদের,	
cheerontan,	চিরন্তান,	চিরন্তন,	
zaire,	জায়ার,	জাইরে,	
nothivookta,	নথিবভক্ত,	নথিভুক্ত,	
blasterke,	ব্লাস্টারকে,	ব্লাস্টারকে,	
nothivukto,	নথিভুক্ত,	নথিভুক্ত,	
chapchap,	চাপচাপ,	চাপচাপ,	
akheli,	আখেলী,	আখেলী,	
baharamporer,	বাহারমমপরের,	বহরমপুরের,	
masjidtir,	মাসজিদ্টির,	মসজিদটির,	
santaa,	সন্তা,	সান্তা,	
ghumachchila,	ঘুমাচ্ছিলা,	ঘুমাচ্ছিল,	
siddhante,	সিদ্ধান্তে,	সিদ্ধান্তে,	
stona,	স্টোনা,	স্টোন,	
riazuddin,	রিজাযুদ্দিন,	রিয়াজউদ্দীন,	
horiddar,	হরিদদার,	হরিদ্বার,	
popaike,	পপাইকে,	পপাইকে,	
fastara,	ফস্তারা,	ফস্টার,	
prokolpogulor,	প্রকল্পগুলোর,	প্রকল্পগুলোর,	
bhramapraban,	ভ্রমরপ্রণা,	ভ্রমপ্রবণ,	
fakhrul,	ফখরুল,	ফাখরুল,	
societytey,	সকিস্টেটে,	সোসাইটিতে,	
parisankhanvid,	পরিসংখ্যানিদিভ,	পরিসংখ্যানবিদ,	
sikkhagata,	সিক্ষাগতা,	শিক্ষাগত,	
batsmanei,	বা্সমানেই,	ব্যাটসম্যানই,	
siit,	সিট,	শীত,	
avidur,	অভিদুর,	আভিদুর,	
sangram,	সংগ্রাম,	সঙ্গ্রাম,	
andamana,	আন্দমনা,	আন্দামান,	
sausage,	সসসগে,	সসেজ,	
shikkhartheerao,	শিক্ষার্থীরাও,	শিক্ষার্থীরাও,	
proteemar,	প্রতিমার,	প্রতিমার,	
tomader,	তোমাদের,	তোমাদের,	
labonaaktotaar,	লাবানক্ততারা,	লবণাক্ততার,	
bikargrasta,	বিকারগ্রস্তা,	বিকারগ্রস্ত,	
highcommissionay,	হাইক্মোমিননাস,	হাইকমিশনে,	
bonobhumi,	বনভূমি,	বনভূমি,	
nopdnodir,	নপ্দনদির,	নদনদীর,	
francine,	ফ্রান্সিন,	ফ্রান্সিন,	
neemeetto,	নিমিত্ব,	নিমিত্ত,	
windo,	উইন্ডো,	উইন্ডো,	
abikaul,	আবিকাল,	অবিকল,	
ghotaibe,	ঘোটাইবে,	ঘটাইবে,	
bihar,	বিহার,	বিহার,	
neerbahe,	নিরবাহে,	নির্বাহে,	
shahoshikatar,	শহশিকাটার,	সাহসিকতার,	
baaik,	বাইক,	বাইক,	
protectionism,	প্রোটিকেনসিম,	প্রোটেকশনিজম,	
soteciety,	সটেসিটিই,	সোসাইটিতে,	
joubankal,	যৌবনকাল,	যৌবনকাল,	
bhromonkaale,	ভ্রমণকালে,	ভ্রমণকালে,	
saranor,	সারানোর,	সরানোর,	
batikromshalee,	বাতিকর্শমললি,	ব্যতিক্রমধর্মী,	
gosthike,	গোষ্ঠীকে,	গোষ্ঠীকে,	
durgatsob,	দুর্গাতসব,	দুর্গোৎসব,	
haridware,	হরিদ্বরে,	হরিদ্বারে,	
sanaktokaron,	সানাক্তকরণ,	সনাক্তকরণ,	
patishapta,	পাতিশপ্ত,	পাটিসাপটা,	
tennis,	টেনিস,	টেনিস,	
horidbar,	হরিদবার,	হরিদ্বার,	
prity,	প্রিটি,	প্রিটি,	
okkhorke,	অক্ষরকে,	অক্ষরকে,	
snehban,	স্নেহবান,	স্নেহবান,	
shikshakrom,	শিক্ষাক্রম,	শিক্ষাক্রম,	
anchalsaho,	অঞ্চলসহ,	অঞ্চলসহ,	
anisa,	আনিসা,	আনিস,	
mohajote,	মহাজতে,	মহাজোট,	
ghomtaa,	ঘোটমা,	ঘোমটা,	
talaa,	তালা,	তালা,	
elaakate,	এলাকাতে,	এলাকাতে,	
jonesh,	জনেশ,	জোন্স,	
toxoid,	টক্সোড,	টক্সয়েড,	
platform,	প্ল্যাটফফর্ম,	প্লাটফর্ম,	
suparichito,	সুপারিচিত,	সুপরিচিত,	
omeettrakkhor,	অমিত্রাক্ষর,	অমিত্রাক্ষর,	
sinaake,	সিনাকে,	সিনাকে,	
ingrejra,	ইংরেজ্রা,	ইংরেজরা,	
mohammadi,	মোহাম্মদি,	মুহাম্মদী,	
jaandrel,	যান্ড্রেল,	জাঁদরেল,	
obosore,	অবসরে,	অবসরে,	
jeshh,	জেশ,	জেস,	
assaciates,	অ্যাসাসিয়েটেস,	এসোসিয়েটস,	
dakshinangsho,	দক্ষিণাংশ,	দক্ষিণাংশ,	
ateetkaale,	অতিটকালে,	অতীতকালে,	
naubom,	নয়াবম,	নবম,	
hertj,	হের্জ,	হার্জ,	
vugorvey,	ভুগর্ভে,	ভূগর্ভে,	
moshjidke,	মস্যিদকে,	মসজিদকে,	
ipl,	আইপিএল,	আইপিএল,	
cholchhe,	চলছে,	চলছে,	
duhsthanostho,	দুষ্ঠানসন্থ,	দুঃস্থানস্থ,	
bangulzai,	বাঙ্গুলজাই,	বঙ্গুলিজাই,	
besur,	বেসুর,	বেসুর,	
kuldip,	কুলডিপ,	কুলদীপ,	
sqalarashipa,	স্কলরাশিপাপ,	স্কলারশিপ,	
poripakey,	পরিপাকে,	পরিপাকে,	
kanthar,	কান্থার,	কাঁথার,	
lutherana,	লুথেরানা,	লুথেরান,	
khoor,	খুর,	ক্ষুর,	
ajij,	আজিজ,	আজিজ,	
longhan,	লোংহান,	লংঘন,	
schilling,	সিকলিং,	শিলিং,	
thandabhabe,	থাঁ্দাভাবে,	ঠাণ্ডাভাবে,	
duple,	ডাপল,	ডুপ্লে,	
hojurer,	হজুরের,	হজুরের,	
gronthao,	গ্রন্থাও,	গ্রন্থও,	
nirvachaker,	নির্ভাচকের,	নির্বাচকের,	
awrbit,	অব্রিটি,	অরবিট,	
sondhisthaponer,	সন্ধিষ্ঠাপনের,	সন্ধিস্থাপনের,	
fanding,	ফ্যান্ডিং,	ফান্ডিং,	
uthe,	উঠে,	উঠে,	
shresthoshcho,	শ্রেষ্ঠশ্চ,	শ্রেষ্ঠশ্চ,	
dorneca,	ডর্নেকা,	ডরনেকা,	
gazipur,	গাজিপুর,	গাজিপুর,	
senabahineeow,	সেনানাহিবিও,	সেনাবাহিনীও,	
salapheeta,	সালাফিটা,	সালফেট,	
ratishilatai,	রতিশিলাটাই,	রতিশীলতায়,	
osamarik,	ওসামারিক,	অসামরিক,	
collaborators,	কলাবারটটররস,	কলাবরেটরস,	
karadando,	কারাদান্ডো,	কারাদণ্ড,	
aatto,	আট্যোট,	আত্ম,	
salmanul,	সালমানুল,	সালমানুল,	
dufresne,	ডাফরেসন,	ডুফরেস্ন,	
oncholtee,	অন্চলটি,	অঞ্চলটি,	
uthaney,	উঠানে,	উঠানে,	
rasunkunchi,	রসুন্নুচ্ছি,	রসুনকুঁচি,	
scholarsip,	স্কোলারিপ,	স্কলারশিপ,	
sushposhtolikhito,	সুষ্পপ্থকলিিতি,	সুষ্পষ্টলিখিত,	
darjiling,	ডার্জিলিং,	দার্জিলিং,	
noitik,	নৈতিক,	নৈতিক,	
sponsorshipe,	স্পন্রশ্পীপে,	স্পন্সরশীপে,	
rotheen,	রথিন,	রথীন,	
bosontoke,	বসন্তকে,	বসন্তকে,	
bishshaasho,	বিশ্বাশ,	বিশ্বাসও,	
teunar,	টেউনার,	টিউনার,	
paira,	পাইরা,	পাইরা,	
meshmeshya,	মেশমেশ্য,	মেশহমেশহিইয়া,	
aasar,	আসার,	আসর,	
ayumi,	আয়ুমি,	আয়ুমি,	
ekoghore,	একঘরে,	একঘরে,	
zerusalemer,	জেরুসালেমের,	জেরুজালেমের,	
totokhon,	ততোখন,	ততক্ষন,	
boudhher,	বৌধের,	বৌদ্ধের,	
anagarikra,	অনাগরিক্র,	অনাগরিকরা,	
rahshahi,	রহশাহী,	রাহশাহী,	
ishton,	ইস্টন,	স্টোন,	
nagarikera,	নাগারিকেরা,	নাগরিকেরা,	
jumlalancer,	জুমলল্যান্সের,	জুমলাল্যান্সার,	
rubidiyaam,	রুবিদিয়াম,	রুবিডিয়াম,	
keuoi,	কেওয়,	কেউই,	
poriskoron,	পরিস্করণ,	পরিষ্করণ,	
graambaaseeo,	গ্রামবাসাই,	গ্রামবাসীও,	
digri,	ডিগ্রি,	ডিগ্রি,	
shringge,	শ্রিং,	শৃঙ্গে,	
weelcomee,	ভিলকোমি,	ওয়েলকাম,	
sqolastiq,	স্কোলাক্টিক,	স্কলাস্টিক,	
ansarir,	আনসারির,	আনসারীর,	
miley,	মিলে,	মিলে,	
mokhmoley,	মোখমলে,	মখমলে,	
karmazog,	কারমাজোগ,	কর্মযোগ,	
forma,	ফরমা,	ফর্মা,	
makame,	মাকামে,	মাকামে,	
deqe,	ডেকে,	ডেকে,	
oncolsoho,	অন্কলসহ,	অঞ্চলসহ,	
bajite,	বাজিতে,	বাজিতে,	
homsher,	হমশের,	হোমসের,	
valobase,	ভালোবাসে,	ভালোবাসে,	
notikotar,	নতীকতার,	নৈতিকতার,	
valobasen,	ভালোবাসেন,	ভালোবাসেন,	
jaanar,	জানার,	জানার,	
shommotite,	শম্মতিতে,	সম্মতিতে,	
bayshorkarikarone,	বাইশরককারীরণে,	বেসরকারিকরণ,	
bongsho,	বংশ,	বংশ,	
playtey,	প্লেয়েট,	প্লেটে,	
ahalya,	আহাল্যা,	অহল্যা,	
maudelti,	মাউডলিটি,	মডেলটি,	
tikto,	টিক্ত,	তিক্ত,	
zonsa,	জোসা,	জোন্স,	
kortam,	কর্তাম,	করতাম,	
amburi,	অম্বুরি,	আম্বুরি,	
habathu,	হাবাথু,	হাবাথু,	
azimpur,	আজিম্পুর,	আজিমপুর,	
setikey,	সেটিকে,	সেটিকে,	
chhaikalo,	ছাইকালো,	ছাইকালো,	
cinemapremider,	সিনেমাপ্রেমীদের,	সিনেমাপ্রেমীদের,	
antennal,	অ্যান্টেন্নাল,	অ্যান্টেনাল,	
colgirl,	কলগির,	কলগার্ল,	
shilpajata,	শিল্পজাতা,	শিল্পজাত,	
neemeette,	নিমিত্বে,	নিমিত্তে,	
katbe,	কাতবে,	কাটবে,	
idipasha,	ইডিপাশা,	ইডিপাস,	
houzgulite,	হৌজগুলিতে,	হাউজগুলিতে,	
rohosyoti,	রোহস্যটি,	রহস্যটি,	
bonbhumi,	বনভূমি,	বনভূমি,	
mekapgulo,	মেকাগগুলো,	মেকআপগুলো,	
shho,	শো,	শো,	
kartona,	কার্টনা,	করতনা,	
kk,	কিএক,	কেকে,	
heart,	হার্ট,	হার্ট,	
ebham,	ইবাম,	ইভিএম,	
bosantake,	বসনাতাকে,	বসন্তকে,	
aakabar,	আকাবার,	আকাবার,	
baffer,	বাফার,	বাফার,	
charger,	চার্গার,	চার্জার,	
kakhnoba,	কাখনোবা,	কখনওবা,	
salphat,	সালফাট,	সালফেট,	
falasrutite,	ফ্যালাস্রুতিতে,	ফলশ্রুতিতে,	
soundorjotakei,	সৌন্দর্যটাকেই,	সৌন্দর্যটাকেই,	
poste,	পো্্টে,	পোষ্টে,	
pracharanamulak,	প্রচারণমূলক,	প্রচারণামূলক,	
naneer,	ননীর,	নানীর,	
jounotar,	যৌনতার,	যৌনতার,	
chhutee,	ছুটি,	ছুটি,	
jolrong,	জলরং,	জলরঙ,	
dacope,	ডাযাকোপ,	দাকোপ,	
noteti,	নোটেটি,	নোটটি,	
parking,	পার্কিং,	পার্কিং,	
skolastik,	স্কলাস্তিক,	স্কলাস্টিক,	
niharkantibabu,	নিহারকান্তিবাবু,	নিহারকান্তিবাবু,	
niropekshtar,	নিরোপেষ্টার,	নিরপেক্ষতার,	
khalid,	খালিদ,	খালিদ,	
chatrorai,	চত্ররাই,	ছাত্ররাই,	
chikitshar,	চিকিৎসার,	চিকিত্সার,	
poddhotiteyi,	পদ্ধতিতেই,	পদ্ধতিতেই,	
niphelheim,	নিইলেইলেম,	নিফেলহেইম,	
alaol,	আলযালল,	আলাওল,	
conflikt,	কনফলিক্ট,	কনফ্লিক্ট,	
marketing,	মার্কেটিং,	মার্কেটিং,	
siqhar,	সিকার,	শিকার,	
jonosomaj,	জনসমাজ,	জনসমাজ,	
balokarak,	বালোকারাক,	বলকারক,	
sukumaree,	সুকুমারি,	সুকুমারী,	
bhumija,	ভূমিজা,	ভূমিজ,	
euqalyptus,	ইউকল্যালাটাউস,	ইউক্যালিপ্টাস,	
jaruri,	জারুরি,	জরূরী,	
senior,	সেনিওর,	সিনিয়র,	
poketchorder,	পকেত্ররদের,	পকেটচরদের,	
manibhaijaner,	মানিভাজাইনের,	মণিভাইজানের,	
shabkam,	শবকাম,	শবকাম,	
minilosar,	মিনিলোসার,	মিনিলোসার,	
vabnakey,	ভাবনাকে,	ভাবনাকে,	
sollallhu,	সোল্লাল্লু,	সল্লাল্লাহু,	
elakasoho,	এলাকাসহ,	এলাকাসহ,	
mitro,	মিত্রো,	মিত্র,	
tukroti,	টুকর্তি,	টুকরোটি,	
deep,	দিপ,	দীপ,	
deefinition,	ডিফিনিশন,	ডেফিনেশন,	
marri,	মারিরি,	ম্যারি,	
ameettrakkhor,	অমিত্রক্ষর,	অমিত্রাক্ষর,	
dhrubaker,	ধ্রুবাকের,	ধ্রুবকের,	
kaferderke,	কাফেরদেরকে,	কাফেরদেরকে,	
elaakaati,	এলাকাটি,	এলাকাটি,	
townshhip,	টাউনশিপ,	টাউনশিপ,	
bikretara,	বিক্রেতারা,	বিক্রেতারা,	
dimbacriti,	ডিম্বাক্রিতি,	ডিম্বাকৃতি,	
grauth,	গ্রাউথ,	গ্রোথ,	
harbur,	হারবুর,	হারবার,	
icelands,	ইসেলাযান্ডস,	আইসল্যান্ডসহ,	
kokeyin,	কোকেইন,	কোকেইন,	
echhti,	এছটি,	এছটি,	
qor,	কোর,	কর,	
neutrinoo,	নিউট্রিনিও,	নিউট্রিনো,	
desiseyer,	ডেসিসের,	ডিজিজের,	
piulir,	পিউলির,	পিউলির,	
tata,	তাটা,	তাতা,	
foolkopi,	ফুলকপি,	ফুলকপি,	
rajpur,	রাজপুর,	রাজপুর,	
khilaphat,	খিলাফাট,	খিলাফত,	
nuhas,	নুহাস,	নুহাশ,	
gaphiloti,	গাইলিটি,	গাফিলতি,	
bii,	বিইইই,	বি,	
ji,	জিজি,	জি,	
perri,	পেরিরি,	পেরি,	
hukar,	হুকার,	হুকার,	
flux,	ফ্লাযাক্স,	ফ্লাস্ক,	
adbhanced,	অ্যাডভাযান্ডে,	অ্যাডভান্সড,	
khudhartara,	ক্ষুধারতর,	ক্ষুধার্তরা,	
chittronatyokar,	চিত্ত্রান্তকার,	চিত্রনাট্যকার,	
plate,	প্ল্যাটে,	প্লেট,	
teter,	টেটের,	টেটের,	
rohasyati,	রোহাযাত্যি,	রহস্যটি,	
sikkhakromer,	সিক্ষাক্রমের,	শিক্ষাক্রমের,	
muktilav,	মুক্তিলভ,	মুক্তিলাভ,	
kindom,	কিন্দম,	কিংডম,	
dajhyo,	দাঝ্য,	দাহ্য,	
barack,	ব্যারাক,	বারাক,	
istoone,	ইস্টুনে,	স্টোন,	
samaveshke,	সমাভেষকে,	সমাবেশকে,	
female,	ফেমালে,	ফিমেল,	
sbaajan,	স্বজান,	স্বজন,	
shamshere,	শমশেরে,	শমসের,	
mookhomandoler,	মুখমান্ডলের,	মুখমণ্ডলের,	
kailashrao,	কৈলাশরাও,	কৈলাশরাও,	
patininda,	পাটিনিন্দা,	পতিনিন্দ,	
ved,	ভেড,	বেদ,	
jandrel,	জান্ড্রেল,	জাঁদরেল,	
andon,	আন্দোন,	আন্দোন,	
suporichita,	সুপরিচিতা,	সুপরিচিত,	
poscater,	পোস্কাটের,	পশ্চাতের,	
shommoteer,	শম্মতির,	সম্মতির,	
footbalarra,	ফুটবলরার,	ফুটবলাররা,	
chenza,	চেঞ্জা,	চেঞ্জ,	
akhando,	আখান্দো,	অখন্ড,	
chaloke,	চালকে,	চালকে,	
adhunikkale,	আধুনিক্লালে,	আধুনিককালে,	
video,	ভিডেও,	ভিডিয়োও,	
tanshree,	তশ্শরী,	তানশ্রী,	
pooshti,	পুষ্টি,	পুষ্টি,	
mile,	মিলে,	মিলে,	
pluck,	প্লাক,	প্ল্যাক,	
atwabishvashi,	আত্ববিশবাশী,	আত্মবিশ্বাসী,	
jerushalema,	জেরুশেলামা,	জেরুসালেম,	
bhandti,	ভান্ডটি,	ভাণ্ডটি,	
antarctica,	অ্যান্টার্ট্সিকা,	অ্যান্টার্কটিকার,	
zommu,	জম্মু,	জম্মু,	
dwipke,	দ্বিপকে,	দ্বীপকে,	
seo,	সিও,	সেও,	
shaddhi,	শাদ্ধি,	সাধ্বী,	
janagononar,	জানাগোনার,	জনগণনার,	
kirke,	কিরকে,	কিরকে,	
orrgho,	অর্ঘ,	অর্ঘ্য,	
dologuloo,	দললগুলো,	দলগুলোও,	
impaction,	ইম্পায়েশন,	ইমপ্যাকশন,	
adhunikkaley,	অধুনিক্লায়ে,	আধুনিককালে,	
hypar,	হাইপার,	হাইপার,	
durbhagya,	দুর্ভাগ্যা,	দূর্ভাগ্য,	
songbadmadhyame,	সংবাদমধ্যামে,	সংবাদমাধ্যমে,	
saatzoner,	সাটজনের,	সাতজনের,	
rahimed,	রহহিমদদ,	রহিমেদ,	
jacksonke,	জ্যাকসনকে,	জ্যাকসনকে,	
shasankorta,	শাসাঙকর্ত,	শাসনকর্তা,	
bhenicer,	ভেনিসের,	ভেনিসের,	
detik,	ডেটিক,	দেতিক,	
konnoder,	কন্যদের,	কন্যদের,	
deputy,	ডিপুটি,	ডেপুটি,	
samley,	স্যামলে,	সামলে,	
markeetim,	মার্কিটিম,	মার্কেটিং,	
ayantarqatiqa,	অয়ন্ত্রাকাটি,	অ্যান্টার্কটিকা,	
bornolikhon,	বর্ণলিখোন,	বর্ণলিখন,	
konroop,	কন্রুপ,	কোনরূপ,	
jiland,	জিলান্ড,	জিল্যান্ড,	
fokskon,	ফকক্কন,	ফক্সকন,	
fevarite,	ফেভারিতে,	ফেভারিট,	
vejjanno,	ভেজজান্ন,	ভেজানো,	
sahocorje,	সহচর্যে,	সাহচর্যে,	
dera,	ডেরা,	ডেরা,	
ekatto,	একাত্ত,	একাত্ব,	
gamdan,	গামদান,	গামদান,	
cheess,	চিস,	চেস,	
aarik,	আরিক,	আরিক,	
asaktibandhan,	অসাকতিবন্ধন,	আসক্তিবন্ধন,	
songasthaner,	সং্গস্থানের,	সংস্থানের,	
oikhan,	ঐখান,	ঐখান,	
durgotsab,	দুর্গতৎসব,	দুর্গোৎসব,	
bhikkharthe,	ভিক্ষার্থে,	ভিক্ষার্থে,	
diniphition,	ডিনিফিশন,	ডেফিনেশন,	
durgatsabe,	দুর্গতসাবে,	দুর্গোৎসবে,	
bike,	বিকে,	বাইক,	
jaatti,	যাত্তি,	জাতটি,	
suparharo,	সুপারহারো,	সুপারহিরো,	
nischitvabe,	নিষ্টিভাববে,	নিশ্চিতভাবে,	
rakim,	রাকিম,	রাকিম,	
dharabahikbhabe,	ধারাবাহিকভাবে,	ধারাবাহিকভাবে,	
casper,	ক্যাস্পার,	ক্যাসপার,	
anchalei,	অঞ্চলেই,	অঞ্চলেই,	
shandra,	শান্দ্রা,	শান্দ্রার,	
dhanak,	ধানাক,	ধানক,	
louhojato,	লৌহজাত,	লৌহজাত,	
machhti,	মাছটি,	মাছটি,	
dekaner,	দেকানের,	দেকানের,	
ovarview,	ওভারভিউ,	ওভারভিউ,	
direectoratee,	ডিরিরেট্রটি,	ডিরেক্টরেট,	
kayartara,	কয়ারটারা,	কোয়ার্টার,	
bostubad,	বস্তুবাদ,	বস্তুবাদ,	
byabaharkareederke,	ব্যবহারকারীদেরকে,	ব্যবহারকারীদেরকে,	
khagen,	খাগেন,	খগেন,	
bosonte,	বসন্তে,	বসন্তে,	
rudrasagar,	রুদ্রসাগর,	রুদ্রসাগরের,	
gannaprakasham,	গণ্যপ্রণশাম,	গন্নাপ্রকাশম,	
shansthagulo,	শাঁষ্ঠাগুলো,	সংস্থাগুলো,	
quartar,	কুয়ারটার,	কোয়ার্টার,	
dokaangoolote,	ডাকাংগুলোতে,	দোকানগুলোতে,	
jotinkey,	জটিনকে,	যতীনকে,	
vool,	ভুল,	উল,	
taposgoner,	তপসগণের,	তাপসগণের,	
porjotoker,	পর্যতকের,	পর্যটকের,	
potka,	পোটকা,	পটকা,	
udyem,	উদ্যেম,	উদ্যেম,	
probondhobhittik,	প্রবণ্ভভিত্তিক,	প্রবন্ধভিত্তিক,	
ajibon,	আজিবন,	আজীবন,	
lampot,	ল্যাম্পট,	লম্পট,	
bhangle,	ভাংলে,	ভাঙলে,	
phokser,	ফোকসের,	ফক্সের,	
rata,	রাতা,	রত,	
byatari,	ব্যাতারি,	ব্যাটারী,	
hijrite,	হিজরিতে,	হিজরীতে,	
kurdider,	কুর্দিদের,	কুর্দিদের,	
bolvodro,	বল্োদ্র,	বলভদ্র,	
rajnikant,	রাজনিকান্ত,	রাজনীকান্ত,	
poripake,	পরিপাকে,	পরিপাকে,	
korimpur,	করিমপুর,	করিমপুর,	
hunine,	হুনিনে,	হুনাইন,	
bhotomulyoke,	ভোটমুল্যকে,	ভোটমূল্যকে,	
licencedhari,	লিইসেন্চারী,	লাইসেন্সধারী,	
attorkite,	অত্রকৃতে,	অতর্কিতে,	
pyor,	প্য়ার,	পিওর,	
sorsa,	সর্সা,	সোর্স,	
kormokarer,	কর্মকারের,	কর্মকারের,	
maail,	মাইল,	মাইল,	
protul,	প্রোতুল,	প্রতুল,	
shaahaabiike,	সাহাবাবিইকে,	সাহাবীকে,	
anektai,	আনেকটাই,	অনেকটাই,	
mugdal,	মুগদাল,	মুগডাল,	
poorohitder,	পুরহিতদের,	পুরোহিতদের,	
engrejra,	এঞ্জ্রেজার,	ইংরেজরা,	
baganoto,	বাগানোত,	বাগানত,	
donat,	ডোনাট,	ডোনাট,	
karaa,	কারা,	কারো,	
khudrokar,	ক্ষুদ্রকার,	ক্ষুদ্রকার,	
bbiswasho,	বিব্বাশা,	বিশ্বাসও,	
shahidputra,	শহিদপুত্র,	শহীদপুত্র,	
govindarajan,	গোবিন্দর্জন,	গোবিন্দরাজন,	
chitronattakar,	চিত্রনাত্তাকার,	চিত্রনাট্যকার,	
tarkareer,	তারকারীর,	তরকারীর,	
senabahineekey,	সেনাবাহিনীকে,	সেনাবাহিনীকে,	
zozyota,	যজ্জতা,	যোজ্যতা,	
swadesh,	স্বদেশ,	স্বদেশ,	
jamjomat,	জম্জমত,	জমজমাট,	
swasthohinotay,	স্বাস্থ্যহনিতায়,	স্বাস্থ্যহীনতায়,	
achintyabhedaved,	অচিন্ত্যদেভবাদ,	অচিন্ত্যভেদাভেদ,	
eporjonto,	এপর্যন্ত,	এপর্যন্ত,	
eukalyptus,	ইউকল্যামাপ্টস,	ইউক্যালিপ্টাস,	
shten,	স্টেন,	স্টেন,	
kanar,	কানার,	কণার,	
prime,	প্রিমে,	প্রাইম,	
samratder,	সমর্তদের,	সম্রাটদের,	
amontronkarider,	আমনন্ত্রকারীদের,	আমন্ত্রণকারীদের,	
ikbaaler,	ইকবালের,	ইকবালের,	
nutoner,	নুটনের,	নূতনের,	
sardar,	সারদার,	সরদার,	
parikha,	পরিখা,	পরিখার,	
palestine,	পালেস্টাইন,	প্যালেস্টাইনে,	
bondi,	বন্ডি,	বন্দী,	
rajashri,	রাজাশ্রী,	রাজশ্রী,	
brake,	ব্রাকে,	ব্রেক,	
spreedashita,	স্প্রীদাশিত,	স্প্রেডশীট,	
naabbota,	নাব্বতা,	নাব্যতা,	
choopi,	চুপি,	চুপি,	
sayatana,	সায়াতনা,	শয়তান,	
sabrakamer,	সব্রাকামের,	সবরকমের,	
shomser,	শমসের,	সমশের,	
hossne,	হোসনে,	হোসনে,	
bhenkates,	ভেনকেটস,	ভেঙ্কটেশ,	
kraanti,	ক্রান্টি,	ক্রান্তি,	
magical,	ম্যাগিকাল,	ম্যাজিকাল,	
ahong,	আহং,	অহং,	
hetimganje,	হেটিমগঞ্জে,	হেতিমগঞ্জে,	
guzober,	গুজবের,	গুজবের,	
chaka,	চাকা,	চাকা,	
baibosthar,	বাইবস্থার,	ব্যবস্থার,	
graambasider,	গ্রামবাসীদের,	গ্রামবাসীদের,	
vugoley,	ভুগলে,	ভূগোলে,	
bunot,	বুনোট,	বুনট,	
orunima,	ওরুনিমা,	অরুণিমা,	
seramiks,	সেরামিক্স,	সিরামিকস,	
bojhao,	বোঝাও,	বোঝাও,	
titarer,	তিতারের,	তিতারের,	
sachetonvabe,	সাচতনাভাবে,	সচেতনভাবে,	
shamuker,	শামুকের,	শামুকের,	
dharavahikbhabe,	ধারাবাহিকভাবে,	ধারাবাহিকভাবে,	
bonorajite,	বনরাজিতে,	বনরাজিতে,	
seconder,	সেকন্ডার,	সেকেন্ডের,	
bojata,	বোজাটা,	বোজাটা,	
vodqa,	ভোডকা,	ভদকা,	
wilderske,	উইলডার্সকে,	উইল্ডার্সকে,	
fanse,	ফ্যানস,	ফাঁসে,	
dholeshwari,	ধলেশ্বরী,	ধলেশ্বরী,	
talgachh,	তালগাছ,	তালগাছ,	
spredashiita,	স্প্রেশিয়াতি,	স্প্রেডশীট,	
nirapattamulok,	নিরাপত্তমূলক,	নিরাপত্তামূলক,	
sucre,	সুক্রে,	সাকার,	
treebhuj,	ত্রিভুজ,	ত্রিভূজ,	
poribahokotto,	পরিবাহকত্ব,	পরিবাহকত্ব,	
feemalee,	ফিমললি,	ফিমেল,	
emiratas,	এমিরাটাস,	এমিরেটাস,	
sumoo,	সুমো,	সুমো,	
shniper,	শ্নিপের,	স্নাইপার,	
zesa,	জেসা,	জেস,	
bamon,	বামোন,	বামন,	
eshiyetika,	এসিয়েটিকা,	এশিয়াটিক,	
chinito,	চিনিতো,	চিনতো,	
aabarte,	আবার্তে,	আবর্তে,	
megacaldera,	মেগাকাল্ডারা,	মেগাক্যাল্ডেরা,	
bhagno,	ভাগন,	ভগ্ন,	
laatimer,	লাটিমের,	লাটিমের,	
duburir,	দুবুরির,	ডুবুরির,	
nodimatrik,	নদীমার্তিক,	নদীমাতৃক,	
abheedhaaneek,	অভিদানিক,	অভিধানিক,	
karecho,	কারেছো,	করেছো,	
nirmankarmisaha,	নির্মণরীকরসহহ,	নির্মাণকর্মীসহ,	
bairey,	বাইরে,	বাইরে,	
barder,	বার্ডার,	বার্ডের,	
lebina,	লেবিনা,	লেবিনা,	
alraji,	আলরাজি,	আলরাজী,	
lagchhe,	লাগছে,	লাগছে,	
grambaseer,	গ্রামবাসীর,	গ্রামবাসীর,	
sosoa,	সোসয়া,	শশা,	
ul,	আলএস,	উল,	
swartho,	স্বার্থ,	স্বার্থ,	
deh,	দেহ,	দেহ্,	
bohoodin,	বহুদিন,	বহুদিন,	
bohudeen,	বহুদিন,	বহুদিন,	
cbi,	সিবিআি,	সিবিআই,	
gandhiir,	গান্ধিয়ার,	গান্ধীর,	
as,	এসএস,	অস,	
pakistanira,	পাকিস্তানিরা,	পাকিস্তানীরা,	
nirmol,	নির্মোল,	নির্মল,	
mele,	মেলে,	মাইল,	
jakso,	যাকস,	যক্ষ,	
ala,	আলালা,	আলা,	
romarder,	রোমার্ডের,	রোমারদের,	
ramolino,	রামোলিনো,	রামোলিনো,	
indrani,	ইন্দ্রানি,	ইন্দ্রাণী,	
qarlosa,	কারলোসা,	কার্লোস,	
alaul,	আলাউল,	আলাওল,	
mangoleek,	মঙ্গললিক,	মাঙ্গলিক,	
madhoori,	মাধুরি,	মাধুরী,	
uponeeshod,	উপনিশদ,	উপনিষদ,	
qraima,	ক্রাইমা,	ক্রাইম,	
matthews,	মাথভিস,	ম্যাথিউস,	
mukhomandal,	মুখোমন্ডল,	মুখমণ্ডল,	
madhukori,	মধুকরি,	মাধুকরী,	
sorano,	সোরানো,	সরানো,	
grambasheeo,	গ্রামবাশাই,	গ্রামবাসীও,	
onchalgulir,	অঞ্চালগুলির,	অঞ্চলগুলির,	
aakik,	আকিক,	আকিক,	
asovya,	অসোভ্যা,	অসভ্য,	
bibechyo,	বিবেচ্য,	বিবেচ্য,	
diznee,	দিজনি,	ডিজনী,	
behrampurer,	বেহরামপুরের,	বহরমপুরের,	
abdan,	আবদান,	আব্দান,	
tochhnochh,	তন্চোছ,	তছনছ,	
larson,	লারসন,	লারসন,	
dhalur,	ধালুর,	ঢালুর,	
veemsen,	ভিমসেন,	ভীমসেন,	
azijer,	আজিজের,	আজিজের,	
shringey,	শ্রিঙ্গে,	শৃঙ্গে,	
balatkar,	বালাটকার,	বলাৎকার,	
teennis,	টিনিনিস,	টেনিস,	
planea,	প্লানে,	প্লেনে,	
kidambi,	কিদাম্বি,	কিদম্বি,	
monzooshree,	মন্জশুরি,	মঞ্জুশ্রী,	
ghoshanapatratio,	ঘোষানাপত্রাতিও,	ঘোষণাপত্রটিও,	
dayitta,	দয়িত্ব,	দায়িত্ব,	
rubidium,	রুবিডিউয়াম,	রুবিডিয়াম,	
sobchey,	সবচে,	সবচে,	
podotyagsongkranto,	পদত্যাসংক্রান্ত,	পদত্যাগসংক্রান্ত,	
soceitytey,	সোসিটেটি,	সোসাইটিতে,	
magar,	মাগার,	মাগার,	
durgotshob,	দুর্গতশব,	দুর্গোৎসব,	
yukeliptash,	যুয়েক্লিপাস,	ইউক্যালিপ্টাস,	
neelkamal,	নীলকামাল,	নীলকমল,	
paikgachha,	পাইকগাছ,	পাইকগাছা,	
adorso,	আদারসো,	আর্দশ,	
dhila,	ধিলা,	ঢিলা,	
gaje,	গাজে,	গেজ,	
cholocchitrer,	চলচচিত্রের,	চলচ্চিত্রের,	
jinsa,	জিনসা,	জিন্স,	
chitlar,	চিতলার,	চিতলার,	
paab,	পাব,	পাব,	
kayech,	কয়েছ,	কায়েছ,	
teamothy,	টিমোথি,	টিমোথি,	
crime,	ক্রিমে,	ক্রাইম,	
monzeele,	মঞ্জিলে,	মঞ্জিলে,	
suisharke,	সুশারকে,	সুইশারকে,	
meloonborrone,	মেলোববরর্ণে,	মেলবোর্নে,	
sobrakamer,	সব্রাকামের,	সবরকমের,	
gobeshokgon,	গবেষকগণ,	গবেষকগণ,	
kekru,	কেকরু,	কেকরু,	
jund,	জান্ড,	জুন্দ,	
spashtotai,	স্পাষ্টটাই,	স্পষ্টতই,	
dibya,	দিব্যা,	দিব্যা,	
masjidti,	মাসজিদ্টি,	মসজিদটি,	
chaanoo,	চানু,	চানু,	
nilkuthir,	নীলকুঠির,	নীলকুঠির,	
diiptii,	দিপ্টই,	ডেপুটি,	
kormyi,	কর্মি,	কর্মই,	
angshogrohon,	অংশগ্রহণ,	অংশগ্রহন,	
shulfate,	শুলফাতে,	সালফেট,	
abdi,	আবদি,	অব্দি,	
injiniyarim,	ইন্জিনিয়ারিম,	ইঞ্জিনিয়ারিং,	
asovyo,	অস্ভো,	অসভ্য,	
teemothi,	তিমোথি,	টিমোথি,	
soommo,	সুম্ম,	সুমো,	
stanahenja,	স্তানাহেন্জা,	স্টোনহেঞ্জ,	
sachetanvabe,	সচেতনাভবে,	সচেতনভাবে,	
chat,	চাত,	চ্যাট,	
jhimochchilo,	ঝিমচ্ছিল,	ঝিমোচ্ছিলো,	
karmojog,	কার্যোগ,	কর্মযোগ,	
deool,	ডিউল,	দেউল,	
registaner,	রেজিস্টানের,	রেগিস্তানের,	
tookrokey,	তুক্রকে,	টুকরোকে,	
utpotti,	উৎপত্তি,	উতপত্তি,	
sarjur,	সার্জুর,	সরযূর,	
chalochchitraeeo,	চালচ্ঠির্যায়,	চলচ্চিত্রেও,	
akhandata,	আখন্দতা,	অখণ্ডতা,	
khoka,	খোকা,	খোকা,	
cloring,	ক্লারিং,	ক্লোরিং,	
pranibigyani,	প্রাণবিগ্ঞানী,	প্রাণীবিজ্ঞানী,	
alpo,	আল্প,	অল্প,	
dakticket,	ডাক্টিকেট,	ডাকটিকিট,	
prasadhani,	প্রসাধানী,	প্রসাধনী,	
sangbadmadhyamgulote,	সংবাদমধ্যাগগুলোতে,	সংবাদমাধ্যমগুলোতে,	
matt,	ম্যাট্,	ম্যাট,	
niroja,	নিরোজা,	নিরোজা,	
aashtikotaa,	আষ্টিকতা,	আস্তিকতা,	
hilser,	হিলসের,	হিলসের,	
sanaktakaran,	সনাকতারর,	সনাক্তকরণ,	
sookumari,	সুকুমারি,	সুকুমারী,	
lyaataa,	ল্যাটা,	ল্যাটা,	
tooku,	টুকু,	টুকু,	
asif,	আসিফ,	আসিফ,	
abti,	আবটি,	আবতি,	
vittiteo,	ভিট্টিতেও,	ভিত্তিতেও,	
ghoomachhilo,	ঘুমাচিল,	ঘুমাচ্ছিল,	
durarohini,	দুরারহহিনী,	দুরারোহিণী,	
nabyata,	নাব্যাতা,	নাব্যতা,	
olpo,	ওলপ,	অল্প,	
brekethru,	বেরেক্থরু,	ব্রেকথ্রু,	
ovidhaner,	অভিধানের,	অভিধানের,	
wrighter,	বিগ্টের,	রাইটের,	
mandarbani,	মন্দরবানী,	মন্দারবাণী,	
shit,	শিত,	শীত,	
audiotike,	অডডিওটিকে,	অডিওটিকে,	
siqh,	সিক,	শিখ,	
dolu,	ডলল,	ডলু,	
waal,	ওয়াল,	উল,	
chilahaati,	চিলাহাটি,	চিলাহাটি,	
khabarsoho,	খাবারসহ,	খাবারসহ,	
kuthibarike,	কুঠিবারিকে,	কুঠিবাড়ীকে,	
dhanyi,	ধান্ই,	ধন্যি,	
eekbalke,	ইক্বলকে,	ইকবালকে,	
durtomo,	দুর্তম,	দূরতম,	
monjurul,	মঞ্জুরুল,	মনজুরুল,	
abheedhaaneeck,	অভিদানিক্য,	অভিধানিক,	
abhidhanick,	অভিনাধিক্য,	অভিধানিক,	
mmehonoti,	ম্মেহনটি,	মেহনতি,	
poste,	পো্্টে,	পোস্টে,	
karmokarke,	কারমাকারকে,	কর্মকারকে,	
varma,	ভারমা,	ভার্মা,	
awatar,	ওওয়াটার,	অবতার,	
kalki,	কালকি,	কালকি,	
thechar,	থেচার,	থ্যাচার,	
byaboharkariyi,	ব্যবহরকার্যী,	ব্যবহারকারীই,	
augustine,	অগস্টাইন,	অগাস্টিন,	
tapdei,	তাপদেই,	তাপড়েই,	
dhormoprobortokder,	ধর্মপ্রবর্তদের,	ধর্মপ্রবর্তকদের,	
aairees,	আইইরিস,	আইরিস,	
ekbai,	একবাই,	একবাই,	
jatinkey,	জাটিনকে,	যতীনকে,	
chakurijibirao,	চাকুরিজিবারাও,	চাকুরীজীবীরাও,	
seekkhaou,	সিক্ষাউ,	শিক্ষাও,	
sampadoner,	সম্পাদনের,	সম্পাদনের,	
vaabnake,	ভাবনাকে,	ভাবনাকে,	
somoibo,	সমৈবব,	সমৈব,	
bbosonto,	ব্বসন্ত,	বসন্ত,	
tistar,	টিস্টার,	তিস্তার,	
uddhritir,	উদ্ধৃতির,	উদ্ধৃতির,	
bolatkar,	বলাতকার,	বলাৎকার,	
paner,	পাযানের,	পানের,	
kachhakaachhi,	কছাচাছি,	কাছাকাছি,	
mataram,	মাতারাম,	মাতরম,	
tinhazar,	তিনহাজার,	তিনহাজার,	
jibnagore,	জীবনগরে,	জীবননগর,	
dhadhiye,	ধাধিয়ে,	ধাধিয়ে,	
sthaponagulor,	স্থাপননগগুলোর,	স্থাপনাগুলোর,	
lubitz,	লুবিটজ,	লুবিৎজ,	
teentir,	টিনটির,	তিনটির,	
somonnitobhabe,	সমন্তিনভাবে,	সমন্বিতভাবে,	
sthapanatir,	স্থাপানাটির,	স্থাপনাটির,	
labonaktatar,	লাবাকান্তার,	লবণাক্ততার,	
golimodhye,	গলিমধ্যে,	গলিমধ্যে,	
dobhara,	দোভারা,	ডোভার,	
deenes,	দিনেস,	দীনেশ,	
janmat,	জানমাত,	জন্মাত,	
shilbar,	শিলবার,	সিলভার,	
premoronge,	প্রেমরর্গে,	প্রেমরঙে,	
kruser,	ক্রুসের,	ক্রুশের,	
fol,	ফল,	ফল,	
godabari,	গোদাবারী,	গোদাবরী,	
manober,	মানবের,	মানবের,	
palbongser,	পালবংসের,	পালবংশের,	
show,	সাউ,	শো,	
cholochchitrake,	চলচচিত্রকারে,	চলচ্চিত্রকে,	
roktokhoron,	রক্তরোোন,	রক্তক্ষরণের,	
prodiiper,	প্রডিইপের,	প্রদীপের,	
elaakati,	এলাকাটি,	এলাকাটি,	
unitgulo,	ইনিটগুলো,	ইউনিটগুলো,	
bonnopran,	বন্যপ্রান,	বন্যপ্রাণ,	
edaning,	এডানিং,	ইদানিং,	
shansthaner,	শান্স্থানের,	সংস্থানের,	
muchlima,	মুচলিমা,	মুছলিমা,	
dormitory,	ডর্মিটরি,	ডরমিটরি,	
parkin,	পারকিন,	পার্কিং,	
saabyastha,	সাব্যস্থ,	সাব্যস্থ,	
yucalyptus,	লেউক্যালাপ্টস,	ইউক্যালিপ্টাস,	
jemy,	জেমি,	জেমি,	
gardeen,	গার্ডিন,	গার্ডেন,	
jotharthovabey,	যথার্থভাবে,	যথার্থভাবে,	
badhamuktovabe,	বাধামুত্ভভাবে,	বাধামুক্তভাবে,	
infarmatian,	ইনফারমাযায়ান,	ইনফরমেশন,	
jegulur,	জেগুলুর,	যেগুলুর,	
songasthatir,	সং্গাষ্ঠাটির,	সংস্থাটির,	
scholastic,	স্কোলাক্টিক,	স্কলাস্টিক,	
jamanataswarup,	জামানতাস্বরূপ,	জামানতস্বরূপ,	
kormopontha,	কর্মপন্থা,	কর্মপন্থা,	
jounatar,	যৌনাটার,	যৌনতার,	
abhirupbabuke,	অভিরুপবাবুকে,	অভিরূপবাবুকে,	
juboke,	যুবকে,	যুবকে,	
myari,	ম্যারি,	ম্যারি,	
bachai,	বাচাই,	বাছাই,	
zerusalem,	জেরুসালেম,	জেরুসালেম,	
shrimoti,	শ্রীমতি,	শ্রীমতি,	
humira,	হুমিরা,	হুমিরা,	
dhonni,	ধননি,	ধন্যি,	
ghumachhe,	ঘুমাচেছ,	ঘুমাচ্ছে,	
modyer,	মোদ়ের,	মদ্যের,	
probhur,	প্রভূর,	প্রভুর,	
anandamahale,	আনন্দমহলে,	আনন্দমহলে,	
kadam,	কাদাম,	কদম,	
hights,	হাইটস্ট,	হাইটস,	
swostir,	স্বস্তির,	স্বস্তির,	
parther,	পার্থের,	পার্থের,	
hattey,	হ্যাটে,	হাঁটতে,	
daktickete,	ডাক্টিকেতে,	ডাকটিকিটে,	
tecno,	টেকনো,	টেকনো,	
mulvitti,	মুলভিত্তি,	মূলভিত্তি,	
venice,	ভেনিস,	ভেনিস,	
aswasteekor,	অস্বাস্ত্রকর,	অস্বস্তিকর,	
firti,	ফির্টি,	ফিরতি,	
zerusalem,	জেরুসালেম,	জেরুজালেম,	
sheekar,	শীকার,	শিকার,	
shloker,	শ্লোকের,	শ্লোকের,	
koyekbare,	কয়েকবারে,	কয়েকবারে,	
dupleks,	ডাপললক্স,	ডুপ্লে,	
basaalt,	বাসাল্ট,	ব্যাসল্ট,	
hames,	হ্যামেস,	হোমস,	
samaptir,	সমাপ্তির,	সমাপ্তির,	
jonmobhumitir,	জন্মভূমিতির,	জন্মভূমিটির,	
hariken,	হারিকেন,	হ্যারিকেন,	
protijogii,	প্রতিযোগী,	প্রতিযোগী,	
mulyabriddhikale,	মূল্যবৃদ্ধিলাকে,	মূল্যবৃদ্ধিকালে,	
chongar,	চঙ্গার,	চোঙ্গার,	
sealvi,	সিলভি,	সিলভি,	
horippur,	হরিপপুর,	হরিপুর,	
bhromoner,	ভ্রমণের,	ভ্রমণের,	
pleta,	প্লেটা,	প্লেটো,	
scorey,	স্করে,	স্কোরে,	
nichols,	নিকোলস,	নিকলস,	
kareer,	কারির,	কারীর,	
narishwar,	নারীশ্বর,	নারীশ্বরের,	
taranee,	তরানী,	তরণী,	
rakkhanbhag,	রক্ষণভাগ,	রক্ষণভাগ,	
shuperheiro,	শুপারহহরও,	সুপারহিরো,	
sahittopritite,	সাহিত্যপ্রিতিতে,	সাহিত্যপ্রীতিতে,	
minister,	মিনিস্টার,	মিনিস্টার,	
arthurer,	আর্থুরের,	আর্থারের,	
felto,	ফেলটো,	ফেলত,	
dharmee,	ধর্মী,	ধর্মী,	
porirshoder,	পরিষ্রদের,	পরির্ষদের,	
gotirodh,	গতিরোধ,	গতিরোধ,	
grambaaseeder,	গ্রামবাসীদের,	গ্রামবাসীদের,	
jeher,	জেহের,	জেহের,	
guha,	গুহা,	গোহ,	
nothiboddho,	নথিবদ্ধ,	নথিবদ্ধ,	
gabeshonar,	গাবেশনার,	গবেষনার,	
bidghootey,	বিদ্ঘুতে,	বিদঘুটে,	
choshon,	চোষণ,	চোষণ,	
choukato,	চৌকাতো,	চৌকাত,	
jamaanor,	জামানোর,	জমানোর,	
dhamshrenite,	ধামশ্রেনিতে,	ধামশ্রেণীতে,	
deil,	ডিই়,	ডেইল,	
deraa,	ডেরা,	ডেরা,	
duiekdiner,	ডুই়িকডিনের,	দুইএকদিনের,	
akhandota,	আখানদতা,	অখণ্ডতা,	
lyandim,	ল্যান্ডিম,	ল্যান্ডিং,	
gratha,	গ্রাথ,	গ্রোথ,	
gronther,	গ্রন্থের,	গ্রন্থের,	
hevy,	হেভি,	হেভি,	
hitlere,	হিটলারে,	হিটলারে,	
zeeland,	জিলান্ড,	জিল্যান্ড,	
granada,	গ্রানাডা,	গ্র্যানাডা,	
ramnathbabur,	রামনাথবাবুর,	রামনাথবাবুর,	
bisshasi,	বিশ্বাসী,	বিশ্বাসী,	
bhageri,	ভাগেরী,	ভাগেরই,	
samanyai,	সমন্যাই,	সামান্যই,	
shamshernagar,	শমশ্রেনগর,	শমশেরনগর,	
utsahi,	উৎসাহী,	উৎসাহী,	
hyaloyin,	হ্যালোয়ান,	হ্যালোইন,	
saurce,	সার্সে,	সোর্স,	
biprodas,	বিপ্রদাস,	বিপ্রদাস,	
bhupal,	ভূপাল,	ভূপাল,	
lendl,	লেন্ডল,	লেন্ডল,	
nirikhe,	নিরিখে,	নিরিখ,	
qonfliqt,	কনফলিক্ট,	কনফ্লিক্ট,	
parijaner,	পরিজানের,	পরিজনের,	
daakten,	ডাক্তেন,	ডাকতেন,	
bonshi,	বনশি,	বংশী,	
grotha,	গ্রথথা,	গ্রোথ,	
kaamij,	কামিজ,	কামিজ,	
canflikt,	ক্যানফলিক্ট,	কনফ্লিক্ট,	
sotorkobhabey,	সতর্কভাবে,	সতর্কভাবে,	
churger,	চুর্গের,	চার্জের,	
innahu,	ইন্নাহু,	ইন্নাহু,	
mithener,	মিথেনের,	মিথেনের,	
charpanch,	চরপাঞ্চ,	চারপাঁচ,	
jamarate,	জামারাতে,	জামারাতে,	
tigre,	টিগরে,	টাইগার,	
rajendracholer,	রাজেন্দ্রচালের,	রাজেন্দ্রচোলের,	
durlabhatwang,	দুর্লাভভত্বং,	দুর্লভত্বং,	
shukrabab,	শুক্রাবাব,	শুক্রবাব,	
bajpa,	বাজপা,	বাজপা,	
mochlekha,	মোখলেখা,	মোছলেখা,	
firoza,	ফিরোজা,	ফিরোজা,	
sarbhaarti,	সারভার্তি,	সার্ভারটি,	
prothati,	প্রথাটি,	প্রথাটি,	
aakkaash,	আক্কাশ,	আককাস,	
sompadon,	সম্পাদন,	সম্পাদন,	
oojbekistan,	ওজবেক্সিতান,	উজবেকিস্তান,	
naagaalyand,	নাগল্যান্ড,	নাগাল্যান্ড,	
dharavassokar,	ধারাভাসাকরর,	ধারাভাষ্যকার,	
angibhutovabe,	অঙ্গীভূতভাবে,	অঙ্গীভূতভাবে,	
eupheike,	ইউফেই,	ইউফেইকে,	
plasse,	প্লাসে,	প্লাসে,	
segulo,	সেগুলো,	সেগুলো,	
annimated,	অ্যানিমাযাটেড,	এনিমেটেড,	
suparichiti,	সুপারিচিতি,	সুপরিচিতি,	
kuresher,	কুরেশের,	কুরেশের,	
shatan,	শাতান,	শয়তান,	
jini,	জিনি,	যিনি,	
melbourner,	মেলবোর্নের,	মেলবোর্নের,	
ap,	এপিএ,	আপ,	
homshke,	হোমশকে,	হোমসকে,	
jotsna,	জটসনা,	জ্যোৎস্না,	
bizito,	বিজিতো,	বিজিত,	
shattoki,	শাত্তকি,	সাত্যকি,	
shlok,	শ্লোক,	শ্লোক,	
safiha,	সাফিহা,	সাফিহা,	
rajotwo,	রাজত্ব,	রাজত্ব,	
alonkaran,	আলোকরণা,	অলঙ্করণ,	
boshoborty,	বশবর্তি,	বশবর্তী,	
shibraj,	শিবরাজ,	শিবরাজ,	
chhayi,	ছায়া,	ছাই,	
oichchheek,	ঐচ্ছিক,	ঐচ্ছিক,	
fotanor,	ফটানোর,	ফোটানোর,	
shumo,	শুমো,	সুমো,	
shangkalonti,	শ্যাংকান্টি,	সংকলনটি,	
langhaner,	লাঙ্গানের,	লংঘনের,	
addhattikotar,	অদ্ধাত্যিকতার,	আধ্যাত্মিকতার,	
sikkharrtheerao,	সিক্ষার্থীরাও,	শিক্ষার্থীরাও,	
choudhursoho,	চৌধুরসহ,	চৌধুরসহ,	
anusthane,	অনুষ্ঠানে,	অনুষ্ঠানে,	
saqara,	সাকারা,	সাকার,	
somratra,	সম্রাত্র,	সম্রাটরা,	
kanasarabheeshana,	কনসরাভশষণ,	কনসারভেশন,	
station,	স্টেশন,	ষ্টেশন,	
rachanakal,	রচনাকলল,	রচনাকাল,	
teksuser,	টেকসসসের,	টেক্সাসের,	
nirvaha,	নির্ভাহা,	নির্বাহ,	
grushko,	গ্রুষ্কো,	গ্রুশকো,	
calabe,	ক্লাবে,	চালাবে,	
bhangchur,	ভাংচুর,	ভাংচুর,	
ostad,	ওস্তাদ,	ওস্তাদ,	
skolarsip,	স্কোলারিপি,	স্কলারশিপ,	
udvabani,	উদ্ভাবানী,	উদ্ভাবনী,	
taitela,	তাইটেলা,	টাইটেল,	
antarvuktimulak,	অন্তর্ভুক্তমূলকা,	অন্তর্ভুক্তিমূলক,	
obdi,	অবডি,	অব্দি,	
sthapanar,	স্থাপানার,	স্থাপনার,	
favorite,	ফ্যাভরিতে,	ফেভারিট,	
protibedokrao,	প্রতিবেদকরাও,	প্রতিবেদকরাও,	
paste,	প্যাস্টে,	পেষ্ট,	
turbine,	টারবিইন,	টারবাইন,	
oitijhyotike,	ঐতিহ্যটিকে,	ঐতিহ্যটিকে,	
seekkhokbrindo,	শিক্ষকৃণ্দ্ব,	শিক্ষকবৃন্দ,	
kormoi,	কর্মই,	কর্মই,	
chirontan,	চিরন্তান,	চিরন্তন,	
nibirbhabe,	নিবিরভাবে,	নিবিরভাবে,	
zarniz,	জার্নিজ,	জারনিজ,	
hosney,	হোসনে,	হোসনে,	
mimgulor,	মিমগুলোর,	মিমগুলোর,	
mandope,	ম্যান্ডপে,	মন্ডপে,	
cheef,	চিয়,	শেফ,	
avinetar,	অভিনেটার,	অভিনেতার,	
comoros,	কোমোরস,	কোমোরোস,	
promothesh,	প্রমোথেশ,	প্রমথেশ,	
siramikasa,	সিরামিকাসা,	সিরামিকস,	
dhandu,	ধান্দু,	ধন্দু,	
jontrangshogulor,	যন্ত্রাংশগুলোর,	যন্ত্রাংশগুলোর,	
kaathhmaandute,	কথমমান্ডুতে,	কাঠমান্ডুতে,	
hock,	হকক,	হুক,	
shitei,	শিতেই,	শীতেই,	
soori,	সুরি,	সুরি,	
chet,	চেত,	চ্যাট,	
oncoleo,	অন্কোলেও,	অঞ্চলেও,	
peethey,	পিথে,	পীঠে,	
hajeerhatt,	হাজিরহাট,	হাজিরহাট,	
kumbhalnar,	কুম্ভল্নার,	কুম্ভালনার,	
gandogol,	গ্যান্ডোগল,	গন্ডগোল,	
amar,	আমার,	আমর,	
kaia,	কাইয়া,	কায়া,	
monzushree,	মন্জুশ্রী,	মঞ্জুশ্রী,	
bisheshshyer,	বিশেশ্যের,	বিশেষ্যের,	
booroon,	বুরুন,	বোরন,	
kingsh,	কিংশ,	কিংস,	
narsaari,	নারসারী,	নার্সারি,	
aairish,	আইশির,	আইরিস,	
mosharroph,	মোশার্থোফ,	মশাররফ,	
cs,	সিএসএস,	সিএস,	
liceensee,	লিসসনি,	লাইসেন্স,	
smarak,	স্মরক,	স্মারক,	
superheiroo,	সুপারহহরেও,	সুপারহিরো,	
jubokti,	যুবক্তি,	যুবকটি,	
procharona,	প্রচারণা,	প্রচারণা,	
prachando,	প্রাচন্দ,	প্রচণ্ড,	
licensedhari,	লিইসেন্ধারী,	লাইসেন্সধারী,	
doneta,	ডোনেটা,	ডোনাট,	
kaleo,	কালেও,	কালেও,	
moushum,	মশুম,	মৌসুম,	
nikate,	নিকাতে,	নিকটে,	
marketin,	মার্কেটিন,	মার্কেটিং,	
gondogol,	গণ্ডগোল,	গন্ডগোল,	
pyore,	প্য়ের,	পিওর,	
shahabike,	শাহাবিকে,	সাহাবীকে,	
keui,	কুইই,	কেউই,	
ramchander,	রামচন্দের,	রামচন্দরের,	
maila,	মাইলা,	মাইল,	
phaltu,	ফললট,	ফালতু,	
peshto,	পেষ্ট,	পেষ্ট,	
gandagol,	গণ্ডাগোল,	গন্ডগোল,	
gotihin,	গতিহীন,	গতিহীন,	
sarboshokteeman,	সর্বশক্তমান,	সর্বশক্তিমান,	
oporishodhito,	অপরিষধিত,	অপরিশোধিত,	
qulim,	কুলিম,	কুলিং,	
prokar,	প্রকার,	প্রকার,	
shasankarta,	শসনকর্ত,	শাসনকর্তা,	
jonomukhi,	জনমুখী,	জনমুখী,	
arasie,	আরাসি,	আরসিএ,	
drishi,	দৃশি,	দৃশ্যই,	
chalachchitrotike,	চালাচ্চিত্রটিকে,	চলচ্চিত্রটিকে,	
ruptan,	রুপ্তান,	রূপটান,	
prrajanankaal,	প্রাণজানকাল,	প্রজননকাল,	
padee,	পাড়ি,	পাড়ে,	
mekong,	মেকং,	মেকং,	
kkomandar,	ক্কমান্ডার,	কমাণ্ডার,	
naraphoka,	নারোফোকা,	নরফোক,	
chhutochhuti,	ছুটোচুঠি,	ছুটোছুটি,	
pathanatak,	পাঠানাটাক,	পথনাটক,	
jalbe,	জলবে,	জ্বলবে,	
joki,	জোকি,	জকি,	
bo,	বোব,	বু,	
hakone,	হাকোন,	হাকোনে,	
elakatay,	এলাকাটায়,	এলাকাতে,	
opohoron,	অপহরণ,	অপহরন,	
mitrer,	মিত্রের,	মিত্রের,	
siddhanter,	সিদ্ধান্তের,	সিদ্ধান্তের,	
buth,	বুথ,	বুথ,	
gobeshonar,	গোবেশনার,	গবেষনার,	
steeit,	স্টিইট,	স্টেইট,	
accountdharira,	অকযান্টুর্ডিরা,	একাউন্টধারীরা,	
rinobodh,	ঋণবোধ,	ঋণবোধ,	
jathartho,	যথার্থ,	যথার্থ,	
jamseder,	জামেসেদের,	জামসেদের,	
oitijjha,	ঐতিয্যা,	ঐতিহ্য,	
apad,	আপাদ,	আপদ,	
shasonkarta,	শাসনকর্ত,	শাসনকর্তা,	
ekbakke,	একবাক্ে,	একবাক্যে,	
pragreesa,	প্রাগ্রীস,	প্রগ্রেস,	
bhabanipur,	ভবনীপুর,	ভবানীপুর,	
armori,	আরমোরি,	আরমোরি,	
majlishpur,	মজলিশপুর,	মজলিশপুর,	
samajik,	সমাজিক,	সামাজিক,	
edic,	এডিকিক,	এডিক,	
showtey,	সোউটে,	শোতে,	
jonoshongjog,	জনশোগযগ,	জনসংযোগ,	
serology,	সেরোলজি,	সেরোলজি,	
daebug,	দেবেগ,	ডিবাগ,	
delibhara,	দেলিভারা,	ডেলিভার,	
punorabortonte,	পুনর্বরর্তন্তে,	পুনরাবর্তন্তে,	
madeling,	ম্যাডেলিং,	মডেলিং,	
torabgonj,	তরাগঞ্জজ,	তোরাবগঞ্জ,	
deeares,	ডিয়ারেস,	ডিআরএস,	
bhushito,	ভূষিত,	ভূষিত,	
gujab,	গুজাব,	গুজব,	
deputee,	ডিপুটি,	ডেপুটি,	
doltyagi,	দল্্যাগী,	দলত্যাগী,	
lopjonito,	লোপজনিত,	লোপজনিত,	
sahab,	সাহাব,	সাহাব,	
madhobeer,	মাধবীর,	মাধবীর,	
biswashi,	বিশ্বাশী,	বিশ্বাসই,	
adhyatmikata,	অধ্যাম্তিকাা,	আধ্যাত্মিকতা,	
talgach,	তালগাছ,	তালগাছ,	
srabosty,	স্রাবাস্টি,	শ্রাবস্তী,	
safiin,	সাফিন,	সাফিন,	
coons,	কনউস,	কুনস,	
purborekorde,	পূর্বররকেরদ,	পূর্বরেকর্ডে,	
paolasthi,	পাওসাস্থী,	পাওলাসথি,	
pachattar,	পাচাত্র,	পাচাত্তার,	
osomorthito,	অসমর্থিত,	অসমর্থিত,	
amiretus,	আমিরিটুস,	এমিরেটাস,	
kormokarke,	কর্মকারকে,	কর্মকারকে,	
nirbachakder,	নির্বাচকদের,	নির্বাচকদের,	
madhuri,	মধুরি,	মাধুরী,	
aniyantrita,	অনিয়ন্ত্রিত,	অনিয়ন্ত্রিত,	
zeland,	জেলান্ড,	জিল্যান্ড,	
kanshater,	কাঁশাতের,	কানসাটের,	
akten,	আক্তেন,	অকটেন,	
nutunotto,	নুটুনত্ব,	নতুনত্ব,	
falak,	ফালাক,	ফলক,	
footballerra,	ফুটবললরারা,	ফুটবলাররা,	
cholechi,	চলেছি,	চলেছি,	
dharabahikvabe,	ধারাবাহিকভাবে,	ধারাবাহিকভাবে,	
aarke,	আরকে,	আরকে,	
bidyadanke,	বিদ্যাদানকে,	বিদ্যাদানকে,	
mumtaj,	মুমতাজ,	মুমতাজ,	
lyaandeeng,	ল্যান্ডিং,	ল্যান্ডিং,	
lavta,	লাভটা,	লাভটা,	
maailkhanek,	মাইলখানেক,	মাইলখানেক,	
tigmanshu,	টিগমাশনু,	তিগ্মাংশু,	
highcomissione,	হাইক্মসেনন,	হাইকমিশনে,	
audioguloke,	আডিওগুলোকে,	অডিওগুলোকে,	
sylvi,	সিলভি,	সিলভি,	
futote,	ফুটোতে,	ফুটোতে,	
kaley,	কালে,	কালে,	
ispreedshiit,	ইস্প্রিশিষ্টি,	স্প্রেডশীট,	
sikkhokder,	সিক্ষকদের,	শিক্ষকদের,	
kisti,	কিস্টি,	কিস্তি,	
udbodhani,	উদ্বধানী,	উদ্বোধনী,	
inafarameshana,	ইনাররেশনহ,	ইনফরমেশন,	
panthar,	পান্থার,	পন্থার,	
meropenemer,	মেরোপেনমের,	মেরোপেনেমের,	
asiatic,	অসিয়াটিক,	এশিয়াটিক,	
adhikartai,	অধিকর্তই,	অধিকর্তাই,	
yuro,	যুয়রো,	ইউরো,	
scholastik,	স্কলাস্তিক,	স্কলাস্টিক,	
haitasha,	হাইতাশা,	হাইটস,	
konagoolo,	কোনাগুলো,	কণাগুলো,	
prokolpotike,	প্রকল্পটিকে,	প্রকল্পটিকে,	
saazano,	সাজানো,	সাজানো,	
nathibhuktir,	নাথিভুক্তির,	নথিভুক্তির,	
aalkatraa,	আলকাত্রা,	আলকাতরা,	
teenej,	তেনেজ,	টিনেজ,	
digree,	ডিগ্রি,	ডিগ্রি,	
naitikatavodh,	নৈতিকাতাবোধ,	নৈতিকতাবোধ,	
cn,	সিএনএন,	সিএন,	
gostigulo,	গোস্তিগুলো,	গোষ্ঠীগুলো,	
abarte,	আবার্তে,	আবর্তে,	
vabuk,	ভাবুক,	ভাবুক,	
latsaheb,	লাৎসাহেব,	লাটসাহেব,	
tuni,	টিউনি,	টুনি,	
cuti,	কিউটি,	কিউটি,	
gonjona,	গঞ্জনা,	গঞ্জনা,	
dikpal,	দিকপাল,	দিকপাল,	
dei,	ডেই,	দিই,	
alankorana,	আলানকরণা,	অলঙ্করণ,	
moreecha,	মরিচা,	মরিচা,	
ooporoshtho,	অপর্থ,	উপরস্থ,	
tetela,	টেটেলা,	টাইটেল,	
japanostho,	জাপানস্থ,	জাপানস্থ,	
kathghera,	কাঠঘেরা,	কাঠঘেরা,	
harbore,	হারবরে,	হারবারে,	
sonaktokaran,	সোনাক্তকরণ,	সনাক্তকরণ,	
ghamtaa,	ঘামটা,	ঘোমটা,	
satarka,	সতররকা,	সতর্ক,	
saraiki,	সারাইকি,	সরাইকি,	
kheshar,	খেশার,	খেশার,	
onkush,	অন্কুষ,	অংকুশ,	
sohojlovyotar,	সহজ্যভূতার,	সহজলভ্যতার,	
engreziteo,	এংজ্রেজিতেও,	ইংরেজিতেও,	
neemitte,	নিমিত্বে,	নিমিত্তে,	
gananatyo,	গণনাত্য,	গণনাট্য,	
poroborti,	পরবর্তি,	পরর্বতী,	
jatotaa,	যাতোটা,	যতোটা,	
kaferder,	কাফেরদের,	কাফেরদের,	
sommotite,	সম্মতিতে,	সম্মতিতে,	
matrirup,	মাতৃরূপ,	মাতৃরূপ,	
pachak,	পাচক,	পাচক,	
orbi,	অরবি,	ওরবি,	
saver,	সাভের,	সেভার,	
helly,	হেলি,	হিলি,	
jibonnogor,	জীবনগনোর,	জীবননগর,	
uparzoner,	উপার্জনের,	উপার্জনের,	
bojiye,	বজিয়ে,	বজিয়ে,	
lajik,	লাজিক,	লজিক,	
ramantika,	রামান্তিকা,	রোমান্টিক,	
proo,	প্রো,	প্রো,	
chhuti,	ছুটি,	ছুটি,	
fatakasto,	ফাটাকাস্ত,	ফাটাকেষ্ট,	
tigmanshu,	টিগমাশনু,	তিগমংশু,	
bhabanir,	ভবনীর,	ভবানীর,	
shakara,	শকারা,	সাকার,	
bhaibon,	ভাইবন,	ভাইবোন,	
niutrino,	নিউট্রিনো,	নিউট্রিনো,	
kaande,	কাঁড়ে,	কাণ্ডে,	
horiddare,	হরিদ্রাে,	হরিদ্বারে,	
sures,	সুরেস,	সুরেশ,	
jeebonnogor,	জীবনগনোর,	জীবননগর,	
shchalastik,	স্চালাস্টিক,	স্কলাস্টিক,	
smarok,	স্মররক,	স্মারক,	
tanu,	তানু,	তনু,	
taler,	তালের,	তালের,	
uindoos,	উইন্ডসস,	উইন্ডোস,	
eesa,	ইইসএএইএ,	আইএএস,	
leaders,	লিডারস,	লিডার্স,	
hepatitis,	হেপাটিটিস,	হেপাটাইটিস,	
shardotsobei,	শার্দোৎববেই,	শারদোৎসবেই,	
prabhritite,	প্রভৃতিতে,	প্রভৃতিতে,	
nabatarange,	নাবারাঙ্গে,	নবতরঙ্গে,	
chhatrodiger,	ছাত্রদিগের,	ছাত্রদিগের,	
priseflex,	প্রিইসেলফ্সেস্,	প্রাইজফ্লেক্স,	
mukhyo,	মুখ্য,	মুখ্য,	
umedpoor,	উমেদপুর,	উমেদপুর,	
durgotsabe,	দুর্গতৎসবে,	দুর্গোৎসবে,	
helloin,	হেলোইন,	হ্যালোইন,	
niurolaji,	নিউরলজি,	নিউরোলজি,	
atwobishvashi,	আত্ববিশ্বাশী,	আত্মবিশ্বাসী,	
mekon,	মেকন,	মেকং,	
gajetted,	গ্যাজেট্ট,	গেজেটেড,	
turbiner,	টারবিনের,	টারবাইনের,	
ramantic,	রামান্টিক,	রোমান্টিক,	
dumaa,	দুমা,	দুমা,	
hozot,	হজজ,	হজত,	
pulivendla,	পুলিভেন্ডা,	পুলিভেন্ডলা,	
bapokotor,	বাপকতর,	ব্যাপকতর,	
khelechen,	খেলেছেন,	খেলেছেন,	
youth,	যৌউথ,	ইয়ুথ,	
monohputo,	মনোহপুত,	মনঃপুত,	
veenish,	ভিনিশ,	ভেনিস,	
gyada,	জ্যাদা,	গ্যাদা,	
onupater,	অনুপাতের,	অনুপাতের,	
starker,	স্টারকের,	স্টার্কের,	
tyap,	ত্যাপ,	ট্যাপ,	
dharavahiker,	ধারাভাহিকের,	ধারাবাহিকের,	
turkyder,	টারক্ডির,	তুর্কিদের,	
joumana,	জৌমানা,	জুমানা,	
adarsho,	আদারশো,	আর্দশ,	
sobche,	সবচে,	সবচে,	
bokahoke,	বোকাহকে,	বকাহকে,	
gudamjat,	গুদামজাত,	গুদামজাত,	
daltyagi,	দল্্যাগী,	দলত্যাগী,	
marodeho,	মারোদেহো,	মরদেহ,	
taunship,	তাউনশিপ,	টাউনশিপ,	
amorendro,	আমারেন্দ্রো,	অমরেন্দ্র,	
alkatra,	আলকাত্রা,	আলকাতরা,	
ruble,	রাবল,	রুবল,	
samany,	সামানি,	সামান্য,	
bhutbhut,	ভূতভুত,	ভুটভুট,	
utpatti,	উৎপত্তি,	উতপত্তি,	
fatakesto,	ফ্যাটাকেস্ট,	ফাটাকেষ্ট,	
windos,	উইন্ডস,	উইন্ডোস,	
bossoben,	বসবেন,	বসবেন,	
bhyatikaner,	ভ্যাটিকানের,	ভ্যাটিকানের,	
kaansaat,	কানসাত,	কানসাট,	
bodhir,	বোধীর,	বধির,	
seshardhe,	সেশার্ধে,	শেষার্ধে,	
nirikho,	নিরিখো,	নিরিখ,	
rajtantra,	রাজতন্ত্র,	রাজতন্ত্র,	
ramachandranke,	রমমাচন্দ্রানকে,	রামাচন্দ্রনকে,	
ghumachche,	ঘুমাচ্ছে,	ঘুমাচ্ছে,	
daybhager,	দয়ভাগের,	দায়ভাগের,	
byathapather,	ব্যাথাপথার,	ব্যথাপথের,	
daakticketer,	দাক্টিকেটের,	ডাকটিকিটের,	
kortona,	কর্টনা,	করতনা,	
kompeeto,	কম্পিত,	কম্পিত,	
internship,	ইন্টারশনিপ,	ইন্টার্নশিপ,	
nathivukta,	নাথিভুক্ত,	নথিভুক্ত,	
ghurechen,	ঘুরেছেন,	ঘুরেছেন,	
jesh,	জেস,	জেস,	
ronangane,	রোনাঙ্গানে,	রণাঙ্গনে,	
srk,	এসর্ক,	শাহরুখ,	
poorohitra,	পুরহিত্র,	পুরোহিতরা,	
fitarsaho,	ফিতারসহ,	ফিতরসহ,	
spreadshiit,	স্প্রেশডিট,	স্প্রেডশীট,	
chalachchitrei,	চলচাচি্র্যেই,	চলচ্চিত্রেই,	
obosorer,	অবসরের,	অবসরের,	
obdee,	অব্দি,	অব্দি,	
conservetion,	কনসারভেশন,	কনসারভেশন,	
volivoler,	ভলিভোলের,	ভলিভলের,	
spenser,	স্পেনসের,	স্পেন্সার,	
shrabasti,	শ্রাবাস্তি,	শ্রাবস্তী,	
bolbo,	বলবো,	বলবো,	
ekirokom,	একিরকম,	একইরকম,	
jakatke,	জাকাতকে,	যাকাতকে,	
uzobekeestaan,	উজবেক্তেসান,	উজবেকিস্তান,	
hupile,	হুপিলে,	হুপিলে,	
kirti,	কির্তি,	কীর্তি,	
catholicbad,	ক্যাথোলিক্যাড,	ক্যাথলিকবাদ,	
harja,	হারজা,	হার্জ,	
ekhate,	এখাতে,	একহাতে,	
shekarmani,	শেকারমনি,	শেকরমানি,	
eporzonto,	এপর্জন্ত,	এপর্যন্ত,	
argead,	আরজজেড,	আর্জিদ,	
bhoolapuka,	ভূপাপুকা,	ভোলাপুক,	
sikha,	সিখা,	শিখ,	
shakar,	শাকার,	সকার,	
lekhaksattwar,	লেখকক্তত্ব,	লেখকসত্ত্বার,	
bandhubhaabaapanna,	বন্ধুবাযাবন্্্ন,	বন্ধুভাবাপন্ন,	
koruna,	করুনা,	করুণা,	
katui,	কাটুই,	কাতুই,	
ganosochetonota,	গণসচেতনতা,	গণসচেতনতা,	
parswer,	পার্স্বের,	পার্শ্বের,	
sulfatee,	সুলফাটি,	সালফেট,	
lokhindorer,	লোখিন্দরের,	লখিন্দরের,	
deares,	ডিয়ারস,	ডিআরএস,	
bishashke,	বিশাশকে,	বিশ্বাসকে,	
kada,	কাডা,	কোডা,	
rajan,	রাজান,	রাজন,	
scholarship,	স্কলারশিপ,	স্কলারশিপ,	
graambaasheeo,	গ্রামবাশাই,	গ্রামবাসীও,	
chaiten,	চাইতেন,	চাইতেন,	
dito,	দিতো,	দিতো,	
konisttha,	কনিস্ত্থা,	কনিষ্ঠ,	
kantojir,	কান্তজীর,	কান্তজির,	
cholochchitraeeo,	চলচ্ঠিত্রায়,	চলচ্চিত্রেও,	
rupert,	রুপার্ট,	রুপার্ট,	
shpredshiit,	শ্প্রেশিটি,	স্প্রেডশীট,	
choudry,	চৌড্রি,	চৌধুরী,	
anubhutimalar,	অনুভূতিমালার,	অনুভূতিমালার,	
monchosthol,	মন্চস্থল,	মঞ্চস্থল,	
beem,	বিএমএ,	বিম,	
haris,	হারিস,	হ্যারিস,	
urey,	উরেই,	ইউরি,	
neker,	নেকের,	নেকের,	
gondhe,	গন্ধে,	গন্ধে,	
tookrote,	টুকরোতে,	টুকরোতে,	
santoshpore,	সন্তঃশপরে,	সন্তোষপুর,	
shudhui,	শুধুই,	শুধুই,	
peerry,	পিরিরি,	পেরি,	
mumtajer,	মুমতাজের,	মুমতাজের,	
poriharsoho,	পরিহারসহ,	পরিহারসহ,	
holdim,	হোল্ডিম,	হোল্ডিং,	
daaradaa,	দারাদা,	দারদা,	
akkhunno,	আক্ষুণ্য,	অক্ষুণ্ণ,	
asamorik,	অসামরিক,	অসামরিক,	
plak,	প্ল্যাক,	প্ল্যাক,	
shekarone,	শেকারণে,	সেকারণে,	
kloud,	ক্লোড,	ক্লাউড,	
nirobota,	নিরোবতা,	নিরবতা,	
debholopar,	দেভোলপার,	ডেভলপার,	
dovaar,	দভভার,	ডোভার,	
niropekkho,	নিরোপেক্ষ,	নিরপেক্ষ,	
bade,	বাদে,	বাদে,	
kod,	কোড,	কোড,	
makhno,	মাখনো,	মাখনো,	
ganoporibahoner,	গণপরিবহহনের,	গণপরিবহনের,	
agomoney,	আগমনে,	আগমনে,	
chalachchitroi,	চালাচ্চিত্রই,	চলচ্চিত্রই,	
scuvi,	স্কুভি,	স্কুভি,	
bastubad,	বাস্তুবাদ,	বস্তুবাদ,	
ghumunoi,	ঘুমুনোই,	ঘুমুনোই,	
enjineers,	এনজিনির্স,	ইঞ্জিনিয়ার্স,	
nothivuktir,	নথিভুক্তির,	নথিভুক্তির,	
norfolk,	নরফলক,	নরফোক,	
shite,	শিতে,	শীতে,	
danab,	দানাব,	দানব,	
abheedhaneek,	অভিনানিক,	অভিধানিক,	
manjushree,	মঞ্জুশ্রী,	মঞ্জুশ্রী,	
sikarder,	সিকারদের,	শিকারদের,	
mukhomandaler,	মুখোমন্ডলের,	মুখমণ্ডলের,	
capsul,	ক্যাপসুল,	ক্যাপসুল,	
dibi,	ডিবি,	দিবি,	
bone,	বনে,	বনে,	
turkeyder,	টুর্কেদের,	তুর্কিদের,	
ponero,	পনেরও,	পনের,	
dorgaaho,	ঘর্গাহ,	দরগাহ,	
aosafur,	আওয়াফুর,	আওশাফুর,	
bandi,	বান্দি,	বন্দী,	
dankaan,	দাঁকান,	ডানকান,	
mahibur,	মহিবুর,	মহিবুর,	
devolapar,	দেভলাপার,	ডেভলপার,	
plator,	প্ল্যাটর,	প্লেটোর,	
karadandey,	কারাদন্ডে,	কারাদণ্ডে,	
foxer,	ফক্সের,	ফক্সের,	
sohokari,	সোহাকরী,	সহকারী,	
shudden,	শুদ্দেন,	সাডেন,	
disposes,	ডিস্পোস,	ডিসপোজেস,	
kooshumba,	কুশুমবা,	কুশুম্বা,	
sector,	সেক্টর,	সেক্টর,	
polashir,	পোলাশির,	পলাশীর,	
gopalrao,	গোপালরাও,	গোপালরাও,	
hoil,	হইল,	হইল,	
giitikobitar,	গিতিকিবাতির,	গীতিকবিতার,	
joubanbatee,	যৌবনবাতী,	যৌবনবতী,	
elaaka,	এলাকা,	এলাকা,	
musolmanera,	মুসোলমানার,	মুসলমানেরা,	
bhogiroth,	ভোগিরোথ,	ভগীরথ,	
vezano,	ভেজানো,	ভেজানো,	
emarjensi,	এমারজেন্সি,	এমার্জেন্সি,	
plato,	প্ল্যাটো,	প্লেটো,	
hansasya,	হাযাসস্যা,	হংসস্য,	
wictor,	ইইক্টর,	ভিক্টর,	
ishtone,	ইস্তোন,	স্টোন,	
stander,	স্ট্যান্ডার,	স্ট্যাণ্ডের,	
byatikrami,	ব্যতিক্রমমী,	ব্যতিক্রমী,	
israelbahini,	ইস্রালেবাহিনী,	ইস্রায়েলবাহিনী,	
duryogamoyee,	দুর্যোগায়মই,	দুর্যোগময়ী,	
balakarak,	বালাকারাক,	বলকারক,	
dreeshtiheen,	দৃষ্টিহিন,	দৃষ্টিহীন,	
rakhtokkharone,	রাক্ঠকর্ণনে,	রক্তক্ষরণে,	
moorali,	মুরালি,	মুরলী,	
musallati,	মুসললল্তি,	মুসল্লাটি,	
drissogulote,	দৃষ্যগুলোতে,	দৃশ্যগুলোতে,	
temonvabe,	তেমনভাবে,	তেমনভাবে,	
karuna,	করুনা,	করুণা,	
monur,	মনুর,	মনুর,	
kaathhaamaandu,	কথামান্দু,	কাঠমান্ডু,	
rudroke,	রুদ্রকে,	রুদ্রকে,	
codeti,	কোডেটি,	কোডটি,	
arashie,	আরাশিয়ে,	আরসিএ,	
cheentaikaree,	চিন্তাকারী,	ছিনতাইকারী,	
beshakbar,	বেশাকবার,	বেশকবার,	
ovinetar,	অভিনেটার,	অভিনেতার,	
songkoloney,	সংকলনে,	সংকলনে,	
jyaqa,	জ্যাকা,	জ্যাক,	
juktorashtreo,	যুক্তরাশ্ত্রেও,	যুক্তরাষ্ট্রেও,	
vushi,	ভুশি,	ভুষি,	
nothivukta,	নথিভুক্ত,	নথিভুক্ত,	
kinsa,	কিনসা,	কিংস,	
harishankar,	হরিষণকার,	হরিশংকর,	
prothakey,	প্রথাকে,	প্রথাকে,	
mahakabi,	মহাকাবী,	মহাকবি,	
subade,	সুবাদে,	সুবাদে,	
matorom,	মাতোরম,	মাতরম,	
shekender,	শেকেন্দের,	সেকেন্ডের,	
shiulijhra,	শিউলিঝরা,	শিউলিঝরা,	
kommandar,	কোম্মান্দর,	কমাণ্ডার,	
sharansthal,	শরনস্থল,	শরণস্থল,	
chaudhuriyo,	চৌধুরিয়,	চৌধুরীও,	
serup,	সেরুপ,	সেরূপ,	
bikargrosto,	বিকারগ্রস্ত,	বিকারগ্রস্ত,	
deliver,	ডেলিভার,	ডেলিভার,	
jewellery,	জেওয়ালির,	জুয়েলারির,	
carzar,	কারজার,	চার্জার,	
shatodha,	শতধো,	শতধা,	
postay,	পোস্টায়ে,	পোস্টে,	
oncholgulir,	অঞ্চলগুলির,	অঞ্চলগুলির,	
rachonakal,	রচনাকাল,	রচনাকাল,	
akram,	আকরাম,	আকরাম,	
dhangsachchi,	ধাংসাচ্ছি,	ধ্বংসাচ্ছি,	
chetanagoto,	চেতানাগত,	চেতনাগত,	
fiksing,	ফিকসিং,	ফিক্সিং,	
patjata,	পাতজাতা,	পাটজাত,	
sambatsarkal,	সম্বততারকাল,	সম্বৎসরকাল,	
matis,	মাটিস,	ম্যাটিস,	
saainyo,	সাইন্য,	সৈন্য,	
beila,	বেইলা,	বেইলা,	
osthisondhi,	অস্থিসন্ধি,	অস্থিসন্ধি,	
tukrowti,	টুক্রোটি,	টুকরোটি,	
logotype,	লোগোটিপ,	লোগোটাইপ,	
neck,	নেক,	নেক,	
damodar,	দামোদার,	দামদর,	
swajan,	স্বজান,	স্বজন,	
murader,	মুরাদের,	মুরাদের,	
bidhirnityang,	বিধৃতিন্যাং,	বিধির্নিত্যং,	
sethai,	সেথাই,	সেথাই,	
thakeni,	থাকেনি,	থাকেনি,	
chalochchitrogulor,	চালচ্চিত্রগুলোর,	চলচ্চিত্রগুলোর,	
pet,	পেট,	পেত,	
madhabi,	মাধাবী,	মাধবী,	
toki,	টোকি,	তকি,	
laps,	ল্যাপস,	ল্যাপস,	
patochitra,	পাটচিত্র,	পটচিত্র,	
nirgomon,	নির্গমন,	নির্গমন,	
cooda,	কোডা,	কোডা,	
sangkulaan,	সংকুলান,	সংকুলান,	
tarkale,	তারকালে,	তারকালে,	
irish,	ইরিশ,	আইরিস,	
khanabale,	খানাবালে,	খানাবলে,	
ixprission,	ইক্সপিরিসন,	এক্সপ্রেশন,	
nodimaatrik,	নদিমাত্রিক,	নদীমাতৃক,	
kinto,	কিন্তো,	কিনত,	
shishu,	শিশু,	শিশু,	
phakay,	ফাকায়,	ফাকে,	
prosadhoner,	প্রসাধনের,	প্রসাধনের,	
darji,	দারজি,	দরজি,	
groth,	গ্রথ,	গ্রোথ,	
dharavahik,	ধারাবাহিক,	ধারাবাহিক,	
difinishion,	ডিফিনশন,	ডেফিনেশন,	
meghachchanno,	মেঘাচ্ছনন,	মেঘাচ্ছন্ন,	
orbeet,	অরবিত,	অরবিট,	
ganjana,	গঞ্জনা,	গঞ্জনা,	
baibasthaar,	বৈবস্থার,	ব্যবস্থার,	
byapoktor,	ব্যাপক্তর,	ব্যাপকতর,	
bibhinno,	বিভিন্ন,	বিভন্ন,	
chilona,	চিলোনা,	ছিলনা,	
dakkhinkare,	দক্ষিণকারে,	দক্ষিণকরে,	
mulyayonsapekkhe,	মূল্যয়লাপনক্ষে,	মূল্যায়নসাপেক্ষে,	
groundta,	গ্রোউন্ডটা,	গ্রাউন্ডটা,	
masjidke,	মাসজিদকে,	মসজিদকে,	
dep,	ডিপ,	ডেপ,	
dhwajbhango,	ধ্বযাভঙ্গ,	ধ্বজভঙ্গ,	
peeri,	পিরি,	পেরি,	
banglota,	বাংলোতা,	বাংলোটা,	
prokalpagulo,	প্রকলাপগুলো,	প্রকল্পগুলো,	
ostheesandhi,	অস্থানি্ধি,	অস্থিসন্ধি,	
jhumjhumita,	ঝুমঝুমিতা,	ঝুমঝুমিটা,	
bhaisaho,	ভাইসাহ,	ভাইসহ,	
daqop,	ডাকোপ,	দাকোপ,	
mukhmondole,	মুখমন্ডলে,	মুখমণ্ডলে,	
nodiitei,	নদীতেই,	নদীতেই,	
kandy,	কান্ডি,	ক্যান্ডি,	
hughkey,	হুগকে,	হিউজকে,	
mukhbondho,	মুখবন্ধ,	মুখবন্ধ,	
somraatra,	সম্রাত্র,	সম্রাটরা,	
hoteltite,	হোটেলটিতে,	হোটেলটিতে,	
basermick,	ব্যাসারমিক্,	বেসারমিক,	
crucer,	ক্রুসের,	ক্রুশের,	
vangley,	ভ্যাংলি,	ভাঙলে,	
suraaropito,	সুরারপিত,	সুরারোপিত,	
rashedul,	রাশেদুল,	রাশিদুল,	
joisttho,	জৈযস্ত্থ,	জ্যৈষ্ঠ,	
gobeshakgon,	গবেষাকগণ,	গবেষকগণ,	
dipgulote,	দিপগুলোতে,	দ্বীপগুলোতে,	
hadisti,	হাদিস্টি,	হাদিসটি,	
mugdha,	মুগধা,	মুগ্ধ,	
nabatamo,	নাবাতামো,	নবতম,	
attacharito,	অত্যাচারিত,	অত্যাচারিত,	
taateo,	তায়েতেও,	তাতেও,	
joones,	জনেস,	জোন্স,	
armshtrong,	আর্ম্্ট্রং,	আর্মস্ট্রং,	
munim,	মুনিম,	মুনিম,	
siddhantei,	সিদ্ধান্তেই,	সিদ্ধান্তেই,	
shhow,	শাও,	শো,	
nothibhukteer,	নথিভুক্তির,	নথিভুক্তির,	
hol,	হোল,	হোল,	
rananganey,	রানাঙ্গনে,	রণাঙ্গনে,	
sheetke,	শিটকে,	শীতকে,	
cocaine,	কোকাইন,	কোকেইন,	
bapio,	বাপিও,	বাপিও,	
edmeeral,	এডমিরাল,	এডমিরাল,	
shurugulo,	শুরুগুলো,	শুরুগুলো,	
ranangone,	রানাঙ্গনে,	রণাঙ্গনে,	
emerjency,	এমেরজেন্সি,	এমার্জেন্সি,	
yatharthabhabe,	যথরথথভাবে,	যথার্থভাবে,	
elakatike,	এলাকাটিকে,	এলাকাটিকে,	
abosan,	অবসান,	অবসান,	
laat,	লাট,	লাট,	
purple,	পূর্পলে,	পার্পেল,	
teliha,	তেলিহা,	তেলিহা,	
narbur,	নারবুর,	নরবুর,	
kushakhali,	কুশাখালি,	কুশাখালি,	
elahabade,	এলাহাবাদে,	এলাহাবাদে,	
obhaarbhiu,	ওভাভারিউ,	ওভারভিউ,	
paramartha,	পরমার্থ,	পরমার্থ,	
graambasheeo,	গ্রামবাশাই,	গ্রামবাসীও,	
forex,	ফরেক্স,	ফরেক্স,	
pettern,	পেট্রেন,	প্যাটার্ন,	
oncholshomuher,	অন্লমসমূহের,	অঞ্চলসমূহের,	
expreshshion,	এক্সপ্রেশশন,	এক্সপ্রেশন,	
chuti,	চুটি,	ছুটি,	
qara,	কারা,	কর,	
pratishthanik,	প্রতিষ্ঠানিক,	প্রাতিষ্ঠানিক,	
reejideencee,	রিজিডেন্ডি,	রেসিডেন্স,	
krom,	ক্রম,	ক্রম,	
sooya,	সুয়া,	সোয়া,	
sima,	সিমা,	সীমা,	
besooro,	বেশরর,	বেসুর,	
shithilata,	শিথিলতা,	শিথিলতা,	
daraider,	দারাইদের,	দরাইদের,	
fake,	ফাযাকে,	ফাকে,	
manir,	মানির,	মনির,	
ghaghat,	ঘাঘাট,	ঘাঘট,	
chhutir,	ছুটির,	ছুটির,	
suchonakal,	সুচনাকাল,	সূচনাকাল,	
mulor,	মুলোর,	মুলোর,	
jipiusamriddha,	জিপুমিদ্দদ্ধ,	জিপিউসমৃদ্ধ,	
bboponer,	বিপনের,	বপনের,	
uchchotara,	উচ্চতারা,	উচ্চতর,	
prithibir,	পৃথিবির,	পৃথবীর,	
rinattak,	ঋণত্তক,	ঋনাত্মক,	
musabbirul,	মুসাবববিরুল,	মুসাব্বিরুল,	
anyorup,	অন্যরূপ,	অন্যরূপ,	
setike,	সেটিকে,	সেটিকে,	
pharn,	ফর্ন,	ফার্ন,	
primoo,	প্রিমো,	প্রিমো,	
soundarja,	সৌন্দর্য,	সৌর্ন্দয্য,	
rijoor,	রিজুর,	রিজুর,	
samajeek,	সমাজীক,	সামাজিক,	
chal,	চাল,	চাল,	
mukhomandoler,	মুখোমন্ডলের,	মুখমণ্ডলের,	
sepha,	সেফা,	শেফ,	
bhogni,	ভগনি,	ভগ্নী,	
lakkhero,	লক্ষেরও,	লক্ষেরও,	
bishnu,	বিশ্নু,	বিষ্ণু,	
pader,	পাড়ের,	প্যাডের,	
munot,	মুনোট,	মুনোট,	
kaalki,	কালকি,	কালকি,	
maley,	ম্যালে,	মালে,	
kichudinpar,	কিছুদিনপার,	কিছুদিনপর,	
amittrakkhor,	অমিত্তার্কর,	অমিত্রাক্ষর,	
melborrone,	মেলবর্রনে,	মেলবোর্নে,	
times,	টিমস,	টাইমস্,	
atighataner,	অতিঘাটানের,	অতিঘটনের,	
asantosh,	অসন্তসশ,	অসন্তোষ,	
amiya,	আমিয়া,	অমিয়,	
niemond,	নিয়ামন্ড,	নিমন্ড,	
ghuznavi,	ঘুজনাবি,	গজনভি,	
venus,	ভেনুস,	ভেনাস,	
oiteejye,	ঐতিয়েজ,	ঐতিহ্যে,	
johny,	জহনি,	জনি,	
koomarir,	কুমারির,	কুমারীর,	
mane,	ম্যান,	মানে,	
chotogolper,	চটোগল্পের,	ছোটগল্পের,	
orthoneeti,	অর্থনীতি,	অর্থনীতির,	
doula,	ডৌলা,	দৌলা,	
hisabagyan,	হিসাবাজ্ঞান,	হিসাবজ্ঞান,	
bm,	বিএমএ,	বিএম,	
daaktikit,	দাক্তিকিত,	ডাকটিকিট,	
modelgulo,	মড়েলগুলো,	মডেলগুলো,	
shcholastic,	স্কোলোযাক্সিট,	স্কলাস্টিক,	
baju,	বাজু,	বাজু,	
byabaharkariderke,	ব্যবহারকারীদেরকে,	ব্যবহারকারীদেরকে,	
abdoone,	আব্দনু,	আবদুন,	
aaeerese,	আইয়েসে,	আইরেসে,	
abanishankar,	অবানিশঙ্কার,	অবনিশংকর,	
aditisaha,	আদিতিসহ,	অদিতিসহ,	
bandhano,	বানধননো,	বাঁধানো,	
arifin,	আরিফিন,	আরিফিন,	
nyata,	ন্যাতা,	ম্যাট,	
kathmandute,	কাঠমান্দুতে,	কাঠমান্ডুতে,	
byaboharkareer,	ব্যবহরকারীর,	ব্যবহারকারীর,	
install,	ইন্সটাল,	ইন্সটল,	
sanaktokaran,	সনাক্তকরণ,	সনাক্তকরণ,	
bonnypran,	বন্িপ্রান,	বন্যপ্রাণ,	
land,	ল্যান্ড,	ল্যান্ড,	
omarader,	ওমারাদের,	ওমারাদের,	
shikhbe,	শিখবে,	শিখবে,	
sampadon,	সম্পাদন,	সম্পাদন,	
zibonnogor,	জীবনগনোর,	জীবননগর,	
debdebier,	দেবদেবীর,	দেবদেবীর,	
freelancerra,	ফ্রিলান্নেরার,	ফ্রিল্যান্সাররা,	
bibecchyo,	বিবেচ্যচ,	বিবেচ্য,	
salsa,	সালসা,	সালসা,	
philo,	ফিলো,	ফিলো,	
suraaropeeto,	সুরারপপত,	সুরারোপিত,	
neshadrabyer,	নেশাদ্রব্যের,	নেশাদ্রব্যের,	
laesens,	লেসেন্স,	লাইসেন্স,	
aieesha,	এইশিয়া,	আইএএস,	
nodnodeer,	নদনদীর,	নদনদীর,	
batom,	বাযাটম,	বাটম,	
protisthar,	প্রতিষ্ঠার,	প্রতিষ্ঠার,	
fostar,	ফোস্টার,	ফস্টার,	
brookoleen,	ব্রুকললিন,	ব্রুকলিন,	
mexicoteo,	মেক্সিকোটেও,	মেক্সিকোতেও,	
vorkendra,	ভরকেন্দ্র,	ভরকেন্দ্র,	
byke,	বিকে,	বাইক,	
hoonayin,	হুনায়ান,	হুনাইন,	
dipti,	দিপ্টি,	ডেপুটি,	
kalnir,	কালনির,	কালনীর,	
teenisa,	তিনিসা,	টেনিস,	
palkee,	পালকি,	পাল্কি,	
rekhapat,	রেখাপাত,	রেখাপাত,	
headquartus,	হেড্যাক্রাস,	হেডকোয়ার্টাস,	
jibanto,	জীবান্ত,	জীবন্ত,	
bhowanipur,	ভৌনাইপির,	ভবানীপুর,	
tricksguli,	ট্রিক্সগুলি,	ট্রিকসগুলি,	
rilayensa,	রিলয়েেনসা,	রিলায়েন্স,	
autopromotioner,	অটোপ্রোশ্টনের,	অটোপ্রমোশনের,	
ponchasjon,	পঞ্চাজজন,	পঞ্চাশজন,	
carlo,	কারলো,	কার্লো,	
somsher,	সমশের,	সমশের,	
ekroop,	একরুপ,	একরূপ,	
bodhirta,	বধির্তা,	বধিরতা,	
byabosthar,	ব্যবস্থার,	ব্যবস্থার,	
dooburir,	দুবুরির,	ডুবুরির,	
krimlin,	ক্রিমলিন,	ক্রিমলিন,	
cinematographar,	সিনেমোটারোফ্রোফার,	সিনেমাটোগ্রাফার,	
chandrimaa,	চন্দ্রিমা,	চন্দ্রিমা,	
kale,	কালে,	কালে,	
biplabee,	বিপ্লবব,	বিপ্লবী,	
saarbhaarti,	সার্ভারটি,	সার্ভারটি,	
proshtutkarok,	প্রশ্টুত্তকরর,	প্রস্তুতকারক,	
faaj,	ফাজ,	ফাজ,	
protyokkhovabey,	প্রত্যক্যাভাবে,	প্রত্যক্ষভাবে,	
orthanitike,	অর্থানিতিকে,	অর্থনীতিকে,	
salmaner,	সালমানের,	সালমানের,	
mojlish,	মজলিশ,	মজলিশ,	
seguloi,	সেগুলোই,	সেগুলোই,	
dhache,	ছাছে,	ধাঁচে,	
shasyadi,	শস্যদদি,	শস্যাদি,	
ashiatic,	অসিয়াটিক,	এশিয়াটিক,	
kram,	ক্রাম,	ক্রম,	
nirbaho,	নির্বাহ,	নির্বাহ,	
sumi,	সুমি,	সুমি,	
shhepha,	শেফা,	শেফ,	
nili,	নিলি,	নিলি,	
khonjena,	খোঁজেনা,	খোঁজেনা,	
saarbharti,	সার্ভর্তি,	সার্ভারটি,	
bosante,	বসনাতে,	বসন্তে,	
armshtronj,	আর্ম্ট্রোজজন,	আর্মস্ট্রং,	
bhalobaas,	ভালোবাস,	ভালোবাসা,	
safin,	সাফিন,	সাফিন,	
sainyader,	সৈন্যাদের,	সৈন্যদের,	
hul,	হাল,	হুল,	
kinsha,	কিনশা,	কিংস,	
ikboler,	ইকবলের,	ইকবলের,	
ahalyar,	আহাল্যার,	অহল্যার,	
romancha,	রোমাঞ্চা,	রোমাঞ্চ,	
beatleser,	বিটলেসের,	বিটলসের,	
deilee,	দেইলি,	ডেইলি,	
badaghat,	বাদাঘাট,	বাদাঘাট,	
dishani,	দিশানি,	দিশানি,	
dewaben,	দেওবায়েন,	দেওয়াবেন,	
byabostho,	ব্যবস্থ,	ব্যাবস্থা,	
niketon,	নিকেটন,	নিকেতন,	
panchashjan,	পঞ্চাজজন,	পঞ্চাশজন,	
sangbadmadhyame,	সংবাদমধ্যম্যে,	সংবাদমাধ্যমে,	
gaj,	গাজ,	গেজ,	
marmader,	মারমাদের,	মারমাদের,	
azaan,	আজান,	আজান,	
shem,	শেম,	সেম,	
talaal,	তালাল,	তালাল,	
vobobibhuti,	ভববিভূতি,	ভববিভূতি,	
bokul,	বকুল,	বকুল,	
iub,	আইআইবি,	আইইউবি,	
khappar,	খাপপার,	খপ্পর,	
anchalgoolir,	আঞ্চলগুলির,	অঞ্চলগুলির,	
nakkal,	নকক্কাল,	নক্কল,	
bondiira,	বন্ডিয়ারা,	বন্দীরা,	
mayily,	মযয়িলি,	মাইলি,	
roopmatro,	রূপমাত্র,	রূপমাত্র,	
otyacharer,	অত্যাচারের,	অত্যাচারের,	
abheedhanik,	অভিদানিক,	অভিধানিক,	
chalaabi,	চালাবি,	চালাবে,	
onucheeder,	অনুচিদের,	অনুচ্ছেদের,	
fasir,	ফাসির,	ফাসীর,	
keyboarder,	কেয়বোর্ডের,	কীবোর্ডের,	
nirmolota,	নির্মলতা,	নির্মলতা,	
ghenshei,	ঘেঁশেই,	ঘেঁষেই,	
naobihar,	নাওবিহার,	নৌবিহার,	
judge,	জুড্গে,	জাজ,	
ogovir,	অগভির,	অগভীর,	
bupher,	বুফের,	বাফার,	
tintikey,	টিনটিকে,	তিনটিকে,	
idyi,	আইডিআই,	আইডিই,	
maladabha,	মালাদাভা,	মলদোভা,	
teta,	টেটা,	টেটা,	
shotodha,	শতধা,	শতধা,	
torabganj,	তরাগবঞ্জ,	তোরাবগঞ্জ,	
lutheerana,	লুথিরানা,	লুথেরান,	
pleto,	প্লেটো,	প্লেটো,	
feroza,	ফেরোজা,	ফিরোজা,	
kalkarkhana,	কলকর্খনা,	কলকারখানা,	
sommoteer,	সম্মতির,	সম্মতির,	
raiialati,	রাই়ালাাটি,	রয়্যালটি,	
qyantana,	ক্যান্টানা,	ক্যান্টন,	
harbare,	হারবারে,	হারবারে,	
nibondhocheler,	নিবন্ছলিলের,	নিবন্ধছেলের,	
muradke,	মুরাদকে,	মুরাদকে,	
gatibege,	গাতিবেগে,	গতিবেগে,	
sarollo,	সারোলো,	সারল্য,	
ardasha,	আরদাশা,	আর্দশ,	
jontropatigulite,	যন্ত্রপিতাগুলিতে,	যন্ত্রপাতিগুলিতে,	
vince,	ভিন্সে,	ভিন্স,	
phiksim,	ফিসিসম,	ফিক্সিং,	
vandar,	ভান্ডার,	ভাণ্ডার,	
ekatitto,	একাতিত্ব,	একাতিত্ব,	
udbodhaney,	উদ্বোধননে,	উদ্বোধনে,	
bulano,	বুলানো,	বুলান,	
dorgah,	ঘরগাহ,	দরগাহ,	
surakarder,	সুরাকারদের,	সুরকারদের,	
binee,	বিনি,	বেনি,	
gasthi,	গাস্থী,	গোষ্ঠী,	
ceramiker,	সেরামিকের,	সিরামিকের,	
gorjon,	গর্জন,	গর্জন,	
pujit,	পুজিত,	পুজিত,	
taufiq,	টাউিক,	তৌফিক,	
baipash,	বাইপাশ,	বাইপাস,	
eesosiyeetasa,	ইসয়েসিসা,	এসোসিয়েটস,	
sanghar,	সংহর,	সংহার,	
dharmantor,	ধর্মন্তর,	ধর্মান্তর,	
malinga,	মালিঙ্গা,	মালিংগা,	
indra,	ইন্ড্রা,	ইন্দ্র,	
queri,	কুয়েরি,	কোয়েরি,	
middleton,	মিডলেটন,	মিডলটন,	
degreeo,	দেগ্রিও,	ডিগ্রিও,	
vedanta,	বেদান্ত,	বেদান্ত,	
pabo,	পাবো,	পাব,	
totokson,	ততকসন,	ততক্ষন,	
ramonar,	রামোনার,	রমনার,	
maritimer,	মারিটিমের,	মেরিটাইমের,	
sarder,	সারদের,	সরদার,	
amanisha,	আমানিশা,	অমানিশা,	
societykey,	সকিস্টেকে,	সোসাইটিকে,	
firalem,	ফিরালেম,	ফিরালেম,	
oblivion,	অব্লিভিন,	অবলিভিয়ন,	
uthhaane,	উঠানে,	উঠানে,	
prothar,	প্রথার,	প্রথার,	
hool,	হুল,	হুল,	
ghomta,	ঘোটমা,	ঘোমটা,	
bipradas,	বিপ্রদাস,	বিপ্রদাস,	
rca,	আরএসএ,	আরসিএ,	
taatey,	টায়েট,	তাতে,	
sadbi,	সাদবি,	সাধ্বী,	
sahojlovyotar,	সহলযযভভাতার,	সহজলভ্যতার,	
oxite,	অক্সিতে,	অক্সাইট,	
durotamo,	দুরততামো,	দূরতম,	
phareeksa,	ফরিকসস,	ফরেক্স,	
kuronir,	কুরণীর,	কুরনীর,	
ship,	শিপ,	শিপ,	
jatinke,	জাতিনকে,	যতীনকে,	
shunani,	শুনানি,	শুনানী,	
plainey,	প্লেনি,	প্লেনে,	
soource,	সুর্সে,	সোর্স,	
vortuki,	ভর্তুকি,	ভর্তুকি,	
deputi,	ডিপুটি,	ডেপুটি,	
chalochchitraeei,	চালচ্ঠির্যাই়,	চলচ্চিত্রেই,	
scholars,	স্কোলার্স,	স্কলার্স,	
militarite,	মিলিটারিতে,	মিলিটারিতে,	
geja,	গেজা,	গেজ,	
humner,	হুমনের,	হামনার,	
baieq,	বাই়়ক,	বাইক,	
sadadyarao,	সদদ্যারাও,	সদদ্যরাও,	
nadnadeer,	নানদানীর,	নদনদীর,	
kinenni,	কিনেননি,	কিনেননি,	
bhenise,	ভেনিসে,	ভেনিসে,	
salafeta,	সালাফেটা,	সালফেট,	
baugey,	বাউগে,	বাগে,	
site,	সিতে,	সিটে,	
yaq,	য্যাক,	ইয়াক,	
elakaai,	এলাকাই,	এলাকাই,	
dalee,	ডালি,	ডালে,	
hizrite,	হিজরিতে,	হিজরীতে,	
zubokra,	যুবকরা,	যুবকরা,	
lagto,	লাগতো,	লাগতো,	
recondishon,	রেকনন্দশন,	রিকন্ডিশন,	
saralya,	সররল্য,	সারল্য,	
danata,	দানাটা,	ডোনাট,	
rajyabhogi,	রাজ্যভাগী,	রাজ্যভোগী,	
daqten,	ডাকটেন,	ডাকতেন,	
suiti,	সুইটি,	সুইটি,	
tennys,	টেনিস,	টেনিস,	
chereche,	চেরেছে,	ছেড়েছে,	
huk,	হুক,	হুক,	
faskari,	ফাসকারী,	ফাঁসকারী,	
ateetkale,	অতিতকালে,	অতীতকালে,	
chalochchitrei,	চালচ্ছিত্রেই,	চলচ্চিত্রেই,	
rejidens,	রেজিডেন্স,	রেসিডেন্স,	
jones,	জনেস,	জোন্স,	
nodiiteyi,	নদীয়েতেই,	নদীতেই,	
mahafezkhanar,	মহাফেখনার,	মহাফেজখানার,	
akeeb,	আকিব,	আকিব,	
mmadhukkori,	ম্মাধাককররী,	মাধুকরী,	
sompadonkaree,	সম্পাদনকারী,	সম্পাদনকারী,	
taigara,	তাইগারা,	টাইগার,	
odeb,	ওদেব,	ওদেব,	
bhabaaponno,	ভাবানপন্ন,	ভাবাপন্ন,	
bisshonath,	বিশ্বনাথ,	বিশ্বনাথ,	
chhadura,	ছাদুরা,	ছাদুরা,	
shringgo,	শ্রিংগো,	শৃঙ্গ,	
gyandaas,	জ্ঞানদাস,	জ্ঞানদাস,	
gronthoti,	গ্রন্থটি,	গ্রন্থটি,	
ekoirokom,	একারকোম,	একইরকম,	
plack,	প্ল্যাক,	প্ল্যাক,	
krechi,	ক্রেচি,	করেছি,	
granthatyke,	গ্রান্থাটটিকে,	গ্রন্থটিকে,	
shikare,	শিকারে,	শিকারে,	
codee,	কোডি,	কোডে,	
shukraanoo,	শুকরানও,	শুক্রানু,	
ghotol,	ঘটল,	ঘটল,	
rabo,	রাবো,	রব,	
banshite,	বাঁশিতে,	বাঁশিতে,	
si,	সিএসই,	এসআই,	
akpaase,	আক্পাসে,	একপাশে,	
pustir,	পুস্তির,	পুষ্টির,	
bhenom,	ভেনম,	ভেনম,	
dubureer,	দুবুরির,	ডুবুরির,	
raagee,	রাজি,	রাগী,	
habol,	হাবল,	হাবোল,	
kash,	কাশ,	কাস,	
vaphara,	ভাফারা,	বাফার,	
siddhantoke,	সিদ্ধান্তকে,	সিদ্ধান্তকে,	
antarctica,	অ্যান্টার্ট্সিকা,	অ্যান্টার্কটিকা,	
bbiseshyer,	বিবিশেয়ের,	বিশেষ্যের,	
proteemake,	প্রতিমাকে,	প্রতিমাকে,	
yaak,	যাক,	ইয়াক,	
munshiji,	মুঁশিজি,	মুনশীজি,	
jhonkar,	ঝোঁকার,	ঝঙ্কার,	
catholicder,	ক্যাথোলিকদের,	ক্যাথলিকদের,	
cantan,	ক্যান্টান,	ক্যান্টন,	
cholochchitratike,	চলচ্চিত্রটিকে,	চলচ্চিত্রটিকে,	
bodhukeo,	বোধুকেও,	বধুকেও,	
adhyattikota,	অধ্যাত্যকিতা,	আধ্যাত্মিকতা,	
karam,	কারাম,	কেরাম,	
lambi,	লাম্বি,	লম্বি,	
laiseensee,	লাইসেনিস,	লাইসেন্স,	
airish,	এইরিশ,	আইরিস,	
chahidapotrer,	চাহিদাপত্রের,	চাহিদাপত্রের,	
ashor,	আশর,	আসর,	
ranangane,	রানাঙ্গানে,	রণাঙ্গনে,	
doloo,	দলু,	ডলু,	
pleeta,	প্লিটা,	প্লেট,	
godamjato,	গোদামজাত,	গুদামজাত,	
lahano,	লাহানো,	লাহানো,	
satarkatar,	সতরকাটার,	সতর্কতার,	
bondira,	বন্দিরা,	বন্দীরা,	
dharabahiktite,	ধারাবাহিক্তিতে,	ধারাবাহিকটিতে,	
rena,	রেনা,	রেনো,	
taufik,	টাউিক,	তৌফিক,	
teman,	তেমান,	তেমন,	
munjur,	মুঞ্জুর,	মুনজুর,	
mandape,	মান্ডাপে,	মন্ডপে,	
crashlands,	ক্রালশান্ডসস,	ক্র্যাশল্যান্ডস,	
danaqana,	ডানাকানা,	ডানকান,	
mohajot,	মহাজত,	মহাজোট,	
jonoikaa,	জননাকায়,	জনৈকা,	
karore,	কারোরে,	কারোর,	
toufiq,	টাফিক,	তৌফিক,	
pyetarna,	পেটার্না,	প্যাটার্ন,	
fastag,	ফ্যাস্টাগ,	ফ্যাসট্যাগ,	
meshenjar,	মেশেঞ্জার,	মেসেঞ্জার,	
saria,	সরিয়া,	সরিয়া,	
dinar,	দিনার,	ডিনার,	
vimsen,	ভিমসেন,	ভীমসেন,	
bisheshyo,	বিশেষ্য,	বিশেষ্য,	
uindos,	উইন্ডসস,	উইন্ডোস,	
nagorikota,	নাগরিকতা,	নাগরিকতা,	
breq,	ব্রেক,	ব্রেক,	
mukhabandha,	মুখাবন্ধ,	মুখবন্ধ,	
musalmanderke,	মুসলমান্দরকে,	মুসলমানদেরকে,	
jerusaleme,	জেরুসালেমে,	জেরুসালেমে,	
ponchashjon,	পঞ্চাজজন,	পঞ্চাশজন,	
pushtee,	পুষ্টি,	পুষ্টি,	
satarkabhabe,	সতরাকভাবে,	সতর্কভাবে,	
steena,	স্টিনা,	স্টেন,	
rohasyer,	রোহাস্যের,	রহস্যের,	
ultrasonography,	ইল্ট্রোসাগোর্থি,	আলট্রাসনোগ্রাফিও,	
robot,	রোবত,	রোবোট,	
lat,	ল্যাট,	লাট,	
geographics,	জিওগ্রাফিক্স,	জিওগ্রাফিকস,	
adorsho,	আদর্শ,	আর্দশ,	
kei,	কেই,	কেই,	
noiteek,	নৈতিক,	নৈতিক,	
chikitsar,	চিকিৎসার,	চিকিত্সার,	
nadike,	নাদিকে,	নদীকে,	
ispredsiit,	ইস্প্রেসিটি,	স্প্রেডশীট,	
ghumacchilo,	ঘুমাচ্ছিল,	ঘুমাচ্ছিল,	
eura,	ইউরা,	ইউরো,	
remacri,	রিমার্কি,	রেমাক্রী,	
protijogiider,	প্রতিযোগিদের,	প্রতিযোগীদের,	
heepatitis,	হিপাটিটিস,	হেপাটাইটিস,	
komanera,	কোমানেরা,	কমানেরা,	
dhanijomite,	ধানিজয়তিতে,	ধানিজমিতে,	
pinogbagke,	পিনোগবাগকে,	পিনগবাগকে,	
janamukhi,	জনমাুখী,	জনমুখী,	
monjooshree,	মঞ্জশর্ী,	মঞ্জুশ্রী,	
engrejer,	এঞ্জ্রেজের,	ইংরেজের,	
pyaleshtainer,	প্যালেশ্টেইনের,	প্যালেস্টাইনের,	
afzol,	আফজোল,	আফজল,	
ancholgoolir,	আঞ্চলগুলির,	অঞ্চলগুলির,	
timoothi,	তিমোথি,	টিমোথি,	
pack,	প্যাক,	প্ল্যাক,	
brahmanera,	ব্রহ্মণেরা,	ব্রাহ্মণেরা,	
pranidero,	প্রাণীদেরও,	প্রানীদেরও,	
farhetin,	ফারহেটিন,	ফারহেতিন,	
roy,	রয়ে,	রায়,	
nirbahi,	নির্বাহী,	নির্বাহি,	
bangalore,	বাঙ্গালোর,	ব্যাঙ্গালুরে,	
landey,	ল্যান্ডে,	ল্যান্ডে,	
bojhe,	বোঝে,	বোঝে,	
megh,	মেঘ,	মেঘ,	
bibadey,	বিবাদে,	বিবাদে,	
andra,	আন্দ্রা,	আন্ড্রা,	
qaro,	কারো,	কারো,	
choritrotakeo,	চরিত্রতাকেও,	চরিত্রটাকেও,	
shikshakbrinda,	শিক্ষাবৃন্দা,	শিক্ষকবৃন্দ,	
lirikti,	লিরিক্তি,	লিরিকটি,	
jahangirbad,	জাহাঙ্গীরবাদ,	জাহাঙ্গীরবাদ,	
ganoparibahaner,	গণপারিবাহানের,	গণপরিবহনের,	
chhootochhuti,	ছুটছুটি,	ছুটোছুটি,	
daayitto,	দায়িত্ব,	দায়িত্ব,	
bhaangchur,	ভাংচুর,	ভাংচুর,	
unchiyechilo,	উঁচিয়েছিল,	উঁচিয়েছিল,	
mahasava,	মহাসভা,	মহাসভা,	
janghu,	জাহুু,	জঙ্ঘু,	
pravura,	প্রভূরা,	প্রভুরা,	
goonoman,	গুমোন,	গুণমান,	
lagche,	লাগছে,	লাগছে,	
reliance,	রিলিয়ান্স,	রিলায়েন্স,	
koro,	করো,	করো,	
chandanara,	চান্ডনারা,	চন্দনারা,	
dhaleshorii,	ধেলেশরি,	ধলেশ্বরী,	
sipa,	সিপা,	শিপ,	
bondhuvabaponyo,	বন্ধুধাবাবন্য,	বন্ধুভাবাপন্ন,	
uparjoner,	উপার্যনের,	উপার্জনের,	
graambaashio,	গ্রামবাশিও,	গ্রামবাসীও,	
bahubar,	বহুবার,	বহুবার,	
atibiplabi,	অতিবিল্পবী,	অতিবিপ্লবি,	
zoubankal,	যৌবনকাল,	যৌবনকাল,	
victor,	ভিক্টর,	ভিক্টর,	
panchashjon,	পঞ্চাশজন,	পঞ্চাশজন,	
koordira,	কর্ডিরা,	কুর্দিরা,	
samyuktha,	সম্যুক্থ,	সামিউক্তা,	
nanabornobishishto,	নানাবর্ণবিশ্ষিত,	নানাবর্ণবিশিষ্ট,	
shashtra,	শাষ্ট্র,	শাস্ত্র,	
ponthaar,	পন্থার,	পন্থার,	
shtona,	স্টনা,	স্টোন,	
sambhabonao,	সম্ভাবনাও,	সম্ভবনাও,	
yanqee,	য্যান্সি,	ইয়াংকি,	
gafeeloti,	গালিটোি,	গাফিলতি,	
chalai,	চালাই,	চালাবে,	
bollov,	বললভ,	বল্লভ,	
rifleksa,	রিফলেকা,	রিফ্লেক্স,	
korush,	করুশ,	ক্রুশ,	
pradoshik,	প্রদদশিক,	প্রাদশিক,	
chaalkee,	চালকী,	চালকে,	
dinifitian,	ডিনিফিফিনান,	ডেফিনেশন,	
baarnish,	বার্নিশ,	বার্নিশ,	
puroheetder,	পুরহিতদের,	পুরোহিতদের,	
motabolombira,	মোতাবলম্বিরা,	মতাবলম্বীরা,	
votarer,	ভোটারের,	ভোটারের,	
samratra,	সমমর্ত্র,	সম্রাটরা,	
ivil,	ইভিল,	ইভিল,	
ingreziteo,	ইংরজেটিতেও,	ইংরেজিতেও,	
somonwitobhabey,	সমন্তভিবাবে,	সমন্বিতভাবে,	
monroe,	মন্যে,	মনেরোর,	
futonta,	ফুটন্টা,	ফুটন্ত,	
shoori,	শূরি,	সুরি,	
kanasarabhesana,	কনসসাভেশন,	কনসারভেশন,	
tonoo,	টনন,	তনু,	
okritokarjo,	অকৃতিকার্য,	অকৃতকার্য,	
kosambir,	কোসাম্বির,	কোসাম্বীর,	
byaptikaler,	ব্যাপ্তিকালের,	ব্যাপ্তিকালের,	
erokomer,	এরকমের,	এরকমের,	
hajirhat,	হাজিরহাট,	হাজিরহাট,	
kyathlik,	ক্যাথলিিক,	ক্যাথলিক,	
nabayug,	নাবাযুগ,	নবযুগ,	
sinakey,	সিনাকে,	সিনাকে,	
noditir,	নদীতির,	নদীটির,	
terlarang,	টেরলারাং,	তেরলারং,	
nirgoon,	নির্গুন,	নির্গুণ,	
antorvuktimulak,	অন্তর্ভুক্তিমূলক,	অন্তর্ভুক্তিমূলক,	
ucchosito,	উচ্চসিত,	উচ্ছসিত,	
edseler,	এডসেলের,	এডসেলের,	
aamor,	আমোর,	আমর,	
lishenshe,	লিশেশনে,	লাইসেন্স,	
deobonde,	দেওনদ্যে,	দেওবন্দে,	
vittio,	ভিট্টিও,	ভিত্তিও,	
bhabaponno,	ভাবাপন্ন,	ভাবাপন্ন,	
modhyekar,	মধ্যেকর,	মধ্যেকার,	
buddhitii,	বুদ্ধিতিই,	বুদ্ধিটিই,	
prarthitao,	প্রার্থিথাও,	প্রার্থীতাও,	
khargosher,	খারগোষের,	খরগোসের,	
dombhoke,	দম্ভকে,	দম্ভকে,	
uposhthit,	উপশ্থিত,	উপস্থিত,	
manushe,	মানুশে,	মানুষে,	
akreetokarjo,	অকৃতিকার্য,	অকৃতকার্য,	
daakteekite,	দাক্তিকতিতে,	ডাকটিকিটে,	
perry,	পের্রি,	পেরি,	
baibosthaar,	বাইবস্থার,	ব্যবস্থার,	
abhidhaanick,	অভিয়ানানিক,	অভিধানিক,	
obharbhiu,	ওভারভিউ,	ওভারভিউ,	
antercticker,	এন্টারটিক্সির,	অ্যান্টার্কটিকের,	
shikshagato,	শিক্ষাগত,	শিক্ষাগত,	
peri,	পেরি,	পেরি,	
natshi,	নাটশি,	নাত্সি,	
nanilalke,	নানিলালকে,	ননীলালকে,	
orhan,	ওরহান,	ওরহান,	
dantahin,	দন্তাহীন,	দন্তহীন,	
khalidkay,	খালিদকা,	খালিদকে,	
antorbhuktimulak,	অন্তর্ভুক্তিমূলক,	অন্তর্ভুক্তিমূলক,	
aaziz,	আজিজ,	আজিজ,	
bitertrate,	বিটার্টারটে,	বাইটারট্রেট,	
parka,	পারকা,	পার্ক,	
chrystal,	ক্রিস্টাল,	ক্রাইস্টাল,	
mukhoshdharir,	মুখোষধারীর,	মুখোশধারীর,	
ganonanatto,	গণনানাত্য,	গণনাট্য,	
oxforde,	অক্সফোর্ডে,	অক্সফোর্ডে,	
directarate,	ডিরেক্রেটাটে,	ডিরেক্টরেট,	
pacbar,	প্যাকবার,	পাঁচবার,	
breakthrough,	ব্রেক্র্থু,	ব্রেকথ্রু,	
aflatoxin,	অ্যাফটাক্টিসিন,	আ্যফ্ল্যাটক্সিন,	
sorting,	সর্টিং,	সর্টিং,	
sanghatakder,	সংহাকটদদের,	সংঘটকদের,	
orgho,	অর্ঘ,	অর্ঘ্য,	
beauby,	বিউবি,	বিউবি,	
itostatah,	ইটস্তাহা,	ইতস্ততঃ,	
onshogrohoner,	অংশগ্রহণের,	অংশগ্রহনের,	
spredasita,	স্প্রেডিসিটা,	স্প্রেডশীট,	
aarmstrong,	আর্মস্ট্রং,	আর্মস্ট্রং,	
lendal,	লেন্ডাল,	লেন্ডল,	
daltagi,	ডাল্টাগী,	দলত্যাগী,	
lungiti,	লুঙ্গিতি,	লুঙ্গিটি,	
ispredsheet,	ইস্প্রেশিট,	স্প্রেডশীট,	
kottar,	কত্যার,	কট্টর,	
bagdad,	বাগদাদ,	বাগদাদে,	
licensin,	লিসেসন,	লাইসেন্সিং,	
cholochchitro,	চলচচিত্র,	চলচ্চিত্র,	
bijepi,	বিজেপি,	বিজেপি,	
pinglateo,	পিংলাতেও,	পিংলাতেও,	
ragei,	রাগেই,	রাগেই,	
langhoner,	ল্যানঘনের,	লংঘনের,	
ghoomato,	ঘুমাতো,	ঘুমাতো,	
suiza,	সুইজা,	সুইজা,	
sbajan,	স্বজান,	স্বজন,	
votar,	ভোটার,	ভোটার,	
phormat,	ফর্মাত,	ফরম্যাট,	
ceramicsh,	সেরামিক্স,	সিরামিকস,	
yathaarthabhaabe,	যথরথ্থভাবে,	যথার্থভাবে,	
nek,	নেক,	নেক,	
stagecraft,	স্টেযাক্রেফ্ট,	স্টেজক্রাফট,	
toler,	টলের,	তালের,	
muradpur,	মুরাদপুর,	মুরাদপুর,	
pouchute,	পৌছুতে,	পৌঁছুতে,	
gemske,	জেমসকে,	জেমসকে,	
parabortee,	প্রাবার্তি,	পরর্বতী,	
digrir,	ডিগ্রির,	ডিগ্রির,	
oswasteekor,	অস্বাস্ত্রকর,	অস্বস্তিকর,	
bhujangta,	ভুজাংগা,	ভুজঙ্গটা,	
mah,	মাহা,	মাহে,	
doorger,	দুর্গার,	দুর্গের,	
chalochchitreer,	চালচচ্ত্রীর,	চলচ্চিত্রের,	
maunchostho,	মাঁচস্থ,	মঞ্চস্থ,	
juddhahato,	যুদ্ধাহাত,	যুদ্ধাহত,	
mastarsa,	মাস্টারসা,	মাস্টার্স,	
aaireshe,	আইইরেশে,	আইরেসে,	
abhidhaaner,	অভিধানের,	অভিধানের,	
chhuteer,	ছুটির,	ছুটির,	
carlosh,	কার্লোশ,	কার্লোস,	
abeganuvutir,	আবেগানুভুটির,	আবেগানুভূতির,	
karlei,	করলেই,	করলেই,	
basakey,	বাসাকে,	বাসাকে,	
ujbekistaner,	উজবিক্তেতানের,	উজবেকিস্তানের,	
huqa,	হুকা,	হুক,	
jens,	জেন্স,	জিন্স,	
deepan,	দীপান,	দীপন,	
katiusha,	কাটিউশা,	কাতিউশা,	
pratisthanikvabe,	প্রতিষ্ঠানিকভাবে,	প্রাতিষ্ঠানিকভাবে,	
bahati,	বাহাটি,	বাহাতি,	
gloria,	গ্লোরিয়া,	গ্লোরিয়া,	
kings,	কিংস,	কিংস,	
udvaboney,	উদ্ববননে,	উদ্ভাবনে,	
prachirer,	প্রাচিরের,	প্রাচিরের,	
caramiks,	ক্রামাকিকস,	সিরামিকস,	
vobani,	ভোবানি,	ভবানী,	
manatmulak,	মানতমূলক,	মানতমূলক,	
orthonitir,	অর্থনীতির,	অর্থনীতির,	
konistho,	কনিষ্ঠ,	কনিষ্ঠ,	
blogarra,	ব্লগারারা,	ব্লগাররা,	
mozlis,	মজলিস,	মজলিশ,	
sobaiderke,	সবাইদেরকে,	সবাইদেরকে,	
pnouchute,	প্ঞুচুউট,	পৌঁছুতে,	
creshcent,	ক্রেসেেন্ট,	ক্রিসেন্ট,	
aholyar,	আহল্যার,	অহল্যার,	
juktorastrer,	যুক্তরাস্ত্রের,	যুক্তরাষ্ট্রের,	
hurricane,	হারিকানে,	হ্যারিকেন,	
bouddha,	বৌদ্ধ,	বৌদ্ধ,	
byabaharkaree,	ব্যবহারকারি,	ব্যবহারকারী,	
rajtantro,	রাজতন্ত্র,	রাজতন্ত্র,	
marmaraa,	মারমারা,	মারমারা,	
grambaasi,	গ্রামবাসী,	গ্রামবাসী,	
atmobonchito,	আত্মবন্চিত,	আত্মবঞ্চিত,	
maradeha,	মারাদেহা,	মরদেহ,	
sahozlabhbhatar,	সহলজভভভাতার,	সহজলভ্যতার,	
firth,	ফির্থ,	ফার্থ,	
borlen,	বরলেন,	বরলেন,	
tiuning,	টিউনিং,	টিউনিং,	
raia,	রাইয়া,	রায়,	
sthitiko,	স্থিতিকো,	স্থিতিকো,	
madhobi,	মাধবি,	মাধবী,	
kharavel,	খারাভেল,	খারবেল,	
shootar,	শুতার,	শ্যুটার,	
landing,	ল্যান্ডিং,	ল্যান্ডিং,	
kalenga,	কালেঙ্গা,	কালেঙ্গা,	
shikkharthirao,	শিক্ষার্থীরাও,	শিক্ষার্থীরাও,	
unchuporjayer,	উঁচুপর্যায়ের,	উঁচুপর্যায়ের,	
ajeeboner,	অজিবনের,	আজীবনের,	
orthanitir,	অর্থানিটির,	অর্থনীতির,	
oncholshomuh,	অঞ্চলমমূহ,	অঞ্চলসমূহ,	
biswashi,	বিশ্বাশী,	বিশ্বাসী,	
shift,	শিফট,	শিফট,	
meridiane,	মেরিডিয়ান,	মেরিডিয়ানে,	
moomtaj,	মুমতাজ,	মুমতাজ,	
bisheshya,	বিশেষ্য,	বিশেষ্য,	
laaisheesh,	লাইশিশ,	লাইসেন্স,	
bulichev,	বুলিচেভ,	বুলিচেভ,	
chhuteete,	ছুটিতে,	ছুটিতে,	
pujito,	পুজিত,	পুজিত,	
kabutorer,	কাবুতরের,	কবুতরের,	
alpa,	আল্পা,	অল্প,	
tottorat,	তত্ত্রাত,	তওরাত,	
bhabatarini,	ভবতারিনী,	ভবতারিণী,	
saptahokal,	সপ্তহালক,	সপ্তাহকাল,	
romjaner,	রোজানের,	রমযানের,	
lettere,	লেট্রের,	লেটারে,	
eevil,	ইভিল,	ইভিল,	
minishtarer,	মিনিষ্টারের,	মিনিস্টারের,	
hafej,	হাফেজ,	হাফেয,	
chorban,	চরবান,	চর্বন,	
gonona,	গণনা,	গননা,	
vaticaner,	ভ্যাটিকানের,	ভ্যাটিকানের,	
milayatane,	মিলয়তানে,	মিলায়তনে,	
punosthaner,	পুনস্থানের,	পুনঃস্থানের,	
remacry,	রিমার্সি,	রেমাক্রী,	
kalirkhal,	কালিরখাল,	কালিরখাল,	
aprasangikbhabei,	অপ্রাঙ্গসঙ্গিকাবেই,	অপ্রাসঙ্গিকভাবেই,	
utshahomulok,	উৎসাহূলক,	উৎসাহমূলক,	
bosturoi,	বস্তুরই,	বস্তুরই,	
horeepur,	হরিপুর,	হরিপুর,	
shikhaboudi,	শিখাবৌদি,	শিখাবৌদি,	
avetar,	আভেতার,	অবতার,	
ralf,	রাল্ফ,	রালফ,	
ponchaashjon,	পঞ্চাশজন,	পঞ্চাশজন,	
bisnukey,	বিস্নুকে,	বিষ্ণুকে,	
drissoteer,	দ্রিশোটির,	দৃশ্যটির,	
tecnokret,	টেকনকর্টে,	টেকনোক্র্যাট,	
fongli,	ফোংলি,	ফংলি,	
kiuti,	কিউটি,	কিউটি,	
bbiswashke,	বিব্বিশাকে,	বিশ্বাসকে,	
niknayman,	নিক্যানময়ন,	নিকনেইমান,	
phutonta,	ফুটন্টা,	ফুটন্ত,	
erajyobasi,	এরাজ্যবাসী,	এরাজ্যবাসী,	
elakatikay,	এলাকাতিকায়,	এলাকাটিকে,	
alexanderke,	আলেক্সানান্দারকে,	আলেকজান্ডারকে,	
black,	ব্ল্যাক,	ব্ল্যাক,	
fatkabazare,	ফতকাবাজারে,	ফাটকাবাজারে,	
gore,	গোরে,	গোর,	
shikkhadikkhay,	শিক্ষাদিক্ষায়,	শিক্ষাদিক্ষায়,	
bhittiti,	ভিত্তিটি,	ভিত্তিটি,	
naper,	নাপের,	ন্যাপের,	
aachhis,	আইছিস,	আছিস,	
rakkhandurga,	রক্ষণদুর্গ,	রক্ষণদুর্গ,	
abhidhaanic,	অভিভাযানিক,	অভিধানিক,	
aizulke,	আইজুলকে,	আইজুলকে,	
evereste,	এভার্সেট,	এভারেস্টে,	
ragee,	রাজি,	রাগী,	
tahorir,	তাহরির,	তাহরীর,	
krush,	কুরশ,	ক্রুশ,	
bodna,	বোদনা,	বদনা,	
cholchhee,	চলছি,	চলছে,	
toufik,	টৌফিক,	তৌফিক,	
shector,	শেক্টর,	সেক্টর,	
qaferderkey,	কাফেরডারকে,	কাফেরদেরকে,	
shubhag,	শুভাগ,	শুভাগ,	
sangkalanti,	সংকল্ন্তি,	সংকলনটি,	
bitlaser,	বিটলাসের,	বিটলসের,	
onchalti,	অন্চলটি,	অঞ্চলটি,	
kaalaam,	কালাম,	কালাম,	
vushito,	ভুষিত,	ভূষিত,	
proshadhoner,	প্রশাধনের,	প্রসাধনের,	
weenis,	ভিনিস,	ভেনিস,	
pratiyogita,	প্রাতিযোগীতা,	প্রতিযোগীতা,	
pratijogitamulak,	প্রাতিযোগিতমমূলক,	প্রতিযোগীতামূলক,	
kul,	কুল,	কুল,	
pancbaar,	প্যান্কবার,	পাঁচবার,	
myat,	ম্যাট,	ম্যাট,	
asommoti,	অসমম্তি,	অসম্মতি,	
garora,	গারোরা,	গারোরা,	
musalmani,	মুসলমানি,	মুসলমানই,	
kholdhular,	খোলধুলার,	খোলধূলার,	
silabhara,	সিলাভারা,	সিলভার,	
khuliechilam,	খুলিয়েছিলাম,	খুলিয়েছিলাম,	
jothartho,	যথার্থ,	যথার্থ,	
eoki,	ইওকি,	এওকি,	
nirvachokder,	নির্ভাচকদের,	নির্বাচকদের,	
blacq,	ব্ল্যাক,	ব্ল্যাক,	
karmosansthan,	কর্মসন্্থান,	কর্মসংস্থান,	
ganoporibahon,	গণপরিবহহন,	গণপরিবহন,	
varote,	ভারোটে,	ভারতে,	
sangosrobomukto,	সংস্রবামুক্ত,	সংস্রবমুক্ত,	
ceramiksh,	সেরামিক্ষ,	সিরামিকস,	
gejetade,	গেজেটাদে,	গেজেটেড,	
railliner,	রেলিনের,	রেললাইনের,	
palteche,	পালটেছে,	পাল্টেছে,	
gate,	গাতে,	গ্যেটে,	
spredashita,	স্প্রেশিদাত,	স্প্রেডশীট,	
birishiritey,	বিরিশিরিতে,	বিরিশিরিতে,	
simaa,	সিমায়,	সীমা,	
cheekitsar,	চিকিৎসার,	চিকিত্সার,	
transapharma,	ট্রান্সোফর্ম,	ট্রান্সফর্ম,	
pingna,	পিংনা,	পিংনা,	
bangobandhu,	বাঙ্গবন্ধু,	বঙ্গবন্ধু,	
mozdur,	মোজুদুর,	মজদুর,	
spredshiit,	স্প্রেশিটি,	স্প্রেডশীট,	
masjidsaho,	মাসজিসাহ,	মসজিদসহ,	
breqathru,	ব্রেকথরু,	ব্রেকথ্রু,	
nutan,	নুতান,	নূতন,	
ajuhath,	অজুহাথ,	অজুহাত,	
shikh,	শিখ,	শিখ,	
bisnuke,	বিস্নুকে,	বিষ্ণুকে,	
tirmijii,	তির্মিজি,	তিরমিজি,	
welcome,	ওয়েলকমে,	ওয়েলকাম,	
bishhnu,	বিশ্নু,	বিষ্ণু,	
torkarir,	তর্কারীর,	তরকারীর,	
saqara,	সাকারা,	সকার,	
roopdan,	রুপদান,	রুপদান,	
shikkhakram,	শিক্ষাক্রম,	শিক্ষাক্রম,	
gujob,	গুজবব,	গুজব,	
aamontrito,	আমন্ত্রিত,	আমন্ত্রিত,	
amanisa,	আমানিসা,	অমানিশা,	
parqim,	পার্কিম,	পার্কিং,	
parkasa,	পারকাসা,	পার্কস,	
shikara,	শিকারা,	শিকার,	
oyebjin,	ওয়েবজিন,	ওয়েবজিন,	
proboleme,	প্রবলেমে,	প্রবলেমে,	
chirkoot,	চিরকুট,	চিরকুট,	
babona,	বাবোনা,	বাবনা,	
chakundite,	চাকুন্দিতে,	চাকুন্দিতে,	
dhaleshwari,	ধলেশ্বরী,	ধলেশ্বরী,	
cheerokoomari,	চিরকুমারি,	চিরকুমারী,	
tukroke,	টুকরকে,	টুকরোকে,	
elakai,	এলাকাই,	এলাকাই,	
graambasi,	গ্রামবাসী,	গ্রামবাসী,	
refleks,	রেফলেস্,	রিফ্লেক্স,	
kaloniir,	কালোনির,	কালনীর,	
afrazuler,	আফরাজুলের,	আফরাজুলের,	
reetesh,	রেটেশ,	রিতেশ,	
uponishad,	উপনিশাদ,	উপনিষদ,	
tantubayer,	তন্তুবায়ের,	তন্তুবায়ের,	
poschimey,	পশ্চিমে,	পশ্চিমে,	
planeti,	প্লানেটি,	প্লেনটি,	
bisshasyi,	বিশ্বাস্যি,	বিশ্বাসই,	
lettar,	লেট্রার,	লেটার,	
shfingtar,	শ্ফিংটার,	স্ফিংটার,	
annorup,	অ্যানরোরূপ,	অন্যরূপ,	
kramp,	ক্রাম্প,	ক্র্যাম্প,	
graambaaseeder,	গ্রামবাসীদের,	গ্রামবাসীদের,	
agaldar,	আগালদার,	আগলদার,	
postac,	পোস্টাক,	পোস্টকে,	
khoakshir,	খোয়াক্ষীর,	খোয়াক্ষীর,	
laaz,	লাজ,	লাজ,	
temone,	তেমোন,	তেমনই,	
karmake,	কারমাকে,	কর্মকে,	
nick,	নিক,	নিক্,	
chyeta,	চেয়েটা,	চ্যাট,	
nikela,	নিকেলা,	নিকেল,	
ministara,	মিনিস্টরা,	মিনিস্টার,	
danakana,	দানাকানা,	ডানকান,	
manoharpur,	মনহহররপুর,	মনোহরপুর,	
beekaargrasta,	বিকারগ্রাস্ত,	বিকারগ্রস্ত,	
kushumba,	কুশুমবা,	কুশুম্বা,	
kusumeshu,	কুসুমেশু,	কুসুমেষু,	
russad,	রুসাদ,	রুশদ,	
nepchooner,	নেপচুনের,	নেপচুনের,	
mitroder,	মিত্রদের,	মিত্রদের,	
soheensotar,	সহিনসতার,	সহিংসতার,	
panchbar,	পাঁচবার,	পাঁচবার,	
vange,	ভ্যাঙ্গে,	ভাঙ্গে,	
khali,	খালি,	খালি,	
bhadaka,	ভাদাকা,	ভদকা,	
