beshyasdone,	বেশ্যাসদনে,	বেশ্যাসদনে,	
saarbhaarti,	সর্ভারটি,	সার্ভারটি,	
buddhitii,	বুদ্ধিটিই,	বুদ্ধিটিই,	
artherer,	আর্থারের,	আর্থারের,	
shatoke,	শতকে,	শতকে,	
muradpur,	মুরাদপুর,	মুরাদপুর,	
ddheela,	ঢিলা,	ঢিলা,	
premo,	প্রেমো,	প্রিমো,	
koreempoor,	করিমপুর,	করিমপুর,	
akkhunno,	অক্ষুন্ন,	অক্ষুণ্ণ,	
dakten,	ডাক্তেন,	ডাকতেন,	
foloshrutite,	ফলশ্রুটিতে,	ফলশ্রুতিতে,	
freekeh,	ফ্রিকেহ,	ফ্রিকেহ,	
ostheesandhi,	অস্থীসন্ধি,	অস্থিসন্ধি,	
peengna,	পেংগা,	পিংনা,	
arekdol,	আরেকডল,	আরেকদল,	
meshenjar,	মেশেঙ্জার,	মেসেঞ্জার,	
jesh,	জেশ,	জেস,	
recondishon,	রেকোনিনোশ,	রিকন্ডিশন,	
footbalarra,	ফুটবলাররা,	ফুটবলাররা,	
tetela,	টেটেলা,	টাইটেল,	
jwar,	জ্বার,	জ্বর,	
paripakey,	পরিপাকে,	পরিপাকে,	
uddharkarmirai,	উদ্ধারকারমীরাই,	উদ্ধারকর্মীরাই,	
ragee,	রাগি,	রাগী,	
harishankar,	হরিষঙ্কার,	হরিশংকর,	
laaisheesh,	লৈশিশ,	লাইসেন্স,	
ronangane,	রোনাঙ্গনে,	রণাঙ্গনে,	
hosbaleke,	হোসবালেকে,	হোসবালেকে,	
anusvara,	অনুসভারা,	অনুস্বার,	
progresh,	প্রোগ্রেশ,	প্রগ্রেস,	
bachhaikrito,	বাছাইকৃত,	বাছাইকৃত,	
nogore,	নগরে,	নগরে,	
dobhaar,	ডোভার,	ডোভার,	
elakatir,	এলাকাটির,	এলাকাটির,	
purohitder,	পুরোহিতদের,	পুরোহিতদের,	
damodar,	দামোদার,	দামদর,	
anchalei,	আঞ্চলেই,	অঞ্চলেই,	
guha,	গুহা,	গোহ,	
goteehin,	গোতহীন,	গতিহীন,	
sarollo,	সারোল,	সারল্য,	
kaferder,	কাফেরদের,	কাফেরদের,	
niemond,	নিয়মন্ড,	নিমন্ড,	
dharmadasbabu,	ধর্মদাসবাবু,	ধর্মদাসবাবু,	
daayitto,	দায়িত্ব,	দায়িত্ব,	
dimbacriti,	ডিম্বাকৃতি,	ডিম্বাকৃতি,	
baarnish,	বার্নিশ,	বার্নিশ,	
heawy,	হিউভি,	হেভি,	
anyarup,	অন্যারূপ,	অন্যরূপ,	
shitei,	শিতেই,	শীতেই,	
procharjontrogulo,	প্রচারচন্ত্রগুলো,	প্রচারযন্ত্রগুলো,	
vimsen,	ভিমসেন,	ভীমসেন,	
choddo,	চদ্দো,	চোদ্দো,	
dip,	ডিপ,	দীপ,	
bipti,	বিপ্তি,	বিপ্তি,	
obosore,	অবসরে,	অবসরে,	
chalachchitrotike,	চালাচ্তিরতিকে,	চলচ্চিত্রটিকে,	
seekkharthirao,	শিক্ষার্থীরাও,	শিক্ষার্থীরাও,	
bisshasi,	বিশ্বাসী,	বিশ্বাসী,	
chalachchitro,	চালাচিত্র,	চলচ্চিত্র,	
silabhara,	সিলাভারা,	সিলভার,	
senabahineekey,	সেনাবাহিনীকে,	সেনাবাহিনীকে,	
nobotom,	নবতম,	নবতম,	
treend,	ট্রিন্ড,	ট্রেন্ড,	
pustir,	পুস্তির,	পুষ্টির,	
scholastik,	স্কলাস্তিক,	স্কলাস্টিক,	
debholopar,	দেভলোপার,	ডেভলপার,	
jeher,	জেহের,	জেহের,	
kaalki,	কালকি,	কালকি,	
elakatikay,	এলাকাটিকায়,	এলাকাটিকে,	
tecnokret,	টেকনকরেট,	টেকনোক্র্যাট,	
ovarview,	ওভারভিউ,	ওভারভিউ,	
chiraharit,	চিরাহারিত,	চিরহরিৎ,	
daaktikit,	ডাকটিকিট,	ডাকটিকিট,	
meshmeshya,	মেশমেশ্যা,	মেশহমেশহিইয়া,	
ahmed,	আহমেদ,	আহামদ,	
aatmobishwasi,	আত্মবিশ্বাসী,	আত্মবিশ্বাসী,	
seniar,	সেনিয়ার,	সিনিয়র,	
ashamorthito,	আশামর্থিত,	অসমর্থিত,	
turkamena,	তুর্কামেনা,	তুর্কমেন,	
thanvi,	থানভি,	থানভী,	
ghumunoi,	ঘুমুনোই,	ঘুমুনোই,	
gyandas,	জ্ঞানদাস,	জ্ঞানদাস,	
bowie,	বোউই,	বওই,	
dhani,	ধনী,	ধানি,	
jerusalema,	জেরুসালেমা,	জেরুসালেম,	
dobhara,	ডোভারা,	ডোভার,	
cantan,	ক্যান্টান,	ক্যান্টন,	
harbare,	হরবারে,	হারবারে,	
mozdur,	মোজদুর,	মজদুর,	
fuss,	ফিউএস,	ফাস,	
xpose,	ক্কপসে,	এক্সপোজ,	
bisheshyo,	বিশেষ্য,	বিশেষ্য,	
brixfield,	ব্রিক্সফিল্ড,	ব্রিক্সফিল্ড,	
stoic,	স্টোয়েক,	স্টোয়িক,	
bapio,	বাপিও,	বাপিও,	
dhadhiye,	ধাধিয়ে,	ধাধিয়ে,	
ashor,	আশোর,	আসর,	
tanshree,	তানশৃ,	তানশ্রী,	
gotihin,	গতিহীন,	গতিহীন,	
fostar,	ফোস্তার,	ফস্টার,	
sohinsotar,	সহিনসতার,	সহিংসতার,	
bangulzai,	বাংলুজআই,	বঙ্গুলিজাই,	
daaoon,	দাওন,	ডাউন,	
asantosh,	অসন্ত্ষ,	অসন্তোষ,	
laesensh,	লেশেনস,	লাইসেন্স,	
upobasher,	উপবাশের,	উপবাসের,	
nirobota,	নিরবতা,	নিরবতা,	
chhaikalo,	ছাইকালো,	ছাইকালো,	
jontrototto,	যন্ত্রতত্ত্ব,	যন্ত্রতত্ত্ব,	
veemsen,	ভিমসেন,	ভীমসেন,	
aaps,	এপিএসএস,	এএপিএস,	
shikare,	শিকারে,	শিকারে,	
krus,	ক্রুস,	ক্রুশ,	
baaik,	বায়াক,	বাইক,	
bisnoo,	বিস্নৌ,	বিষ্ণু,	
kanader,	কানাদের,	কণাদের,	
baffer,	বাফের,	বাফার,	
dakteekiter,	ডাক্তিকিতের,	ডাকটিকিটের,	
commissionvogider,	কমিন্সভোগীর,	কমিশনভোগীদের,	
edipass,	এডিপ্যাস,	ইডিপাস,	
amiretus,	অ্যামিরুটস,	এমিরেটাস,	
ovidhanik,	অভিধানিক,	অভিধানিক,	
ekok,	একক,	একক,	
path,	পাথা,	পাথ,	
bhageri,	ভাগেরি,	ভাগেরই,	
kyathlik,	ক্যাথলিক,	ক্যাথলিক,	
talaal,	তালাল,	তালাল,	
vitti,	ভিত্তি,	ভিত্তিই,	
grambaashi,	গ্রামবাশী,	গ্রামবাসী,	
yatharthabhabe,	যাথার্থভাবে,	যথার্থভাবে,	
paramartha,	পরমার্থ,	পরমার্থ,	
bhumija,	ভূমিজা,	ভূমিজ,	
audiotike,	অডিওটিকে,	অডিওটিকে,	
sift,	সিফ্ট,	শিফট,	
rashedul,	রাশেদুল,	রাশিদুল,	
souripurang,	সৌরীপুরং,	সৌরিপুরং,	
narishwar,	নারীশ্বর,	নারীশ্বরের,	
peshto,	পেশতো,	পেষ্ট,	
nili,	নীলি,	নিলি,	
dokaanei,	ডোকানেই,	দোকানেই,	
pratijogitamulak,	প্রতিযোগিতামূলক,	প্রতিযোগীতামূলক,	
sikarder,	সিকার্ডের,	শিকারদের,	
adhunikkaley,	আধুনিককালে,	আধুনিককালে,	
soheensotar,	সহিনসতার,	সহিংসতার,	
adhikartai,	অধিকারটাই,	অধিকর্তাই,	
ogovir,	ওগোভির,	অগভীর,	
sheshardhe,	শেষার্ধে,	শেষার্ধে,	
rajotta,	রাজত্বা,	রাজত্ব,	
nathibhuktir,	নাঠিভুক্তির,	নথিভুক্তির,	
daltyagi,	দল্ত্যাগী,	দলত্যাগী,	
bongsho,	বংশ,	বংশ,	
sectore,	সেক্টরে,	সেক্টরে,	
bhutbhut,	ভূভভূত,	ভুটভুট,	
hillse,	হিলসে,	হিলসে,	
fitarsaho,	ফিতারসহ,	ফিতরসহ,	
shasonamoleri,	শাসনামলেরই,	শাসনামলেরই,	
sangbadmadhyome,	সংবাদমাধ্যমে,	সংবাদমাধ্যমে,	
kaaferder,	কাফেরদের,	কাফেরদের,	
bahjya,	বাহজ্যা,	বাহ্য,	
byabaharkarike,	ব্যবহারকারীকে,	ব্যবহারকারীকে,	
mohajote,	মহাজতে,	মহাজোট,	
palteche,	পাল্টেকে,	পাল্টেছে,	
rajashri,	রাজশ্রী,	রাজশ্রী,	
liaodong,	লিয়াডোং,	লিয়াওদং,	
soolke,	সুলকে,	শুল্কে,	
dokan,	দোকান,	দোকান,	
parqim,	পার্কিম,	পার্কিং,	
dikpal,	দিকপাল,	দিকপাল,	
bishwasho,	বিশ্বশা,	বিশ্বাসও,	
bikargrasta,	বিকারগ্রস্ত,	বিকারগ্রস্ত,	
konflict,	কনফ্লিকট,	কনফ্লিক্ট,	
mandondo,	মান্ডন্ড,	মানদণ্ড,	
ghomta,	ঘোমটা,	ঘোমটা,	
graambaashio,	গ্রামবাশীও,	গ্রামবাসীও,	
zaire,	জায়েরে,	জাইরে,	
setike,	সেতিকে,	সেটিকে,	
saatzoner,	সাতজনের,	সাতজনের,	
manjushri,	মঞ্জুশ্রী,	মঞ্জুশ্রী,	
bidghootey,	বিদঘুতে,	বিদঘুটে,	
eporzonto,	অপর্ন্ত,	এপর্যন্ত,	
prachirer,	প্রাচীরের,	প্রাচিরের,	
arashie,	আরাশী,	আরসিএ,	
thaii,	থাই,	থাই,	
udvaboney,	উদভাবনে,	উদ্ভাবনে,	
suisharke,	সুইশারকে,	সুইশারকে,	
bhangle,	ভাংলে,	ভাঙলে,	
mele,	মেলে,	মাইল,	
jaatti,	যাত্তি,	জাতটি,	
tiger,	টিগার,	টাইগার,	
concerter,	কনসার্টার,	কানসাটের,	
nathivukteer,	নাঠিভুক্তির,	নথিভুক্তির,	
ujobekeestaner,	উজবেকস্তানের,	উজবেকিস্তানের,	
afzol,	আফজোল,	আফজল,	
proboleme,	প্রবলেমে,	প্রবলেমে,	
jahara,	জাহারা,	যাহরা,	
omeettrakkhor,	অমিত্যারক্ষর,	অমিত্রাক্ষর,	
sayatana,	সায়াতনা,	শয়তান,	
krishibigyani,	কৃষিবিজ্ঞানী,	কৃষিবিজ্ঞানী,	
rachanakal,	রচনাকাল,	রচনাকাল,	
nirbahey,	নির্বাহে,	নির্বাহে,	
bondhuvabaponyo,	বন্ধুভাবপন্য,	বন্ধুভাবাপন্ন,	
supplenza,	সাপ্লেঞ্জা,	সাপলেঞ্জা,	
achintyabhedaved,	অচিন্ত্যদেবাদ,	অচিন্ত্যভেদাভেদ,	
dhonni,	ধন্নী,	ধন্যি,	
saalsa,	সালসা,	সালসা,	
bandhubhaabaapanna,	বন্ধুভাবপপন্ন,	বন্ধুভাবাপন্ন,	
bbosben,	বিবসবেন,	বসবেন,	
vogno,	ভগ্ন,	ভগ্ন,	
hariken,	হারিকেন,	হ্যারিকেন,	
geographics,	জিওগ্রাফিকস,	জিওগ্রাফিকস,	
jyaqasana,	জ্যাকাসন,	জ্যাকসন,	
hughes,	হুগেস,	হিউজেস,	
moomtaj,	মোমতাজ,	মুমতাজ,	
paira,	পাইরা,	পাইরা,	
kajangale,	কজজঙ্গলে,	কজঙ্গলে,	
mousumeo,	মৌসুমেও,	মৌসুমেও,	
sambhabonao,	সম্ভাবনাও,	সম্ভবনাও,	
kazianis,	কাজিয়ানিস,	কাজানিস,	
inapharameshana,	ইনাফারেশন,	ইনফরমেশন,	
ghuznavi,	ঘুজনাভি,	গজনভি,	
umedpoor,	আমেডপুর,	উমেদপুর,	
uparzoner,	উপার্জনের,	উপার্জনের,	
olympicer,	অলিম্পিসের,	অলিম্পিকের,	
taler,	তালের,	তালের,	
bamon,	বামোন,	বামন,	
chupani,	চুপানি,	চুপানি,	
pretti,	প্রেটি,	প্রিটি,	
uttor,	উত্তর,	উওর,	
louhojato,	লৌহজাত,	লৌহজাত,	
palta,	পাল্টা,	পালটা,	
porizoner,	পরিজনের,	পরিজনের,	
totokhon,	টোটোখোন,	ততক্ষন,	
lyaataa,	ল্যাটা,	ল্যাটা,	
probhuder,	প্রভুদের,	প্রভুদের,	
greep,	গ্রিপ,	গ্রিপ,	
janoganonar,	জনগানার,	জনগণনার,	
bishhnu,	বিষ্ণু,	বিষ্ণু,	
batikromshalee,	বাতিক্রমশালক,	ব্যতিক্রমধর্মী,	
black,	ব্ল্যাক,	ব্ল্যাক,	
danab,	দানাব,	দানব,	
sookkho,	সূক্ষ,	সুক্ষ্ম,	
sucre,	সাক্রে,	সাকার,	
ghamtaa,	ঘামটা,	ঘোমটা,	
ohalyar,	ওহল্যার,	অহল্যার,	
mumtajer,	মুমতাজের,	মুমতাজের,	
nariderke,	নারীদেরকে,	নারিদেরকে,	
lutharan,	লুথারান,	লুথেরান,	
site,	সাটে,	সিটে,	
aansaareer,	আনসারীর,	আনসারীর,	
grambasheeo,	গ্রামবাশীও,	গ্রামবাসীও,	
probhritike,	প্রভৃতিকে,	প্রভৃতিকে,	
laaishenshh,	লাশেশশ,	লাইসেন্স,	
kruser,	ক্রুসের,	ক্রুশের,	
peeth,	পিথ,	পীঠ,	
daqop,	ডাকপ,	দাকোপ,	
dong,	ডং,	ডং,	
pettern,	পেটার্ন,	প্যাটার্ন,	
kanasarabhesana,	কনসারভেষণা,	কনসারভেশন,	
mag,	ম্যাগ,	এমএজি,	
chandrimaa,	চন্দ্রীমা,	চন্দ্রিমা,	
bisheshshyo,	বিশেষ্য,	বিশেষ্য,	
sadbi,	সাদবি,	সাধ্বী,	
postay,	পোস্টে,	পোস্টে,	
lutharen,	লুথারেন,	লুথেরান,	
chhooti,	ছুটি,	ছুটি,	
granthatyke,	গ্র্যাথটেকে,	গ্রন্থটিকে,	
jotota,	যততা,	যতোটা,	
mathews,	ম্যাথেস,	ম্যাথিউস,	
gatibege,	গাতিবেগে,	গতিবেগে,	
moresbai,	মোরেসবাই,	মোরেসবাই,	
suchanakal,	সূচননকাল,	সূচনাকাল,	
somonnitobhabe,	সমন্নিতভাবে,	সমন্বিতভাবে,	
kkhur,	ক্যুর,	ক্ষুর,	
vejjanno,	ভেজজান্ন,	ভেজানো,	
mitro,	মিত্র,	মিত্র,	
rajyabhogi,	রাজ্যাোগো,	রাজ্যভোগী,	
bodhirta,	বধিরটা,	বধিরতা,	
kiibord,	কাইবোর্ড,	কীবোর্ড,	
upbasher,	উপবাশের,	উপবাসের,	
bashoborty,	বাশবোর্তি,	বশবর্তী,	
shamshere,	শামশেরে,	শমসের,	
bisheshya,	বিশেষ্য,	বিশেষ্য,	
reshmirekha,	রেশমিরেখা,	রেশমীরেখা,	
ghumachche,	ঘুমাচ্ছে,	ঘুমাচ্ছে,	
difinishian,	ডিফিনিশয়ন,	ডেফিনেশন,	
shilpajata,	শিল্পজতা,	শিল্পজাত,	
literacy,	লিটারেসি,	লিটারেসি,	
chaudhurider,	চৌধুরীদের,	চৌধুরীদের,	
pooshteer,	পুষ্টির,	পুষ্টির,	
kinenni,	কিনেননি,	কিনেননি,	
priseflex,	প্রাইসফেক্স,	প্রাইজফ্লেক্স,	
daap,	ডাপ,	ড্যাপ,	
holding,	হোল্ডিং,	হোল্ডিং,	
kooshumba,	কুশুম্বা,	কুশুম্বা,	
adhyatmik,	আধ্যাতমিক,	আধ্যাত্মিক,	
madhukori,	মধুকোরি,	মাধুকরী,	
daaktikite,	দাকটিকিতে,	ডাকটিকিটে,	
bhalobaas,	ভালোবাস,	ভালোবাসা,	
srichoitonnodeb,	শ্রীচৈতন্নদেব,	শ্রীচৈতন্যদেব,	
soommo,	সুমো,	সুমো,	
byabaharkareer,	ব্যবহারকারীর,	ব্যবহারকারীর,	
obosan,	অবসান,	অবসান,	
shalook,	শালুক,	শালুক,	
pluck,	প্লাক,	প্ল্যাক,	
stanahenja,	স্তানাহেঞ্জ,	স্টোনহেঞ্জ,	
distance,	ডিস্ট্যান্স,	ডিসট্যান্স,	
shikkhakram,	শিক্ষাক্রম,	শিক্ষাক্রম,	
qara,	কার,	কর,	
aakkaash,	আক্কাশ,	আককাস,	
pratiyogitar,	প্রতিযোগীতার,	প্রতিযোগীতার,	
yak,	যাক,	ইয়াক,	
protijogitamulok,	প্রতিযোগিতামূলক,	প্রতিযোগীতামূলক,	
aakabar,	আকাবার,	আকাবার,	
miraclee,	মিরাকলি,	মিরাকেল,	
modhumotii,	মধুমতিই,	মধুমতী,	
manohputa,	মনোোপুটা,	মনঃপুত,	
bagdadii,	বাগদাদী,	বাগদাদী,	
codeti,	কোডেটি,	কোডটি,	
sumeeta,	সুমিতা,	সুমিতা,	
ghoorchen,	ঘূরছেন,	ঘুরেছেন,	
probeshkari,	প্রবেশকারী,	প্রবেশকারী,	
hondooras,	হন্ডররাস,	হন্ডুরাস,	
metropolitan,	মেট্রোপোলিটান,	মেট্রোপলিটন,	
melbourner,	মেলবোর্নের,	মেলবোর্নের,	
musallati,	মুসললতা,	মুসল্লাটি,	
ancholgoolir,	আঞ্চলগুলির,	অঞ্চলগুলির,	
antorbhuktimulak,	আন্তর্ভুক্তিমূলক,	অন্তর্ভুক্তিমূলক,	
anisa,	অনিসা,	আনিস,	
lambi,	লাম্মি,	লম্বি,	
valobase,	ভালোবাসে,	ভালোবাসে,	
shaahaabiike,	সাহাবীকে,	সাহাবীকে,	
chalachchitra,	চলচ্চিত্র,	চলচ্চিত্র,	
chalochchitreer,	চলচ্ছিত্রির,	চলচ্চিত্রের,	
khiladirao,	খিলাড়িরাও,	খিলাড়িরাও,	
manobikotao,	মানবিকতাও,	মানবিকতাও,	
byke,	বাইক,	বাইক,	
foreks,	ফোরেকস,	ফরেক্স,	
karmosansthan,	কর্মসন্ঠান,	কর্মসংস্থান,	
keyu,	কেই়ু,	কেউ,	
rata,	রাটা,	রত,	
poschimey,	পশ্চিমে,	পশ্চিমে,	
hosto,	হোস্টো,	হস্ত,	
dankaan,	ডানকান,	ডানকান,	
patishapta,	পাটিশাপ্ত,	পাটিসাপটা,	
rahimed,	রহিমেদ,	রহিমেদ,	
saurce,	সার্সে,	সোর্স,	
lishenshe,	লিশেন্স,	লাইসেন্স,	
teksuser,	টেকসুসের,	টেক্সাসের,	
mookhomaundoler,	মৌখমূণ্ডলের,	মুখমণ্ডলের,	
osamarik,	ওসামারিক,	অসামরিক,	
mahbunur,	মাহবুনুর,	মাহবুনুর,	
deenesh,	দেনেশেষ,	দীনেশ,	
somosto,	সমস্ত,	সমস্ত,	
niropekkho,	নিরপেক্ষ,	নিরপেক্ষ,	
ganoporibahon,	গণপরিবহন,	গণপরিবহন,	
neshnos,	নেশনোস,	নেশনস,	
shkalarashhipa,	স্কলারশিপ,	স্কলারশিপ,	
heerani,	হিরানী,	হিরানি,	
volivoler,	ভলিভোলের,	ভলিভলের,	
monohputo,	মনোপুুত,	মনঃপুত,	
arg,	আর্গ,	আর্গ,	
maladabha,	মালাদা,	মলদোভা,	
notey,	নোটে,	নোটে,	
taranee,	তারানি,	তরণী,	
mukhobondho,	মুখবন্ধ,	মুখবন্ধ,	
gara,	গার,	গোর,	
mmadhuri,	ম্মাধুরি,	মাধুরী,	
purple,	পারপল,	পার্পেল,	
graambaaseeder,	গ্রামবাসীদের,	গ্রামবাসীদের,	
hitokor,	হিতকর,	হিতকর,	
riphleksa,	রিফ্কেস,	রিফ্লেক্স,	
pushtee,	পুষ্ি,	পুষ্টি,	
asthishondhi,	অস্থিনশ্ধি,	অস্থিসন্ধি,	
veniser,	ভেনিসের,	ভেনিসের,	
nobotomo,	নবতম,	নবতম,	
creshcent,	ক্রেশেন্ট,	ক্রিসেন্ট,	
kheylechen,	খেয়েলেছেন,	খেলেছেন,	
autopromotioner,	অটোপ্রোফিশনের,	অটোপ্রমোশনের,	
deefinition,	ডিফিনিশন,	ডেফিনেশন,	
zoojyota,	যোজ্যতা,	যোজ্যতা,	
shipley,	শিপলি,	শিপলে,	
zerusaleme,	জেরুসালেমে,	জেরুসালেমে,	
kirke,	কীরকে,	কিরকে,	
aakkas,	আক্কাস,	আককাস,	
korush,	করুশ,	ক্রুশ,	
poschime,	পশ্চিমে,	পশ্চিমে,	
kram,	ক্রাম,	ক্রম,	
bandhan,	বানধন,	বাঁধন,	
bo,	বোএ,	বু,	
veenish,	ভিনিশ,	ভেনিস,	
welaqama,	ওয়েলাকামা,	ওয়েলকাম,	
songrahak,	সংগ্রহক,	সংগ্রাহক,	
langhangulir,	লংঘণগুলির,	লঙ্ঘনগুলির,	
padee,	পাদি,	পাড়ে,	
proshadhoner,	প্রশাধনের,	প্রসাধনের,	
aanaan,	আনান,	আনান,	
bohoodin,	বহুদিন,	বহুদিন,	
asabhya,	অসভ্য,	অসভ্য,	
alaol,	অ্যালাওল,	আলাওল,	
turisht,	টুরিশ্ট,	টুরিস্ট,	
klaud,	ক্লাউদ,	ক্লাউড,	
lampot,	লামপট,	লম্পট,	
raia,	রাইয়া,	রায়,	
shariba,	শরিবা,	শরিবা,	
zerusalemer,	জেরুসালেমের,	জেরুজালেমের,	
tukrote,	টুকররে,	টুকরোতে,	
aosafur,	আওসাফুর,	আওশাফুর,	
sylvi,	সিলভি,	সিলভি,	
bishashke,	বিশাষকে,	বিশ্বাসকে,	
graambasider,	গ্রামবাসীদের,	গ্রামবাসীদের,	
jhamala,	ঝামালা,	ঝামালা,	
abhidhaaner,	অভিধানের,	অভিধানের,	
chinito,	চিনিতো,	চিনতো,	
siqh,	সিক্হ,	শিখ,	
kings,	কিংস,	কিংস,	
prijon,	প্রিজন,	প্রিজন,	
parkasa,	পার্কাসা,	পার্কস,	
gajano,	গজননো,	গজানো,	
mekon,	মেকন,	মেকং,	
sangaskritipreme,	সংস্কৃতিপ্রেমে,	সংস্কৃতিপ্রেমে,	
cs,	সিএসএই,	সিএস,	
swostir,	স্বস্তির,	স্বস্তির,	
cholochchitrai,	চলচ্চিত্রায়,	চলচ্চিত্রই,	
shikhbe,	শিখবে,	শিখবে,	
edaningkale,	এদানিকালে,	ইদানীংকালে,	
nirabota,	নিরাবতা,	নিরবতা,	
irish,	ইরিশ,	আইরিস,	
paadee,	পাডি,	পাড়ে,	
gabinius,	গ্যাবিওয়াস,	গাবিনিআস,	
shakara,	শাকারা,	সাকার,	
nathivukta,	নািভুক্ত,	নথিভুক্ত,	
phund,	ফুন্ড,	ফান্ড,	
bulichev,	বুলিভেভ,	বুলিচেভ,	
lyaanding,	ল্যানডিং,	ল্যান্ডিং,	
prosadhoner,	প্রসাধনের,	প্রসাধনের,	
badaghat,	বাঁঘাট,	বাদাঘাট,	
sinakey,	সিনাকে,	সিনাকে,	
segulo,	সেগুলো,	সেগুলো,	
raagee,	রাগী,	রাগী,	
trenda,	ট্রেন্ড,	ট্রেন্ড,	
kompeeto,	কম্পিট,	কম্পিত,	
domonmulok,	দমনমূলক,	দমনমূলক,	
ateetkale,	আতীতকালে,	অতীতকালে,	
bisshonath,	বিশ্বনাথ,	বিশ্বনাথ,	
toching,	টোচিং,	টোচিং,	
jatotaa,	জাতোটা,	যতোটা,	
osoborno,	অসবর্ণ,	অসবর্ণ,	
patrol,	প্যাটরোল,	পেট্রোল,	
duhsthanostho,	দুঃস্থানস্থ,	দুঃস্থানস্থ,	
shrabastee,	শ্রাবস্তি,	শ্রাবস্তী,	
lesense,	লেসেন্স,	লাইসেন্স,	
santaa,	সান্টা,	সান্তা,	
chenza,	চেনজা,	চেঞ্জ,	
cheess,	চেস,	চেস,	
ghoor,	ঘূর,	ঘুর,	
primoo,	প্রাইমুও,	প্রিমো,	
catholicbad,	ক্যাথোলিক্াদ,	ক্যাথলিকবাদ,	
ruble,	রাবল,	রুবল,	
shudhui,	শুধুই,	শুধুই,	
songbadmadhyame,	সংবাদমাধ্যমে,	সংবাদমাধ্যমে,	
surke,	সুরকে,	সুরকে,	
drishyer,	দৃশ্যের,	দৃশ্যের,	
qirq,	কার্ক,	কার্ক,	
jolaatonko,	জলাতন্যক,	জলাতঙ্ক,	
dokaangulotey,	ডোকানগুলোতে,	দোকানগুলোতে,	
digreeke,	দিগ্রীকে,	ডিগ্রিকে,	
arshie,	আরশি,	আরসিএ,	
militarite,	মিলিটারিতে,	মিলিটারিতে,	
swartho,	স্বর্থ,	স্বার্থ,	
baasaate,	বাসাতে,	বাসাতে,	
soomitrar,	সুমিত্রার,	সুমিত্রার,	
slatgulor,	স্লেগগুলোর,	স্ল্যাটগুলোর,	
ramnathbabur,	রামনাথবাবুর,	রামনাথবাবুর,	
katateo,	কাটাতেও,	কাটাতেও,	
sausagee,	সৌগাগি,	সসেজ,	
nischitobhabe,	নিশ্চিতভাবে,	নিশ্চিতভাবে,	
bedanta,	বেদন্ত,	বেদান্ত,	
gorjon,	গর্জন,	গর্জন,	
alpo,	আল্পো,	অল্প,	
nachiketa,	নচিকেতা,	নচিকেতা,	
sqolastiq,	স্কল্যাস্টিক,	স্কলাস্টিক,	
starker,	স্টার্কার,	স্টার্কের,	
aansareer,	আনসারীর,	আনসারীর,	
uthe,	উঠে,	উঠে,	
chhanada,	ছানাদা,	ছানাদা,	
vittiteo,	ভিত্তিতেও,	ভিত্তিতেও,	
shcholastic,	স্কলাস্টিক,	স্কলাস্টিক,	
shurugulo,	শুরুগুলো,	শুরুগুলো,	
eigulor,	এইগুলোর,	এইগুলোর,	
manob,	মানব,	মানব,	
khali,	খালি,	খালি,	
valobasen,	ভালোবাসেন,	ভালোবাসেন,	
muktijuddhojato,	মুক্তিযুদ্ধতা,	মুক্তিযুদ্ধজাত,	
hertj,	হার্টজ,	হার্জ,	
sahapathike,	সহপাঠিকে,	সহপাঠীকে,	
bishshasho,	বিশ্বাষো,	বিশ্বাসও,	
bitertrate,	বাইটাররেট,	বাইটারট্রেট,	
dara,	দারা,	দারা,	
vushito,	ভূষিত,	ভূষিত,	
mangolic,	ম্যানগোলিক,	মাঙ্গলিক,	
ingrejra,	ইংরেজরা,	ইংরেজরা,	
nutunotto,	নুতুনত্ব,	নতুনত্ব,	
loombinee,	লুমবিনী,	লুম্বিনী,	
deobonde,	দেওবন্দে,	দেওবন্দে,	
qredita,	ক্রেদিত,	ক্রেডিট,	
anchalsaho,	অঞ্চলসহ,	অঞ্চলসহ,	
jathartho,	যথার্থ,	যথার্থ,	
arthurer,	আর্থুরের,	আর্থারের,	
ponchaashjon,	পঞ্চাশজন,	পঞ্চাশজন,	
muchlima,	মুছলিমা,	মুছলিমা,	
camerapersoner,	ক্যামেরাপারসনের,	ক্যামেরাপার্সনের,	
alexandar,	আলেক্সান্ডার,	আলেকজান্ডার,	
sip,	সিপ,	শিপ,	
abhirupbabuke,	অভিরূপবাবুকে,	অভিরূপবাবুকে,	
mumtaz,	মুমতাজ,	মুমতাজ,	
bishesyo,	বিশেষ্য,	বিশেষ্য,	
pratishthanik,	প্রতিষ্ঠানিক,	প্রাতিষ্ঠানিক,	
shapad,	শাপাদ,	শ্বাপদ,	
encidablu,	এনসিডাব্যু,	এনসিডাব্লু,	
balaruma,	বালারুমা,	বলরুম,	
freelancerra,	ফ্রিল্যান্সরা,	ফ্রিল্যান্সাররা,	
aholya,	অহোল্যা,	অহল্যা,	
lotharan,	লোথারান,	লুথেরান,	
sarboporee,	সার্বপরী,	সর্বোপরী,	
sthapona,	স্থাপনা,	স্থাপনা,	
mandope,	মণ্ডপে,	মন্ডপে,	
nagarikera,	নাগারিকেরা,	নাগরিকেরা,	
harysoner,	হারিসনের,	হ্যারিসনের,	
prabhritite,	প্রভৃতিতে,	প্রভৃতিতে,	
dalee,	ডলি,	ডালে,	
vugorvey,	ভুগর্ভে,	ভূগর্ভে,	
azimpur,	আজিমপুর,	আজিমপুর,	
nakkal,	নাককাল,	নক্কল,	
boshoborti,	বশবর্তী,	বশবর্তী,	
taatey,	তাতে,	তাতে,	
somraat,	সোমরাট,	সম্রাট,	
mochlekha,	মোললেছা,	মোছলেখা,	
aembed,	এমবেড,	এম্বেড,	
ul,	ইউএল,	উল,	
ala,	আলা,	আলা,	
birmuktijoddhagan,	বীরমুক্তিযাদ্ধধান,	বীরমুক্তিযোদ্ধাগণ,	
glanio,	গ্লানিও,	গ্লানিও,	
shahanara,	শাহানারা,	শাহানারা,	
ekghare,	একঘারে,	একঘরে,	
tookrote,	টুকরোটে,	টুকরোতে,	
zohns,	জোন্স,	জন্স,	
anchalgoolir,	আঞ্চালগুলির,	অঞ্চলগুলির,	
nirbaahe,	নির্বাহে,	নির্বাহে,	
oblivion,	অবলিভিয়ন,	অবলিভিয়ন,	
motkey,	মটকে,	মতকে,	
militarir,	মিলিতারির,	মিলিটারির,	
jaanar,	জানার,	জানার,	
balatkar,	বালতকর,	বলাৎকার,	
inphormeshon,	ইনফ্রমেনন,	ইনফরমেশন,	
rasunkunchi,	রসুনকুঞ্চি,	রসুনকুঁচি,	
thaanobhi,	থানোভি,	থানভী,	
grooth,	গ্রোথ,	গ্রোথ,	
abheedhaaneeck,	অভেধানিক,	অভিধানিক,	
muhaiminer,	মুহাইমিনের,	মুহাইমিনের,	
zerusalem,	জেরুসালেম,	জেরুজালেম,	
dojo,	ডজ,	ডোজো,	
jeshh,	জেশ,	জেস,	
chemjong,	চেমজং,	চেমজং,	
hul,	হাল,	হুল,	
judge,	জুড,	জাজ,	
uqeliptas,	উকেলিপ্টাস,	ইউক্যালিপ্টাস,	
dianes,	ডিয়েন্স,	ডিএনএস,	
graambasio,	গ্রামবাসিও,	গ্রামবাসীও,	
samanyai,	সামন্যই,	সামান্যই,	
yanqee,	য্যাঙ্কি,	ইয়াংকি,	
janar,	জানার,	জানার,	
barrageke,	বাযারেজেকে,	ব্যারেজকে,	
chalachchitrei,	চলচ্চিত্রেই,	চলচ্চিত্রেই,	
bhiktara,	ভিক্তারা,	ভিক্টর,	
elakayi,	এলাকাই,	এলাকাই,	
panchasjan,	পঞ্চজসন,	পঞ্চাশজন,	
manushti,	মানুষ্টি,	মানুষটি,	
dhwajbhango,	ধ্যাবভঙ্গ,	ধ্বজভঙ্গ,	
itastata,	ইতাস্তাটা,	ইতস্তত,	
peeri,	পীরি,	পেরি,	
ghamta,	ঘামটা,	ঘোমটা,	
minister,	মিনিস্টার,	মিনিস্টার,	
mane,	মানই,	মানে,	
desiseyer,	দেসিয়েসের,	ডিজিজের,	
prakalpatike,	প্রকলপতিকে,	প্রকল্পটিকে,	
zerusalem,	জেরুসালেম,	জেরুসালেম,	
pulivendla,	পুলিভেন্ডলা,	পুলিভেন্ডলা,	
scholars,	স্কোলারস,	স্কলার্স,	
batom,	বাতোম,	বাটম,	
prokolpogulikei,	প্রকল্পগুলিকেই,	প্রকল্পগুলিকেই,	
monchosthol,	মন্চস্থল,	মঞ্চস্থল,	
cheekitsar,	চিকিৎসার,	চিকিত্সার,	
mausumeo,	মাউসুমেও,	মৌসুমেও,	
seekkhokbrindo,	সিক্ষকবৃন্দ,	শিক্ষকবৃন্দ,	
shoreefpur,	শরীফপুরের,	শরিফপুর,	
maner,	মানের,	মানে,	
ekekrokom,	একেক্রম,	একেকরকম,	
registrikrito,	রেগিস্তৃতিকৃত,	রেজিস্ট্রীকৃত,	
milekhaanek,	মিলেখানেক,	মাইলখানেক,	
nirarthak,	নিরার্থক,	নিরর্থক,	
jetam,	জেতাম,	যেতাম,	
jubokti,	যুবকটি,	যুবকটি,	
phaltu,	ফাল্টু,	ফালতু,	
chakurijibirao,	চাকুরিজীবীরাও,	চাকুরীজীবীরাও,	
abodamaner,	অবদামানের,	অবদমনের,	
akmato,	আকমতো,	একমত,	
panchashjon,	পঞ্চাশজন,	পঞ্চাশজন,	
volapuk,	ভোলাপুকে,	ভোলাপুক,	
panchadadu,	পঞ্চাদাদু,	পঞ্চাদাদু,	
aasirbaad,	আসিরবাদ,	আশির্বাদ,	
gandhiio,	গান্ধিও,	গান্ধীও,	
chalchhe,	চালছে,	চলছে,	
edmiral,	এডমিরাল,	এডমিরাল,	
bbiseshyer,	বিবিশেষ্যের,	বিশেষ্যের,	
mukhyo,	মুখ্য,	মুখ্য,	
carzar,	কারজজার,	চার্জার,	
sommotitey,	সম্মতিতে,	সম্মতিতে,	
safiin,	সাফিন,	সাফিন,	
pragreesa,	প্রা্গ্রীস,	প্রগ্রেস,	
bhittimul,	ভিত্তিমূল,	ভিত্তিমূল,	
lettere,	লেট্টার,	লেটারে,	
batistambhatike,	বাতিস্মাতটাবীকে,	বাতিস্তম্ভটিকে,	
baman,	বামান,	বামন,	
shikkharrthirao,	শিক্ষার্থীরাও,	শিক্ষার্থীরাও,	
aamoode,	আমোদে,	আমুদে,	
vobanipur,	ভববানিপুর,	ভবানীপুর,	
foxer,	ফক্সের,	ফক্সের,	
duple,	ডুপলে,	ডুপ্লে,	
sahojlovyotar,	সহজলভ্যতার,	সহজলভ্যতার,	
lutheerana,	লুথিরানা,	লুথেরান,	
sedikei,	সেদিকেই,	সেদিকেই,	
fatkabazare,	ফটকাবাজারে,	ফাটকাবাজারে,	
qarpeta,	কার্পেটা,	কার্পেট,	
manushsoho,	মানুষসহ,	মানুষসহ,	
chokrantosoho,	চক্রান্তসহ,	চক্রান্তসহ,	
sachetanvabe,	সচেতনভাবে,	সচেতনভাবে,	
kantojir,	কান্তজির,	কান্তজির,	
pabo,	পাব,	পাব,	
dep,	ডিপ,	ডেপ,	
prokolpow,	প্রকল্পপূ,	প্রকল্পও,	
prokalpagulo,	প্রকল্পগুলো,	প্রকল্পগুলো,	
kinsha,	কিনশা,	কিংস,	
oswasteekor,	অস্বাস্তিকর,	অস্বস্তিকর,	
drishyogulote,	দৃশ্যগুলোতে,	দৃশ্যগুলোতে,	
sanghar,	সংহর,	সংহার,	
kalki,	কালকি,	কালকি,	
sponsorshipe,	স্পনসর্শীপে,	স্পন্সরশীপে,	
deeares,	ডিয়াররস,	ডিআরএস,	
prity,	প্রীতি,	প্রিটি,	
kathmandute,	কাঠমাণ্ডুতে,	কাঠমান্ডুতে,	
kormobuddhite,	কর্মবুদ্ধিতে,	কর্মবুদ্ধিতে,	
eucalyptus,	ইউকালিইট্টাস,	ইউক্যালিপ্টাস,	
nirvachaker,	নির্ভাচকের,	নির্বাচকের,	
naitikatavodh,	নৈতিকতাবোধ,	নৈতিকতাবোধ,	
pillai,	পিল্লাই,	পিল্লাই,	
ostad,	ওস্তাদ,	ওস্তাদ,	
kyatagorir,	ক্যাটাগরির,	ক্যাটাগরির,	
phareeksa,	ফারিক্স,	ফরেক্স,	
abhijitda,	অভিজিৎদা,	অভিজিতদা,	
societytey,	সোশিটিয়ে,	সোসাইটিতে,	
dola,	দোলা,	দলা,	
times,	টাইমস,	টাইমস্,	
marpit,	মারপিট,	মারপিট,	
upobasee,	উপবাসী,	উপবাসী,	
jacksoner,	জ্যাকসনের,	জ্যাকসনের,	
zonsa,	জোন্সা,	জোন্স,	
ramzaner,	রামজানের,	রমযানের,	
doula,	দৌলা,	দৌলা,	
khanabale,	খানাবালে,	খানাবলে,	
aborto,	আবর্ত,	আবর্ত,	
bagdad,	বাগদাদ,	বাগদাদে,	
suiza,	সুইজা,	সুইজা,	
shilver,	শিলভের,	সিলভার,	
abhiyojan,	অভিযোজন,	অভিযোজন,	
mukhbondho,	মুখবন্ধ,	মুখবন্ধ,	
mukhomondoler,	মুখমণ্ডলের,	মুখমণ্ডলের,	
bojhe,	বোঝে,	বোঝে,	
anichchi,	অনিচ্ছি,	আনিচ্ছি,	
ceramiksh,	সেরামিক্ষ,	সিরামিকস,	
simons,	সিমোন্স,	সিমন্স,	
directorete,	ডিরেক্টরেট,	ডিরেক্টরেট,	
thabai,	থাবাই,	থাবাই,	
rajnoitik,	রাজনৈতিক,	রাজনৈতীক,	
keyboarder,	কীয়োবরদের,	কীবোর্ডের,	
porjotoker,	পর্যটকের,	পর্যটকের,	
angsogrohone,	অংসগ্রহণে,	অংশগ্রহনের,	
narsaari,	নরসারি,	নার্সারি,	
waal,	ওয়াল,	উল,	
shringa,	শ্রীংগা,	শৃঙ্গ,	
suparharo,	সুপারহারো,	সুপারহিরো,	
onucheeder,	অনুচেদের,	অনুচ্ছেদের,	
shhepha,	সেফ,	শেফ,	
onshogrohoner,	অংশগ্রহণের,	অংশগ্রহনের,	
bonvumitey,	বনভূমিতে,	বনভূমিতে,	
suraropito,	সুরাপরিপত,	সুরারোপিত,	
wagadada,	ওয়াগাদাদা,	বাগদাদ,	
boudhher,	বৌধের,	বৌদ্ধের,	
drissogoolote,	দৃশ্যগুলোতে,	দৃশ্যগুলোতে,	
meghachchanno,	মেঘাচ্ছন্ন,	মেঘাচ্ছন্ন,	
shommoteer,	সম্মতির,	সম্মতির,	
modelkey,	মডেলকে,	মডেলকে,	
suparichiti,	সুপারিচিটি,	সুপরিচিতি,	
barack,	বাযারাক,	বারাক,	
utsahamulak,	উৎসাহামূলক,	উৎসাহমূলক,	
titarer,	টিটারের,	তিতারের,	
kobulennechha,	কবুলেন্েছা,	কবুলেন্নেছা,	
poroborti,	পরবর্তী,	পরর্বতী,	
residensa,	রেসিডেন্সা,	রেসিডেন্স,	
moddhyoshtho,	মধ্যস্থ,	মধ্যস্থ,	
youth,	যযুথ,	ইয়ুথ,	
kortam,	করর্তাম,	করতাম,	
taalaal,	তালাল,	তালাল,	
bahubar,	বাহুবার,	বহুবার,	
mah,	মাহ,	মাহে,	
scoore,	স্কোরে,	স্কোর,	
shektor,	শেকতোর,	সেক্টর,	
plack,	প্ল্যাক,	প্ল্যাক,	
argho,	অর্ঘ,	অর্ঘ্য,	
hosne,	হোসনে,	হোসনে,	
jansa,	জনসা,	জন্স,	
jounotar,	যৌনতার,	যৌনতার,	
scholastic,	স্কোলাস্টিক,	স্কলাস্টিক,	
rakim,	রািম,	রাকিম,	
courtcaser,	কোর্টক্সের,	কোর্টকেসের,	
kinsa,	কিন্স,	কিংস,	
aziboner,	আজিবনের,	আজীবনের,	
toler,	টোলের,	তালের,	
roopmatro,	রূপমাত্র,	রূপমাত্র,	
bhenise,	ভেনিসে,	ভেনিসে,	
popke,	পোপকে,	পোপকে,	
modele,	মডেলে,	মডেলে,	
sikkhakromer,	শিক্ষাক্রমের,	শিক্ষাক্রমের,	
kanthar,	কাঁঠার,	কাঁথার,	
majlishpur,	মজলিশপুর,	মজলিশপুর,	
bhaibon,	ভাইবন,	ভাইবোন,	
lendal,	লেন্ডাল,	লেন্ডল,	
shukraanoo,	শুকরানু,	শুক্রানু,	
chakundite,	চাকুন্দিতে,	চাকুন্দিতে,	
anubhutimalar,	অনুভূতিমালার,	অনুভূতিমালার,	
kode,	কোড,	কোড,	
puding,	পুডিং,	পুডিং,	
sanstha,	সান্থা,	সংস্থা,	
doorger,	ডুর্গার,	দুর্গের,	
karmakarke,	কারমাকারকে,	কর্মকারকে,	
armeenian,	আরমিনীয়,	আর্মেনিয়ান,	
fol,	ফোল,	ফল,	
taigara,	টাইগারা,	টাইগার,	
koordider,	কর্দিদের,	কুর্দিদের,	
chirontan,	চিরোন্তান,	চিরন্তন,	
poribahokotto,	পরিবাহকত্ব,	পরিবাহকত্ব,	
perry,	পেরি,	পেরি,	
pratijogider,	প্রতিযোগীদের,	প্রতিযোগীদের,	
with,	উইথ,	ভিত,	
sarjur,	সারজুর,	সরযূর,	
bhenom,	ভেনম,	ভেনম,	
hank,	হ্যাংক,	হাঙ্ক,	
difinision,	ডিফিনিয়ান,	ডেফিনেশন,	
beam,	বিআইএম,	বিম,	
dipke,	দিপকে,	দ্বীপকে,	
heze,	হেজে,	হেজ,	
adwanced,	অ্যাড্যান্ডস,	অ্যাডভান্সড,	
jhumjhumita,	ঝুমঝুমিতা,	ঝুমঝুমিটা,	
poscater,	পশ্কাটের,	পশ্চাতের,	
karadandey,	কারাদন্ডে,	কারাদণ্ডে,	
koordira,	কোরদিরা,	কুর্দিরা,	
sangsakti,	সংসক্তি,	সংসক্তি,	
onupater,	অনুপাতের,	অনুপাতের,	
mail,	মাইল,	মাইল,	
landing,	ল্যান্ডিং,	ল্যান্ডিং,	
aamor,	আমর,	আমর,	
thechar,	থেচার,	থ্যাচার,	
simaa,	সিমা,	সীমা,	
horidwar,	হরিদ্বার,	হরিদ্বার,	
atmira,	আত্মীরা,	আত্মীরা,	
doneta,	ডনেটা,	ডোনাট,	
beem,	বীম,	বিম,	
bondishalatei,	বন্দিশালাতেই,	বন্দিশালাতেই,	
humner,	হামনার,	হামনার,	
patininda,	পাতিনিন্দা,	পতিনিন্দ,	
vabnakey,	ভবনকেকে,	ভাবনাকে,	
fasir,	ফ্যাসির,	ফাসীর,	
borlen,	বরলল,	বরলেন,	
husni,	হুসনি,	হুসনি,	
khoor,	খুর,	ক্ষুর,	
aairish,	আইরিশ,	আইরিস,	
kaferderke,	কাফেরদেরকে,	কাফেরদেরকে,	
shunani,	শুনানি,	শুনানী,	
charger,	চার্জার,	চার্জার,	
bandra,	বান্দ্রা,	বন্দীরা,	
icelands,	আইসেল্ন্ডস,	আইসল্যান্ডসহ,	
noitik,	নৈতিক,	নৈতিক,	
pinglateo,	পিংলাতেও,	পিংলাতেও,	
sobchey,	সব্যে,	সবচে,	
fatakesto,	ফাটাকেস্টো,	ফাটাকেষ্ট,	
poddhotiteyi,	পদ্ধটিতিই,	পদ্ধতিতেই,	
arsie,	আরসি,	আরসিএ,	
townshhip,	টোউনশিপ,	টাউনশিপ,	
skolastik,	স্কলাস্তিক,	স্কলাস্টিক,	
natshi,	নাশশি,	নাত্সি,	
torkarite,	তররকারিতে,	তরকারিতে,	
tookrokey,	টুকরকে,	টুকরোকে,	
jaruri,	জরুরি,	জরূরী,	
sohojlovyotar,	সহজ্লব্যতার,	সহজলভ্যতার,	
koro,	করর,	করো,	
samashtike,	সমষ্টিকে,	সমষ্টিকে,	
morodeho,	মরদেহ,	মরদেহ,	
shchalastik,	স্লালস্তিক,	স্কলাস্টিক,	
fokskon,	ফককসকন,	ফক্সকন,	
firti,	ফিরটি,	ফিরতি,	
crashlands,	ক্রাশল্যান্ডস,	ক্র্যাশল্যান্ডস,	
oncholke,	অঞ্চলকে,	অঞ্চলকে,	
eporjonto,	অপর্ন্ত,	এপর্যন্ত,	
akheli,	আখেলি,	আখেলী,	
rahi,	রহি,	রাহী,	
ishahak,	ইশাহাক,	ইসাহাক,	
narbur,	নারবুরের,	নরবুর,	
rakkhandurga,	রক্ষণদূর্গ,	রক্ষণদুর্গ,	
prosadhoni,	প্রসাধনী,	প্রসাধনী,	
chet,	চেট,	চ্যাট,	
onkush,	অঙ্কুশ,	অংকুশ,	
jewellery,	জিউভেলিরি,	জুয়েলারির,	
prokolpoti,	প্রকল্পটি,	প্রকল্পটি,	
varote,	ভারতে,	ভারতে,	
oitijhyotike,	ঐতিহ্যটিকে,	ঐতিহ্যটিকে,	
shardotsobei,	শার্দতসবেই,	শারদোৎসবেই,	
rekhapat,	রেখাপাত,	রেখাপাত,	
niharkantibabu,	নিহার্ণকান্তিবাবু,	নিহারকান্তিবাবু,	
karlei,	কারলেই,	করলেই,	
victor,	ভিক্টর,	ভিক্টর,	
bosontoke,	বসন্তকে,	বসন্তকে,	
srisri,	শ্রীশ্রি,	শ্রীশ্রী,	
cheento,	চিন্তো,	চিনতো,	
jamkaalo,	জামকালো,	জমকালো,	
jakatke,	জাকাতকে,	যাকাতকে,	
laagche,	লাগছে,	লাগছে,	
duuma,	ডুউমা,	দুমা,	
satarkabhabe,	সতর্কভাবে,	সতর্কভাবে,	
byabaharkaree,	ব্যবহারকারী,	ব্যবহারকারী,	
sainyader,	সৈন্যাদের,	সৈন্যদের,	
mozlis,	মজলিস,	মজলিশ,	
bhenkates,	ভেঙকেট,	ভেঙ্কটেশ,	
byabosthar,	ব্যবস্থার,	ব্যবস্থার,	
venuser,	ভেনাসাসের,	ভেনাসের,	
dighol,	দিঘল,	দীঘল,	
kuthibarike,	কুঠিবারীকে,	কুঠিবাড়ীকে,	
jegulur,	যেগুলুর,	যেগুলুর,	
hijri,	হিজরি,	হিজরী,	
guzon,	গুজন,	গুজব,	
pracharanamulak,	প্রচারণমূলক,	প্রচারণামূলক,	
hijrite,	হিজরিতে,	হিজরীতে,	
billaho,	বিলাহল,	বিল্লাহ,	
dipon,	ডিপন,	দীপন,	
pohnpeic,	পহনপেকেক,	ফোনপেইক,	
dhanak,	ধনক,	ধানক,	
chat,	চ্যাট,	চ্যাট,	
rohosyoti,	রহস্যটি,	রহস্যটি,	
vezano,	ভেজানো,	ভেজানো,	
rilayensa,	রিলেয়েনসা,	রিলায়েন্স,	
gyandaas,	জ্ঞানদাস,	জ্ঞানদাস,	
phiqsa,	ফিকসা,	ফিক্স,	
supparak,	সুপ্ারক,	সুপ্পারক,	
iqbalke,	ইকবালকে,	ইকবালকে,	
homeser,	হোমেসের,	হোমসের,	
shilpikuler,	শিল্পীকুলের,	শিল্পীকুলের,	
nek,	নেক,	নেক,	
thyachar,	থ্যাচার,	থ্যাচার,	
trutimatra,	ত্রুতিমাত্র,	ত্রুটিমাত্র,	
pathkrom,	পাঠক্রম,	পাঠক্রম,	
foolkopi,	ফুলকপি,	ফুলকপি,	
shamuker,	শামুকের,	শামুকের,	
paolasthi,	পাওলাস্থি,	পাওলাসথি,	
vittio,	ভিত্তিও,	ভিত্তিও,	
asommoti,	অসম্মতি,	অসম্মতি,	
chikitshar,	চিকিৎশার,	চিকিত্সার,	
graambasi,	গ্রামবাসী,	গ্রামবাসী,	
sossar,	সোসার,	সকার,	
neemeette,	নিমেত্যে,	নিমিত্তে,	
akhandata,	আখণ্ডতা,	অখণ্ডতা,	
tookror,	টুকর,	টুকরোর,	
erajyobasi,	এরাজ্যবাসী,	এরাজ্যবাসী,	
engrejer,	এংরেজের,	ইংরেজের,	
nirikho,	নিরিখো,	নিরিখ,	
hizrite,	হিজরিতে,	হিজরীতে,	
aalkaatra,	আলকাত্রা,	আলকাতরা,	
katiusha,	কাটিশশা,	কাতিউশা,	
srivatsalakshanang,	শ্রীবাৎসালংশকং,	শ্রীবৎসলক্ষণং,	
bojhao,	বোঝাও,	বোঝাও,	
chalochchitraeer,	চলচ্চিত্রীর,	চলচ্চিত্রের,	
himsrot,	হিমস্রোট,	হিমস্রোত,	
pothnirdeshona,	পঠনির্দেশনা,	পথনির্দেশনা,	
ingrezeeteo,	ইংরেজিতেও,	ইংরেজিতেও,	
rananganey,	রণাঙ্গনে,	রণাঙ্গনে,	
jokkher,	জক্ষের,	যক্ষের,	
faltu,	ফাল্টু,	ফালতু,	
aranyani,	অরণ্যনী,	অরণ্যানী,	
kormopontha,	কর্মপন্থা,	কর্মপন্থা,	
kortona,	কর্তনা,	করতনা,	
wrighter,	ঘৃঘার,	রাইটের,	
wilderske,	উইলডার্সকে,	উইল্ডার্সকে,	
marathi,	মারাথি,	মরাঠি,	
shajano,	শাজানো,	সাজানো,	
bayii,	বায়ি,	বাঈ,	
stander,	স্ট্যান্ডার,	স্ট্যাণ্ডের,	
gingbhalobasen,	গিংহাবাবলেন,	গিংভালোবাসেন,	
sanghitar,	সংঘীতার,	সংহিতার,	
tahorir,	তাহরীর,	তাহরীর,	
definition,	ডিফিশিন়ন,	ডেফিনেশন,	
sushposhtolikhito,	সুষ্পশ্থলিতিত,	সুষ্পষ্টলিখিত,	
prakar,	প্রকার,	প্রকার,	
amudey,	অমেদে,	আমুদে,	
ashonkai,	আশোককাই,	আশঙ্কাই,	
katbe,	কাটবে,	কাটবে,	
panchbar,	পাঁচবার,	পাঁচবার,	
monur,	মনুর,	মনুর,	
shandra,	শান্দ্রার,	শান্দ্রার,	
parswer,	পারস্বের,	পার্শ্বের,	
hafej,	হাফেজ,	হাফেয,	
addata,	আদ্দাতা,	আড্ডাটা,	
azaan,	আজান,	আজান,	
brail,	ব্রেইল,	ব্রেইল,	
ranangone,	রণাঙ্গনে,	রণাঙ্গনে,	
chargar,	চরগগার,	চার্জার,	
jerusalemer,	জেরুসাসেমের,	জেরুজালেমের,	
smarak,	স্মারক,	স্মারক,	
farna,	ফার্না,	ফার্ন,	
coons,	কিনস,	কুনস,	
bairey,	বায়েরে,	বাইরে,	
ooipoka,	আয়পকা,	উইপোকা,	
neker,	নেকের,	নেকের,	
miley,	মিলি,	মিলে,	
kalenga,	কালেঙ্গা,	কালেঙ্গা,	
aamontrito,	আমন্ত্রিত,	আমন্ত্রিত,	
vaibon,	ভাই়োন,	ভাইবোন,	
zeebonto,	জীবন্ত,	জীবন্ত,	
durgotsabe,	দুর্গদৎসবে,	দুর্গোৎসবে,	
shomser,	শমসের,	সমশের,	
huk,	হুক,	হুক,	
shikkhartheerao,	শিক্ষার্থীরাও,	শিক্ষার্থীরাও,	
yukeliptash,	যুকেলিপ্তস,	ইউক্যালিপ্টাস,	
echhti,	এছটি,	এছটি,	
mase,	মাসে,	মাসে,	
gloria,	গ্লোরিয়া,	গ্লোরিয়া,	
jhijhi,	ঝিঝি,	ঝিঝি,	
ekbakke,	একবাককে,	একবাক্যে,	
monroe,	মনরর,	মনেরোর,	
touraat,	তৌরা,	তওরাত,	
soceitytey,	সকিটিয়ে,	সোসাইটিতে,	
ashanka,	আশঙ্ক,	আশংকা,	
jalbe,	জালবে,	জ্বলবে,	
abheedhaaneek,	অভিধানীক,	অভিধানিক,	
bajhyo,	বাঝ্য,	বাহ্য,	
cheerokoomari,	চিরকুমারী,	চিরকুমারী,	
metropalitana,	মেট্রোপালিটা,	মেট্রোপলিটন,	
goora,	গুরা,	গোর,	
afrazuler,	আফরাজুলের,	আফরাজুলের,	
lagto,	লাগতো,	লাগতো,	
dokkhinangsho,	দক্ষিণাংশ,	দক্ষিণাংশ,	
byepass,	ব্যেপস,	বাইপাস,	
dai,	দাই,	দিই,	
chhootochhuti,	ছছুটছুটি,	ছুটোছুটি,	
bhoolapuka,	ভূলাপুকা,	ভোলাপুক,	
harees,	হেরিস,	হ্যারিস,	
kiuti,	কিউটি,	কিউটি,	
rokibul,	রোকিবুল,	রকিবুল,	
cholchhe,	চলছে,	চলছে,	
nikote,	নিকোট,	নিকটে,	
daltagi,	দালতাগী,	দলত্যাগী,	
janghu,	জংঘু,	জঙ্ঘু,	
matt,	ম্যাট,	ম্যাট,	
shiulijhra,	শিউলিঝরা,	শিউলিঝরা,	
esprito,	এসপ্রিতো,	এস্পিরিটো,	
groth,	গ্রোথ,	গ্রোথ,	
eexpreession,	ইক্সপ্রেশন,	এক্সপ্রেশন,	
raiji,	রাইজি,	রাইজি,	
shekarmani,	শেকররমণি,	শেকরমানি,	
rubidium,	রুবিউদিয়ামের,	রুবিডিয়াম,	
kisti,	কিস্তি,	কিস্তি,	
jandrel,	জন্দ্রেল,	জাঁদরেল,	
vabuk,	ভবুক,	ভাবুক,	
rodney,	রডনি,	রেডনি,	
soinyo,	সৈন্য,	সৈন্য,	
harasta,	হারাস্তা,	হারাস্তা,	
rena,	রেনা,	রেনো,	
pet,	পেট,	পেত,	
rca,	আরএসএ,	আরসিএ,	
jyesthaa,	জ্যেষ্ট,	জ্যেষ্ঠা,	
chalachchitrer,	চলাচিত্রের,	চলচ্চিত্রের,	
ganaporibahaner,	গণপরিবাহনের,	গণপরিবহনের,	
khaaneker,	খানেকের,	খানেকের,	
sangitanusthane,	সঙ্গীতানুষ্ঠানে,	সঙ্গীতানুষ্ঠানে,	
nirbachakder,	নির্বাচকদের,	নির্বাচকদের,	
licensin,	লাইসেনসিন,	লাইসেন্সিং,	
samaveshke,	সমাভেষকে,	সমাবেশকে,	
abosare,	অবসারে,	অবসরে,	
jini,	জিনি,	যিনি,	
maaktoome,	মাকতুমে,	মাকতুম,	
konorup,	কোনরূপ,	কোনরূপ,	
title,	টিটলে,	টাইটেল,	
bhushito,	ভূষিত,	ভূষিত,	
apad,	আপাদ,	আপদ,	
prarthitao,	প্রার্থীতাও,	প্রার্থীতাও,	
sharifpur,	শরিফপুরের,	শরিফপুর,	
elakatay,	এলাকাটা,	এলাকাতে,	
ghotaibe,	ঘটাইবে,	ঘটাইবে,	
hitaishi,	হিতাইশি,	হিতৈষী,	
hepatetisa,	হেপাটেটিস,	হেপাটাইটিস,	
ajeeboner,	আজীবনের,	আজীবনের,	
corymb,	কোরিম্ব,	করিম,	
deqe,	দেকে,	ডেকে,	
nikela,	নিকেলা,	নিকেল,	
konroop,	কোরুপ,	কোনরূপ,	
bokul,	বকুল,	বকুল,	
sangkulaan,	সংকুলান,	সংকুলান,	
forex,	ফররেক্স,	ফরেক্স,	
modhyekar,	মধ্যেকার,	মধ্যেকার,	
uposhthit,	উপস্থিত,	উপস্থিত,	
fooloo,	ফুলু,	পোলো,	
dibi,	দিবি,	দিবি,	
highcomissione,	হাইকমোশিশনে,	হাইকমিশনে,	
batsmanei,	ব্যাটসম্যানেই,	ব্যাটসম্যানই,	
doorotomo,	দূরতম,	দূরতম,	
gafeeloti,	গাফিলতি,	গাফিলতি,	
panchashjan,	পঞ্চশজন,	পঞ্চাশজন,	
bikromei,	বিক্রমেই,	বিক্রমেই,	
nirmolota,	নির্মলতা,	নির্মলতা,	
shtonehenge,	স্তনেেহেঙ্গে,	স্টোনহেঞ্জ,	
bm,	বিএমএম,	বিএম,	
sollallhu,	সোল্লাল্লহু,	সল্লাল্লাহু,	
hypar,	হাপার,	হাইপার,	
manbe,	মানবে,	মানবে,	
uddhrita,	উদ্ধৃত,	উদ্ধৃত,	
kaia,	কাই,	কায়া,	
noteti,	নোটি,	নোটটি,	
gronther,	গ্রন্থের,	গ্রন্থের,	
karuna,	করুনা,	করুণা,	
khoakshir,	খোয়াকশির,	খোয়াক্ষীর,	
sanaktakaran,	সনক্তকরণ,	সনাক্তকরণ,	
sikkharrtheerao,	শিক্ষার্থীরাও,	শিক্ষার্থীরাও,	
umb,	ইউএমবি,	ইউএমবি,	
kommandar,	কোম্মান্দার,	কমাণ্ডার,	
rajtantro,	রাজতান্ত্র,	রাজতন্ত্র,	
raghubar,	রঘুবার,	রঘুবীর,	
byaboharkareer,	ব্যবহারকারীর,	ব্যবহারকারীর,	
teemothi,	তীমোথি,	টিমোথি,	
awatar,	আআয়াতার,	অবতার,	
matthews,	ম্যাথেভস,	ম্যাথিউস,	
duio,	দুইও,	দুইও,	
kartona,	কার্তনা,	করতনা,	
plak,	প্লাক,	প্ল্যাক,	
hindutirtha,	হিন্দুতীর্থ,	হিন্দুতীর্থ,	
deputee,	দেপুটি,	ডেপুটি,	
peterke,	পেটারকে,	পিটারকে,	
lavta,	লাভতা,	লাভটা,	
conservetion,	কনজারভেশন,	কনসারভেশন,	
mumtazer,	মুমতাজের,	মুমতাজের,	
anchalgulir,	আঞ্চলগুলির,	অঞ্চলগুলির,	
makong,	মাকং,	মেকং,	
epiela,	এপিয়াল,	আইপিএল,	
nodiitei,	নোদিতেই,	নদীতেই,	
chhotogolper,	ছোটগলপের,	ছোটগল্পের,	
bishnoo,	বিষ্ণ,	বিষ্ণু,	
unchuporjayer,	উঁচুরপর্যায়ের,	উঁচুপর্যায়ের,	
bostubad,	বস্তুবাদ,	বস্তুবাদ,	
atak,	আটাক,	আটক,	
licencer,	লাইসেন্সের,	লাইসেন্সের,	
kuronir,	কুরোনির,	কুরনীর,	
uindoos,	উইন্ডসস,	উইন্ডোস,	
kumbhalnar,	কুম্ভলন্নার,	কুম্ভালনার,	
gujob,	গুজব,	গুজব,	
probondhobhittik,	প্রবন্ধভিত্তিক,	প্রবন্ধভিত্তিক,	
bapokotor,	বাপকতর,	ব্যাপকতর,	
abanishankar,	অবনশিঙ্কর,	অবনিশংকর,	
beshirbhaagei,	বেশীরভাগেই,	বেশিরভাগেই,	
probeshan,	প্রবেশাণ,	প্রবেশন,	
horippur,	হরিপপুর,	হরিপুর,	
bonnypran,	বনিপ্রান,	বন্যপ্রাণ,	
mukhya,	মুখ্যা,	মুখ্য,	
nosihote,	নসীহতে,	নসিহতে,	
eesosiyeetasa,	ইসোসিয়েটস,	এসোসিয়েটস,	
playtey,	প্লেটে,	প্লেটে,	
vobani,	ভবানি,	ভবানী,	
soomita,	সুমিতা,	সুমিতা,	
drissoteer,	দৃশ্মটির,	দৃশ্যটির,	
infarmatian,	ইনফারমেশন,	ইনফরমেশন,	
shotodha,	ষতধা,	শতধা,	
purbancoler,	পূর্বানকলের,	পূর্বাঞ্চলের,	
chirkoot,	চিরকুট,	চিরকুট,	
stagecraft,	স্টেগকার্ট্ট,	স্টেজক্রাফট,	
kichutei,	কিছুটেই,	কিছুতেই,	
bulan,	বুলান,	বুলান,	
sommotite,	সম্মতিতে,	সম্মতিতে,	
dabliudabliui,	ডাব্লিউডিবাউলিই,	ডাব্লিউডাব্লিউই,	
kanar,	কানার,	কণার,	
ramachandranke,	রামাচন্দ্রকে,	রামাচন্দ্রনকে,	
talgachh,	তালগাছ,	তালগাছ,	
konruup,	কনরুপ,	কোনরূপ,	
anhu,	আনহু,	আনহু,	
bayshorkarikarone,	বায়শর্ককিকরণে,	বেসরকারিকরণ,	
shatan,	শাতান,	শয়তান,	
kormoke,	কর্মকে,	কর্মকে,	
lidars,	লিডারস,	লিডার্স,	
jaadrel,	যাদরেল,	জাঁদরেল,	
pooshti,	পুশটি,	পুষ্টি,	
nothivukta,	নথিভুক্ত,	নথিভুক্ত,	
nagorikke,	নাগরীককে,	নাগরিককে,	
biswashi,	বিশ্বাসী,	বিশ্বাসই,	
arifin,	আরিফিন,	আরিফিন,	
bethikata,	বেথিকাতা,	বেঠিকতা,	
streegon,	স্ট্রীগন,	স্ত্রীগণ,	
jonoshongjog,	জনশংযোগ,	জনসংযোগ,	
milayatane,	মিলায়াতনে,	মিলায়তনে,	
transapharma,	ট্রান্সারফম্মা,	ট্রান্সফর্ম,	
chitronattakar,	চিত্রনাত্তকর,	চিত্রনাট্যকার,	
puroheetder,	পুরোহিতদের,	পুরোহিতদের,	
railliner,	রেল্লিনের,	রেললাইনের,	
choudry,	চৌদ্রি,	চৌধুরী,	
liedtke,	লিডডটকে,	লইডটক,	
shhow,	সোও,	শো,	
mojdur,	মজদুর,	মজদুর,	
ancholgoolote,	অঞ্চলগুলোতে,	অঞ্চলগুলোতে,	
ahong,	আহংং,	অহং,	
shrichaitanyadev,	শ্রীচাতন্যাবে,	শ্রীচৈতন্যদেব,	
augustine,	অগাস্টাইন,	অগাস্টিন,	
upobaashee,	উপবাশী,	উপবাসী,	
karmake,	কার্মাকে,	কর্মকে,	
manushe,	মানুশে,	মানুষে,	
hooldim,	হুল্ডমি,	হোল্ডিং,	
nyeta,	নইয়েটা,	ম্যাট,	
sten,	স্টেন,	স্টেন,	
nanir,	নানির,	নানীর,	
greenald,	গ্রিনাল্ড,	গ্রিনল্ড,	
nopdnodir,	নপ্দদদির,	নদনদীর,	
kampita,	কম্পিটা,	কম্পিত,	
protinito,	প্রতিনীত,	প্রতিনিত,	
shilpojaat,	শিল্পজাত,	শিল্পজাত,	
saoum,	সিওওওএম,	সাওম,	
torkareer,	তরকারীর,	তরকারীর,	
shaddhi,	শাদ্ধি,	সাধ্বী,	
sompadon,	সম্পাদন,	সম্পাদন,	
cbi,	সিবিআই,	সিবিআই,	
durtomo,	দুর্তম,	দূরতম,	
bhandti,	ভাণ্ডটি,	ভাণ্ডটি,	
arke,	আরকে,	আরকে,	
tigmanshu,	তিগংমানশু,	তিগ্মাংশু,	
sonaicha,	সোনাইচা,	সোনাইচা,	
pakistanira,	পাকিস্তানিরা,	পাকিস্তানীরা,	
parisankhanbid,	পরিসংখা্বিদ,	পরিসংখ্যানবিদ,	
monzushree,	মঞ্জুশ্রী,	মঞ্জুশ্রী,	
fatakasto,	ফাতাকাস্ত,	ফাটাকেষ্ট,	
agaldar,	আগলদার,	আগলদার,	
shasonkarta,	শাসনকারটা,	শাসনকর্তা,	
sangbadmadhyamgulote,	সংবাদমাধ্যমগুলোতে,	সংবাদমাধ্যমগুলোতে,	
paroner,	পারণের,	পারণের,	
nodimaatrik,	নদীমাত্রিক,	নদীমাতৃক,	
rohasyati,	রহাস্যাটি,	রহস্যটি,	
falak,	ফালাক,	ফলক,	
kantajir,	কান্তাজির,	কান্তজির,	
grootha,	গ্রুথা,	গ্রোথ,	
ghurechen,	ঘুরেছেন,	ঘুরেছেন,	
oitijhya,	ঐতিহ্যা,	ঐতিহ্য,	
shubhag,	শুভাগ,	শুভাগ,	
olympic,	অলিম্পিক,	অলিম্পিক,	
oncoleo,	অংকলেও,	অঞ্চলেও,	
bojhaao,	বোঝাও,	বোঝাও,	
grambaasheeo,	গ্রামবাশীও,	গ্রামবাসীও,	
achintopurer,	অচিন্তপুরের,	অচিন্তপুরের,	
middleton,	মিডলটন,	মিডলটন,	
ekatto,	একাত্ব,	একাত্ব,	
sanaktokaran,	সনক্তকরণ,	সনাক্তকরণ,	
aabarte,	আবর্তে,	আবর্তে,	
karir,	কারীর,	কারীর,	
langhaner,	লাঘনের,	লংঘনের,	
chhooteete,	ছুটিতে,	ছুটিতে,	
tokeo,	টোকেও,	টোকেও,	
sheetke,	সীতকে,	শীতকে,	
rastagulikeo,	রাস্তাগুলিকেও,	রাস্তাগুলিকেও,	
haripur,	হরিপুর,	হরিপুর,	
hilser,	হিলসের,	হিলসের,	
swastir,	স্বস্তির,	স্বস্তির,	
tricksguli,	ট্রিকসসগুলি,	ট্রিকসগুলি,	
bohudeen,	বহুদীন,	বহুদিন,	
tintikey,	তিনটিকে,	তিনটিকে,	
suparichito,	সুপারিচিত,	সুপরিচিত,	
spreadshiit,	স্প্রেডশিট,	স্প্রেডশীট,	
bouddho,	বৌদ্ধ,	বৌদ্ধ,	
myat,	ম্যাট,	ম্যাট,	
karmokarke,	কার্মকারকে,	কর্মকারকে,	
mojlish,	মজলিশ,	মজলিশ,	
neelkamal,	নীলকামাল,	নীলকমল,	
latsaheb,	লটসহেব,	লাটসাহেব,	
poriikkhateo,	পরীক্ষাতেও,	পরীক্ষাতেও,	
annorup,	আন্নুরূপ,	অন্যরূপ,	
shoori,	শূরী,	সুরি,	
udbhaboni,	উদ্ভাবনী,	উদ্ভাবনী,	
sures,	সুরেস,	সুরেশ,	
spredasita,	স্প্র্যাডিটি,	স্প্রেডশীট,	
manatmulak,	মননতমূলক,	মানতমূলক,	
semai,	সেমাই,	সেমাই,	
yuroo,	যুরু,	ইউরো,	
byaboharkari,	ব্যবহারকারী,	ব্যবহারকারী,	
uddhrito,	উদ্ধৃত,	উদ্ধৃত,	
nibirbhabe,	নিবীরভাবে,	নিবিরভাবে,	
beshakbar,	বেশকবার,	বেশকবার,	
vishnuu,	বিষ্ণু,	বিষ্ণু,	
moshzidtike,	মশশ্দিটিকে,	মসজিদটিকে,	
weelcomee,	ওইলকম্,	ওয়েলকাম,	
jomjamat,	জজমাাত,	জমজমাট,	
khaschandpur,	খাসচাঁদপুর,	খাসচাঁদপুর,	
masjidsaha,	মাজসিদসহ,	মসজিদসহ,	
nisader,	নিসাদের,	নিষাদের,	
salmaner,	সালমানের,	সালমানের,	
ghotolen,	ঘটলেন,	ঘটলেন,	
bolbo,	বলবো,	বলবো,	
nothibhukteer,	নথিভুক্তির,	নথিভুক্তির,	
tata,	টেটা,	তাতা,	
parka,	পারকা,	পার্ক,	
bonvumi,	বনভূমি,	বনভূমি,	
laishensha,	লাইশেন্স,	লাইসেন্স,	
manabmaner,	মানবমানের,	মানবমনের,	
aflatoxin,	আফ্লাটককিনস,	আ্যফ্ল্যাটক্সিন,	
rajshri,	রাজশ্রী,	রাজশ্রী,	
prajanankal,	প্রজানকল,	প্রজননকাল,	
directorate,	ডিরেক্টরেট,	ডিরেক্টরেট,	
zubokder,	যুবকদের,	যুবকদের,	
utkhaat,	উৎকাাত,	উত্খাত,	
biphal,	বিপাল,	বিফল,	
indro,	ইন্দ্রো,	ইন্দ্র,	
sumoo,	সুমোও,	সুমো,	
kutubuddinke,	কুতুবুদ্দিনকে,	কুতুবুদ্দিনকে,	
chinto,	চিন্তো,	চিনতো,	
michhilti,	মিছিলটি,	মিছিলটি,	
soorsa,	সূরসা,	সোর্স,	
hajirhat,	হাজীরহাট,	হাজিরহাট,	
asif,	আসিফ,	আসিফ,	
tuleche,	তুলেছে,	তুলেছে,	
shangkulaan,	সংকুলান,	সংকুলান,	
sondhisthaponer,	সন্ধিষ্ঠাপনের,	সন্ধিস্থাপনের,	
rajan,	রাজান,	রাজন,	
songasthatike,	সংস্থাতাকে,	সংস্থাটিকে,	
mayily,	মায়িলি,	মাইলি,	
zibonnogor,	জীবনগর,	জীবননগর,	
mukhomandal,	মুখমান্ডল,	মুখমণ্ডল,	
basakey,	বাসাকে,	বাসাকে,	
ghoshito,	ঘোষিত,	ঘোষিত,	
khargosher,	খার্োশের,	খরগোসের,	
madraser,	মাদ্রাসের,	মাদ্রাজের,	
chotogolper,	চটগলপের,	ছোটগল্পের,	
siddhante,	সিদ্ধান্তে,	সিদ্ধান্তে,	
associatis,	অ্যাসোসিয়াটিস,	এসোসিয়েটস,	
shector,	সেক্টর,	সেক্টর,	
anandamahale,	আনন্দমহলে,	আনন্দমহলে,	
bidhirnityang,	বিধিরৃত্যংং,	বিধির্নিত্যং,	
rajtontre,	রাজতন্ত্রে,	রাজতন্ত্রে,	
elakaai,	এলাকাই,	এলাকাই,	
toufik,	তৌফিক,	তৌফিক,	
hoondayi,	হুন্দায়ি,	হুন্দাই,	
rudroke,	রুদ্রকে,	রুদ্রকে,	
bhabarlaler,	ভাবারলালের,	ভবরলালের,	
hijritey,	হিজরিতে,	হিজরীতে,	
nederlande,	নেদারল্যান্ডে,	নেদারল্যান্ডে,	
seekkhaou,	সিক্ষাও,	শিক্ষাও,	
pleto,	প্লেটো,	প্লেটো,	
abosan,	অবসান,	অবসান,	
nirikhe,	নিরিখে,	নিরিখ,	
mercial,	মার্সিয়াল,	মার্শিয়াল,	
mutar,	মুতার,	মুতার,	
indrani,	ইন্দ্রানী,	ইন্দ্রাণী,	
sangosrobomukto,	সংস্ররূমক্ত,	সংস্রবমুক্ত,	
hari,	হারি,	হরি,	
kaley,	কালে,	কালে,	
besirvagei,	বেসিরভাগেই,	বেশিরভাগেই,	
sadadyarao,	সদাদ্যারাও,	সদদ্যরাও,	
noditir,	নদীতির,	নদীটির,	
gobeshakgon,	গবেষাকগণ,	গবেষকগণ,	
sumitrar,	সুমিত্রার,	সুমিত্রার,	
swairacharibirodhi,	স্বৈরাচারিবোধী,	স্বৈরাচারীবিরোধী,	
asamanyo,	অসামান্য,	অসামান্য,	
dorgaaho,	দর্গাহ,	দরগাহ,	
balakarak,	বালাকারক,	বলকারক,	
orthanitir,	অর্থানীতির,	অর্থনীতির,	
keuoi,	কেও,	কেউই,	
sadeena,	সাদিনা,	সাডেন,	
poripakey,	পরিপাকে,	পরিপাকে,	
chalochchitreei,	চলচ্চিত্রী,	চলচ্চিত্রেই,	
ooporoshtho,	অপরস্থ,	উপরস্থ,	
sampadon,	সম্পাদন,	সম্পাদন,	
soleel,	সোলিল,	সলিল,	
hansasya,	হানসস্য,	হংসস্য,	
choson,	চোন,	চোষণ,	
siddhanter,	সিদ্ধান্তের,	সিদ্ধান্তের,	
meloonborrone,	মেলুনবরেণ,	মেলবোর্নে,	
fotanor,	ফোটানোর,	ফোটানোর,	
backflipe,	ব্যাকফ্লিপে,	ব্যাকফ্লিপে,	
mexicoteo,	মেক্সিকটেও,	মেক্সিকোতেও,	
everestey,	এভারেস্টেই,	এভারেস্টে,	
bisshas,	বিশ্বাস,	বিশ্বাস,	
qonflict,	কনফ্লিকট,	কনফ্লিক্ট,	
dhormoprobortokder,	ধর্মপ্রবর্তকবেদের,	ধর্মপ্রবর্তকদের,	
pancbaar,	পাঁ্বার,	পাঁচবার,	
hojurer,	হজুরের,	হজুরের,	
ganoporibahoner,	গণপরিবাহনের,	গণপরিবহনের,	
noditei,	নদিতেই,	নদীতেই,	
airish,	আইরিশ,	আইরিস,	
conflikt,	কনফ্লিক্ট,	কনফ্লিক্ট,	
sarboshokteeman,	সর্বশক্তিমান,	সর্বশক্তিমান,	
uporitale,	উপরিতালে,	উপরিতলে,	
tiunara,	টিউনার,	টিউনার,	
orthisoho,	অর্থিসহ,	অর্থিসহ,	
bossoben,	বসবেন,	বসবেন,	
pratisthanikvabe,	প্রতিস্থানিকভাবে,	প্রাতিষ্ঠানিকভাবে,	
taroni,	তারোনি,	তরণী,	
faaj,	ফাজ,	ফাজ,	
lambaate,	লাম্বাতে,	লম্বাটে,	
chaloke,	চালোকে,	চালকে,	
khonjena,	খোঁজেনা,	খোঁজেনা,	
shikhaboudi,	শিখাবৌদি,	শিখাবৌদি,	
nirmankarmisaha,	নির্মানকর্মীসহ,	নির্মাণকর্মীসহ,	
gavaskar,	গাভাসকার,	গাভাস্কার,	
muradkey,	মুরাদকে,	মুরাদকে,	
chikitsar,	চিকিৎসার,	চিকিত্সার,	
basaalt,	বাসল্,	ব্যাসল্ট,	
edmeeral,	এডমিরাল,	এডমিরাল,	
blasterke,	ব্লাস্টারকে,	ব্লাস্টারকে,	
parq,	পার্ক,	পার্ক,	
makhno,	মাখনও,	মাখনো,	
plasse,	প্লাসে,	প্লাসে,	
gaj,	গাজ,	গেজ,	
dekaner,	দেকানের,	দেকানের,	
bishaashke,	বিশাশকে,	বিশ্বাসকে,	
huqa,	হুকা,	হুক,	
bhagno,	ভাগননো,	ভগ্ন,	
qor,	করর,	কর,	
jibonnogor,	জীবনগর,	জীবননগর,	
rushad,	রুশাদ,	রুশদ,	
barnis,	বার্নিস,	বার্নিশ,	
shten,	শ্টেন,	স্টেন,	
chittronatyokar,	চিত্রনাত্রকাযার,	চিত্রনাট্যকার,	
annanere,	আন্নানেরে,	অন্যানেরে,	
bondira,	বন্দীরা,	বন্দীরা,	
sayanaida,	সায়নাইদা,	সায়ানাইড,	
pyor,	প্যোর,	পিওর,	
habol,	হাবল,	হাবোল,	
rajbandir,	রাজবন্দির,	রাজবন্দীর,	
songkolonti,	সংকলনটি,	সংকলনটি,	
projanankal,	প্রজাননকাল,	প্রজননকাল,	
kobutorer,	কবুতরের,	কবুতরের,	
satarkabhabey,	সতর্কভাবে,	সতর্কভাবে,	
headquartus,	হেডকার্টাস,	হেডকোয়ার্টাস,	
prakalpagulor,	প্রকালপুগুর,	প্রকল্পগুলোর,	
chalochchitro,	চালচ্ছিত্র,	চলচ্চিত্র,	
atighataner,	অতিঘাতানের,	অতিঘটনের,	
protibedokrao,	প্রতিবেদকারাও,	প্রতিবেদকরাও,	
nirapattamulok,	নিরাপত্তামূলক,	নিরাপত্তামূলক,	
kushakhali,	কুশাখালি,	কুশাখালি,	
akeeb,	আকিব,	আকিব,	
kindom,	কিন্দম,	কিংডম,	
jemy,	জেম্যি,	জেমি,	
maila,	মাইলা,	মাইল,	
samoshtigato,	সমষ্টিগত,	সমষ্টিগত,	
babona,	বাবনা,	বাবনা,	
steen,	স্টিন,	স্টেন,	
giitikobita,	গীতিকবিতা,	গীতিকবিতা,	
naneer,	নানীর,	নানীর,	
mesenjarer,	মেজেঙ্জারের,	মেসেঞ্জারের,	
khamotagulor,	ক্ষমতাগুলোর,	ক্ষমতাগুলোর,	
nisshongotake,	নিঃশঙ্গতাকে,	নিঃসঙ্গতাকে,	
ansareer,	আনসারীর,	আনসারীর,	
podarthobidder,	পদার্থবিদদের,	পদার্থবিদদের,	
salapheeta,	সালফিত,	সালফেট,	
nabyata,	নব্যতা,	নাব্যতা,	
bhittow,	ভিত্তৌ,	ভিত্তিও,	
laaz,	লাজ,	লাজ,	
ekghore,	একঘরে,	একঘরে,	
kuttake,	কুট্টাকে,	কুত্তাকে,	
erokomer,	এরকমের,	এরকমের,	
poddhotitei,	পদ্ধটিতেই,	পদ্ধতিতেই,	
pyaleshtainer,	প্লালেশ্টাইনের,	প্যালেস্টাইনের,	
disni,	দিসনি,	ডিজনী,	
tigre,	টিগ্রে,	টাইগার,	
akten,	আকতেন,	অকটেন,	
choshon,	চোষণ,	চোষণ,	
neshadrabyer,	নেশাদ্রব্যের,	নেশাদ্রব্যের,	
drishi,	দ্রিশী,	দৃশ্যই,	
milton,	মিলটন,	মিলটন,	
iuro,	ইউর,	ইউরো,	
agomonke,	আগমনকে,	আগমনকে,	
hena,	হেনা,	হেনা,	
rajendracholer,	রাজেন্দ্রচলের,	রাজেন্দ্রচোলের,	
ekshoti,	একশটি,	একশোটি,	
thyachara,	থ্যাচারা,	থ্যাচার,	
install,	ইনস্টেল,	ইন্সটল,	
adorso,	আদরসো,	আর্দশ,	
vodqa,	ভোদকা,	ভদকা,	
azin,	আজিন,	আজিন,	
restuarant,	রেস্টুয়েরান্ট,	রেষ্টুরেন্ট,	
hoteltee,	হোটেলটি,	হোটেলটি,	
pariyech,	পারিয়েছ,	পরিয়েছ,	
lebina,	লেবিনা,	লেবিনা,	
tapdei,	তাপদেই,	তাপড়েই,	
taunsheep,	তৌনশীপ,	টাউনশিপ,	
pratisthasaho,	প্রতিষ্ঠাসহ,	প্রতিষ্ঠাসহ,	
gopalrao,	গোপললারাও,	গোপালরাও,	
narsinghomgulor,	নার্সিংহগুলোর,	নার্সিংহোমগুলোর,	
shasankorta,	শাসনকর্তা,	শাসনকর্তা,	
drishyogulotey,	দৃশ্যগুলোতে,	দৃশ্যগুলোতে,	
paste,	পাস্তে,	পেষ্ট,	
mentither,	মেনটিথের,	মেনটিথের,	
shikshakbrinda,	শিক্ষকবৃন্দ,	শিক্ষকবৃন্দ,	
byatari,	ব্যাতারি,	ব্যাটারী,	
gyada,	জ্যাদা,	গ্যাদা,	
indra,	ইন্দ্রা,	ইন্দ্র,	
utpatti,	উৎপাতটি,	উতপত্তি,	
dhormokorme,	ধর্মকর্মে,	ধর্মকর্মে,	
ekspression,	এক্সপ্রেশন,	এক্সপ্রেশন,	
spreedashita,	স্প্রদাশিত,	স্প্রেডশীট,	
lekhaksattwar,	লেখকসত্ত্বর,	লেখকসত্ত্বার,	
magical,	ম্যাজিক্যাল,	ম্যাজিকাল,	
madaspushto,	মাদাপপুষ্ট,	মদদপুষ্ট,	
kichudinpar,	কিছুদিন্পর,	কিছুদিনপর,	
acrolect,	অ্যাক্রোলেক্ট,	অ্যাক্রোলেক্ট,	
jeelyaand,	জিল্যান্ড,	জিল্যান্ড,	
sardar,	সারদার,	সরদার,	
saranor,	সারানোর,	সরানোর,	
songbadmadhyomer,	সংবাদমাধ্যমের,	সংবাদমাধ্যমের,	
bharotchilo,	ভারততিল,	ভারতছিল,	
gannaprakasham,	গণ্নাপ্রকা্ষম,	গন্নাপ্রকাশম,	
drissogulote,	দৃশ্যগুলোতে,	দৃশ্যগুলোতে,	
okritokarjo,	অকৃতিকার্য,	অকৃতকার্য,	
prokolpogulor,	প্রকল্পগুলোর,	প্রকল্পগুলোর,	
nanilalke,	নানীলালকে,	ননীলালকে,	
chalaabi,	চালাবি,	চালাবে,	
qraima,	ক্রেইমা,	ক্রাইম,	
byan,	ব্যান,	ব্যাং,	
aachhis,	আছিস,	আছিস,	
idipasha,	ইডিপাশা,	ইডিপাস,	
daaradaa,	দারাদা,	দারদা,	
municipal,	মুনিসিপাল,	মিউনিসিপ্যাল,	
abhidhaner,	অভিধানের,	অভিধানের,	
mirina,	মিরিনা,	মিরিনা,	
diiptii,	দিয়প্তিই,	ডেপুটি,	
contemporary,	কন্টমমাররির,	কন্টেম্পোরারি,	
taffsherer,	তফফেরের,	তাফসীরের,	
baptics,	ব্যাপ্টিক্স,	ব্যাপটিকস,	
crucer,	ক্রুসের,	ক্রুশের,	
udbodhaney,	উদ্বোধনী,	উদ্বোধনে,	
churger,	চার্গার,	চার্জের,	
durgatsabe,	দুর্গৎসবে,	দুর্গোৎসবে,	
obdi,	অব্দি,	অব্দি,	
aalkatraa,	আলকাত্রা,	আলকাতরা,	
chaaktir,	চাক্তির,	চাকতির,	
mulbhitti,	মূলভিত্তি,	মূলভিত্তি,	
seoul,	সিউল,	সোল,	
mosharroph,	মোশারফফ,	মশাররফ,	
jor,	জোর,	জ্বর,	
prosadhani,	প্রসাধানি,	প্রসাধনী,	
dooburir,	দুবুরির,	ডুবুরির,	
laishensh,	লেইশেন্স,	লাইসেন্স,	
chhintayikari,	ছিন্তাইকারী,	ছিনতাইকারী,	
hamburgey,	হ্যামবুর্গে,	হামবুর্গে,	
mulvitti,	মূলভীত্তি,	মূলভিত্তি,	
kaathhaamaandu,	কাঠামন্ডু,	কাঠমান্ডু,	
mardud,	মরদুদ,	মরদুদ,	
bharatey,	ভারতে,	ভারতে,	
baibasthaar,	বাইবাস্থার,	ব্যবস্থার,	
songasthatir,	সংস্থাটির,	সংস্থাটির,	
prasadhani,	প্রসাধানি,	প্রসাধনী,	
maail,	মাল,	মাইল,	
lyandim,	ল্যান্ডিম,	ল্যান্ডিং,	
bachai,	বাচাই,	বাছাই,	
daybhager,	ডয়ভাগের,	দায়ভাগের,	
gujab,	গুজাব,	গুজব,	
chitlar,	চিতলার,	চিতলার,	
wedanta,	ওয়েদান্টা,	বেদান্ত,	
podotyagsongkranto,	পদত্যাসংক্রান্ত,	পদত্যাগসংক্রান্ত,	
bolatkar,	বলাতকর,	বলাৎকার,	
kosambir,	কোসাম্বীর,	কোসাম্বীর,	
booksar,	বুকসার,	বুক্সার,	
sambatsarkal,	সম্বাতসরকল,	সম্বৎসরকাল,	
chandanara,	চন্দনারা,	চন্দনারা,	
nagorikota,	নাগরীকোা,	নাগরিকতা,	
byomkes,	ব্য়মকেস,	ব্যোমকেশ,	
sahojatprobritti,	সহজাত্রবৃত্তি,	সহজাতপ্রবৃত্তি,	
shahurgulor,	শহুরগুলোর,	শহুরগুলোর,	
munshiji,	মুন্সিজি,	মুনশীজি,	
bhabaponno,	ভাপাপন্ন,	ভাবাপন্ন,	
transformaarer,	ট্রান্সফরমারের,	ট্রান্সফরমারের,	
jansha,	জানশা,	জন্স,	
nischitobhave,	নিশ্চিতভাবে,	নিশ্চিতভাবে,	
khuliechilam,	খুলিয়েছিলাম,	খুলিয়েছিলাম,	
turky,	টার্কি,	তুর্কি,	
shucharita,	শুচারিতা,	সুচরিতা,	
sohokari,	সহকারী,	সহকারী,	
anusthane,	অনুষ্ঠানে,	অনুষ্ঠানে,	
maunchostho,	মঞ্চস্থ,	মঞ্চস্থ,	
armshtronj,	আর্মশ্টররঞ্জ,	আর্মস্ট্রং,	
mach,	মাচ,	মাছ,	
kadapaker,	কাডাপাকার,	কড়াপাকের,	
uparjon,	উপার্জন,	উপার্জন,	
gabeshonar,	গবেশনার,	গবেষনার,	
evaner,	ইভানের,	ইভানের,	
prakare,	প্রকারে,	প্রকারে,	
patjata,	পাটজাতা,	পাটজাত,	
piulir,	পিউলির,	পিউলির,	
tolemyr,	টোলমমার,	টলেমির,	
rifleksa,	রিফলেকসা,	রিফ্লেক্স,	
chowdhurir,	চৌধুরির,	চৌধুরীর,	
reejideencee,	রেজিডিন্সে,	রেসিডেন্স,	
dishani,	দিশানি,	দিশানি,	
gaddaphii,	গদ্ড়াই,	গাদ্দাফী,	
cinematographar,	সিনেমাটোগ্রাফার,	সিনেমাটোগ্রাফার,	
shringge,	শ্রিংগে,	শৃঙ্গে,	
ixprission,	আইক্সপ্রিশন,	এক্সপ্রেশন,	
thailandshoho,	থাইলান্দসহ,	থাইল্যান্ডসহ,	
dwibidho,	দ্বিবিধো,	দ্বিবিধ,	
dacope,	ড্যাকোপ,	দাকোপ,	
jakso,	জাকোসো,	যক্ষ,	
bosonte,	বসন্তে,	বসন্তে,	
mile,	মিলে,	মিলে,	
cn,	সিএনএন,	সিএন,	
buth,	বুথ,	বুথ,	
nirbaaho,	নির্বাহ,	নির্বাহ,	
romancha,	রোমাঞ্চা,	রোমাঞ্চ,	
ray,	রায,	রায়,	
teemothy,	টীমোথি,	টিমোথি,	
ongshogrohoner,	অংশগ্রহণের,	অংশগ্রহনের,	
alsaar,	আলসার,	আলসার,	
daktikit,	ডাকটিকিট,	ডাকটিকিট,	
marry,	মারি,	ম্যারি,	
promodwara,	প্রমোদ্বারা,	প্রমদ্বারা,	
munim,	মুনিম,	মুনিম,	
fibergulote,	ফাইারগুলোতে,	ফাইবারগুলোতে,	
juboke,	যুবকে,	যুবকে,	
brittakare,	বৃত্তকারে,	বৃত্তাকারে,	
falasrutite,	ফলস্রুতিতে,	ফলশ্রুতিতে,	
chakradhare,	চক্রধারে,	চক্রধরে,	
pingna,	পিংনা,	পিংনা,	
diniphition,	ডিনিফিইশন,	ডেফিনেশন,	
ispreedshiit,	ইসপ্রেডিশি,	স্প্রেডশীট,	
cholochchitro,	চলচ্চিত্র,	চলচ্চিত্র,	
jaandrel,	যান্দ্রেল,	জাঁদরেল,	
gorrer,	গরের,	গোরের,	
koruna,	করুনা,	করুণা,	
roopdan,	রূপদান,	রুপদান,	
gajiipur,	গজিিপুর,	গাজীপুর,	
average,	এভারেজ,	এভারেজ,	
hastantar,	হস্তান্তর,	হস্তান্তর,	
scuvi,	স্কুভি,	স্কুভি,	
shikara,	শিকারা,	শিকার,	
mekapgulo,	মেকাপগুলো,	মেকআপগুলো,	
plaiin,	প্লেইন,	প্লেন,	
homshke,	হোমশকে,	হোমসকে,	
ghatleo,	ঘটলেেও,	ঘটলেও,	
gandhikey,	গান্ধিকে,	গান্ধীকে,	
lutherana,	লুথেরানা,	লুথেরান,	
mahakabi,	মহাকাবি,	মহাকবি,	
poripake,	পরিপাকে,	পরিপাকে,	
miraqela,	মিরাকেলা,	মিরাকেল,	
vortuki,	ভর্তুকি,	ভর্তুকি,	
bastubad,	বস্তুবাদ,	বস্তুবাদ,	
keui,	কেউ,	কেউই,	
dorun,	ডরুন,	দরুণ,	
jaistho,	জাইস্থ,	জ্যৈষ্ঠ,	
swarther,	স্বার্থের,	স্বার্থের,	
jarmaniteo,	জারমানিতেও,	জার্মানিতেও,	
alonkaran,	আলনকারণ,	অলঙ্করণ,	
prapokkey,	প্রাপক্কে,	প্রাপককে,	
brittakar,	বৃত্তকার,	বৃত্তাকার,	
samajikatar,	সমাজিকাতার,	সামাজিকতার,	
madhuree,	মধুরী,	মাধুরী,	
dubaate,	ডুবাতে,	ডুবাতে,	
elaakaa,	এলাকা,	এলাকা,	
jonee,	জননি,	জনি,	
sthitiko,	স্থিটিক,	স্থিতিকো,	
tenishe,	তেনিশে,	টেনিসে,	
eokee,	এইকি,	এওকি,	
kamla,	কামলা,	কামলা,	
opohoron,	অপহরণ,	অপহরন,	
sonaktokaran,	সোনাক্তকরণ,	সনাক্তকরণ,	
ajeem,	আজিম,	আজিম,	
niphelheim,	নাইফলাহেম,	নিফেলহেইম,	
satyaky,	সত্যাকি,	সাত্যকি,	
artore,	আর্তরে,	আর্টরে,	
aporishodhito,	অপরিষিত,	অপরিশোধিত,	
probolshoktio,	প্রবলশক্তিও,	প্রবলশক্তিও,	
karecho,	করেছো,	করেছ,	
nirgomon,	নির্গমন,	নির্গমন,	
cheekitshar,	চিকিৎশার,	চিকিত্সার,	
ujobekeestan,	উজবেকিস্তান,	উজবেকিস্তান,	
musalmani,	মুসলমানি,	মুসলমানই,	
ralf,	রালফ,	রালফ,	
taposgoner,	তাপসগণের,	তাপসগণের,	
foks,	ফকস,	ফক্স,	
samratder,	সমরততদের,	সম্রাটদের,	
bhramapraban,	ভ্রমপ্রবণ,	ভ্রমপ্রবণ,	
jothon,	যথন,	যথন,	
pinogbagke,	পিনগবাগকে,	পিনগবাগকে,	
digri,	ডিগ্রি,	ডিগ্রি,	
megacaldera,	মেগালাকাদারা,	মেগাক্যাল্ডেরা,	
prodiiper,	প্রদীপের,	প্রদীপের,	
jerusaleme,	জেরুসালেমে,	জেরুসালেমে,	
brindaboney,	বৃন্দাবনে,	বৃন্দাবনে,	
rohasyer,	রহাস্যের,	রহস্যের,	
jolrang,	জোলাং,	জলরঙ,	
siramikasa,	সিরামিকাসা,	সিরামিকস,	
grushko,	গ্র্ষকো,	গ্রুশকো,	
postar,	পোস্টার,	পোস্টের,	
niketaner,	নিকেতানের,	নিকেতনের,	
baieq,	বাইক,	বাইক,	
steeit,	স্তিত,	স্টেইট,	
koota,	কোট,	কোটা,	
besirbhaagi,	বেশিরভাগী,	বেশিরভাগই,	
chaiten,	চৈতেন,	চাইতেন,	
rupert,	রুপার্ট,	রুপার্ট,	
hastamathun,	হস্তমাথুন,	হস্তমথুন,	
licenshe,	লাইসেন্স,	লাইসেন্স,	
onchalgulir,	অঞ্চালগুলির,	অঞ্চলগুলির,	
cxt,	সিএসসি,	সিএক্সটি,	
kada,	কাদা,	কোডা,	
syfy,	সিফি,	সাইফাই,	
samley,	সমলে,	সামলে,	
nirbachokder,	নির্বাচকদের,	নির্বাচকদের,	
prothar,	প্রথার,	প্রথার,	
pratista,	প্রতিস্তা,	প্রতিষ্টা,	
amanisa,	আমানিসা,	অমানিশা,	
mawdeel,	মাওদিল,	মডেল,	
kloud,	ক্লাউড,	ক্লাউড,	
bhaandar,	ভান্দার,	ভাণ্ডার,	
remakri,	রিমাক্রি,	রেমাক্রী,	
oisamoyer,	ঐশায়ের,	ঐসময়ের,	
sahittekder,	সাহিত্যকদের,	সাহিত্যেকদের,	
europia,	ইউরোপিয়া,	ইউরোপিয়া,	
shanno,	সান্নো,	সান্নো,	
laaisens,	লাইসেন্স,	লাইসেন্স,	
logic,	লোগিক,	লজিক,	
boshoborty,	বশবর্তী,	বশবর্তী,	
bhuushito,	ভূষিত,	ভূষিত,	
graambaaseer,	গ্রামবাসীর,	গ্রামবাসীর,	
ateetkaale,	আতীতকালে,	অতীতকালে,	
ponthaar,	পন্থার,	পন্থার,	
sahittopritite,	সাহিত্যপৃতিতে,	সাহিত্যপ্রীতিতে,	
hert,	হার্ট,	হার্ট,	
choritrotakeo,	চরিত্রতাকেও,	চরিত্রটাকেও,	
shiter,	শিতের,	শীতের,	
khanonkaj,	খননকজা,	খননকাজ,	
shfingtar,	শ্ফীংটার,	স্ফিংটার,	
pronoti,	প্রণতি,	প্রণতি,	
orthanitike,	অর্থানীতিকে,	অর্থনীতিকে,	
gaphiloti,	গাফিলোটি,	গাফিলতি,	
tukrowti,	টুকরৌুটি,	টুকরোটি,	
kadam,	কাদাম,	কদম,	
dharavassokar,	ধারাবাসককার,	ধারাভাষ্যকার,	
ispredsiit,	ইইস্পিডেটি,	স্প্রেডশীট,	
nabatamo,	নবতামো,	নবতম,	
obhijojan,	অভিযোজন,	অভিযোজন,	
superheroo,	সুপারহারো,	সুপারহিরো,	
bhogiroth,	ভগিরোথ,	ভগীরথ,	
agomoney,	আগমনে,	আগমনে,	
byaboharkarike,	ব্যবহারকারীকে,	ব্যবহারকারীকে,	
kekru,	কেকরু,	কেকরু,	
byaboharkarir,	ব্যবহারকারীর,	ব্যবহারকারীর,	
atwobishvashi,	অত্ববিশ্বাসী,	আত্মবিশ্বাসী,	
prothati,	প্রথাটি,	প্রথাটি,	
monjurul,	মঞ্জুরুল,	মনজুরুল,	
musalmanderke,	মুসলমানদেরকে,	মুসলমানদেরকে,	
serology,	সেরোলজি,	সেরোলজি,	
rinattak,	ঋণিত্তক,	ঋনাত্মক,	
korijachilen,	করিযাছিলেন,	করিযাছিলেন,	
khudhartara,	ক্ষুধারটার,	ক্ষুধার্তরা,	
sarder,	সার্ডের,	সরদার,	
sikkhakbrinda,	শিক্ষাকবৃন্দ,	শিক্ষকবৃন্দ,	
behrampurer,	বেহরামপুরের,	বহরমপুরের,	
eshtoniya,	এষ্টনীয়,	এস্তোনিয়া,	
teunar,	তেউনার,	টিউনার,	
yuro,	যুরোর,	ইউরো,	
saifullahil,	সাইফুল্লাহিল,	সাইফুল্লাহিল,	
modelgulo,	মডেলগুলো,	মডেলগুলো,	
geja,	গেজা,	গেজ,	
probhura,	প্রভুরা,	প্রভুরা,	
atmabishvashi,	আত্মবিশ্বাষী,	আত্মবিশ্বাসী,	
shahjapur,	শাহজাপুর,	শাহজাপুর,	
mozdoor,	মজদুর,	মজদুর,	
proteemake,	প্রতিমাকে,	প্রতিমাকে,	
nagorikkey,	নাগরিকে,	নাগরিককে,	
dufresne,	দুফরেসে,	ডুফরেস্ন,	
munot,	মুনোত,	মুনোট,	
uponeeshod,	উপনেষদ,	উপনিষদ,	
temonbhabe,	তেমনভাবে,	তেমনভাবে,	
dibet,	দিবেত,	ডিবেট,	
injiniyarim,	ইনজিনিয়ারিম,	ইঞ্জিনিয়ারিং,	
nimitte,	নিমিত্বে,	নিমিত্তে,	
noiteek,	নৈটিক,	নৈতিক,	
bhalobasar,	ভালোবাসার,	ভালোবাসার,	
bee,	বিইএ,	বি,	
srabosty,	শ্র্যাসটি,	শ্রাবস্তী,	
atibiplabi,	অতিবিব্লাবি,	অতিবিপ্লবি,	
ajuhath,	অজুহা,	অজুহাত,	
caramiks,	ক্যারামিকস,	সিরামিকস,	
gaaddafee,	গ্যাডাফি,	গাদ্দাফী,	
bhenus,	ভেনুস,	ভেনাস,	
jhimochchilo,	ঝিমোচ্ছিল,	ঝিমোচ্ছিলো,	
bosano,	বসানো,	বসানো,	
dewaben,	দেওয়াবেন,	দেওয়াবেন,	
ispredsheet,	ইসপ্রেডশট,	স্প্রেডশীট,	
phood,	ফুড,	ফুড,	
ikboler,	ইকবলের,	ইকবলের,	
nutaner,	নুতানের,	নূতনের,	
nojder,	নজদের,	নজদের,	
mirakela,	মিরাকেলা,	মিরাকেল,	
golghare,	গলঘরে,	গোলঘরে,	
shommotite,	সম্মতিতে,	সম্মতিতে,	
akpaase,	আকপাসে,	একপাশে,	
vetrillocuism,	ভেট্রিফুলজেক্স,	ভেট্রিলোকুইজম,	
sharif,	শরিফ,	শরিফ,	
cloudbook,	ক্লাডবুক,	ক্লাউডবুক,	
myathiou,	ম্যাথিউ,	ম্যাথিউ,	
jhalkanite,	ঝাকানিতে,	ঝলকানীতে,	
korimpur,	করিমপুর,	করিমপুর,	
taufiq,	তাফিক,	তৌফিক,	
monir,	মনির,	মনির,	
nathivookto,	নাথিভুক্ত,	নথিভুক্ত,	
simantarkkhibahinir,	সীমান্তরক্ষিকৃতিনীর,	সীমান্তরক্ষীবাহিনীর,	
jati,	জাতি,	যাতি,	
vogiroth,	ভগিরথ,	ভগীরথ,	
tukroti,	তুক্রোটি,	টুকরোটি,	
jhanjra,	ঝঞ্জরা,	ঝাঁজরা,	
cholocchitrer,	চলচিত্রের,	চলচ্চিত্রের,	
saainyo,	সৈন্য,	সৈন্য,	
sexperter,	সেক্সপার্টার,	সেক্সপার্টের,	
firozapure,	ফিরোজাপুরে,	ফিরোজাপুরে,	
chintakarma,	চিন্তাকর্ম,	চিন্তাকর্ম,	
saptahokal,	সপ্তাহকাল,	সপ্তাহকাল,	
gandhiir,	গান্ধীর,	গান্ধীর,	
daacktickete,	ডাক্টিকেটে,	ডাকটিকিটে,	
uponishad,	উপনিষাদ,	উপনিষদ,	
laga,	লাগা,	লগ,	
haris,	হারিস,	হ্যারিস,	
khalidke,	খালিদকে,	খালিদকে,	
as,	এসএ,	অস,	
gabhaskaar,	গাভাসকার,	গাভাস্কার,	
rajtantrey,	রাজতন্ত্রে,	রাজতন্ত্রে,	
neerbahi,	নির্বাহী,	নির্বাহি,	
bagicha,	বাগিছা,	বাগিচা,	
phuda,	ফুড়া,	ফুড,	
nibobondhonkrito,	নিবব্্ধনকৃত,	নিববন্ধনকৃত,	
shikshagato,	শিক্ষাগত,	শিক্ষাগত,	
sarajibonbyapi,	সারাজিবনবযাপি,	সারাজীবনব্যাপী,	
parinati,	পরিণাটি,	পরিণতি,	
byabosthar,	ব্যবস্থার,	ব্যাবস্থার,	
bairer,	বাইরের,	বাইরের,	
naagaalyand,	নাগল্যান্ড,	নাগাল্যান্ড,	
macbeth,	ম্যাকবেথ,	ম্যাকবেথ,	
vaticaner,	ভ্যাটিকেনের,	ভ্যাটিকানের,	
nilfamarir,	নীলফামারির,	নীলফামারীর,	
renoo,	রেনু,	রেনো,	
vagni,	ভাগ্নি,	ভগ্নী,	
transhapharma,	ট্রান্সফর্ম,	ট্রান্সফর্ম,	
chaka,	চাকা,	চাকা,	
itostatah,	ইতোস্টাসা,	ইতস্ততঃ,	
bufer,	বুফার,	বাফার,	
atorkitey,	অটোর্কিতে,	অতর্কিতে,	
stona,	স্তোনা,	স্টোন,	
uddhritto,	উদ্ধৃত্ত,	উদ্ধৃত,	
supreetira,	সুপ্রীতিরা,	সুপ্রীতিরা,	
rakkhanvag,	রক্ষণবাগ,	রক্ষণভাগ,	
ancholsaha,	আঞ্চলসহ,	অঞ্চলসহ,	
arthonitir,	অর্থনীতির,	অর্থনীতির,	
chhuteer,	ছুটির,	ছুটির,	
ameettrakkhor,	আমিতেক্রক্ষর,	অমিত্রাক্ষর,	
mukhomandoler,	মুখমান্ডলের,	মুখমণ্ডলের,	
prachando,	প্রাচাণ্ড,	প্রচণ্ড,	
besooro,	বেসুরও,	বেসুর,	
ship,	সিপ,	শিপ,	
sadeep,	সাদীপ,	সদীপ,	
breqathru,	ব্রেকথরু,	ব্রেকথ্রু,	
bhagnekeo,	ভাগনেকেও,	ভাগ্নেকেও,	
birishiritey,	বিরিশিরিতে,	বিরিশিরিতে,	
subade,	সুবাদে,	সুবাদে,	
alpakichudin,	অল্পাকিচুদিন,	অল্পকিছুদিন,	
jothartho,	যথার্থ,	যথার্থ,	
capsul,	ক্যাপসুল,	ক্যাপসুল,	
gazetted,	গ্যাজেট,	গেজেটেড,	
jolrong,	জলরং,	জলরঙ,	
laicenshe,	লাইশেন্স,	লাইসেন্স,	
rashider,	রাশীদের,	রশিদের,	
tarunra,	তরুণরা,	তরুণরা,	
dorneca,	ডর্নেকা,	ডরনেকা,	
aro,	আরো,	আরও,	
dibya,	দিব্যা,	দিব্যা,	
pare,	পারে,	পাড়ে,	
booponer,	বপনের,	বপনের,	
sikara,	সিকারা,	শিকার,	
armeeniyana,	আর্মীনীয়ান,	আর্মেনিয়ান,	
kaamij,	কামিজ,	কামিজ,	
palbongsher,	পালবংশের,	পালবংশের,	
chhedon,	ছেদন,	ছেদন,	
sikha,	সিখা,	শিখ,	
plate,	প্লেট,	প্লেটে,	
byboshthar,	বিবোষ্থার,	ব্যাবস্থার,	
akkharkey,	অক্ষর্কে,	অক্ষরকে,	
nabbata,	নাববাটা,	নাব্যতা,	
munsi,	মুনসি,	মুন্সী,	
sabrakamer,	সব্রকামের,	সবরকমের,	
societykey,	সোশিটিয়েকে,	সোসাইটিকে,	
orgho,	অর্ঘ,	অর্ঘ্য,	
antarvuktimulak,	অন্তর্ভূক্তিমূলক,	অন্তর্ভুক্তিমূলক,	
ancholsomuho,	আঞ্চলসমূহ,	অঞ্চলসমূহ,	
dharavahiker,	ধারাবাহিকের,	ধারাবাহিকের,	
fansi,	ফাঁসি,	ফাঁসী,	
diznee,	দিজনি,	ডিজনী,	
dajjha,	দাজ্ঝা,	দাহ্য,	
jens,	জেন্স,	জিন্স,	
golimodhye,	গলিমধ্যে,	গলিমধ্যে,	
anektai,	অনেকটাই,	অনেকটাই,	
chire,	চিরে,	চিরে,	
kayech,	কায়েছ,	কায়েছ,	
brookoleen,	ব্রকুলীন,	ব্রুকলিন,	
popaike,	পোপাইকে,	পপাইকে,	
ministara,	মিনিস্তারা,	মিনিস্টার,	
bisshaskey,	বিশ্বাস্কে,	বিশ্বাসকে,	
basaake,	বাসাকে,	বাসাকে,	
nibondhocheler,	নিবন্ধচেলের,	নিবন্ধছেলের,	
euqalyptus,	ইউক্লাইল্টাস,	ইউক্যালিপ্টাস,	
protisthan,	প্রতিস্থান,	প্রতিষ্টান,	
irana,	ইরানা,	ইরান,	
bonshi,	বনশি,	বংশী,	
fasi,	ফ্যাসি,	ফাঁসী,	
ghoshanapatratio,	ঘোষণাপাত্রীও,	ঘোষণাপত্রটিও,	
beekaargrasta,	বিকারগ্রস্ত,	বিকারগ্রস্ত,	
nischitvabe,	নিশ্চিৎভাবে,	নিশ্চিতভাবে,	
bokahoke,	বোকাহোকে,	বকাহকে,	
vittimul,	ভিত্তিমূল,	ভিত্তিমূল,	
kanshat,	কাশষাট,	কানসাট,	
sanaktokaron,	সনক্তকোণরণ,	সনাক্তকরণ,	
shite,	শীতে,	শীতে,	
shrimoti,	শ্রিমটি,	শ্রীমতি,	
chhooteer,	ছুটির,	ছুটির,	
oxite,	অক্সিতে,	অক্সাইট,	
blacq,	ব্ল্যাক,	ব্ল্যাক,	
furio,	ফুরিও,	ফুরিও,	
byaptikaler,	ব্যাপ্তিকালের,	ব্যাপ্তিকালের,	
showtey,	শোটে,	শোতে,	
highcommissionay,	হাইকসমিনিয়া,	হাইকমিশনে,	
osthishondhi,	অস্থিসন্ধি,	অস্থিসন্ধি,	
ghatiti,	ঘাটিটি,	ঘাঁটিটি,	
satjaner,	সাতজনের,	সাতজনের,	
houzgulite,	হাউজগুলিতে,	হাউজগুলিতে,	
joubanbatee,	যৌবনবাত,	যৌবনবতী,	
karima,	কারিমা,	করিম,	
bollov,	বল্ল,	বল্লভ,	
bohorompurer,	বহরমপুরের,	বহরমপুরের,	
fud,	ফুদ,	ফুড,	
brittakarey,	বৃত্তকরে,	বৃত্তাকারে,	
towraat,	তউরাত,	তওরাত,	
oncolsoho,	অংকলসহ,	অঞ্চলসহ,	
awrbit,	অঅ্রিট,	অরবিট,	
kaalaam,	কালাম,	কালাম,	
pachchi,	পাচ্ছি,	পাচ্ছি,	
blyaka,	ব্ল্যাকা,	ব্ল্যাক,	
prasadhoner,	প্রাসাধনের,	প্রসাধনের,	
rakkhanbhag,	রক্ষণভাগ,	রক্ষণভাগ,	
caroline,	ক্যারোলাইন,	ক্যরোলিন,	
aalaa,	আলা,	আলা,	
kormokarer,	কর্মকারের,	কর্মকারের,	
ajeejer,	আজিজের,	আজিজের,	
khitkar,	খিটকার,	ক্ষিতকর,	
sweety,	স্বী,	সুইটি,	
swadhinotatukui,	স্বাধীনতাটুকুই,	স্বাধীনতাটুকুই,	
prithibir,	পৃথিবীর,	পৃথবীর,	
ahalya,	অহল্য,	অহল্যা,	
drissoke,	দ্রিষ্ককে,	দৃশ্যকে,	
foxcon,	ফক্সকন,	ফক্সকন,	
satan,	সতান,	শয়তান,	
jerushalema,	জেরুশালেমা,	জেরুসালেম,	
byabaharkariderke,	ব্যাবহারকারীদেরকে,	ব্যবহারকারীদেরকে,	
bbiswashi,	বিব্বিশাষী,	বিশ্বাসই,	
soori,	সুরী,	সুরি,	
kraanti,	ক্রান্টি,	ক্রান্তি,	
seeramiks,	সেরিমিকস,	সিরামিকস,	
bhangchur,	ভাংচুর,	ভাংচুর,	
vool,	ভুল,	উল,	
baugey,	বাউজে,	বাগে,	
vobobibhuti,	ভববিভূতি,	ভববিভূতি,	
tiuning,	টিউনিং,	টিউনিং,	
banshite,	বাঁশিতে,	বাঁশিতে,	
kanasharabheshhana,	কনাশরেষণেষণ,	কনসারভেশন,	
konar,	কোনার,	কণার,	
ucchosito,	উচ্চসিত,	উচ্ছসিত,	
uponeesoder,	উপনেসদের,	উপনিষদের,	
phormat,	ফর্মাট,	ফরম্যাট,	
choudhursoho,	চৌধূরসহ,	চৌধুরসহ,	
elakasoho,	এলাকাসহ,	এলাকাসহ,	
yathaarthabhaabe,	যাথার্থভাবে,	যথার্থভাবে,	
manab,	মানব,	মানব,	
koyekbare,	কয়েকবারে,	কয়েকবারে,	
cooda,	কুডা,	কোডা,	
abeganuvutir,	আবেগানুভুতির,	আবেগানুভূতির,	
neerbachoker,	নির্বাচকের,	নির্বাচকের,	
nodnodeer,	নদনদীদর,	নদনদীর,	
tep,	টেপ্,	ট্যাপ,	
labonaktatar,	লবণকোত্তার,	লবণাক্ততার,	
aviyojan,	অভিযোজন,	অভিযোজন,	
vedanta,	ভেদান্ত,	বেদান্ত,	
chiroharit,	চিরোহারিত,	চিরহরিৎ,	
qyapasula,	ক্যাপাসুলা,	ক্যাপসুল,	
sahocorje,	সহকর্যে,	সাহচর্যে,	
elaakati,	এলাকাটি,	এলাকাটি,	
overholing,	ওভারহোলিং,	ওভারহোলিং,	
vangley,	ভ্যাংলি,	ভাঙলে,	
chhutochhooti,	ছুটোছুটি,	ছুটোছুটি,	
sethai,	সেথাই,	সেথাই,	
trabuco,	ট্রাবুকো,	ট্র্যাবুকো,	
taims,	টাইমস্,	টাইমস্,	
sinaake,	সিনাকে,	সিনাকে,	
andon,	আন্দন,	আন্দোন,	
rubala,	রুবালা,	রুবল,	
collaborators,	কোলাবারোটারস,	কলাবরেটরস,	
goodamjato,	গুড়ামাতো,	গুদামজাত,	
oncholgulir,	অঙ্চলগুলির,	অঞ্চলগুলির,	
skirt,	স্কাইট,	স্কার্ট,	
bbiswashke,	বিব্বিশাককে,	বিশ্বাসকে,	
shekender,	সেকেন্দার,	সেকেন্ডের,	
eenameela,	ইনামিলা,	এনামেল,	
metrikoleshana,	মেট্রিকেলনন,	মেট্রিকোলেশন,	
orthoneeti,	অর্থনীতি,	অর্থনীতির,	
shoodhooi,	শুধই,	শুধুই,	
jotinkey,	জটিনকে,	যতীনকে,	
poste,	পো্তে,	পোস্টে,	
neerbahe,	নিরবাহে,	নির্বাহে,	
uindos,	উইন্দোস,	উইন্ডোস,	
mononiitoder,	মনোনীতদের,	মনোনীতদের,	
abheedhanic,	অভিধানিক,	অভিধানিক,	
rakhtokkharoner,	রাখতক্ষকরণের,	রক্তক্ষরণের,	
photanor,	ফোটানোর,	ফোটানোর,	
bishnu,	বিষ্ণু,	বিষ্ণু,	
juktorastrer,	যুক্তরাস্ত্রের,	যুক্তরাষ্ট্রের,	
rijoor,	রিজুর,	রিজুর,	
licencedhari,	লাইসেন্ডধারী,	লাইসেন্সধারী,	
amanisha,	আমানিশা,	অমানিশা,	
angshogrohon,	অংশগ্রহণ,	অংশগ্রহন,	
bhebechili,	ভেবেছিলি,	ভেবেছিলি,	
nazad,	নাজাদ,	নজদ,	
bhoutikeshu,	ভৌতিকেষু,	ভৌতিকেষু,	
eshtonia,	এষতনিয়া,	এস্তোনিয়া,	
salafeta,	সালাফেটা,	সালফেট,	
bharpur,	ভারপুর,	ভরপুর,	
ragei,	রাগেই,	রাগেই,	
neemeetto,	নিমেত্য,	নিমিত্ত,	
hetimganje,	হেটিমগঞ্জে,	হেতিমগঞ্জে,	
raunanganey,	রৌনাঙ্গনে,	রণাঙ্গনে,	
shaater,	সাতের,	শ্যুটার,	
oichchheek,	ঐচ্ছিক,	ঐচ্ছিক,	
romnar,	রোমনার,	রমনার,	
neck,	নেক,	নেক,	
shuri,	শুরী,	সুরি,	
kathmandu,	কাঠমণ্ডু,	কাঠমান্ডু,	
turista,	টুরিস্টা,	টুরিস্ট,	
eura,	ইউরা,	ইউরো,	
hafsa,	হাফসা,	হাফসা,	
dhrubaker,	ধ্রুবাকের,	ধ্রুবকের,	
calabe,	ক্যালাবে,	চালাবে,	
khoka,	খোকা,	খোকা,	
sooya,	সুয়া,	সোয়া,	
khudrokar,	ক্ষুদ্রকার,	ক্ষুদ্রকার,	
uter,	উতের,	উটের,	
santoshpore,	সন্তশ্পরে,	সন্তোষপুর,	
catholicder,	ক্যাথোলিকদের,	ক্যাথলিকদের,	
assexe,	অ্যাসেক্সে,	অ্যাসেক্সে,	
giitikobitar,	গীতিকবিতার,	গীতিকবিতার,	
aakik,	আকিক,	আকিক,	
daktickete,	ডাক্তিকটে,	ডাকটিকিটে,	
alaoler,	অ্যালাওলের,	আলাওলের,	
adhunikkale,	আধুনিক্যালে,	আধুনিককালে,	
nirmankaaj,	নির্মাণকাজ,	নির্মাণকাজ,	
machsoho,	মাছসহ,	মাছসহ,	
doorotaumo,	দূরতাাৌম,	দূরতম,	
boikalyo,	বৈকাল্য,	বৈকল্য,	
dienes,	ডায়েনিস,	ডিএনএস,	
sahooseekotar,	সাহসেকতার,	সাহসিকতার,	
charpanch,	চারপাঁচ,	চারপাঁচ,	
mandanda,	মান্দান্দা,	মানদণ্ড,	
michir,	মিছির,	মিচির,	
shho,	শো,	শো,	
ashiatic,	আশিয়াটিক,	এশিয়াটিক,	
laishenshim,	লইশেশনিম,	লাইসেন্সিং,	
spenser,	স্পেন্সের,	স্পেন্সার,	
ekroop,	একরপপ,	একরূপ,	
amorendro,	অমরেন্দ্র,	অমরেন্দ্র,	
gemske,	গেএমসকে,	জেমসকে,	
protectionism,	প্রটেক্নিশমম,	প্রোটেকশনিজম,	
prosadhaner,	প্রসাধানের,	প্রসাধনের,	
dhache,	ধাছে,	ধাঁচে,	
bornolikhon,	বর্ণলিখন,	বর্ণলিখন,	
nothibhukto,	নথিভুক্ত,	নথিভুক্ত,	
aakaabaar,	আকাবার,	আকাবার,	
lakshmir,	লক্ষ্মীর,	লক্ষ্মীর,	
chikitsanirbhar,	চিকিৎসানির্ভর,	চিকিৎসানির্ভর,	
samle,	সামলে,	সামলে,	
minishtarer,	মিনিস্টারের,	মিনিস্টারের,	
sobche,	সবচে,	সবচে,	
deilee,	ডিলি,	ডেইলি,	
bondi,	বন্দী,	বন্দী,	
asovarno,	অসভার্ন,	অসবর্ণ,	
chaanoo,	চাঁযুও,	চানু,	
dheke,	ঢেকে,	ঢেকে,	
firoza,	ফিরোজা,	ফিরোজা,	
nilkuthir,	নীলকুঠির,	নীলকুঠির,	
mukharji,	মুখারজি,	মুখার্জী,	
mishal,	মিশাল,	মিশাল,	
shrabostee,	শ্রাসব্তি,	শ্রাবস্তী,	
tigmanshu,	তিগংমানশু,	তিগমংশু,	
gobeshokgon,	গবেষকগণ,	গবেষকগণ,	
superheiroo,	সুপারহাইরোও,	সুপারহিরো,	
horidbar,	হরিদবার,	হরিদ্বার,	
agora,	আগোরা,	আগোরা,	
venus,	ভেনাস,	ভেনাস,	
durgatsob,	দুর্গাতসব,	দুর্গোৎসব,	
baibosthaar,	বাইবস্থার,	ব্যবস্থার,	
wodka,	ওয়াককা,	ভদকা,	
dei,	দেই,	দিই,	
spancer,	স্প্যান্সার,	স্পেন্সার,	
cuti,	কিউটি,	কিউটি,	
chandrima,	চন্দ্রীমা,	চন্দ্রিমা,	
somoodrotote,	সমদ্রততে,	সমুদ্রতটে,	
rahee,	রাহি,	রাহি,	
jamjomat,	জমজোমাত,	জমজমাট,	
matorom,	মাতরম,	মাতরম,	
janamukhi,	জনামুখী,	জনমুখী,	
koomarir,	কোমারির,	কুমারীর,	
bishwaashshoi,	বিশ্বশশই,	বিশ্বাসই,	
sanghatakder,	সংঘটকদের,	সংঘটকদের,	
shikshagata,	শিক্ষাত,	শিক্ষাগত,	
colgirl,	কলজারল,	কলগার্ল,	
murad,	মুরাদ,	মুরাদ,	
land,	ল্যান্ড,	ল্যান্ড,	
charukala,	চারুকলা,	চারুকলা,	
informetion,	ইনফরমেশন,	ইনফরমেশন,	
nirdesika,	নির্দেশিকা,	নির্দেশিকা,	
serup,	সেরূপ,	সেরূপ,	
nirgaman,	নির্গামান,	নির্গমন,	
bohudin,	বহুদিন,	বহুদিন,	
hizriite,	হিজরিতে,	হিজরীতে,	
bangladesh,	বাংলাদেশ,	বঙ্গালাদেস,	
hadisti,	হাদিস্টি,	হাদিসটি,	
aairees,	আইরিস,	আইরিস,	
panthar,	পান্থার,	পন্থার,	
kraim,	ক্রেম,	ক্রাইম,	
kogake,	কোগাকে,	কোগাকে,	
bopoon,	বপুন,	বপন,	
yaak,	যাযক,	ইয়াক,	
duiekdiner,	দুই়েকদিনের,	দুইএকদিনের,	
akkaas,	আক্কাস,	আককাস,	
shamijir,	শামিজীর,	স্বামীজীর,	
dharmiyabhabei,	ধর্মিয়ভাবেই,	ধর্মীয়ভাবেই,	
enamela,	এনামেলা,	এনামেল,	
redcrosser,	রেডক্রসসের,	রেডক্রসের,	
ongkush,	অঙ্কুশ,	অংকুশ,	
remacri,	রিএমক্রি,	রেমাক্রী,	
anchalo,	আঞ্চালো,	অঞ্চলও,	
harbur,	হার্বুর,	হারবার,	
manir,	মানির,	মনির,	
prakalpoguli,	প্রকলগপগুলি,	প্রকল্পগুলি,	
oporishodhito,	অপরিষিত,	অপরিশোধিত,	
thandabhabe,	থান্ডাভাবে,	ঠাণ্ডাভাবে,	
bikargrosto,	বিকারগ্রস্ত,	বিকারগ্রস্ত,	
pravura,	প্রভুরা,	প্রভুরা,	
akhandota,	আখণ্ডতা,	অখণ্ডতা,	
naobihar,	নাওবহহার,	নৌবিহার,	
janosamaj,	জনসমাজ,	জনসমাজ,	
jumlalancer,	জামলাল্যান্সের,	জুমলাল্যান্সার,	
bijepi,	বিজেপি,	বিজেপি,	
ranangane,	রানাঙ্গানে,	রণাঙ্গনে,	
bujhechhila,	বুঝেছিলা,	বুঝেছিল,	
udor,	উদর,	উদর,	
orrgho,	অর্ঘ,	অর্ঘ্য,	
uporzon,	উপরজন,	উপার্জন,	
maadla,	মাডলা,	মাদলা,	
bizito,	বিজিত,	বিজিত,	
protijogiider,	প্রতিযোগীদের,	প্রতিযোগীদের,	
kirti,	কীর্তি,	কীর্তি,	
basab,	বাসাব,	বাসাব,	
poscime,	পশ্চিমে,	পশ্চিমে,	
marri,	মারি,	ম্যারি,	
basturoi,	বাস্তুরোই,	বস্তুরই,	
hydrological,	হাইড্রোলজিক্যাল,	হাইড্রোলজিক্যাল,	
gardeen,	গার্ডিন,	গার্ডেন,	
naraphoka,	নারাফোকা,	নরফোক,	
teter,	তেতের,	টেটের,	
batikromee,	বাতিক্রমী,	ব্যতিক্রমী,	
poorohitder,	পতরিহতদের,	পুরোহিতদের,	
cheenja,	চিনজা,	চেঞ্জ,	
lakkhero,	লক্ষেরও,	লক্ষেরও,	
digrir,	দিগ্রির,	ডিগ্রির,	
nationalser,	ন্যাটনলালের,	ন্যাশনালসের,	
shakankti,	শকাক্তি,	শকাঙ্কটি,	
ekbakye,	একবাক্যে,	একবাক্যে,	
iling,	ইলিং,	ইলিং,	
hosney,	হোসনে,	হোসনে,	
hariner,	হরিণের,	হরিণের,	
soommita,	সুমিতা,	সুমিতা,	
welcome,	ওয়েককমে,	ওয়েলকাম,	
indrakanan,	ইন্দ্রকানান,	ইন্দ্রকানন,	
mulor,	মুলোর,	মুলোর,	
bhromoner,	ভ্রমণের,	ভ্রমণের,	
nartana,	নরতানা,	নর্টন,	
amontronkarider,	আমন্ত্রকারীদের,	আমন্ত্রণকারীদের,	
aasar,	আসার,	আসর,	
fishing,	ফিশিং,	ফিসিং,	
bojata,	বজাতা,	বোজাটা,	
proshtutkarok,	প্রশ্তুতকারক,	প্রস্তুতকারক,	
aniyantrita,	অনিয়ন্ত্রীত,	অনিয়ন্ত্রিত,	
corsin,	করসিন,	করসিন,	
ashankai,	আশঙ্কাই,	আশঙ্কাই,	
alumni,	আলুমনি,	অ্যালমনি,	
neshnosh,	নেশ্নশ,	নেশনস,	
bibecchyo,	বিবেচ্ছি,	বিবেচ্য,	
aziza,	আজিজা,	আজিজা,	
akkheperi,	অক্ষেপেরই,	আক্ষেপেরই,	
borkhastokritora,	বরখাস্তকৃতা,	বরখাস্তকৃতরা,	
rajyotiro,	রাজ্যতিরও,	রাজ্যটিরও,	
mooney,	মুনি,	মুনে,	
arthonitite,	অর্থনীতিতে,	অর্থনীতিতে,	
byatikrami,	ব্যতিক্রমী,	ব্যতিক্রমী,	
torkarir,	তরকারীর,	তরকারীর,	
madhnagar,	মধনগর,	মাধনগরের,	
kash,	কাশ,	কাস,	
nathivookteer,	নাঠিভুক্তির,	নথিভুক্তির,	
madrasa,	মাদরাা,	মাদ্রাসা,	
moushumei,	মৌশুমেই,	মৌসুমেই,	
grahoksebai,	গ্রাহকেষবাই,	গ্রাহকসেবায়,	
ajuhat,	অজুহাত,	অজুহাত,	
bsnleu,	বিএসএনসিএলই,	বিএসএনএলইইউ,	
chatrorai,	ছাত্ররাই,	ছাত্ররাই,	
amarjito,	অমর্জিত,	অমার্জিত,	
debate,	দেবাতে,	ডিবেট,	
marodeho,	মারোদেও,	মরদেহ,	
byaktigotovabeo,	ব্যক্তিগতভাবেও,	ব্যাক্তিগতভাবেও,	
hol,	হোল,	হোল,	
asamorik,	আসামরিক,	অসামরিক,	
mesenjjar,	মেজেঙ্জর,	মেসেঞ্জার,	
safin,	সাফিন,	সাফিন,	
atarkitey,	অতারকিতে,	অতর্কিতে,	
boiporiityen,	বইপরিতিয়েন,	বৈপরীত্যেন,	
footbalarer,	ফুটবলাারের,	ফুটবলারের,	
faskari,	ফাসকারি,	ফাঁসকারী,	
graambaaseeo,	গ্রামবাসীও,	গ্রামবাসীও,	
jund,	জান্ড,	জুন্দ,	
urey,	উরে,	ইউরি,	
siima,	সিমা,	সীমা,	
cholechi,	চলেছি,	চলেছি,	
bhyatikaner,	ভ্যাটিকানের,	ভ্যাটিকানের,	
pothon,	পথন,	পঠন,	
kinto,	কিন্তো,	কিনত,	
ovidhaner,	অভিধানের,	অভিধানের,	
shabkam,	শবকম,	শবকাম,	
planea,	প্লেনিয়া,	প্লেনে,	
chuti,	চুটি,	ছুটি,	
cathalic,	ক্যাথালিক,	ক্যাথলিক,	
khude,	খুদে,	ক্ষুদে,	
flux,	ফ্লাক্স,	ফ্লাস্ক,	
sudrissho,	সুদৃশ্য,	সুদৃশ্য,	
shansthaner,	শান্স্থানের,	সংস্থানের,	
parshwer,	পার্শ্বের,	পার্শ্বের,	
ponera,	পনেরা,	পনের,	
akai,	আকাই,	একাই,	
palashir,	পালাশির,	পলাশীর,	
armashtram,	আর্মাষ্ট্রম,	আর্মস্ট্রং,	
kk,	কেকিএক,	কেকে,	
mitrata,	মিত্রাটা,	মিত্রতা,	
parijaner,	পারিজানের,	পরিজনের,	
protijogi,	প্রতিযোগী,	প্রতিযোগী,	
gaziipur,	গাজীপুর,	গাজীপুর,	
phiksa,	ফিকসা,	ফিক্স,	
bhotomulyoke,	ভোটমূল্যকে,	ভোটমূল্যকে,	
somoibo,	সময়বো,	সমৈব,	
uchchotara,	উচ্চতারা,	উচ্চতর,	
bite,	বিতে,	বাইট,	
barder,	বার্ডের,	বার্ডের,	
elbamtite,	এলবামটিতে,	এলবামটিতে,	
bibadey,	বিবাদে,	বিবাদে,	
mukhomandaley,	মুখমান্ডলে,	মুখমণ্ডলে,	
jaubankal,	যৌবনকাল,	যৌবনকাল,	
mekong,	মেকং,	মেকং,	
govindarajan,	গোবিন্দরাজন,	গোবিন্দরাজন,	
bhenicer,	ভেনিসের,	ভেনিসের,	
manushera,	মানুষেরা,	মানুষেরা,	
horash,	হোরাশ,	হোরাস,	
tophaat,	তোফাত,	তফাৎ,	
nothivuktir,	নথিভুক্তির,	নথিভুক্তির,	
shhikara,	শিকারা,	শিকার,	
bouddha,	বৌদ্ধা,	বৌদ্ধ,	
krisenta,	ক্রিসেন্টা,	ক্রিসেন্ট,	
shumo,	শুমো,	সুমো,	
pichte,	পিছটে,	পিছতে,	
teenej,	তেনেজ,	টিনেজ,	
dai,	দাই,	ডে,	
dumaa,	ডুমায,	দুমা,	
krush,	ক্রুশ,	ক্রুশ,	
ramchander,	রামচন্দর,	রামচন্দরের,	
lendl,	লেন্ডল,	লেন্ডল,	
taufik,	তাফিক,	তৌফিক,	
moonshi,	মুনশি,	মুন্সি,	
meropenemer,	মেরোপেনিমার,	মেরোপেনেমের,	
sahozlabhbhatar,	সহজলাভকতার,	সহজলভ্যতার,	
rilayensha,	রিলেয়েনশা,	রিলায়েন্স,	
adhyattikota,	অধ্যাত্মিকতা,	আধ্যাত্মিকতা,	
sikkharthirao,	সিক্ষার্থীরাও,	শিক্ষার্থীরাও,	
suchonakal,	সূচনাকাল,	সূচনাকাল,	
heavy,	হেভি,	হেভি,	
bhorkendra,	ভরকেন্দ্রের,	ভরকেন্দ্র,	
kolkarkhana,	কোলকারখানা,	কলকারখানা,	
vandar,	ভান্ডার,	ভাণ্ডার,	
shishu,	শিশু,	শিশু,	
qarqa,	কার্কা,	কার্ক,	
shasheja,	শােশা,	সসেজ,	
shikshakrom,	শিক্ষাক্রম,	শিক্ষাক্রম,	
bupher,	বুফার,	বাফার,	
ghumacchilo,	ঘুমাফ্ছিলো,	ঘুমাচ্ছিল,	
blacker,	ব্লেকার,	ব্ল্যাকের,	
chikkingsasoho,	চিক্কিংগাসহ,	চিকিংসাসহ,	
sportstar,	স্পোর্টস্টার,	স্পোর্টসস্টার,	
pleeta,	প্লিটা,	প্লেট,	
vesselli,	ভেসেলি,	ভেসেলি,	
hughkey,	হুগকে,	হিউজকে,	
dabarer,	দাবারের,	দাবারের,	
elahabade,	এলাহাবাদে,	এলাহাবাদে,	
pacchi,	পা্চি,	পাচ্ছি,	
pitiler,	পিটিলের,	পিটিলের,	
sqirt,	স্কার্ট,	স্কার্ট,	
said,	সাইদ,	সাইদ,	
favorite,	ফ্যাভোরিতে,	ফেভারিট,	
chorchita,	চর্চিতা,	চর্চিত,	
brekethru,	ব্রেকথররু,	ব্রেকথ্রু,	
rakhete,	রাখেতে,	রাখেতে,	
choopi,	চুপি,	চুপি,	
shniper,	শ্ণিপের,	স্নাইপার,	
purbanchaler,	পূর্বনচলের,	পূর্বাঞ্চলের,	
change,	চাঙ্গে,	চেঞ্জ,	
satarkokari,	সতর্ককারী,	সতর্ককারী,	
bakhyateet,	বাখ্যািত,	ব্যাখ্যাতীত,	
kaash,	কাশ,	কাস,	
osamanno,	ওসামান্য,	অসামান্য,	
pray,	প্রয়,	প্রায়,	
pratijogira,	প্রতিযোগীরা,	প্রতিযোগীরা,	
rajbondir,	রাজবন্দির,	রাজবন্দীর,	
moshjidke,	মশশীদকে,	মসজিদকে,	
saramukhe,	সারামুখে,	সারামুখে,	
haridware,	হরিদ্বারে,	হরিদ্বারে,	
dekhso,	দেখসো,	দেখসো,	
naabyota,	নাব্যতা,	নাব্যতা,	
grambaashio,	গ্রামবাশীও,	গ্রামবাসীও,	
biplobi,	বিপ্লবী,	বিপ্লবী,	
chalake,	চালাকে,	চালকে,	
bbosonto,	বিবস্ত,	বসন্ত,	
hyaloyin,	হ্যালয়ন,	হ্যালোইন,	
militaryr,	মিলিটারির,	মিলিটারির,	
siropa,	সিরোপা,	শিরোপা,	
feroza,	ফেরোজা,	ফিরোজা,	
chhadite,	ছাড়িতে,	ছড়িতে,	
laaishheshh,	লাইশেষ,	লাইসেন্স,	
qrisenta,	ক্রাইসেন্টা,	ক্রিসেন্ট,	
sealvi,	সিলভি,	সিলভি,	
bhramarotsab,	ভ্রামারতসব,	ভ্রমরোৎসব,	
duryogamoyee,	দুর্যগাময়,	দুর্যোগময়ী,	
gostigulo,	গোস্টিগুলো,	গোষ্ঠীগুলো,	
mastarsa,	মাস্তারসস,	মাস্টার্স,	
dupleks,	ডুপলক্স,	ডুপ্লে,	
qaferder,	কাফেরদের,	কাফেরদের,	
konisttha,	কনিষ্ঠ,	কনিষ্ঠ,	
dapadpi,	দাপাদপি,	দাপাদপি,	
capsule,	ক্যাপসেল,	ক্যাপ্সুল,	
punosthaner,	পুনস্থানের,	পুনঃস্থানের,	
pouchute,	পৌছুতে,	পৌঁছুতে,	
balabhadra,	বালাভর্রা,	বলভদ্র,	
aagera,	আগেরা,	আগোরা,	
madelim,	মাদেলিম,	মডেলিং,	
shithilata,	শিথিলতা,	শিথিলতা,	
kareer,	করীর,	কারীর,	
khelechen,	খেলেছেন,	খেলেছেন,	
rojapalaner,	রোজাপালানের,	রোজাপালনের,	
pleena,	প্লেনা,	প্লেন,	
alexanderke,	আলেক্সান্ডারকে,	আলেকজান্ডারকে,	
battery,	ব্যাটারি,	ব্যাটারী,	
bade,	বাদি,	বাদে,	
emerjency,	এমেরজেন্সি,	এমার্জেন্সি,	
sallallahu,	সাল্লাল্লাহু,	সল্লাল্লাহু,	
gronthao,	গ্রন্থাও,	গ্রন্থও,	
devolapar,	দেবলাপার,	ডেভলপার,	
tachnach,	তাচনাচ,	তছনছ,	
avinetar,	অভিনেতার,	অভিনেতার,	
danaqana,	ডানাকানা,	ডানকান,	
societyke,	সোশিটিকে,	সোসাইটিকে,	
bodhukeo,	বধুকেও,	বধুকেও,	
carloos,	কার্লুস,	কার্লোস,	
obharbhiu,	অভারভিউ,	ওভারভিউ,	
gonjona,	গঞ্জনা,	গঞ্জনা,	
nanabornobishishto,	নানাবর্ণবিশ্ষ্ট,	নানাবর্ণবিশিষ্ট,	
madhobi,	মাধবী,	মাধবী,	
artilary,	আর্টিলারি,	আর্টিলারি,	
mangoleek,	ম্যাঙলগিক,	মাঙ্গলিক,	
siqhar,	সিকহার,	শিকার,	
shorifer,	শরীফের,	শরিফের,	
kaathhmaandute,	কাঠমাণ্ডুতে,	কাঠমান্ডুতে,	
saom,	সাওম,	সাওম,	
protizogiita,	প্রতিযোগীতা,	প্রতিযোগীতা,	
chikittsar,	চিকিতটার,	চিকিত্সার,	
shikkharthirao,	শিক্ষার্থীরাও,	শিক্ষার্থীরাও,	
votarer,	ভোারের,	ভোটারের,	
oswastikor,	অস্বাস্তিকর,	অস্বস্তিকর,	
show,	সিউ,	শো,	
brake,	ব্রেকে,	ব্রেক,	
torabgonj,	তরাবগঞ্জ,	তোরাবগঞ্জ,	
madhumati,	মধুমতি,	মধুমতী,	
quota,	কুওটা,	কোটা,	
jonoikaa,	জনৈকা,	জনৈকা,	
qyantana,	ক্যান্টানা,	ক্যান্টন,	
kormokarke,	কর্মকারকে,	কর্মকারকে,	
gazeetteed,	গাজেত্তিদ,	গেজেটেড,	
meghacchonno,	মেঘাক্ছন্ন,	মেঘাচ্ছন্ন,	
gej,	গেজ,	গেজ,	
asovyo,	অসাভ্য,	অসভ্য,	
longhan,	লংহান,	লংঘন,	
magrey,	ম্যাগ্রে,	ম্যাগ্রে,	
tonoo,	টনু,	তনু,	
turkeyder,	তুর্কেদের,	তুর্কিদের,	
sokkhomotabriddhi,	সক্ষমাত্্র্ধ্ধী,	সক্ষমতাবৃদ্ধি,	
prangulo,	প্রাণগুলো,	প্রানগুলো,	
bbiswash,	বিবিশ্বাশ,	বিশ্বাস,	
akreetokarjo,	আকৃতকার্য্য,	অকৃতকার্য,	
byapoktor,	ব্যাপকতর,	ব্যাপকতর,	
poste,	পো্তে,	পোষ্টে,	
niurolaji,	নিউরোাজি,	নিউরোলজি,	
sulfatee,	সালফেটি,	সালফেট,	
sahozlabhbhotar,	সহজলাভ্যতার,	সহজলভ্যতার,	
israelbahini,	ইসরাবেলবাহিনী,	ইস্রায়েলবাহিনী,	
fake,	ফাকে,	ফাকে,	
bouddher,	বৌদ্ধের,	বৌদ্ধের,	
antorvuktimulak,	আন্তর্ভুক্তিমূলক,	অন্তর্ভুক্তিমূলক,	
jorury,	জরিরি,	জরূরী,	
dubureer,	ডুবুরীর,	ডুবুরির,	
gunje,	গুঞ্জে,	গুঁজে,	
dharabahikvabe,	ধারাবাহিকভাবে,	ধারাবাহিকভাবে,	
godamjato,	গোডামজাত,	গুদামজাত,	
diibug,	দিবিগ,	ডিবাগ,	
beauby,	বিউবি,	বিউবি,	
osomorthito,	অসমর্থিত,	অসমর্থিত,	
asovya,	অসোভ্যা,	অসভ্য,	
lahano,	লাহানো,	লাহানো,	
internship,	ইন্টারনশিপ,	ইন্টার্নশিপ,	
chilahaati,	চিলাহাটি,	চিলাহাটি,	
mandape,	মণ্ডপে,	মন্ডপে,	
peri,	পেরী,	পেরি,	
mmadhukkori,	ম্মাধুক্করি,	মাধুকরী,	
tinage,	টিনাজ,	টিনেজ,	
registaner,	রেজিস্ট্যানের,	রেগিস্তানের,	
nabatarange,	নবতরঙ্গে,	নবতরঙ্গে,	
soinyora,	সৈন্যরা,	সৈন্যরা,	
canservatian,	ক্যান্সভেরিটান,	কনসারভেশন,	
tawnship,	টাযানশিপ,	টাউনশিপ,	
pratool,	প্রাটুল,	প্রতুল,	
durgotshob,	দুর্গদৎশব,	দুর্গোৎসব,	
ganochin,	গনছিন,	গণচীন,	
ingreziteo,	ইংরেজিতেও,	ইংরেজিতেও,	
angibhutovabe,	অঙ্গিভূতভে,	অঙ্গীভূতভাবে,	
pnouchute,	পৌঁচুতে,	পৌঁছুতে,	
unchiyechilo,	উঁচিয়েছিল,	উঁচিয়েছিল,	
dhaleshorii,	ধলেশরি,	ধলেশ্বরী,	
songkulan,	সংকুলন,	সংকুলান,	
sthapanar,	স্থাপানার,	স্থাপনার,	
dhanche,	ধাঁছে,	ধাঁচে,	
somsher,	সোমশের,	সমশের,	
vushi,	ভূশি,	ভুষি,	
bishasey,	বিশাসে,	বিশ্বাসে,	
aditisaha,	আদিতিসহ,	অদিতিসহ,	
gobeshana,	গবেষণা,	গবেষনা,	
assaciates,	অ্যাসিসিট,	এসোসিয়েটস,	
niketon,	নিকেতন,	নিকেতন,	
gate,	গাতে,	গ্যেটে,	
bihar,	বিহার,	বিহার,	
chhutochhuti,	ছুটোছুটি,	ছুটোছুটি,	
bim,	বিআইএমএম,	বিম,	
engrejra,	এংরেজরা,	ইংরেজরা,	
matis,	মাতিস,	ম্যাটিস,	
phutbolarder,	ফুটবলারদের,	ফুটবলারদের,	
soketgulor,	সকেগগুলোর,	সকেটগুলোর,	
bheenisa,	ভীনিসা,	ভেনিস,	
vaphara,	ভাপারা,	বাফার,	
sthaponagulor,	স্থাপনাগুলোর,	স্থাপনাগুলোর,	
ponero,	পনেরও,	পনের,	
sharansthal,	শরনস্থল,	শরণস্থল,	
boikolyo,	বৈকল্য,	বৈকল্য,	
tunaita,	টুনাইটা,	টুনাইট,	
geejeeteeda,	জেজেটিড,	গেজেটেড,	
aholyar,	আহল্যার,	অহল্যার,	
vange,	ভ্যাঙ্গে,	ভাঙ্গে,	
vault,	ভাউল্ট,	ভল্ট,	
firozaa,	ফিরোজা,	ফিরোজা,	
porbotmala,	পর্বতমালা,	পর্বতমালা,	
kadakhonchar,	কাদাখোচরের,	কাদাখোঁচার,	
esoosiyetasa,	এসোসিয়েটস,	এসোসিয়েটস,	
tantubayer,	তন্তুবায়ের,	তন্তুবায়ের,	
nischoy,	নিশ্চয়,	নিশ্চয়,	
uporoshtho,	উপরস্থ,	উপরস্থ,	
breel,	ব্রীল,	ব্রিল,	
kotibondhe,	কতিবন্ধে,	কটিবন্ধে,	
habsi,	হাবসি,	হাবশী,	
helly,	হেলি,	হিলি,	
doloo,	দলু,	ডলু,	
moorali,	মুরালি,	মুরলী,	
poderthobid,	পদের্িিব,	পদার্থবিদ,	
bejiye,	বেজিয়ে,	বেজিয়ে,	
satarkatar,	সতর্কতার,	সতর্কতার,	
rejidens,	রেজিডেন্স,	রেসিডেন্স,	
johny,	জনি,	জনি,	
salmanul,	সালমানুল,	সালমানুল,	
distibutor,	দিস্তিবুতর,	ডিস্টিবিউটারের,	
suparahiro,	সুপারাহিরও,	সুপারহিরো,	
manush,	মানুষ,	মানুষ,	
dormroome,	ডরম্রুম,	ডর্মরুমে,	
bangobandhu,	বঙ্গবন্ধুই,	বঙ্গবন্ধু,	
bardhitansh,	বর্ধিতংশ,	বর্ধিতাংশ,	
chirkut,	চিরকুট,	চিরকুট,	
emiratas,	এমিরাতাস,	এমিরেটাস,	
sangbadmadhyomgulote,	সংবাদমাধ্যমগুলোতে,	সংবাদমাধ্যমগুলোতে,	
expreshshion,	এক্সপ্রেশন,	এক্সপ্রেশন,	
suhayeler,	সুহায়েলের,	সুহায়েলের,	
noitikota,	নৈতিকতা,	নৈতিকতা,	
leaders,	লিডার্স,	লিডার্স,	
sahinsatar,	সহিনসতার,	সহিংসতার,	
andamana,	আন্দামানা,	আন্দামান,	
elakaatite,	এলাকাটিতে,	এলাকাটিকে,	
istoone,	ইস্টুন,	স্টোন,	
stonehenje,	স্তনেহেঞ্জে,	স্টোনহেঞ্জ,	
tochhnochh,	তছ্ছন,	তছনছ,	
machkabar,	মাচকাবার,	মাচকাবার,	
stana,	স্তানা,	স্টোন,	
rajtantra,	রাজতন্ত্রে,	রাজতন্ত্র,	
mimgulor,	মিমগুলোর,	মিমগুলোর,	
abhidhaaneeck,	অভিনাধিনক,	অভিধানিক,	
uthaney,	উঠানে,	উঠানে,	
perri,	পেররি,	পেরি,	
senabahinio,	সেনাবাহিনীও,	সেনাবাহিনীও,	
meshintao,	মেশিনটাও,	মেশিনটাও,	
eesa,	ইইএসএ,	আইএএস,	
shainyader,	শৈন্যাদের,	সৈন্যদের,	
raiialati,	রাইয়ালতি,	রয়্যালটি,	
mumtaj,	মুমতাজ,	মুমতাজ,	
eupheike,	ইউফেইকে,	ইউফেইকে,	
oikhan,	ঐখন,	ঐখান,	
mookhomandoler,	মূখমান্ডলের,	মুখমণ্ডলের,	
aprasangikbhabei,	অপ্রসঙগীকভাবেই,	অপ্রাসঙ্গিকভাবেই,	
armshtrong,	আর্মশ্ট্রং,	আর্মস্ট্রং,	
batikromi,	বাটিক্রমী,	ব্যতিক্রমী,	
tinhazar,	তিনহাজার,	তিনহাজার,	
orbit,	অরবিট,	অরবিট,	
shishupalgarh,	শিশুপালগড়ার,	শিশুপালগড়ে,	
edic,	এডিক,	এডিক,	
prashikkhane,	প্রাশিক্ষণে,	প্রশিক্ষণে,	
chhuteete,	ছুটিতে,	ছুটিতে,	
chhayi,	ছাযি,	ছাই,	
hundai,	হুন্দাই,	হুন্দাই,	
shootar,	সূতার,	শ্যুটার,	
punorabortonte,	পুনরাবরতত্ত্তে,	পুনরাবর্তন্তে,	
ghatla,	ঘাটলা,	ঘটল,	
ghomtaa,	ঘোমটা,	ঘোমটা,	
salchak,	সালচাক,	সালচাক,	
shpredshiit,	স্পাইডশিইট,	স্প্রেডশীট,	
laaisensh,	লাইসেন্স,	লাইসেন্স,	
sahajlabhbhotar,	সহজললকভাতার,	সহজলভ্যতার,	
abheedhanik,	অভিধানিক,	অভিধানিক,	
karaa,	কারা,	কারো,	
muradke,	মুরাদকে,	মুরাদকে,	
kusumeshu,	কুসুমেষু,	কুসুমেষু,	
karore,	কারোর,	কারোর,	
hames,	হেমেস,	হোমস,	
soundorjotakei,	সৌন্দর্যতাকেই,	সৌন্দর্যটাকেই,	
elaaka,	এলাকা,	এলাকা,	
bojiye,	বজিয়ে,	বজিয়ে,	
purohitra,	পুরোহিত্রা,	পুরোহিতরা,	
landin,	ল্যান্ডিন,	ল্যান্ডিং,	
daakticketer,	ডাক্তিকটের,	ডাকটিকিটের,	
chhon,	ছোন,	ছোঁ,	
akpashe,	আকপাশে,	একপাশে,	
weenis,	ওইনিসিস,	ভেনিস,	
wishnu,	উশননু,	বিষ্ণু,	
inafarameshana,	ইনাফারমেশন,	ইনফরমেশন,	
zeeland,	জাইল্যান্ড,	জিল্যান্ড,	
chalochchitraeeo,	চলচ্চিত্র্যাও,	চলচ্চিত্রেও,	
laesens,	লেসেন্স,	লাইসেন্স,	
iksaprishana,	ইক্সপ্রিশন,	এক্সপ্রেশন,	
motke,	মটকে,	মতকে,	
byathapather,	ব্যথাপথের,	ব্যথাপথের,	
upbrazillian,	উপরাজ্জিলিজিন,	আপব্রাজিলিয়ান,	
dushtogone,	দুষ্টগণে,	দুষ্টগণে,	
sithilota,	সিথিলতা,	শিথিলতা,	
shommotir,	সম্মতির,	সম্মতির,	
jolbe,	জলবে,	জ্বলবে,	
nabotom,	নাবতম,	নবতম,	
ramantic,	র্যামান্টিক,	রোমান্টিক,	
purborekorde,	পূর্বরেকদর্ে,	পূর্বরেকর্ডে,	
audioguloke,	অডিওগুলোকে,	অডিওগুলোকে,	
salsa,	সালসা,	সালসা,	
neelfamarir,	নীলফারারির,	নীলফামারীর,	
sthaponagulo,	স্থাপনাগুলো,	স্থাপনাগুলো,	
chopal,	চোপাল,	চপল,	
bipajjanak,	বিপাজ্জনক,	বিপজ্জনক,	
torabganj,	তোরাগগঞ্জ,	তোরাবগঞ্জ,	
proo,	প্রু,	প্রো,	
baet,	বেযাট,	বাইট,	
scorey,	স্কোরে,	স্কোরে,	
subader,	সুবাদের,	সুবাদে,	
balatarin,	ব্যালাটারিন,	বালাতারিয়ান,	
residence,	রেসিডেন্সে,	রেসিডেন্স,	
dera,	দেরা,	ডেরা,	
bisnuke,	বিস্নুকে,	বিষ্ণুকে,	
oncholshomuh,	অংচলমসূহ,	অঞ্চলসমূহ,	
deefinision,	ডিফিনিসন,	ডেফিনেশন,	
lungiti,	লুঙ্গিটি,	লুঙ্গিটি,	
bongshokey,	বংশকে,	বংশকে,	
ansarir,	আনসারীর,	আনসারীর,	
grambaseer,	গ্রামবাসীর,	গ্রামবাসীর,	
asamonjasyopurno,	অসামজন্যপূর্ণ,	অসামঞ্জস্যপূর্ণ,	
otyacharito,	অত্যাচারিত,	অত্যাচারিত,	
byaboharkariyi,	ব্যবহারকারীী,	ব্যবহারকারীই,	
oncholsomuho,	অংচলমসহু,	অঞ্চলসমূহ,	
binee,	বিনী,	বেনি,	
ekjoge,	একজোগে,	একযোগে,	
bhogno,	ভগ্ন,	ভগ্ন,	
kathla,	কাললা,	কাঠলা,	
siddhantei,	সিদ্ধান্তেই,	সিদ্ধান্তেই,	
sqalarashipa,	স্কলারশিপা,	স্কলারশিপ,	
dharmee,	ধরমী,	ধর্মী,	
lyataa,	ল্যাটা,	ল্যাটা,	
protishtan,	প্রতিষ্টান,	প্রতিষ্টান,	
abhidhaanick,	অভিধানিক,	অভিধানিক,	
mukhomandaler,	মুখমন্ডলের,	মুখমণ্ডলের,	
deliver,	ডেলিভার,	ডেলিভার,	
abhidhanick,	অভিধানিক,	অভিধানিক,	
teentir,	তীন্টির,	তিনটির,	
shasankarta,	শাসনকর্তা,	শাসনকর্তা,	
chai,	চাই,	ছাই,	
sarsa,	সার্সা,	সোর্স,	
gandhike,	গান্ধীকে,	গান্ধীকে,	
roktokhoron,	রক্তখরণ,	রক্তক্ষরণের,	
benojir,	বেনজির,	বেনজীর,	
jibanto,	জীবন্ত,	জীবন্ত,	
carbus,	কারবুস,	কারবাস,	
jotharthovabey,	যথার্থভাবে,	যথার্থভাবে,	
shingping,	সিংপিং,	শিংপিং,	
idyi,	আইদি,	আইডিই,	
torunderke,	তরুণ্দারকে,	তরুণদেরকে,	
adbhanced,	অ্যাডভ্যাডড,	অ্যাডভান্সড,	
dinara,	দিনারা,	ডিনার,	
boiragirhat,	বৈরাগীরহাট,	বৈরাগিরহাট,	
jamaanor,	জামানোর,	জমানোর,	
boner,	বনের,	বনের,	
tolemy,	টোলেমি,	টলেমির,	
neermol,	নির্মোল,	নির্মল,	
mandarbani,	মান্দাবাণী,	মন্দারবাণী,	
chalachchitroke,	চালাচ্তিত্রকে,	চলচ্চিত্রকে,	
gajetted,	গজেট্টদ,	গেজেটেড,	
kourabe,	কৌরবে,	কৌরবে,	
teta,	টেট,	টেটা,	
konagoolo,	কানাগুলো,	কণাগুলো,	
kurdira,	কুর্দিরা,	কুর্দিরা,	
bhejaano,	ভেজানো,	ভেজানো,	
bhaisaho,	ভাইসহ,	ভাইসহ,	
labonaaktotaar,	লবণকোত্ততার,	লবণাক্ততার,	
kidambi,	কিদাম্বী,	কিদম্বি,	
uporitaley,	উপরিতালে,	উপরিতলে,	
jamarate,	জামারাতে,	জামারাতে,	
hurricane,	হুরিকানে,	হ্যারিকেন,	
romjaner,	রোমজানের,	রমযানের,	
maudelti,	মুডেলটি,	মডেলটি,	
hoil,	হইল,	হইল,	
dakticket,	ডাক্তিক্টে,	ডাকটিকিট,	
horipur,	হরিপুর,	হরিপুর,	
mokhmoley,	মোখমলে,	মখমলে,	
nagorikra,	নাগরীকরা,	নাগরিকেরা,	
scholarsip,	স্কলারসীপ,	স্কলারশিপ,	
songkoloney,	সংকলনে,	সংকলনে,	
deelibhara,	দিলিভারা,	ডেলিভার,	
goonoman,	গুণমান,	গুণমান,	
dhhaabi,	ঢাবি,	ঢাবি,	
gejetade,	গেজেটাদে,	গেজেটেড,	
jamseder,	জ্যামসেদের,	জামসেদের,	
ponjikar,	পঞ্জিকার,	পঞ্জিকার,	
toufiq,	তৌফিক,	তৌফিক,	
chilona,	চিলোনা,	ছিলনা,	
totokson,	টোটকসন,	ততক্ষন,	
bonobhumi,	বনভূমি,	বনভূমি,	
krom,	ক্রম,	ক্রম,	
oedipus,	আইদিপুস,	ইডিপাস,	
shektore,	শেক্টরে,	সেক্টরে,	
bhittitei,	ভিত্তিতেই,	ভিত্তিতেই,	
charban,	চারবান,	চর্বন,	
ispredseet,	ইইস্পিডেস্ট,	স্প্রেডশীট,	
kormyi,	কর্মি,	কর্মই,	
goolen,	গুলেন,	গুলেন,	
kade,	কাদ়ে,	কোড,	
akatwa,	আকাত্ব,	একাত্ব,	
brahmanera,	ব্রাহ্মণেরা,	ব্রাহ্মণেরা,	
sima,	সিমা,	সীমা,	
dalnata,	দালনাটা,	ডালনাটা,	
shtona,	স্তনা,	স্টোন,	
susamo,	সুসামো,	সুসম,	
pack,	প্যাক্ক,	প্ল্যাক,	
krechi,	ক্রেছি,	করেছি,	
sangbadmadhyame,	সংবাদমাধ্যমে,	সংবাদমাধ্যমে,	
porinoti,	পরিণটি,	পরিণতি,	
mohit,	মহিত,	মুহিত,	
nutoner,	নিটনের,	নূতনের,	
shekarone,	শেকারণে,	সেকারণে,	
suhasini,	সুহাসিনী,	সুহাসিনী,	
firalem,	ফিরালেম,	ফিরালেম,	
osommotite,	অসম্মটিতে,	অসম্মতি,	
uporitoler,	উপরিতলের,	উপরিতলের,	
sangharshik,	সংঘর্ষিক,	সাংঘর্ষিক,	
romarder,	রোমার্ডের,	রোমারদের,	
saseza,	সাসেজা,	সসেজ,	
confliqt,	কনফ্লিক্ট,	কনফ্লিক্ট,	
spredshiit,	স্পারশেইটি,	স্প্রেডশীট,	
karadando,	কারাান্দ,	কারাদণ্ড,	
fastara,	ফাস্তারা,	ফস্টার,	
ganakantha,	গণকাঁথা,	গণকণ্ঠ,	
dhangsachchi,	ধ্বংস্চি,	ধ্বংসাচ্ছি,	
machhti,	মাছটি,	মাছটি,	
daraider,	দারাইদের,	দরাইদের,	
sofie,	সফি,	সোফি,	
templet,	টেম্পলেট,	টেম্পলেট,	
rohosyo,	রহস্য,	রহস্য,	
deaubande,	ডিউব্যান্ডে,	দেওবন্দে,	
marmader,	মার্মাদের,	মারমাদের,	
bedey,	বেদে,	বেদে,	
carlosh,	কার্লোশ,	কার্লোস,	
turbine,	টারবিন,	টারবাইন,	
nirmalata,	নির্মলতা,	নির্মলতা,	
otyacharer,	অত্যাচরের,	অত্যাচারের,	
omarader,	ওমারাদের,	ওমারাদের,	
beetloser,	বেটলসের,	বিটলসের,	
sawam,	সাওয়াম,	সাওম,	
aieesha,	আইস,	আইএএস,	
vabaponno,	ভবাপন্ন,	ভাবাপন্ন,	
saifai,	সাইফাই,	সাইফাই,	
difinishion,	ডিফিনিশন,	ডেফিনেশন,	
rockibul,	রোকবুল,	রকিবুল,	
gaichey,	গাইছে,	গাইছে,	
pakhtunistan,	পাখতুনিস্তান,	পাখতুনিস্তান,	
cocaine,	কোকেনে,	কোকেইন,	
fanse,	ফ্যান্সে,	ফাঁসে,	
madrasi,	মাদরাসি,	মাদ্রাজি,	
besur,	বেসুর,	বেসুর,	
degree,	ডিগ্রি,	ডিগ্রি,	
nirbahi,	নির্বাহী,	নির্বাহি,	
bosante,	বসান্তে,	বসন্তে,	
jyaqa,	জ্যাক,	জ্যাক,	
phartha,	ফার্থা,	ফার্থ,	
notti,	নট্তি,	নোটটি,	
argead,	আর্জিড,	আর্জিদ,	
senabahineeow,	সেনাবাহিনী,	সেনাবাহিনীও,	
sbajan,	স্বজন,	স্বজন,	
seo,	সেও,	সেও,	
surakarder,	সুরকরদের,	সুরকারদের,	
uthhaane,	উঠানে,	উঠানে,	
soource,	সুর্স,	সোর্স,	
swajan,	স্বজন,	স্বজন,	
jaunotar,	যৌনতার,	যৌনতার,	
phising,	ফিসিং,	ফিসিং,	
goshthiti,	গোষ্ঠিটি,	গোষ্ঠীটি,	
pratisthanik,	প্রতিস্থানিক,	প্রাতিষ্ঠানিক,	
manjushree,	মঞ্জুশ্রী,	মঞ্জুশ্রী,	
dito,	দিটো,	দিতো,	
carlos,	কার্লোস,	কার্লোস,	
telakucha,	তেলাকুচা,	তেলাকুচা,	
ponchasjon,	পঞ্চাজজন,	পঞ্চাশজন,	
shashtra,	শাষ্ট্র,	শাস্ত্র,	
bunot,	বুনোট,	বুনট,	
chamski,	চ্যামস্কি,	চমস্কি,	
swadesh,	স্বদেশ,	স্বদেশ,	
juboksoho,	যুবকসহ,	যুবকসহ,	
paab,	পাব,	পাব,	
noiteekotar,	নৈতিকতার,	নৈতিকতার,	
balithubar,	বালিথুবার,	বালিথুবার,	
ishter,	ইশ্ার,	ইস্টের,	
gazipur,	গাজীপুর,	গাজিপুর,	
biplabee,	বিপ্লবী,	বিপ্লবী,	
banglota,	বাংলোটা,	বাংলোটা,	
abdoone,	আবদুনে,	আবদুন,	
gonohotyakey,	গণহট্যাকে,	গণহত্যাকে,	
grontho,	গ্রন্থ,	গ্রন্থ,	
patengar,	পাযাটেঙ্গার,	পতেঙ্গার,	
emargency,	এমারজেন্সি,	এমার্জেন্সি,	
antarctika,	অন্তর্কটিকা,	অ্যান্টার্কটিকা,	
abdi,	আবদি,	অব্দি,	
abti,	আবটি,	আবতি,	
odeb,	ওডেব,	ওদেব,	
seconder,	সেকন্ডার,	সেকেন্ডের,	
harris,	হ্যারিস,	হ্যারিস,	
abheedhaneek,	অভিধানিক,	অভিধানিক,	
salphat,	সালফাত,	সালফেট,	
balokarak,	বালোকারাক,	বলকারক,	
kushumba,	কুশুম্বা,	কুশুম্বা,	
aajeej,	আজিজ,	আজিজ,	
veenis,	ভেনিনিস,	ভেনিস,	
talaa,	তালা,	তালা,	
shnaipara,	শ্নাইপার,	স্নাইপার,	
attorkite,	অট্রকটিতে,	অতর্কিতে,	
dristiheen,	দৃষ্টিহীন,	দৃষ্টিহীন,	
pharmesigulote,	ফার্মেসিগুলোতে,	ফার্মেসীগুলোতে,	
dipankar,	দীপাঙ্কার,	দিপঙ্কর,	
forma,	ফরমা,	ফর্মা,	
holuder,	হলুদের,	হলুদের,	
rajdhani,	রাজধানি,	রাজধানি,	
marmaraa,	মারমারা,	মারমারা,	
tasminer,	তাসমিনের,	তাসমিনের,	
female,	ফেমালে,	ফিমেল,	
joones,	জেনস,	জোন্স,	
ekhate,	এখাতে,	একহাতে,	
torunra,	তরুণরা,	তরুণরা,	
damakalkarmirao,	দামাকারমিরারা,	দমকলকর্মীরাও,	
dhaanche,	ধাঁছে,	ধাঁচে,	
mosjidsoho,	মসজিদসহ,	মসজিদসহ,	
dipgulote,	ডিপগুলোতে,	দ্বীপগুলোতে,	
ratishilatai,	রতিশীলতাই,	রতিশীলতায়,	
proshtotto,	প্রস্তত্ত্ব,	প্রস্ত্তত,	
bhikkharthe,	ভিক্ষার্থে,	ভিক্ষার্থে,	
sobrakomer,	সব্রাকমের,	সবরকমের,	
humira,	হুমিরা,	হুমিরা,	
monjooshree,	মঞ্জশ্রী,	মঞ্জুশ্রী,	
jeten,	জেটেন,	জেতেন,	
monzeele,	মনজিলে,	মঞ্জিলে,	
bike,	বিকে,	বাইক,	
taronee,	তারণী,	তরণী,	
debdebier,	দেবদেবিয়ের,	দেবদেবীর,	
habathu,	হাবাথু,	হাবাথু,	
mugdal,	মুগদাল,	মুগডাল,	
graminphonor,	গ্রামিনফোরর,	গ্রামীণফোনর,	
parqa,	পার্কা,	পার্ক,	
karaponner,	কারাপণ্যের,	কারাপণ্যের,	
dagmukta,	দাগমুক্ত,	দাগমুক্ত,	
jonmobhumitir,	জন্মভূমিটির,	জন্মভূমিটির,	
bonke,	বনকে,	বনকে,	
karmojog,	কর্মযোগ,	কর্মযোগ,	
lopjonito,	লোপজনিত,	লোপজনিত,	
liseensee,	লিসেন্স,	লাইসেন্স,	
toroonra,	তরুণরা,	তরুণরা,	
maarmaader,	মারমাদের,	মারমাদের,	
chhutir,	ছুটির,	ছুটির,	
everage,	এভারেজ,	এভারেজ,	
danata,	দানাটা,	ডোনাট,	
firth,	ফির্থ,	ফার্থ,	
eoki,	ইওকি,	এওকি,	
sangkoolan,	সংকুলন,	সংকুলান,	
innahu,	ইন্নাহু,	ইন্নাহু,	
tooku,	টুকু,	টুকু,	
ghotol,	ঘটল,	ঘটল,	
abdan,	আবদান,	আব্দান,	
qanasarabheshana,	কনসারাভেষণা,	কনসারভেশন,	
poripaker,	পরিপাকের,	পরিপাকের,	
yaq,	যাক্ক,	ইয়াক,	
maudelder,	মাউডলেদের,	মডেলদের,	
upobaasee,	উপবাসী,	উপবাসী,	
mukhmondole,	মুখমণ্ডলে,	মুখমণ্ডলে,	
asbab,	আসবাব,	আসবাব,	
skolarsip,	স্কলারসিপ,	স্কলারশিপ,	
asiatic,	অ্যিয়াটিক,	এশিয়াটিক,	
peerry,	পেরি,	পেরি,	
magar,	মাগার,	মাগার,	
debeting,	ডেবেটিং,	ডিবেটিং,	
ghoomachhe,	ঘুমাচ্ছে,	ঘুমাচ্ছে,	
saazano,	সাজানো,	সাজানো,	
uzobekeestaan,	উজজেবস্তান,	উজবেকিস্তান,	
bojhey,	বোঝে,	বোঝে,	
darjiling,	ডার্জিলিং,	দার্জিলিং,	
fimela,	ফিমেলা,	ফিমেল,	
korle,	করলে,	করলে,	
shef,	শেফ,	শেফ,	
bifol,	বিফল,	বিফল,	
ekla,	একলা,	একলা,	
nirmol,	নির্মলে,	নির্মল,	
huka,	হুকা,	হুক,	
deebug,	দেবুগ,	ডিবাগ,	
sakshatkarer,	সাক্ষাতকারের,	সাক্ষাৎকারের,	
ovinetar,	অভিনেতার,	অভিনেতার,	
rahee,	রাহি,	রাহী,	
pranibigyani,	প্রাণীবিজ্ঞানী,	প্রাণীবিজ্ঞানী,	
hights,	হাইটস,	হাইটস,	
champa,	চম্পা,	চাঁপা,	
udvabani,	উদ্ভাবনী,	উদ্ভাবনী,	
durgotsab,	দুর্গোৎসব,	দুর্গোৎসব,	
masto,	মাস্টো,	মাস্ত,	
phutanta,	ফুটান্ত,	ফুটন্ত,	
planey,	প্লেনি,	প্লেনে,	
naubom,	নৌবম,	নবম,	
shangsthaner,	সাংস্থানের,	সংস্থানের,	
maailkhanek,	মাইলখানেক,	মাইলখানেক,	
madhoori,	মাধুরি,	মাধুরী,	
elaakaate,	এলাকাতে,	এলাকাতে,	
gotirodh,	গতিরোধ,	গতিরোধ,	
dinifitian,	দিনিফিশিয়ান,	ডেফিনেশন,	
serveray,	সারভেরে,	সার্ভারে,	
nuhas,	নুহাস,	নুহাশ,	
bipradas,	বিপ্রদাস,	বিপ্রদাস,	
saraiki,	সারাইকি,	সরাইকি,	
zubokra,	যুবকরা,	যুবকরা,	
avisongson,	অভিশংসন,	অভিশংসন,	
sarbhare,	সার্ভারে,	সার্ভারে,	
chyeta,	চিয়াতা,	চ্যাট,	
bhimsenkei,	ভীমসেনকেই,	ভীমসেনকেই,	
daebug,	দাইবুগ,	ডিবাগ,	
mankisundar,	মান্কিসুন্দার,	মানকিসুন্দর,	
ishtone,	ইষ্টনে,	স্টোন,	
shoriph,	শরীফ,	শরিফ,	
korley,	করলি,	করলে,	
monchostho,	মঞ্চস্থ,	মঞ্চস্থ,	
jatinke,	জাতিনকে,	যতীনকে,	
tottorat,	তত্ত্রাত,	তওরাত,	
providere,	প্রভিদেরে,	প্রভাইডারে,	
kuldip,	কুলদীপ,	কুলদীপ,	
nabayug,	নবয়াগু,	নবযুগ,	
ganesh,	গণেশ,	গণেশ,	
byabaharkareederke,	ব্যাবহারকারীদেরকে,	ব্যবহারকারীদেরকে,	
ankanshilpe,	অঙ্কল্ষিপেপে,	অঙ্কনশিল্পে,	
donat,	ডোনাট,	ডোনাট,	
zarniz,	জার্নিজ,	জারনিজ,	
sikarer,	সিকারের,	শিকারের,	
capshule,	ক্যাপশুলে,	ক্যাপসুল,	
reetesh,	রেতেশ,	রিতেশ,	
kalirkhal,	কালিরখাল,	কালিরখাল,	
kingsh,	কিংস,	কিংস,	
nimnosakkharkari,	নিম্মসানকারকারী,	নিম্নস্বাক্ষরকারী,	
themekey,	থেমেকে,	থিমকে,	
dharavahikbhabe,	ধারাবাহিকভাবে,	ধারাবাহিকভাবে,	
thakeni,	থাকেনি,	থাকেনি,	
dayitta,	দায়িত্ব,	দায়িত্ব,	
ashok,	আশোক,	আশোক,	
sheshdinti,	শেষদিন্তি,	শেষদিনটি,	
nichupattir,	নিচুপাট্টির,	নিচুপট্টির,	
krisenter,	ক্রিসেন্টের,	ক্রিসেন্টের,	
teenisa,	টেনিসা,	টেনিস,	
bondhukey,	বন্ধুকে,	বন্ধুকে,	
mercedes,	মার্সেদস,	মার্সেডেস,	
kalkarkhana,	কালকারখানা,	কলকারখানা,	
dwijenbabuder,	দ্বিজেনবাবুদের,	দ্বিজেনবাবুদের,	
somonwitobhabey,	সমন্বিতভাবে,	সমন্বিতভাবে,	
bhimsen,	ভীমসেন,	ভীমসেন,	
sangkalanti,	সংকলনটি,	সংকলনটি,	
addabaj,	আড্ডাবাজ,	আড্ডাবাজ,	
sukumaree,	সুকুমারী,	সুকুমারী,	
amittrakkhor,	অমিত্রাক্ষর,	অমিত্রাক্ষর,	
vugoley,	ভুগোলে,	ভূগোলে,	
liceensee,	লাইসন্সি,	লাইসেন্স,	
cheentaikaree,	চিন্তাইকারী,	ছিনতাইকারী,	
reflex,	রিফ্লেক্স,	রিফ্লেক্স,	
survative,	সার্ভাটিভ,	সারভেটিভ,	
soundarja,	সৌন্দর্য,	সৌর্ন্দয্য,	
gananatyo,	গণনাত্য,	গণনাট্য,	
hukar,	হুকার,	হুকার,	
bhyaatikaner,	ভ্যাটিকানের,	ভ্যাটিকানের,	
sumita,	সুমিতা,	সুমিতা,	
kokeyin,	কোকেনিন,	কোকেইন,	
khagen,	খাগেন,	খগেন,	
dakter,	ডাক্তার,	ডাকতের,	
cheef,	চিফ,	শেফ,	
prarthonakokkher,	প্রার্থনাকক্ষের,	প্রার্থনাকক্ষের,	
jontrangshogulor,	যন্ত্রাণশগুলোর,	যন্ত্রাংশগুলোর,	
oboshore,	অবশরে,	অবসরে,	
sorsa,	সোরসা,	সোর্স,	
jibnagore,	জীবনগরে,	জীবননগর,	
baikalyo,	বাইকাল্য,	বৈকল্য,	
murali,	মুরালি,	মুরলী,	
hoteltite,	হোটেলটিতে,	হোটেলটিতে,	
laat,	লাট,	লাট,	
anutpadanshil,	অনুউপদতনাীল,	অনুৎপাদনশীল,	
tuni,	টিউনি,	টুনি,	
dala,	ডালা,	দলা,	
gurmukh,	গুরমুখ,	গুরমুখ,	
becha,	বেচা,	বেচা,	
wictor,	উইক্টর,	ভিক্টর,	
rushod,	রুশোদ,	রুশদ,	
biprodas,	বিপ্রদাস,	বিপ্রদাস,	
laiseensee,	লইজেন্সি,	লাইসেন্স,	
nishad,	নিশাদ,	নিষাদ,	
shomostigoto,	সমস্তিগত,	সমষ্টিগত,	
kachhakaachhi,	কাছাকাছি,	কাছাকাছি,	
snehban,	স্নেহবান,	স্নেহবান,	
sector,	সেক্টর,	সেক্টর,	
okkhorke,	অক্ষরকে,	অক্ষরকে,	
ancholtike,	আঞ্চলটিকে,	অঞ্চলটিকে,	
drabyatah,	দ্রব্যতঃ,	দ্রব্যতঃ,	
medilek,	মেদিলেক,	মেডিলেক,	
browser,	ব্রয়াসর,	ব্রাউজার,	
juakhelar,	জুয়াখেলার,	জুয়াখেলার,	
inziniyarsa,	ইনজিনিয়ারস,	ইঞ্জিনিয়ার্স,	
shlok,	শ্লোক,	শ্লোক,	
konistho,	কনিষ্ঠ,	কনিষ্ঠ,	
miitar,	মিয়ার,	মিত্র,	
provritike,	প্রভৃতিকে,	প্রভৃতিকে,	
kabutorer,	কাবুতরের,	কবুতরের,	
windows,	উইনডোউস,	উইন্ডোস,	
harza,	হার্জা,	হার্জ,	
udyem,	উদ্যেম,	উদ্যেম,	
fastag,	ফাস্টাগ,	ফ্যাসট্যাগ,	
siit,	সিত,	শীত,	
panda,	পাণ্ডা,	পান্ডে,	
probhur,	প্রভুর,	প্রভুর,	
feemalee,	ফীমালি,	ফিমেল,	
toki,	টোকি,	তকি,	
mette,	মেট্টে,	ম্যাট,	
gabhaaskar,	গাভাসকার,	গাভাস্কার,	
chalochchitraeei,	চলচ্চিত্রায়ী,	চলচ্চিত্রেই,	
vvimsenn,	ভিভিমসেন্স,	ভীমসেন,	
bodhir,	বধির,	বধির,	
kodorer,	কদরের,	কদরের,	
sthapanatir,	স্থাপানাটির,	স্থাপনাটির,	
cholochchitra,	চলচ্চিত্র,	চলচ্চিত্র,	
mukherjee,	মুখেরজি,	মুখার্জী,	
juktorashtreo,	যুক্তরাশ্ট্রেও,	যুক্তরাষ্ট্রেও,	
grauth,	গ্রাউথ,	গ্রোথ,	
gejeted,	জেজেটেড,	গেজেটেড,	
mataram,	মাতারাম,	মাতরম,	
aarmstrong,	আর্মস্ট্রং,	আর্মস্ট্রং,	
shem,	শেম,	সেম,	
ramantika,	রামান্তিকা,	রোমান্টিক,	
plator,	প্ল্যাটর,	প্লেটোর,	
folleni,	ফলেনি,	ফলেনি,	
elakatike,	এলাকাটিকে,	এলাকাটিকে,	
kaansaat,	কানসাত,	কানসাট,	
jinsa,	জিনসা,	জিন্স,	
chadake,	চড়াকে,	চড়াকে,	
ji,	জি,	জি,	
firoze,	ফিরোজে,	ফিরোজ,	
aizulke,	আইজুলকে,	আইজুলকে,	
uparjoner,	উপার্যনের,	উপার্জনের,	
parjotaker,	পার্যকাকের,	পর্যটকের,	
russad,	রুশাদ,	রুশদ,	
basermick,	বেসারমিক,	বেসারমিক,	
kheshar,	খেশার,	খেশার,	
khorsed,	খোরসেড,	খোরশেদ,	
juddhahato,	যুদ্ধাহত,	যুদ্ধাহত,	
dephinishion,	ডেফিশিশন,	ডেফিনেশন,	
elgoridom,	এলগোরিডম,	এলগরিদম,	
samajik,	সমাজিক,	সামাজিক,	
maudelgulo,	মাউদেলগুলো,	মডেলগুলো,	
rudrasagar,	রুদ্রসাগর,	রুদ্রসাগরের,	
nepchooner,	নেপচুনের,	নেপচুনের,	
melborrone,	মেলবোরনে,	মেলবোর্নে,	
rahshahi,	রাহশাহী,	রাহশাহী,	
jamanataswarup,	জমানতস্বরূপ,	জামানতস্বরূপ,	
ponchashjon,	পঞ্চাশজন,	পঞ্চাশজন,	
oitijje,	ঐতিহ্যে,	ঐতিহ্যে,	
pratiyogita,	প্রতিযোগীতা,	প্রতিযোগীতা,	
ebhara,	এভারা,	এভার,	
naazee,	নাজি,	নাত্সি,	
manushgulor,	মানুষগুলোর,	মানুষগুলোর,	
bishwaashshke,	বিশ্বশ্ষকে,	বিশ্বাসকে,	
asaktibandhan,	অসক্তিবন্ধন,	আসক্তিবন্ধন,	
phiksim,	ফিকসিম,	ফিক্সিং,	
bhujangta,	ভূজংটা,	ভুজঙ্গটা,	
hunine,	হুনিন,	হুনাইন,	
bhabaaponno,	ভাবাপন্ন,	ভাবাপন্ন,	
vince,	ভিন্সে,	ভিন্স,	
oshtader,	অষ্টাদের,	ওস্তাদের,	
bonorajite,	বনরাজিতে,	বনরাজিতে,	
tennis,	টেনিস,	টেনিস,	
whole,	ভোলে,	হোল,	
dhalur,	ধলুর,	ঢালুর,	
nichols,	নিচোলস,	নিকলস,	
choudhurike,	চৌধুরীকে,	চৌধুরীকে,	
baipass,	বাইপ্যাস,	বাইপাস,	
eekbalke,	ইকবালকে,	ইকবালকে,	
smarok,	স্মারক,	স্মারক,	
turkyder,	তুর্কিদের,	তুর্কিদের,	
sathik,	সাথিক,	সঠিক,	
deejeejer,	দেজীজের,	ডিজিজের,	
kormoi,	কর্মই,	কর্মই,	
chintamani,	চিন্তামনি,	চিন্তামনি,	
jalarong,	জালারং,	জলরঙ,	
sikkhagata,	সিক্ষাগত,	শিক্ষাগত,	
dajhyo,	দাঝ্য,	দাহ্য,	
shit,	শিত,	শীত,	
niroja,	নিরোজা,	নিরোজা,	
mahasava,	মহাসাভা,	মহাসভা,	
babare,	বাবারে,	বাবারে,	
laiseensim,	লইইসিন্ম,	লাইসেন্সিং,	
biswashi,	বিশ্বাসী,	বিশ্বাসী,	
jounatar,	যৌনাটার,	যৌনতার,	
khilaphat,	খিলাফাট,	খিলাফত,	
ghotleo,	ঘটলেও,	ঘটলেও,	
landey,	ল্যান্ডে,	ল্যান্ডে,	
taunship,	টাউনশিপ,	টাউনশিপ,	
torikher,	তরিখের,	তরিখের,	
naajii,	নাজি,	নাত্সি,	
bhabanipur,	ভবানিপুর,	ভবানীপুর,	
dakope,	ডাকোপ,	দাকোপ,	
atmobonchito,	আত্মবঞ্চিত,	আত্মবঞ্চিত,	
philipiner,	ফিলিপিনের,	ফিলিপাইনের,	
drissogulo,	দৃশ্মগুলো,	দৃশ্যগুলো,	
ganaparibahan,	গণপারিবহন,	গণপরিবহন,	
venice,	ভেনিসি,	ভেনিস,	
aatto,	আট্টো,	আত্ম,	
braqe,	ব্রেক,	ব্রেক,	
daaun,	দাউন,	ডাউন,	
byomkesh,	ব্যমকেশ,	ব্যোমকেশ,	
ghoomato,	ঘুমাতো,	ঘুমাতো,	
karpeter,	কারপেটের,	কার্পেটের,	
swasthohinotay,	স্বাস্থহিতনায়,	স্বাস্থ্যহীনতায়,	
provur,	প্রভুর,	প্রভুর,	
muhuriganj,	মুহুরীগঞ্জ,	মুহুরীগঞ্জ,	
seqtara,	সেক্টার,	সেক্টর,	
nirikh,	নিরিখ,	নিরিখ,	
kanasarabheeshana,	কনসাররিষণ,	কনসারভেশন,	
badhamuktovabe,	বাধামুক্তভাবে,	বাধামুক্তভাবে,	
chandil,	চণ্ডিল,	চান্ডিল,	
dijijer,	দিজিজের,	ডিজিজের,	
bhandar,	ভান্ডার,	ভাণ্ডার,	
treebhuj,	ট্রীভজ,	ত্রিভূজ,	
tyap,	ত্যাপ,	ট্যাপ,	
dweepgoolotey,	দ্বীপগুলোতে,	দ্বীপগুলোতে,	
patigoniter,	পাতিগণিতের,	পাটিগণিতের,	
debdebie,	দেবদেবি,	দেবদেবী,	
amiya,	আমিয়া,	অমিয়,	
tongaa,	টঙ্গা,	টোঙ্গা,	
pharanyeta,	ফরান্যেট,	ফরম্যাট,	
hajeerhatt,	হাজীরহাট,	হাজিরহাট,	
nottee,	নটি,	নোটটি,	
sobaiderke,	সবাইদেরকে,	সবাইদেরকে,	
nariderke,	নারীদেরকে,	নারীদেরকে,	
chalai,	চালাই,	চালাবে,	
suraaropeeto,	সুরাররীপত,	সুরারোপিত,	
andra,	আন্দ্রার,	আন্ড্রা,	
shikh,	শিখ,	শিখ,	
machgulo,	মাছগুলো,	মাছগুলো,	
suraaropito,	সুরারোপিত,	সুরারোপিত,	
aswasteekor,	অস্বা্্তীকর,	অস্বস্তিকর,	
masjidtir,	মাসজিদটির,	মসজিদটির,	
vromonkaley,	ভ্রমণকালে,	ভ্রমণকালে,	
bujhtepari,	বুঝতেপারি,	বুঝতেপারি,	
sommoteer,	সম্মতির,	সম্মতির,	
hood,	হোড,	হুড,	
hossne,	হসসে,	হোসনে,	
sithilotar,	সিথিলতার,	শিথিলতার,	
phonekari,	ফোনেকারি,	ফোনকারী,	
badargaji,	বদরগাজী,	বদরগাজী,	
kayartara,	কয়ররতাা,	কোয়ার্টার,	
mathieu,	ম্যাথিউ,	ম্যাথিউ,	
gandharir,	গান্ধারীর,	গান্ধারীর,	
bibader,	বিবাদের,	বিবাদের,	
ramonar,	রমোনার,	রমনার,	
saria,	সারিয়া,	সরিয়া,	
turbiner,	টারবিনের,	টারবাইনের,	
suporichita,	সুপরিচিতা,	সুপরিচিত,	
majdur,	মজদুর,	মজদুর,	
ashociatesh,	আশোচিতায়েস,	এসোসিয়েটস,	
ase,	আসে,	আসে,	
ghurte,	ঘুরতে,	ঘুরতে,	
nikate,	নিকাতে,	নিকটে,	
pujito,	পুজিত,	পুজিত,	
ashirbadatri,	আশির্বাদাত্রী,	আশীর্বাদাত্রী,	
gamdan,	গামডান,	গামদান,	
dooburira,	দুবুরীরা,	ডুবুরিরা,	
jonomukhi,	জনমুখি,	জনমুখী,	
kod,	কোড,	কোড,	
nirgamon,	নির্গামন,	নির্গমন,	
ekoirokom,	একইরোকম,	একইরকম,	
karecho,	করেছো,	করেছো,	
samyuktha,	সম্যুক্থ,	সামিউক্তা,	
proteemar,	প্রতিয়ামার,	প্রতিমার,	
mukhoshdharir,	মুখোষধারীর,	মুখোশধারীর,	
utsahi,	উতসাহি,	উৎসাহী,	
ayumi,	আয়ুমী,	আয়ুমি,	
tennys,	টেনিস,	টেনিস,	
prottokkhovabe,	প্রত্যক্ষভাবে,	প্রত্যক্ষভাবে,	
atmiyasulabh,	আত্মীয়সুলভ,	আত্মীয়সুলভ,	
kkomandar,	ক্কমান্দার,	কমাণ্ডার,	
nowel,	নোয়েল,	নভেল,	
emarjenshi,	এমরজেন্সি,	এমার্জেন্সি,	
yura,	যুররা,	ইউরো,	
fongli,	ফল্ি,	ফংলি,	
kagbeni,	কাগবেনি,	কাগবেনি,	
shamshernagar,	শমশশরনগরের,	শমশেরনগর,	
orbeet,	অরবিত,	অরবিট,	
aaeerese,	আইরেসে,	আইরেসে,	
poketchorder,	পকেটচরদের,	পকেটচরদের,	
qarlosa,	কার্লোসা,	কার্লোস,	
upacharjo,	উপাচার্য,	উপাচার্য,	
rayyaleti,	রায়্যলেলি,	রয়্যালটি,	
rajotwo,	রাজত্ব,	রাজত্ব,	
byaktikegreptar,	ব্যক্তিগেতপ্রেষ্টার,	ব্যক্তিকেগ্রেপ্তার,	
hoonayin,	হুনাইনিন,	হুনাইন,	
muktilav,	মুক্তিলাভ,	মুক্তিলাভ,	
mulyabriddhikale,	মূল্যবৃদ্ধিকলে,	মূল্যবৃদ্ধিকালে,	
utotoro,	উতততর,	উততর,	
madhobeer,	মাধবীর,	মাধবীর,	
breakthrough,	ব্রেকফরুঘ,	ব্রেকথ্রু,	
dologuloo,	দলগুলো,	দলগুলোও,	
bodhirota,	বধিরতা,	বধিরতা,	
shahabike,	শাহাবীকে,	সাহাবীকে,	
sarbhaarti,	সর্ভারটি,	সার্ভারটি,	
fand,	ফ্যান্ড,	ফান্ড,	
udbodhani,	উদ্বোধনী,	উদ্বোধনী,	
teennis,	টেনিস,	টেনিস,	
durarohini,	দুরারোহিনী,	দুরারোহিণী,	
beatleser,	বেটলসের,	বিটলসের,	
debdebyr,	দেবদেবির,	দেবদেবীর,	
canflikt,	ক্যানফ্লিক্ট,	কনফ্লিক্ট,	
taitela,	টাইতেলা,	টাইটেল,	
ceramiker,	সেরামিকের,	সিরামিকের,	
bitlaser,	বিটলেসের,	বিটলসের,	
janmat,	জন্মত,	জন্মাত,	
shuchonakal,	শুচনাকাল,	সূচনাকাল,	
dholeshwari,	ধোলেশ্বরী,	ধলেশ্বরী,	
grambaaseeder,	গ্রামবাসীদের,	গ্রামবাসীদের,	
krema,	ক্রেমা,	ক্রাইম,	
nirbahe,	নির্বাহে,	নির্বাহে,	
baarbadoj,	বারবাদোজ,	বার্বাডোজ,	
aaireshe,	আইরেশে,	আইরেসে,	
boudher,	বৌধের,	বৌদ্ধের,	
shahidputra,	শহিদপুত্র,	শহীদপুত্র,	
chokhwala,	চোখ্বালা,	চোখওয়ালা,	
mitroder,	মিত্রদের,	মিত্রদের,	
hooq,	হুক,	হুক,	
ooipokar,	উয়োপাকার,	উইপোকার,	
jacksonke,	জ্যাকসনকে,	জ্যাকসনকে,	
deefinishion,	ডিফিনিশন,	ডেফিনেশন,	
kharar,	খার,	খরার,	
shibraj,	শিবরাজ,	শিবরাজ,	
delibhara,	ডেলিভারা,	ডেলিভার,	
bhabanir,	ভবনীর,	ভবানীর,	
shikhra,	শিখরা,	শিখরা,	
pacbar,	পাঁবার,	পাঁচবার,	
muhurtati,	মুহুর্তাটি,	মুহুর্তটি,	
tateo,	তাতেও,	তাতেও,	
bonsho,	বংশ,	বংশ,	
rakhtokkharone,	রাখতক্ষকরণে,	রক্তক্ষরণে,	
hisaber,	হিসাবের,	হিসাবের,	
zozyota,	যোজ্যতা,	যোজ্যতা,	
esasiyetasa,	এসাসিয়েতস,	এসোসিয়েটস,	
rakshanbhag,	রক্ষণবাগ,	রক্ষণভাগ,	
antennal,	অ্যান্টেননাল,	অ্যান্টেনাল,	
nibeditar,	নিবেদিতার,	নিবেদিতার,	
pathanirdeshona,	পাঠানির্দেশনা,	পথনির্দেশনা,	
votar,	ভোাার,	ভোটার,	
moreecha,	মরিছা,	মরিচা,	
pharn,	ফার্ন,	ফার্ন,	
zakharovar,	যাখারোভার,	জাখারোভার,	
heelser,	হিলসের,	হিলসের,	
cena,	সিইন,	সিনা,	
yucalyptus,	য়াউল্যিটাাস,	ইউক্যালিপ্টাস,	
chaalkee,	চালকি,	চালকে,	
drissotir,	দৃশ্বটির,	দৃশ্যটির,	
gosthike,	গোষ্ঠীকে,	গোষ্ঠীকে,	
karam,	কারাম,	কেরাম,	
kathghera,	কাঠঘেরা,	কাঠঘেরা,	
bosontokke,	বসন্তককে,	বসন্তকে,	
dhila,	ধিলা,	ঢিলা,	
daakten,	ডাক্তেন,	ডাকতেন,	
minilosar,	মিনিলোসার,	মিনিলোসার,	
saralya,	সরলা,	সারল্য,	
rezidence,	রেজিডেন্স,	রেসিডেন্স,	
bonbhumi,	বনভূমি,	বনভূমি,	
comoros,	কমোরোস,	কোমোরোস,	
ukeliptash,	উকেলিপ্তষা,	ইউক্যালিপ্টাস,	
siitei,	সীতেই,	শীতেই,	
chapal,	চাপাল,	চপল,	
gobeshonar,	গবেষণার,	গবেষনার,	
aakaabar,	আকাবার,	আকাবার,	
dolu,	দললু,	ডলু,	
akhhunno,	আখুন্ন,	অক্ষুণ্ণ,	
doltyagi,	দলট্যাগি,	দলত্যাগী,	
venush,	ভেনুশ,	ভেনাস,	
dokanei,	দোকানেই,	দোকানেই,	
annimated,	অ্যানিমেটেড,	এনিমেটেড,	
dolphiny,	ডলফিনি,	ডলফিনি,	
sotorkobhabey,	সতর্ভভাবে,	সতর্কভাবে,	
madhoboir,	মাধবৈর,	মাধবীর,	
kandy,	কাণ্ডী,	ক্যান্ডি,	
chalachchitroi,	চালাচ্িত্রই,	চলচ্চিত্রই,	
ummool,	উম্মুল,	উম্মুল,	
tahalo,	তাহালো,	তাহলো,	
jontropatigulite,	যন্ত্রপালীগুলিতে,	যন্ত্রপাতিগুলিতে,	
plusey,	প্লেসি,	প্লাসে,	
konoroop,	কোনোরূপ,	কোনরূপ,	
ceramicer,	সেরিমেসির,	সিরামিকের,	
chal,	চাল,	চাল,	
thare,	থারই,	থরে,	
deepan,	দীপান,	দীপন,	
abikaul,	অবিকৌল,	অবিকল,	
philo,	ফিলো,	ফিলো,	
muchi,	মুছি,	মুচি,	
ganohotyake,	গণহত্যাকে,	গণহত্যাকে,	
bangalore,	বাঙ্গালোর,	ব্যাঙ্গালুরে,	
bedantodhormo,	বেদান্তরধর্ম,	বেদান্তধর্ম,	
saarbharti,	সর্ভরটি,	সার্ভারটি,	
vabook,	ভযা,	ভাবুক,	
kleentoner,	ক্লিন্টনের,	ক্লিনটনের,	
ajijer,	অজিজের,	আজিজের,	
lyaandeeng,	ল্যাডডিং,	ল্যান্ডিং,	
shulfate,	শুলফাতে,	সালফেট,	
attacharito,	অট্টাচারিত,	অত্যাচারিত,	
jani,	জানি,	জনি,	
seshardhe,	শেষার্ধে,	শেষার্ধে,	
crime,	ক্রাইম,	ক্রাইম,	
lajik,	লাজিক,	লজিক,	
jotsna,	জোটস্না,	জ্যোৎস্না,	
prime,	প্রাইম,	প্রাইম,	
carlo,	কারলো,	কার্লো,	
dinar,	দিনার,	ডিনার,	
duburir,	ডুবুরির,	ডুবুরির,	
phakay,	ফাকয়ে,	ফাকে,	
beila,	বেইলা,	বেইলা,	
toranganj,	তরঙ্গঞ্জ,	তোরাবগঞ্জ,	
shiqara,	শিকারা,	শিকার,	
alankorana,	আলঙ্করননা,	অলঙ্করণ,	
vorkendra,	ভর্কেন্দ্রের,	ভরকেন্দ্র,	
parikhar,	পরিখার,	পরিখার,	
kailashrao,	কৈলাশ্রও,	কৈলাশরাও,	
gratha,	গ্রাথা,	গ্রোথ,	
jeshtha,	যেষথা,	জ্যেষ্ঠা,	
summer,	সুমারের,	সামার,	
rinobodh,	ঋণবধধ,	ঋণবোধ,	
kei,	কেই,	কেই,	
ap,	এপিপি,	আপ,	
addhattikotar,	আদ্ধাত্মিকতার,	আধ্যাত্মিকতার,	
shasyadi,	শাস্যাদি,	শস্যাদি,	
cholochchitrer,	চলচ্চিত্রের,	চলচ্চিত্রের,	
ghotleyo,	ঘটলেও,	ঘটলেও,	
kul,	কুল,	কুল,	
roopdaan,	রূপদান,	রুপদান,	
chhadura,	ছাদুরা,	ছাদুরা,	
sheets,	সিটস,	শীটস,	
sikkhokder,	শিক্ষকদের,	শিক্ষকদের,	
deep,	দীপ,	দীপ,	
sumi,	সুমি,	সুমি,	
zommu,	জম্মু,	জম্মু,	
pyetarna,	প্যেটার্ন,	প্যাটার্ন,	
taderek,	তাদেরেক,	তাদেরেক,	
bikretara,	বিক্রেতারা,	বিক্রেতারা,	
koyeeri,	কয়ীরি,	কোয়েরি,	
chalochchitrei,	চলচ্চিত্রেই,	চলচ্চিত্রেই,	
dharmantor,	ধর্মান্তর,	ধর্মান্তর,	
karu,	করু,	কারু,	
manibhaijaner,	মণিভাইজানের,	মণিভাইজানের,	
sorano,	সোরানো,	সরানো,	
premoronge,	প্রেমরঙ্গে,	প্রেমরঙে,	
nyata,	ন্যাটা,	ম্যাট,	
baganoto,	বাগানত,	বাগানত,	
durlabhatwang,	দূর্লাত্বং,	দুর্লভত্বং,	
guzober,	গুজবের,	গুজবের,	
ekbai,	একবাই,	একবাই,	
shilbar,	শিলবার,	সিলভার,	
bbiswasho,	বিব্বিশাশ,	বিশ্বাসও,	
byaboharkarie,	ব্যবহারকারি,	ব্যবহারকারীই,	
protul,	প্রতুল,	প্রতুল,	
toxoid,	টক্সইড,	টক্সয়েড,	
dibug,	দিবুগ,	ডিবাগ,	
lendol,	লেন্ডল,	লেন্ডল,	
dhandu,	ধন্দু,	ধন্দু,	
safiha,	সাফিহা,	সাফিহা,	
myari,	ম্যারি,	ম্যারি,	
haitasha,	হাইতাশা,	হাইটস,	
ardasha,	আর্দশা,	আর্দশ,	
protiakromonei,	প্রতিকায়ম্রনেই,	প্রতিআক্রমণেই,	
futote,	ফুটোতে,	ফুটোতে,	
sontoshpur,	সন্তশসুর,	সন্তোষপুর,	
langhoner,	লাংহনের,	লংঘনের,	
sachetonvabe,	সচেতনভাবে,	সচেতনভাবে,	
teoyana,	তেওয়ানা,	তাইওয়ান,	
procharona,	প্রচারণা,	প্রচারণা,	
thailandsaho,	থাইলান্দসহ,	থাইল্যান্ডসহ,	
tistar,	তিস্তার,	তিস্তার,	
poriskoron,	পরিস্করণ,	পরিষ্করণ,	
lirikti,	লিরিকটি,	লিরিকটি,	
upobashii,	উপবাশীই,	উপবাসী,	
gandhariir,	গান্ধারীর,	গান্ধারীর,	
bisheshshyer,	বিশেষ্ষের,	বিশেষ্যের,	
chhutee,	ছুটি,	ছুটি,	
dembakreeti,	ডেম্বাকৃতি,	ডিম্বাকৃতি,	
samajikotar,	সমাজিকতার,	সামাজিকতার,	
auttacharer,	অট্টাচারের,	অত্যাচারের,	
dharabahikbhabe,	ধারাবাহিকভাবে,	ধারাবাহিকভাবে,	
laps,	ল্যাপস,	ল্যাপস,	
chilahatee,	চিলাহাটি,	চিলাহাটি,	
naper,	নাপার,	ন্যাপের,	
america,	আমেরিকা,	আমেরিকা,	
ikbaaler,	ইকবালের,	ইকবালের,	
somratra,	সমরাত্রা,	সম্রাটরা,	
ponchaasjon,	পঞ্চাজজন,	পঞ্চাশজন,	
ashamarthita,	আশামার্থিতা,	অসমর্থিত,	
mehsus,	মেহসাস,	মেহসুস,	
prokar,	প্রকার,	প্রকার,	
chapchap,	চ্যাপচাপ,	চাপচাপ,	
qlauda,	কোলাউ,	ক্লাউড,	
gondogol,	গণ্ডগোল,	গন্ডগোল,	
hugeke,	হুগেকে,	হিউজকে,	
raagei,	রাগেই,	রাগেই,	
quartar,	কোয়ার্ার,	কোয়ার্টার,	
ekoghore,	একঘরে,	একঘরে,	
gandogol,	গণ্ডগোল,	গন্ডগোল,	
bandhano,	বাঁধানো,	বাঁধানো,	
sepha,	সেফ,	শেফ,	
meridiane,	মেরিডিয়েন,	মেরিডিয়ানে,	
orhan,	ওরহান,	ওরহান,	
timoothi,	তিমোথি,	টিমোথি,	
shattoki,	সত্তককি,	সাত্যকি,	
shrabosty,	শ্র্যাস্টি,	শ্রাবস্তী,	
oxforde,	অক্সফোর্ডে,	অক্সফোর্ডে,	
asociatis,	অ্যাসোসিয়াটিস,	এসোসিয়েটস,	
baibosthar,	বাইবস্থার,	ব্যবস্থার,	
hattey,	হ্যাটে,	হাঁটতে,	
avidur,	অভিদুর,	আভিদুর,	
eukalyptus,	ইউক্যালিপ্টাস,	ইউক্যালিপ্টাস,	
remission,	রিমিশন,	রিমিশন,	
tokee,	তকি,	তকি,	
korimkey,	করিমকে,	করিমকে,	
remacry,	রিমেক্রি,	রেমাক্রী,	
shatokeo,	শতকেও,	শতকেও,	
brojomohun,	ব্রজমহূণ,	ব্রোজোমোহন,	
iraner,	ইরানের,	ইরানের,	
dhyana,	ধ্যানা,	ধ্যান,	
ajibon,	আজিবন,	আজীবন,	
joisttho,	জৈষ্ঠ,	জ্যৈষ্ঠ,	
agamane,	আগামানে,	আগমনে,	
chaudhurio,	চৌধুরিও,	চৌধুরীও,	
oojbekistan,	অজবেকিস্তান,	উজবেকিস্তান,	
ganjana,	গঞ্জনা,	গঞ্জনা,	
toptoshele,	তপ্তশেলে,	তপ্তশেলে,	
gaujano,	গৌজানো,	গজানো,	
bidyadanke,	বিদ্যাদানকে,	বিদ্যাদানকে,	
elakatite,	এলাকাটিতে,	এলাকাটিকে,	
shoreefer,	শরীফের,	শরিফের,	
fulkapi,	ফুলকাপী,	ফুলকপি,	
nirvachokder,	নির্ভাকদের,	নির্বাচকদের,	
megh,	মেঘ,	মেঘ,	
dharavahik,	ধারাবাহিক,	ধারাবাহিক,	
parikha,	পারিখা,	পরিখার,	
lobbytey,	লবিটি,	লবিতে,	
bosoben,	বসবেন,	বসবেন,	
gagee,	গগি,	গেজ,	
lat,	লাট,	লাট,	
heepatitis,	হিপাটিটিস,	হেপাটাইটিস,	
mosjidtir,	মসজিদটির,	মসজিদটির,	
mythological,	মাইথোলজিকাল,	মাইথলজিকাল,	
shift,	শিফ্ট,	শিফট,	
shourshe,	শৌর্শে,	সোর্স,	
amarika,	আমারিকা,	আমেরিকা,	
ebham,	এভাম,	ইভিএম,	
oncholshomuher,	অঞ্চলসমূহের,	অঞ্চলসমূহের,	
jeebanjapon,	জীবঞ্জপন,	জীবনযাপন,	
rajbandi,	রাজবন্দি,	রাজবন্দী,	
amor,	আমর,	আমর,	
spashtotai,	স্পষ্টতাই,	স্পষ্টতই,	
samratra,	সমরাত্রা,	সম্রাটরা,	
bhittiti,	ভিত্তিটি,	ভিত্তিটি,	
nick,	নিক,	নিক্,	
elakai,	এলাকাই,	এলাকাই,	
harbore,	হারবোর,	হারবারে,	
cloring,	ক্লোরিং,	ক্লোরিং,	
daqten,	ডাক্টেন,	ডাকতেন,	
danakana,	দানাকানা,	ডানকান,	
sheepha,	শেফা,	শেফ,	
spredsheet,	স্প্রেডশিট,	স্প্রেডশীট,	
akkelpure,	আক্কেলপুরে,	আক্কেলপুরে,	
byabostho,	ব্যবস্থ,	ব্যাবস্থা,	
zeland,	জেল্যান্ড,	জিল্যান্ড,	
bodna,	বোদা,	বদনা,	
onurbar,	অনুরবার,	অনুর্বর,	
sosoa,	সোসা,	শশা,	
bikretaara,	বিক্রেটারা,	বিক্রেতারা,	
chowdhuryke,	চুধুরীকে,	চৌধুরীকে,	
chouhate,	চৌহাতে,	চৌহাটে,	
bhabotarini,	ভাবতারিণী,	ভবতারিণী,	
schilling,	স্কালিং,	শিলিং,	
gronthoti,	গ্রন্থটি,	গ্রন্থটি,	
protizogii,	প্রোটিগোই,	প্রতিযোগী,	
tanu,	তানু,	তনু,	
mohajot,	মহাজত,	মহাজোট,	
juktarashtrasaha,	যুক্তারশ্রাসহ,	যুক্তরাষ্ট্রসহ,	
katui,	কাটুই,	কাতুই,	
chirantan,	চিরান্তন,	চিরন্তন,	
aaziz,	আজিজ,	আজিজ,	
samaptir,	সমাপ্তির,	সমাপ্তির,	
query,	কুয়েরি,	কোয়েরি,	
direectoratee,	ডিরেক্টরিত,	ডিরেক্টরেট,	
chheher,	ছেহের,	ছেহের,	
porobortii,	পরবর্তীই,	পরর্বতী,	
rokkhonabekkhoner,	রক্ষণাকেষণের,	রক্ষণাবেক্ষণের,	
nadnadeer,	নদনাাদীর,	নদনদীর,	
enginiiring,	ইঞ্জিনিরিং,	ইঞ্জিনিয়ারিং,	
farhetin,	ফারহেটিন,	ফারহেতিন,	
sudrishya,	সুদৃশ্য,	সুদৃশ্য,	
nothibhukta,	নথিভুক্ত,	নথিভুক্ত,	
sqalastiqa,	স্ক্যাল্সটিকা,	স্কলাস্টিক,	
heart,	হার্ট,	হার্ট,	
jyesttha,	জ্যেষ্ঠা,	জ্যেষ্ঠা,	
agomone,	আগমনে,	আগমনে,	
taholo,	তাহোলো,	তাহলো,	
sorting,	সর্টিং,	সর্টিং,	
refleks,	রিফ্লেক্স,	রিফ্লেক্স,	
vagini,	ভাগিনি,	ভগিনী,	
senior,	সেনিওর,	সিনিয়র,	
sharoker,	শারোকের,	স্মারকের,	
ekirokom,	একিরকম,	একইরকম,	
nachar,	নাচর,	নাচার,	
graambaasheeo,	গ্রামবাশীও,	গ্রামবাসীও,	
kiandi,	কিয়ান্দি,	ক্যান্ডি,	
mailkhanek,	মাইলখানেক,	মাইলখানেক,	
bhupal,	ভূপাল,	ভূপাল,	
nothivookta,	নথিভুক্ত,	নথিভুক্ত,	
ceramicsh,	সেরামিক্স,	সিরামিকস,	
teliha,	তেলিহা,	তেলিহা,	
shikshakbrindo,	শিক্ষাবৃন্দ,	শিক্ষকবৃন্দ,	
qaro,	কারো,	কারো,	
cholchhee,	চোলছি,	চলছে,	
parisankhanvid,	পরিসংখানভিদ,	পরিসংখ্যানবিদ,	
tikta,	টিকটা,	তিক্ত,	
hugheke,	হুগেকে,	হিউজকে,	
chahidapotrer,	চহিদাপত্রের,	চাহিদাপত্রের,	
deil,	ডিল,	ডেইল,	
setikey,	সেটিকে,	সেটিকে,	
windos,	উইন্ডোস,	উইন্ডোস,	
siddhantoke,	সিদ্ধান্তকে,	সিদ্ধান্তকে,	
khalid,	খালিদ,	খালিদ,	
moushum,	মৌশুম,	মৌসুম,	
komanera,	কোমানেরা,	কমানেরা,	
elaakate,	এলাকাতে,	এলাকাতে,	
quary,	কোয়ারী,	কোয়েরি,	
nagorikra,	নাগরীকরা,	নাগরিকরা,	
milekhanek,	মিলেখানেক,	মাইলখানেক,	
daakteekite,	দাকটিকিতে,	ডাকটিকিটে,	
nagorikderkey,	নাগরিকদেরকে,	নাগরিকদেরকে,	
ritesh,	রীটেশ,	রিতেশ,	
satarkakari,	সতর্ককারী,	সতর্ককারী,	
shringey,	শৃঙ্গে,	শৃঙ্গে,	
johor,	জোরোর,	জহর,	
orthonitir,	অর্থনীতির,	অর্থনীতির,	
seramiks,	সেরামিকস,	সিরামিকস,	
somabeshti,	সমাবেশটি,	সমাবেশটি,	
shudden,	শুদ্দেন,	সাডেন,	
palestine,	প্যালেস্টাইন,	প্যালেস্টাইনে,	
bishshaasho,	বিশ্াশা,	বিশ্বাসও,	
croak,	ক্রকাক,	ক্রোক,	
gasthi,	গা্থি,	গোষ্ঠী,	
arthanitike,	অর্থানীতিকে,	অর্থনীতিকে,	
rajnaiteek,	রাজনৈতিক,	রাজনৈতীক,	
khappar,	খা্পার,	খপ্পর,	
kani,	কানি,	কানি,	
mashtarsha,	মা্টার্ষ,	মাস্টার্স,	
orbi,	অরবি,	ওরবি,	
masjidke,	মাসজিদকে,	মসজিদকে,	
akar,	আকার,	একার,	
vaisoho,	ভাইসহ,	ভাইসহ,	
azijer,	আজিজের,	আজিজের,	
abadamoner,	অবাদমনের,	অবদমনের,	
emarjensi,	এমরজেন্সি,	এমার্জেন্সি,	
kaale,	কালে,	কালে,	
pradoshik,	প্রদোশিক,	প্রাদশিক,	
dharabahikotitey,	ধারাবাহিকতিতে,	ধারাবাহিকটিতে,	
shresthoshcho,	শ্রেষ্ঠশ্চ,	শ্রেষ্ঠশ্চ,	
bibechyo,	বিবেচ্ছও,	বিবেচ্য,	
jins,	জিনস,	জিন্স,	
polashir,	পলাশির,	পলাশীর,	
choukato,	চৌকাতো,	চৌকাত,	
gudamjat,	গুদ়াজত,	গুদামজাত,	
shangkalonti,	সংকলনটটি,	সংকলনটি,	
ganosochetonota,	গণসেচনতা,	গণসচেতনতা,	
maryir,	মারীর,	ম্যারির,	
rachonakal,	রচনাকাল,	রচনাকাল,	
timathi,	তিমাথি,	টিমোথি,	
hock,	হোক,	হুক,	
vaabnake,	ভবনাকে,	ভাবনাকে,	
mukhamandoler,	মুখামণ্ডলের,	মুখমণ্ডলের,	
chereche,	চেরেছে,	ছেড়েছে,	
promothesh,	প্রমথেশ,	প্রমথেশ,	
samanwitovabe,	সমন্বিতভাবে,	সমন্বিতভাবে,	
sheekar,	শীকার,	শিকার,	
marketin,	মার্কেটিন,	মার্কেটিং,	
gronthowo,	গ্রন্থওয়,	গ্রন্থও,	
siddhantoo,	সিদ্ধান্ত,	সিদ্ধান্তও,	
queri,	কুরে,	কোয়েরি,	
osthisondhi,	অস্থিসন্ধি,	অস্থিসন্ধি,	
niknayman,	নিকনায়মান,	নিকনেইমান,	
avetar,	আভেটার,	অবতার,	
ciima,	সিমে,	সীমা,	
madhabike,	মাধাবিকে,	মাধবীকে,	
enjineers,	এনজিনির্স,	ইঞ্জিনিয়ার্স,	
mast,	মাস্ট,	মাস্ত,	
sursur,	সুরসুর,	সুরসুর,	
shchalastic,	স্কালস্টিক,	স্কলাস্টিক,	
codee,	কোডি,	কোডে,	
orunima,	অরুণিমা,	অরুণিমা,	
brindabane,	বৃন্দাবানে,	বৃন্দাবনে,	
halding,	হেলিং,	হোল্ডিং,	
domone,	ডমনে,	দমনে,	
madrasake,	মাদরাসাকে,	মাদ্রাসাকে,	
bandi,	বান্দী,	বন্দী,	
jocqey,	জক্কে,	জকি,	
cheerontan,	চিরোতন্ন,	চিরন্তন,	
footballerra,	ফুটবলাররা,	ফুটবলাররা,	
somraatder,	সম্রাটদের,	সম্রাটদের,	
dhojovongo,	ধোবভঙ্গ,	ধ্বজভঙ্গ,	
existing,	এক্সিস্টিং,	এক্সিসটিং,	
bondiira,	বন্দীরা,	বন্দীরা,	
talgach,	তালগাছ,	তালগাছ,	
generalissimo,	জেনারালিসিিমো,	জেনারেলিসিমো,	
siddharther,	সিদ্ধার্থের,	সিদ্ধার্থের,	
bornanukrome,	বর্ণানুক্রমে,	বর্নানুক্রমে,	
markeetim,	মার্কিটিং,	মার্কেটিং,	
flexta,	ফ্লেক্সটা,	ফ্লেক্সটা,	
farid,	ফারিদ,	ফরিদ,	
dhyanastha,	ধ্যানস্থ,	ধ্যানস্থ,	
ghumachchila,	ঘুমাচ্ছিলা,	ঘুমাচ্ছিল,	
saver,	সেভের,	সেভার,	
sahab,	সাহাব,	সাহাব,	
bhardwaj,	ভর্দ্বাজ,	ভরদ্বাজ,	
windo,	উইন্ডো,	উইন্ডো,	
konnoder,	কন্যদের,	কন্যদের,	
dokaangoolote,	দোকানগুলোতে,	দোকানগুলোতে,	
elakaate,	এলাকাতে,	এলাকাতে,	
kaatbey,	কাতবে,	কাটবে,	
deenes,	দেনেস,	দীনেশ,	
borendroke,	বরেন্দ্রকে,	বরেন্দ্রকে,	
chakrapani,	চক্রপণি,	চক্রপানী,	
norfolk,	নরফলক,	নরফোক,	
antercticker,	অ্যান্টারক্টিকার,	অ্যান্টার্কটিকের,	
jahangirbad,	জাহানগিরবাদ,	জাহাঙ্গীরবাদ,	
nodiiteyi,	নোডিটিই,	নদীতেই,	
protistha,	প্রতিষ্ঠা,	প্রতিষ্টা,	
onchalti,	অঞ্চলটি,	অঞ্চলটি,	
accountdharira,	অকাউন্থ্রীরা,	একাউন্টধারীরা,	
protishta,	প্রতিষ্টা,	প্রতিষ্টা,	
godabari,	গোড়াবারি,	গোদাবরী,	
bage,	বাগে,	বাগে,	
atwabishvashi,	অত্বাবিশাবিশী,	আত্মবিশ্বাসী,	
chrystal,	ক্রিস্টাল,	ক্রাইস্টাল,	
deputy,	ডিপুটি,	ডেপুটি,	
horiddare,	হরিদ্দারে,	হরিদ্বারে,	
oindrila,	ঐন্দ্রিলা,	ঐন্দ্রিলা,	
pisach,	পিশাচ,	পিশাচ,	
pranidero,	প্রাণীদেরও,	প্রানীদেরও,	
dharabahiktite,	ধারাবাহিকটিতে,	ধারাবাহিকটিতে,	
garora,	গ্যারোরা,	গারোরা,	
cholochchitratike,	চলচ্চিত্রাটিকে,	চলচ্চিত্রটিকে,	
spredashiita,	স্প্রাডেশিয়াট,	স্প্রেডশীট,	
keu,	কেউ,	কেউ,	
malinga,	মালিংগা,	মালিংগা,	
mmehonoti,	ম্মেহনতি,	মেহনতি,	
joumana,	জৌমনা,	জুমানা,	
impaction,	ইমপ্যাক্ন,	ইমপ্যাকশন,	
bamni,	বামনি,	বামনী,	
baait,	বইইট,	বাইট,	
jhonkar,	ঝোঁকার,	ঝঙ্কার,	
lubitz,	লুবিৎজ,	লুবিৎজ,	
kaande,	কান্ডে,	কাণ্ডে,	
bhenasha,	ভেনাশা,	ভেনাস,	
larson,	লারসন,	লারসন,	
dormetori,	ডরমেটরি,	ডরমিটরি,	
jeebonnogor,	জীবনগর,	জীবননগর,	
patochitra,	পাতচিত্র,	পটচিত্র,	
romantik,	রোমান্তিক,	রোমান্টিক,	
habshi,	হাবশি,	হাবশী,	
protisthar,	প্রতিষ্ঠার,	প্রতিষ্ঠার,	
asaciates,	অ্যাকিসিয়াটস,	এসোসিয়েটস,	
spredashita,	স্প্রদেষিত,	স্প্রেডশীট,	
aarik,	আরিক,	আরিক,	
soteciety,	সোটেসিটি,	সোসাইটিতে,	
kanshater,	কাশনাটের,	কানসাটের,	
ekatitto,	একাতিত্ব,	একাতিত্ব,	
eeksapreeshana,	ইক্সপ্রেশন,	এক্সপ্রেশন,	
oxfordey,	অক্সফোর্ডে,	অক্সফোর্ডে,	
graambaashee,	গ্রামবাশী,	গ্রামবাসী,	
parkin,	পারকিন,	পার্কিং,	
tomader,	তোমাদের,	তোমাদের,	
samajeek,	সমাজিক,	সামাজিক,	
jiland,	জিলান্দ,	জিল্যান্ড,	
tatey,	ট্যাটে,	তাতে,	
hisabagyan,	হিসাবজ্ঞান,	হিসাবজ্ঞান,	
pyatarne,	প্যাটার্ন,	প্যাটার্নে,	
udbhabaney,	উদ্ভাবনে,	উদ্ভাবনে,	
temonvabe,	তেমনভাবে,	তেমনভাবে,	
dipti,	দীপ্তি,	ডেপুটি,	
akram,	আকরাম,	আকরাম,	
logotype,	লগটাইপ,	লোগোটাইপ,	
felto,	ফেল্টো,	ফেলত,	
ajij,	আজিজ,	আজিজ,	
cholochchitraeeo,	চলচ্চিত্র্যাও,	চলচ্চিত্রেও,	
shansthagulo,	শান্সথাগুলো,	সংস্থাগুলো,	
obdee,	অবদি,	অব্দি,	
oitijjha,	ঐতিহ্ঝ,	ঐতিহ্য,	
chorban,	চরবান,	চর্বন,	
norpholk,	নরফলক,	নরফোক,	
saqara,	সাকারা,	সাকার,	
baaiq,	বাইক,	বাইক,	
erythrian,	এরিথ্রিয়ান,	এরিথ্রিয়ান,	
omanisa,	ওমানিসা,	অমানিশা,	
orthobochorke,	অর্থবছরকে,	অর্থবছরকে,	
chhuti,	ছুটি,	ছুটি,	
monzooshree,	মনজুশ্রী,	মঞ্জুশ্রী,	
ishton,	ইষ্টন,	স্টোন,	
angkita,	অংংকিতা,	অঙ্কিতা,	
harja,	হার্জা,	হার্জ,	
prothakey,	প্রথাকে,	প্রথাকে,	
alimpiqa,	আলিম্পিকা,	অলিম্পিক,	
scholarship,	স্কলারশীপ,	স্কলারশিপ,	
sazanor,	সাজানোর,	সাজানোর,	
hingsar,	হিংসার,	হিংসার,	
engreziteo,	এংরাজিতেও,	ইংরেজিতেও,	
casper,	ক্যাসপার,	ক্যাসপার,	
onker,	অঙ্কের,	ওঙ্কার,	
dreeshtiheen,	দ্রেশতীন,	দৃষ্টিহীন,	
samany,	সাযামি,	সামান্য,	
lisense,	লিসেন্সে,	লাইসেন্স,	
motabolombira,	মতাবলম্বীরা,	মতাবলম্বীরা,	
jamjamat,	জমজামাত,	জমজমাট,	
roy,	রয়ে,	রায়,	
phokser,	ফোকসের,	ফক্সের,	
rajtontro,	রাজতন্ত্র,	রাজতন্ত্র,	
conflict,	কনফ্লিকট,	কনফ্লিক্ট,	
chanoo,	চানু,	চানু,	
seebiai,	সেবিয়াই,	সিবিআই,	
horeepur,	হরিপুর,	হরিপুর,	
rajnikant,	রাজনীকান্ত,	রাজনীকান্ত,	
bhogni,	ভগ্নি,	ভগ্নী,	
gasthii,	গা্্থিই,	গোষ্ঠীই,	
amburi,	অম্বুরী,	আম্বুরি,	
thailand,	থাইল্যান্ড,	থাইল্যান্ড,	
joubankal,	যৌবনকাল,	যৌবনকাল,	
durgatsober,	দুর্গাৎসবের,	দুর্গোৎসবে,	
tukroke,	তুকরোকে,	টুকরোকে,	
kale,	কালে,	কালে,	
mitrer,	মিত্রের,	মিত্রের,	
zesa,	জেস,	জেস,	
musolmanera,	মুসলমানেরা,	মুসলমানেরা,	
manoharpur,	মনোহারপুর,	মনোহরপুর,	
rayyalati,	রাইয়ালতি,	রয়্যালটি,	
kuhelika,	কুহেলিকা,	কুহেলিকা,	
pravritir,	প্রভৃতির,	প্রভৃতির,	
hool,	হুল,	হুল,	
binakar,	বিনাকার,	বিনাকার,	
apolokbhabe,	অপলকভাবে,	অপলকভাবে,	
hupile,	হুপিলে,	হুপিলে,	
reliance,	রিলিয়েন্স,	রিলায়েন্স,	
temanti,	তেমন্তি,	তেমনটি,	
helloin,	হেলিয়ন,	হ্যালোইন,	
fanding,	ফ্যান্ডিং,	ফান্ডিং,	
antorvukta,	আন্তর্ভুক্ত,	অন্তর্ভুক্ত,	
ukeliptas,	উকেলিপ্তাস,	ইউক্যালিপ্টাস,	
hakone,	হাকোন,	হাকোনে,	
bhadaka,	ভদাকা,	ভদকা,	
bhabatarini,	ভাবতরিণী,	ভবতারিণী,	
gonona,	গোনোনা,	গননা,	
pachattar,	পাচাত্তর,	পাচাত্তার,	
nirbaho,	নির্বাহ,	নির্বাহ,	
rohinibabu,	রোহিনিবাবু,	রোহিনীবাবু,	
karmasampadon,	কর্মসম্পদন,	কর্মসম্পাদন,	
manober,	মানবের,	মানবের,	
chalochchitrogulor,	চলচ্চিত্রগুলোর,	চলচ্চিত্রগুলোর,	
karim,	কারিম,	করিম,	
gaddaafee,	গ্যাড্যাফি,	গাদ্দাফী,	
saras,	সারাস,	সরস,	
bhaangchur,	ভাংচুর,	ভাংচুর,	
nothivukto,	নথিভুক্ত,	নথিভুক্ত,	
qaferderkey,	কাফেরদেরকে,	কাফেরদেরকে,	
antarctica,	অ্যান্টারক্টিকা,	অ্যান্টার্কটিকা,	
hepatitis,	হেপাটিটিস,	হেপাটাইটিস,	
sthapanagulo,	স্থাপানাগুলো,	স্থাপনাগুলো,	
rajpur,	রাজপুর,	রাজপুর,	
somraatra,	সোমরাত্র,	সম্রাটরা,	
khuizza,	খুইজ্জা,	খুইজ্জা,	
jipiusamriddha,	জিপিসুম্বাদ,	জিপিউসমৃদ্ধ,	
si,	সিই,	এসআই,	
parther,	পার্থের,	পার্থের,	
nirgoon,	নির্গুন,	নির্গুণ,	
protijogiitamulok,	প্রতিযোগিতামূলক,	প্রতিযোগীতামূলক,	
teamothy,	টিমোথি,	টিমোথি,	
segular,	সেগুলার,	সেগুলোর,	
dorgah,	ডোরগাহ,	দরগাহ,	
notikotar,	নতিকতার,	নৈতিকতার,	
olpo,	অল্পো,	অল্প,	
messengerer,	মেসেঙ্গারের,	মেসেঞ্জারের,	
proshikkhane,	প্রশিক্ষণে,	প্রশিক্ষণে,	
sobrakamer,	সবরাকামের,	সবরকমের,	
tyapa,	ত্যাপ,	ট্যাপ,	
maktum,	মক্তুম,	মাকতুম,	
swatantrata,	স্বততন্ত্রটা,	স্বতন্ত্রতা,	
venisey,	ভেনিসি,	ভেনিসে,	
phutonta,	ফুটোন্টা,	ফুটন্ত,	
ayantarqatiqa,	আয়ান্ত্রকিতক,	অ্যান্টার্কটিকা,	
deool,	দেওল,	দেউল,	
digree,	ডিগ্রি,	ডিগ্রি,	
graambasheeo,	গ্রামবাশীও,	গ্রামবাসীও,	
mahafezkhanar,	মহাফেঝকানার,	মহাফেজখানার,	
karmazog,	কারমাোোগ,	কর্মযোগ,	
laatimer,	লাটিমের,	লাটিমের,	
antarctica,	অ্যান্টারক্টিকা,	অ্যান্টার্কটিকার,	
kalakushalir,	কালাকুশালীর,	কলাকুশলীর,	
murader,	মুরাদের,	মুরাদের,	
aireshe,	আইরেশে,	আইরেসে,	
dadar,	দাদার,	দাদার,	
moshahidur,	মোশাইদুর,	মোশাহিদুর,	
oyebjin,	ওয়েবজিন,	ওয়েবজিন,	
rupantarer,	রূপান্তরের,	রুপান্তরের,	
mausumer,	মাসুমের,	মৌসুমের,	
sompadonkaree,	সম্পাদনকারী,	সম্পাদনকারী,	
krimlin,	ক্রিমলিন,	ক্রিমলিন,	
maritimer,	মেরিটিমের,	মেরিটাইমের,	
ronodeep,	রোনোপীপ,	রণদীপ,	
ultrasonography,	আল্ট্রাসনরারশিফ,	আলট্রাসনোগ্রাফিও,	
lokhindorer,	লোখিন্দরের,	লখিন্দরের,	
senabahinikey,	সেনাবাহিনীকে,	সেনাবাহিনীকে,	
dhaleshwari,	ধলেশ্বরী,	ধলেশ্বরী,	
karmoi,	কার্মই,	কর্মই,	
bajpa,	বাজপা,	বাজপা,	
nariider,	নারীদের,	নারীদের,	
gitikobita,	গীতিকবিটা,	গীতিকবিতা,	
ernad,	এরনাদ,	এরনাড,	
prasadhoni,	প্রাসাধনী,	প্রসাধনী,	
milea,	মিলিয়া,	মাইলে,	
pretty,	প্রেটি,	প্রিটি,	
anagarikra,	আনাগারীকরা,	অনাগরিকরা,	
bhromonkaale,	ভ্রমণকালে,	ভ্রমণকালে,	
jitpur,	জিটপুর,	জিতপুরের,	
vins,	ভিন্স,	ভিন্স,	
brekthrough,	ব্রেক্তরগ্গ,	ব্রেকথ্রু,	
ganoparibahaner,	গণপারিবানের,	গণপরিবহনের,	
paner,	পানের,	পানের,	
mugdha,	মুগ্ধা,	মুগ্ধ,	
jatata,	জাতাটা,	যতোটা,	
toroonraa,	তররুরা,	তরুণরা,	
pleta,	প্লেটা,	প্লেটো,	
tarkareer,	তারকারীর,	তরকারীর,	
varma,	ভার্মা,	ভার্মা,	
antarbhutto,	অন্তরূভ্ত,	অন্তর্ভুক্ত,	
dada,	দাদ,	দাদা,	
madeling,	মাডিলিং,	মডেলিং,	
dovaar,	ডোভার,	ডোভার,	
plato,	প্ল্যাটো,	প্লেটো,	
ved,	ভেড,	বেদ,	
nutan,	নুতান,	নূতন,	
bonnopran,	বন্যপ্রাণ,	বন্যপ্রাণ,	
masjidsaho,	মাজসিদসহ,	মসজিদসহ,	
postac,	পোস্ট্যাক,	পোস্টকে,	
matrirup,	মাতৃরূপ,	মাতৃরূপ,	
tirmijii,	তীর্মিজী,	তিরমিজি,	
parking,	পার্কং,	পার্কিং,	
bhugol,	ভূগল,	ভূগোল,	
satarka,	সতর্কা,	সতর্ক,	
oncholeo,	অঞ্চলেও,	অঞ্চলেও,	
himchi,	হিমছি,	হিমচি,	
teoner,	টেওনার,	টিওনার,	
japanostho,	জাপানস্থ,	জাপানস্থ,	
ganonanatto,	গণনানত্ব,	গণনাট্য,	
omkar,	ওমকার,	ওঙ্কার,	
ched,	চেড,	ছেদ,	
fakhrul,	ফখরুল,	ফাখরুল,	
ghetu,	ঘেটু,	ঘেটু,	
blogarra,	ব্লগাররা,	ব্লগাররা,	
tecno,	টেকনো,	টেকনো,	
kurdider,	কুর্দিদের,	কুর্দিদের,	
kottar,	কোত্তার,	কট্টর,	
ghenshei,	ঘেঁশেই,	ঘেঁষেই,	
shrabasti,	শ্রাবস্তি,	শ্রাবস্তী,	
horiddar,	হরিদ্দার,	হরিদ্বার,	
dantahin,	দাঁতাহীন,	দন্তহীন,	
durotamo,	দূরতাম,	দূরতম,	
dii,	দিঁই,	দিই,	
shikkhadikkhay,	শিক্ষাদিক্ষায়,	শিক্ষাদিক্ষায়,	
joki,	জোকি,	জকি,	
siddhanto,	সিদ্ধান্ত,	সিদ্ধান্তও,	
ujbekistaner,	উজবেকিস্তানের,	উজবেকিস্তানের,	
palkee,	পালকি,	পাল্কি,	
naazi,	নাজি,	নাত্সি,	
niropekshtar,	নিরপেক্ষটার,	নিরপেক্ষতার,	
kakhnoba,	কাখনোবা,	কখনওবা,	
kyatgarite,	ক্যাটগারিতে,	ক্যাটগারিতে,	
hozot,	হজত,	হজত,	
gaje,	গাজ,	গেজ,	
amar,	আমার,	আমর,	
ivil,	আইভিএল,	ইভিল,	
stoonahenja,	স্তননাহেঞ্জা,	স্টোনহেঞ্জ,	
torunosomriddho,	তরুণসমৃদ্ধ,	তরুণসমৃদ্ধ,	
alaul,	আলাউল,	আলাওল,	
nadike,	নাদিকে,	নদীকে,	
maley,	মালে,	মালে,	
alpa,	আলপা,	অল্প,	
shangsthatikey,	শাংস্থাটিকে,	সংস্থাটিকে,	
teestar,	তিস্তার,	তিস্তার,	
mukhabandha,	মুখবন্ধ,	মুখবন্ধ,	
holdim,	হলদিিং,	হোল্ডিং,	
review,	রিভিউ,	রিভিউও,	
jomoker,	জমকের,	জমকের,	
kuresher,	কুরেশের,	কুরেশের,	
heena,	হীনা,	হেনা,	
video,	ভিদেও,	ভিডিয়োও,	
palbongser,	পালবংসের,	পালবংশের,	
jonesh,	জনেশ,	জোন্স,	
khalidkay,	খলিদককে,	খালিদকে,	
nodimatrik,	নদীমাত্রিক,	নদীমাতৃক,	
rotheen,	রথিন,	রথীন,	
jones,	জোন্স,	জোন্স,	
madhabi,	মাধবী,	মাধবী,	
bahati,	বাহাটি,	বাহাতি,	
hazat,	হাজাত,	হজত,	
adarsho,	আদর্শ,	আর্দশ,	
pathanatak,	পাঠানাটাক,	পথনাটক,	
masjidti,	মাসজিদটি,	মসজিদটি,	
lettar,	লেট্তার,	লেটার,	
darji,	দার্জি,	দরজি,	
relance,	রিলেন্সে,	রিলায়েন্স,	
kholdhular,	খোলধুলার,	খোলধূলার,	
vaider,	ভাইদের,	ভাইদের,	
navaratri,	নবরাত্রী,	নবরাত্রি,	
elakaasoho,	এলাকাসহ,	এলাকাসহ,	
jommu,	জম্মু,	জম্মু,	
munjur,	মুঞ্জুর,	মুনজুর,	
robot,	রোবোট,	রোবোট,	
dakkhinkare,	দক্ষিণকারে,	দক্ষিণকরে,	
hitlere,	হিটলারে,	হিটলারে,	
eshiyetika,	এসিএয়েটিকা,	এশিয়াটিক,	
deciliter,	ডিসিলাইটার,	ডেসিলিটার,	
arasie,	আরাসি,	আরসিএ,	
kramp,	ক্র্যাম্প,	ক্র্যাম্প,	
aarke,	আরকে,	আরকে,	
futonta,	ফুটনটা,	ফুটন্ত,	
rubidiyaam,	রুবিদিয়ম,	রুবিডিয়াম,	
shukrabab,	শুক্রাবাব,	শুক্রবাব,	
baju,	বাজু,	বাজু,	
jaaygata,	জায়গত,	জায়গাটা,	
groundta,	গ্রাউন্ডটা,	গ্রাউন্ডটা,	
kayed,	কায়েদ,	কায়েদ,	
mithener,	মিথেনের,	মিথেনের,	
prokolpotike,	প্রকলপতিকে,	প্রকল্পটিকে,	
licensedhari,	লাইসেন্ডধারী,	লাইসেন্সধারী,	
taateo,	তাতেও,	তাতেও,	
oitijjo,	ঐতিহ্য,	ঐতিহ্য,	
khelaphate,	খেলাফাতে,	খেলাফতে,	
marketing,	মার্কেটিং,	মার্কেটিং,	
alraji,	আলরাজি,	আলরাজী,	
kalnir,	কালনির,	কালনীর,	
deares,	ডিয়ারেস,	ডিআরএস,	
gondhe,	গন্ধে,	গন্ধে,	
seguloi,	সেগুলোই,	সেগুলোই,	
faase,	ফাসে,	ফাঁসে,	
jeebnagore,	জীবনাগরে,	জীবননগর,	
protijogii,	প্রতিযোগী,	প্রতিযোগী,	
niutrino,	নিউট্রিনো,	নিউট্রিনো,	
bharotiyotar,	ভারতীয়তার,	ভারতীয়তার,	
directarate,	ডিরেক্টরেট,	ডিরেক্টরেট,	
hevy,	হেভি,	হেভি,	
baarnis,	বার্নিস,	বার্নিশ,	
ganochien,	গনছিয়েন,	গণচীন,	
abhidhaanic,	অভিধানিক,	অভিধানিক,	
ipl,	আইপিএল,	আইপিএল,	
shahoshikatar,	শহোশিকাতার,	সাহসিকতার,	
steena,	স্টিন,	স্টেন,	
kharavel,	খারাভেল,	খারবেল,	
bosturoi,	বস্তুরই,	বস্তুরই,	
baipash,	বাইপাশ,	বাইপাস,	
mohammadi,	মোহাম্মদি,	মুহাম্মদী,	
grotha,	গ্রোথা,	গ্রোথ,	
olympik,	অলিমপিক,	অলিম্পিক,	
evereste,	এভারেস্টে,	এভারেস্টে,	
eduardo,	এডুরাওয়াড,	এডুয়ার্দো,	
francine,	ফ্রান্সিন,	ফ্রান্সিন,	
bii,	বিআই,	বি,	
venkates,	ভেঙ্কেটস,	ভেঙ্কটেশ,	
mujuru,	মুজুরু,	মুজুরু,	
chasee,	চাসি,	চেস,	
bibhinno,	বিভিন্ন,	বিভন্ন,	
ajibooner,	অজিবুনের,	আজীবনের,	
shringgo,	শৃঙ্গ,	শৃঙ্গ,	
obhaarbhiu,	অভারভিউ,	ওভারভিউ,	
elaakaati,	এলাকাটি,	এলাকাটি,	
mitrota,	মিত্রতা,	মিত্রতা,	
dijmarescu,	দিজমার্সেক,	দিজমার্সাকু,	
dibate,	দিবাতে,	ডিবেট,	
iub,	আইউবি,	আইইউবি,	
dhos,	ধোস,	ধস,	
station,	স্টেশন,	ষ্টেশন,	
shakar,	শাকর,	সকার,	
adorsho,	আদর্শ,	আর্দশ,	
musabbirul,	মুসাববিরুল,	মুসাব্বিরুল,	
chongar,	চঙ্গার,	চোঙ্গার,	
maailey,	মেইলে,	মাইলে,	
institutione,	ইন্সটটিউটশনে,	ইনস্টিটিউশনে,	
siraju,	সিরাজু,	সিরাজু,	
shudhir,	শুধির,	শুধীর,	
tintir,	তিনটির,	তিনটির,	
jonosomaj,	জনসমাজ,	জনসমাজ,	
bolechile,	বলেছিলে,	বলেছিলে,	
ahalyar,	অহল্যার,	অহল্যার,	
dosha,	দোশা,	দোসা,	
lagche,	লাগছে,	লাগছে,	
bboponer,	বিপোনের,	বপনের,	
shuperheiro,	শুপারহিরোর,	সুপারহিরো,	
shroddhabihin,	শ্রদ্ধাবিহীন,	শ্রদ্ধাবিহীন,	
taxikeo,	ট্যাক্সিকেও,	ট্যাক্সিকেও,	
difinisian,	ডিফিনিয়ান,	ডেফিনেশন,	
chetanagato,	চেতানাগত,	চেতনাগত,	
edseler,	এডসেলের,	এডসেলের,	
dormitory,	ডর্মিটোরি,	ডরমিটরি,	
poorohitra,	পতরিহত্র,	পুরোহিতরা,	
armstronz,	আর্মস্ট্রোন,	আর্মস্ট্রং,	
dhanyi,	ধনই,	ধন্যি,	
eevil,	ইভিভিল,	ইভিল,	
standards,	স্ট্যান্ডার্ডসহ,	স্টান্ডার্ডস,	
mahibur,	মহিবুর,	মহিবুর,	
bisshasyi,	বিশ্বাসী,	বিশ্বাসই,	
ganosachetanata,	গণসচেনতা,	গণসচেতনতা,	
dadapur,	দাদাপুরের,	দাদাপুর,	
protyokkhovabey,	প্রত্যক্ষভাবে,	প্রত্যক্ষভাবে,	
purushika,	পুরুষিকা,	পুরুষিকা,	
cinemapremider,	সিনেমাপ্রেমীদের,	সিনেমাপ্রেমীদের,	
madhuri,	মধুরি,	মাধুরী,	
flirt,	ফ্লিরট,	ফ্লার্ট,	
prrajanankaal,	প্রজারণকাল,	প্রজননকাল,	
sharthe,	শার্থে,	স্বার্থে,	
teman,	তেমন,	তেমন,	
taap,	টাপ,	ট্যাপ,	
breq,	ব্রেক,	ব্রেক,	
ardasho,	আর্দাশো,	আর্দশ,	
ganokantha,	গণকানঠা,	গণকণ্ঠ,	
pachak,	পাচাক,	পাচক,	
nazad,	নাজাদ,	নাজাদ,	
qonfliqt,	কনফ্লিক্ট,	কনফ্লিক্ট,	
aashanka,	আশনকা,	আশংকা,	
bulano,	বুলানো,	বুলান,	
girilal,	গিরিলাল,	গিরিলাল,	
oncholtee,	অংশলটি,	অঞ্চলটি,	
jackey,	জ্যাকে,	জকি,	
qulim,	কুলিম,	কুলিং,	
rabo,	রাবো,	রব,	
morathee,	মোরথী,	মরাঠি,	
nehle,	নেহলে,	নেহলে,	
bosben,	বসবেন,	বসবেন,	
oiteejye,	ঐতিহ্যে,	ঐতিহ্যে,	
ghumachhe,	ঘুমাচে,	ঘুমাচ্ছে,	
akhando,	আখান্ডো,	অখন্ড,	
gore,	গোরি,	গোর,	
shloker,	শ্লোকের,	শ্লোকের,	
graambashee,	গ্রামবাশী,	গ্রামবাসী,	
baire,	বাইরে,	বাইরে,	
meloonborroner,	মেলুনবরণের,	মেলবোর্নের,	
uddhritir,	উদ্ধৃতির,	উদ্ধৃতির,	
kaleo,	কালেও,	কালেও,	
bosantake,	বসন্তাকে,	বসন্তকে,	
chaalaabi,	চালাবি,	চালাবে,	
chhatrodiger,	ছাত্রদীগের,	ছাত্রদিগের,	
nothiboddho,	নথিবদ্ধ,	নথিবদ্ধ,	
ssahocorze,	সাহকর্জে,	সাহচর্যে,	
suri,	সুরী,	সুরি,	
sombhobonao,	সম্ভবনাও,	সম্ভবনাও,	
neutrinoo,	নিউট্রিনো,	নিউট্রিনো,	
terlarang,	তেরলারাং,	তেরলারং,	
potka,	পটকা,	পটকা,	
kamti,	কামটি,	কমতি,	
saamaanya,	সামন্যা,	সামান্য,	
dhhaloor,	ঢালুর,	ঢালুর,	
modyer,	মোদ্যের,	মদ্যের,	
detik,	ডেটিক,	দেতিক,	
rudiger,	রুডিগের,	রুদিগের,	
transform,	ট্রান্সফর্ম,	ট্রান্সফর্ম,	
bisnukey,	বিস্নুকে,	বিষ্ণুকে,	
alkatra,	আলকাত্র,	আলকাতরা,	
biplabeer,	বিপ্লাবীর,	বিপ্লবীর,	
gaichhe,	গাইছে,	গাইছে,	
selim,	সেলিম,	সেলিম,	
heteler,	হেটেলের,	হেটেলের,	
deputi,	দেপুটি,	ডেপুটি,	
baharamporer,	বাহারামপরের,	বহরমপুরের,	
korkotkraantee,	কর্কৎকান্ত্রী,	কর্কটক্রান্তি,	
jatinkey,	জাতিনকে,	যতীনকে,	
abarte,	আবারতে,	আবর্তে,	
ruptan,	রূপ্তান,	রূপটান,	
durbhagya,	দূর্ভাগ্য,	দূর্ভাগ্য,	
unitgulo,	ইউনিটগুলো,	ইউনিটগুলো,	
gaandaas,	গান্দাস,	জ্ঞানদাস,	
jaanachhe,	যানাচেছে,	জানাচ্ছে,	
themeke,	থেমেকে,	থিমকে,	
aqram,	আকরাম,	আকরাম,	
janagononar,	জনাগোনার,	জনগণনার,	
sangasthagulo,	সংস্থাগুলো,	সংস্থাগুলো,	
porirshoder,	পরিশর্দের,	পরির্ষদের,	
dakshinangsho,	দক্ষিণাংশ,	দক্ষিণাংশ,	
tarkale,	তারকালে,	তারকালে,	
chomski,	কম্সসি,	চমস্কি,	
neemitte,	নীমিত্বে,	নিমিত্তে,	
dombhoke,	দম্ভকে,	দম্ভকে,	
bane,	বানই,	বনে,	
booroon,	বুরুন,	বোরন,	
degreeo,	ডিগ্রোও,	ডিগ্রিও,	
maradeha,	মারেদা,	মরদেহ,	
taunasipa,	টৌনাসিপা,	টাউনশিপ,	
porishongkhanbid,	পরিষংখ্যানবিদ,	পরিসংখ্যানবিদ,	
riazuddin,	রিয়াজদ্দিন,	রিয়াজউদ্দীন,	
fising,	ফিসিং,	ফিসিং,	
direqtareta,	ডিরেক্টরটা,	ডিরেক্টরেট,	
nazranar,	নজরানার,	নাজরানার,	
quata,	কোয়াটা,	কোটা,	
ruby,	রাউবি,	রুবী,	
khabarsoho,	খাবারসহ,	খাবারসহ,	
ddebet,	ডিডিব,	ডিবেট,	
naabbota,	নাব্যতা,	নাব্যতা,	
kaalengaa,	কালেঙ্গা,	কালেঙ্গা,	
kaloniir,	কালোনীর,	কালনীর,	
nirmolotaa,	নির্মলতা,	নির্মলতা,	
gandagol,	গণ্ডাগোল,	গন্ডগোল,	
bijito,	বিজিত,	বিজিত,	
debete,	দেবেতে,	ডিবেট,	
kanuner,	কানুনের,	কানুনের,	
ghaghat,	ঘঘাট,	ঘাঘট,	
sthapanagulor,	স্থাপানাগুলোর,	স্থাপনাগুলোর,	
turkii,	তুরকি,	তুর্কি,	
sipa,	সিপ,	শিপ,	
temone,	তেমনে,	তেমনই,	
grambaasi,	গ্রামবাসী,	গ্রামবাসী,	
dhamshrenite,	ধামশ্রেণীতে,	ধামশ্রেণীতে,	
nomo,	নোমো,	নমো,	
chetanagoto,	চেতানগত,	চেতনাগত,	
parishram,	পরিশ্রম,	পরিশ্রম,	
shatodha,	শতোধা,	শতধা,	
adhyatmikata,	অধ্যাত্মিকতা,	আধ্যাত্মিকতা,	
dhanijomite,	ধনিযোজিতে,	ধানিজমিতে,	
chopol,	চপল,	চপল,	
ramolino,	রামলিনো,	রামোলিনো,	
barbadoj,	বারবাদোজ,	বার্বাডোজ,	
deraa,	দেরা,	ডেরা,	
bossonte,	বসন্তে,	বসন্তে,	
korimer,	করিমের,	করিমের,	
paikgachha,	পাইকগাছা,	পাইকগাছা,	
cholochchitrake,	চলচ্চিত্রাকে,	চলচ্চিত্রকে,	
bhowanipur,	ভোয়ানিপুর,	ভবানীপুর,	
peethey,	পেথে,	পীঠে,	
homsher,	হোমশের,	হোমসের,	
oncoltike,	অংকলটিকে,	অঞ্চলটিকে,	
utshahomulok,	উৎসাহমূলক,	উৎসাহমূলক,	
planeti,	প্লানেটি,	প্লেনটি,	
parabortee,	পারাবর্তী,	পরর্বতী,	
lagchhe,	লাগছে,	লাগছে,	
sahachke,	সহচকে,	সাহাচকে,	
fevarite,	ফেভারাইট,	ফেভারিট,	
disposes,	ডিসপোস,	ডিসপোজেস,	
sombhobonaao,	সম্ভবনাও,	সম্ভবনাও,	
dhauto,	ধাত,	ধৌত,	
bone,	বনে,	বনে,	
makame,	মাকামে,	মাকামে,	
reshidensha,	রেশিডেন্স,	রেসিডেন্স,	
poriharsoho,	পরিহারসহ,	পরিহারসহ,	
bolvodro,	বলভদ্র,	বলভদ্র,	
plate,	প্লেট,	প্লেট,	
edaning,	এডানিং,	ইদানিং,	
zoubankal,	যৌবনকাল,	যৌবনকাল,	
dalip,	দালিপ,	দালিপ,	
deh,	দেহ,	দেহ্,	
sbaajan,	স্বজান,	স্বজন,	
armori,	আর্মরি,	আরমোরি,	
dwipke,	দ্বীপকে,	দ্বীপকে,	
aashtikotaa,	অষ্টিকতা,	আস্তিকতা,	
torutoler,	তরুতলের,	তরুতলের,	
dhangsantup,	ধ্বংসন্তূপ,	ধ্বংসন্তুপ,	
doobate,	দুবাতে,	ডুবাতে,	
krusher,	ক্রুশের,	ক্রুশের,	
platform,	প্ল্যাটফর্ম,	প্লাটফর্ম,	
sutir,	সুতির,	সুতির,	
phox,	অফ্স,	ফক্স,	
bajite,	বাজিতে,	বাজিতে,	
nirvaha,	নির্ভাহা,	নির্বাহ,	
tikto,	টিকটো,	তিক্ত,	
sausage,	সৌগে,	সসেজ,	
mulyayonsapekkhe,	মূল্যায়নপাক্সে,	মূল্যায়নসাপেক্ষে,	
saqara,	সাকারা,	সকার,	
granada,	গ্র্যানাডা,	গ্র্যানাডা,	
pujit,	পুজিত,	পুজিত,	
gonesher,	গনেশের,	গণেশের,	
pader,	পাদের,	প্যাডের,	
obosorer,	অবসরের,	অবসরের,	
horas,	হোরাস,	হোরাস,	
sampadoner,	সম্পাদনের,	সম্পাদনের,	
sangram,	সংগ্রাম,	সঙ্গ্রাম,	
chaudhuriyo,	চৌধুরিয়,	চৌধুরীও,	
ghoomachhilo,	ঘুমাচিল,	ঘুমাচ্ছিল,	
engrezder,	এংগারজেদের,	ইংরেজদের,	
anyorup,	অন্যুরূপ,	অন্যরূপ,	
shhashtra,	শাস্ত্র,	শাস্ত্র,	
songasthaner,	সংস্থানের,	সংস্থানের,	
plainey,	প্লেইন,	প্লেনে,	
fiksing,	ফিকসিং,	ফিক্সিং,	
shiropar,	শিরোপার,	শিরোপার,	
pyore,	প্য়ারে,	পিওর,	
utpotti,	উৎপত্তি,	উতপত্তি,	
sookumari,	সুকুমারি,	সুকুমারী,	
udbhaboney,	উদ্ভাবনে,	উদ্ভাবনে,	
saabyastha,	সাব্যাস্থ,	সাব্যস্থ,	
srk,	স্রিক্কের,	শাহরুখ,	
suiti,	সুইটি,	সুইটি,	
chakti,	চাক্তি,	চাকতি,	
