narsaari,	নরসারী,	নার্সারি,	
okkhorke,	অক্ষরকে,	অক্ষরকে,	
turky,	তুর্কি,	তুর্কি,	
graminphonor,	গ্রামিনফনর,	গ্রামীণফোনর,	
ponchashjon,	পঞ্চাস্জন,	পঞ্চাশজন,	
heze,	হেজে,	হেজ,	
messengerer,	মেসেনগর্গের,	মেসেঞ্জারের,	
duio,	দুইও,	দুইও,	
pharanyeta,	ফর্নেতা,	ফরম্যাট,	
taap,	তাপাপ,	ট্যাপ,	
poripake,	পরিপাকে,	পরিপাকে,	
anchalgulir,	আঞ্চলগুলির,	অঞ্চলগুলির,	
naabbota,	নব্বতা,	নাব্যতা,	
olympicer,	অলিমপিপার,	অলিম্পিকের,	
sthaponagulo,	স্পাপানাগুলো,	স্থাপনাগুলো,	
dwijenbabuder,	জ্জিজেনবাবুদের,	দ্বিজেনবাবুদের,	
gazetted,	গ্জেজেত,	গেজেটেড,	
akhandata,	আখন্ডটা,	অখণ্ডতা,	
megh,	মেঘ,	মেঘ,	
mukhabandha,	মুখাবন্ধ,	মুখবন্ধ,	
sexperter,	সেকপস্টার্টের,	সেক্সপার্টের,	
sanghar,	সংহর,	সংহার,	
bethikata,	বেথিকাটা,	বেঠিকতা,	
uporitoler,	উপরিতলের,	উপরিতলের,	
madelim,	মাডেলিম,	মডেলিং,	
vogiroth,	ভগিরোথ,	ভগীরথ,	
porinoti,	পরিণতি,	পরিণতি,	
sikha,	সিখা,	শিখ,	
rokkhonabekkhoner,	রক্ষণাবেহানের,	রক্ষণাবেক্ষণের,	
mesenjarer,	মেসেন্জের,	মেসেঞ্জারের,	
dei,	দেই,	দিই,	
adorso,	আদরসস,	আর্দশ,	
carlos,	কার্লোস,	কার্লোস,	
jarmaniteo,	জার্মানিতেও,	জার্মানিতেও,	
uparjoner,	উপার্জনের,	উপার্জনের,	
forex,	ফোরেক্স,	ফরেক্স,	
ardasha,	আর্দাস,	আর্দশ,	
srichoitonnodeb,	শ্রীচৈনবেন্ড,	শ্রীচৈতন্যদেব,	
amanisha,	আমানিসা,	অমানিশা,	
sanaktokaron,	সনক্তকরণ,	সনাক্তকরণ,	
daltagi,	দালটাগি,	দলত্যাগী,	
shilpojaat,	শিল্পজাত,	শিল্পজাত,	
kodorer,	কোদোরের,	কদরের,	
primoo,	প্রিমুও,	প্রিমো,	
ponthaar,	পন্থার,	পন্থার,	
khaschandpur,	খাসচান্দপুর,	খাসচাঁদপুর,	
nirgaman,	নির্গান,	নির্গমন,	
europia,	ইউরোপিয়া,	ইউরোপিয়া,	
dep,	ডিপ,	ডেপ,	
dhangsantup,	ধাবসংপুপ,	ধ্বংসন্তুপ,	
istoone,	ইস্টুনে,	স্টোন,	
ispreedshiit,	ইসপ্রিপ্টিত,	স্প্রেডশীট,	
jeebonnogor,	জীবনগর,	জীবননগর,	
bahati,	বহহতি,	বাহাতি,	
indrani,	ইন্দ্রানী,	ইন্দ্রাণী,	
malinga,	মালিঙ্গা,	মালিংগা,	
tachnach,	তাচনাচ,	তছনছ,	
byatari,	ব্যাতারি,	ব্যাটারী,	
nirarthak,	নিরার্থক,	নিরর্থক,	
bajhyo,	বাঝ্য,	বাহ্য,	
shibraj,	শিবরাজ,	শিবরাজ,	
patochitra,	পাতচিত্র,	পটচিত্র,	
aizulke,	আইজুলকে,	আইজুলকে,	
scholastic,	স্কোল্সিক,	স্কলাস্টিক,	
awrbit,	আবরিত,	অরবিট,	
karmakarke,	কর্মারকরে,	কর্মকারকে,	
planea,	প্লানিয়া,	প্লেনে,	
nischitvabe,	নিশ্চিভাবে,	নিশ্চিতভাবে,	
jacksoner,	জ্যাকসসেনের,	জ্যাকসনের,	
aro,	আরো,	আরও,	
bhramarotsab,	ভ্রমরাতশাব,	ভ্রমরোৎসব,	
venuser,	ভেনুসের,	ভেনাসের,	
dokkhinangsho,	দক্ষিনাংশ,	দক্ষিণাংশ,	
chat,	চাট,	চ্যাট,	
antarbhutto,	অন্তারভূত্ত,	অন্তর্ভুক্ত,	
dalee,	দালি,	ডালে,	
senabahinikey,	সেনাবাহেনীনে,	সেনাবাহিনীকে,	
bhalobasar,	ভালোবাসার,	ভালোবাসার,	
zerusalem,	জেরুসামেল,	জেরুসালেম,	
tatey,	তাতে,	তাতে,	
beetloser,	বিতলোসের,	বিটলসের,	
tennys,	টেনিস,	টেনিস,	
fakhrul,	ফখরুল,	ফাখরুল,	
mitrata,	মিত্রাটা,	মিত্রতা,	
jothartho,	যথার্থ,	যথার্থ,	
shikhaboudi,	শিখাবৌদী,	শিখাবৌদি,	
hert,	হার্ট,	হার্ট,	
nisshongotake,	নিশ্গনকাগে,	নিঃসঙ্গতাকে,	
byaboharkarie,	ব্যবহরকারী,	ব্যবহারকারীই,	
sotorkobhabey,	সতরকভাবে,	সতর্কভাবে,	
aakkaash,	আক্কাশ,	আককাস,	
monur,	মোনুর,	মনুর,	
nutoner,	নুতনের,	নূতনের,	
protijogitamulok,	প্রতিজমাজগুলক,	প্রতিযোগীতামূলক,	
kings,	কিংস,	কিংস,	
korley,	করলি,	করলে,	
degree,	দেগ্রি,	ডিগ্রি,	
timathi,	তিমাথি,	টিমোথি,	
phising,	ফিসিং,	ফিসিং,	
adhyatmikata,	আধ্যাতমিকতা,	আধ্যাত্মিকতা,	
songasthatike,	সংস্থাতাঠিকে,	সংস্থাটিকে,	
balokarak,	বালোকারক,	বলকারক,	
obosore,	অবসরে,	অবসরে,	
khargosher,	খরগোগেশের,	খরগোসের,	
nibondhocheler,	নিবন্ধকের,	নিবন্ধছেলের,	
konistho,	কনিস্থ,	কনিষ্ঠ,	
somonwitobhabey,	সমন্বিভাবে,	সমন্বিতভাবে,	
saamaanya,	সামান্যায়,	সামান্য,	
anichchi,	অনিচ্ছি,	আনিচ্ছি,	
jamaanor,	জামানোর,	জমানোর,	
rajtontro,	রাজততন্ত্র,	রাজতন্ত্র,	
shit,	শিত,	শীত,	
karmazog,	কর্মাযোগ,	কর্মযোগ,	
cholochchitrer,	চলচচিত্রের,	চলচ্চিত্রের,	
uttor,	উত্তর,	উওর,	
durgatsober,	দুর্গাতবের,	দুর্গোৎসবে,	
biphal,	বিফাল,	বিফল,	
siraju,	সিরাজু,	সিরাজু,	
damakalkarmirao,	দামাকল্র্মাও,	দমকলকর্মীরাও,	
mukhobondho,	মুখবন্ধ,	মুখবন্ধ,	
asamorik,	আসামরিক,	অসামরিক,	
rashider,	রাশিদের,	রশিদের,	
saver,	সাভের,	সেভার,	
pravritir,	প্রাভ্রিতির,	প্রভৃতির,	
dinara,	দিনারা,	ডিনার,	
aabarte,	আবার্টে,	আবর্তে,	
ankanshilpe,	আঙ্কানশিল্পে,	অঙ্কনশিল্পে,	
sponsorshipe,	স্পন্পর্ষীপে,	স্পন্সরশীপে,	
akeeb,	আকেব,	আকিব,	
amittrakkhor,	অমিত্রাখকর,	অমিত্রাক্ষর,	
proshtutkarok,	প্রশ্তুকর্,	প্রস্তুতকারক,	
senior,	সেনিউর,	সিনিয়র,	
aanaan,	আনান,	আনান,	
orgho,	অর্ঘ,	অর্ঘ্য,	
metropolitan,	মেত্রপপলিটন,	মেট্রোপলিটন,	
dreeshtiheen,	দৃষ্টেহীন,	দৃষ্টিহীন,	
uqeliptas,	উকেলিপ্লাপনস্ট,	ইউক্যালিপ্টাস,	
hariner,	হারিনের,	হরিণের,	
sudrissho,	সুদৃশ্,	সুদৃশ্য,	
meloonborroner,	মেলোবর্বনের,	মেলবোর্নের,	
lambaate,	ল্যামবেটে,	লম্বাটে,	
bhaibon,	ভাইবন,	ভাইবোন,	
ray,	রেয়া,	রায়,	
shasankarta,	শাসাকর্টা,	শাসনকর্তা,	
thaii,	থাই,	থাই,	
kuldip,	কুলদিপ,	কুলদীপ,	
votar,	ভোটার,	ভোটার,	
reetesh,	রীটেশ,	রিতেশ,	
shunani,	শুনানি,	শুনানী,	
nirvachokder,	নির্ভাক্কের,	নির্বাচকদের,	
somoibo,	সমৈবব,	সমৈব,	
muradke,	মুরাদকে,	মুরাদকে,	
mishal,	মিশাল,	মিশাল,	
sangsakti,	সংস্কটি,	সংসক্তি,	
yak,	যাক,	ইয়াক,	
maail,	মাইল,	মাইল,	
basermick,	বাসেরমিক,	বেসারমিক,	
dushtogone,	দুষ্টোগোনে,	দুষ্টগণে,	
duiekdiner,	ডুইকদেনের,	দুইএকদিনের,	
pray,	প্রে,	প্রায়,	
saarbharti,	সারভর্টি,	সার্ভারটি,	
asovarno,	অসাভর্ণও,	অসবর্ণ,	
salmanul,	সালমানুল,	সালমানুল,	
onchalgulir,	অনচলাগুলির,	অঞ্চলগুলির,	
lampot,	ল্যামপট,	লম্পট,	
reshidensha,	রেশিদেন্শ,	রেসিডেন্স,	
shommoteer,	শম্ততির,	সম্মতির,	
seekkhaou,	শিক্ষৌ,	শিক্ষাও,	
sonaktokaran,	সোনাক্তকরণ,	সনাক্তকরণ,	
anchalsaho,	অঞ্চলসহ,	অঞ্চলসহ,	
annanere,	অন্নানের,	অন্যানেরে,	
sommoteer,	সম্মতিতর,	সম্মতির,	
bbosben,	ব্সসবেন,	বসবেন,	
favorite,	ফাভরিতে,	ফেভারিট,	
abheedhanik,	অভিধিনিক,	অভিধানিক,	
bolvodro,	বলভোদ্র,	বলভদ্র,	
osoborno,	অসববর্ণ,	অসবর্ণ,	
degreeo,	দেগ্রিও,	ডিগ্রিও,	
bosontoke,	বসন্তকে,	বসন্তকে,	
thyachara,	থ্যাচারা,	থ্যাচার,	
suchanakal,	সুচানাকাল,	সূচনাকাল,	
shikshagata,	শিকশাগতা,	শিক্ষাগত,	
shfingtar,	সিংটংার,	স্ফিংটার,	
chanoo,	চানুও,	চানু,	
katiusha,	কাতিশা,	কাতিউশা,	
itastata,	ইতাস্তা,	ইতস্তত,	
ajeem,	আজিম,	আজিম,	
chilona,	চিলোনা,	ছিলনা,	
punosthaner,	পুনস্থানের,	পুনঃস্থানের,	
krisenter,	ক্রিসেন্তের,	ক্রিসেন্টের,	
harbore,	হারবোর,	হারবারে,	
phareeksa,	ফারিকসা,	ফরেক্স,	
veenis,	ভিনিস,	ভেনিস,	
byaktikegreptar,	ব্যক্তিকেপ্র,	ব্যক্তিকেগ্রেপ্তার,	
dhwajbhango,	ধ্বাবভাঙ্গ,	ধ্বজভঙ্গ,	
streegon,	স্ট্রেগন,	স্ত্রীগণ,	
vushito,	ভুষিত,	ভূষিত,	
sawam,	সায়াম,	সাওম,	
rupantarer,	রূপান্তের,	রুপান্তরের,	
bonnypran,	বন্নিপ্রাণ,	বন্যপ্রাণ,	
kruser,	ক্রুসের,	ক্রুশের,	
pratool,	প্রাটল,	প্রতুল,	
sinaake,	সিনাকে,	সিনাকে,	
aarke,	আরকে,	আরকে,	
naobihar,	নওবহিহার,	নৌবিহার,	
chhanada,	ছনাদা,	ছানাদা,	
dhandu,	ধান্ডু,	ধন্দু,	
nutan,	নুতান,	নূতন,	
baptics,	ব্যাপ্টিক্স,	ব্যাপটিকস,	
janosamaj,	জনসোমা,	জনসমাজ,	
kaleo,	কালেও,	কালেও,	
jamjomat,	জামজোমাত,	জমজমাট,	
codee,	কোডি,	কোডে,	
steena,	স্টিনা,	স্টেন,	
sardar,	সারদার,	সরদার,	
felto,	ফেলটো,	ফেলত,	
bite,	বিতে,	বাইট,	
sthapona,	স্পাপনা,	স্থাপনা,	
ronodeep,	রনোডীপ,	রণদীপ,	
sosoa,	সোসোয়া,	শশা,	
soinyo,	সৈন্য,	সৈন্য,	
oncholeo,	অঁচলেও,	অঞ্চলেও,	
cathalic,	ক্যাথালিক,	ক্যাথলিক,	
grotha,	গ্রোথা,	গ্রোথ,	
jeebnagore,	জীবনগরে,	জীবননগর,	
mojlish,	মজলিশ,	মজলিশ,	
bowie,	বায়,	বওই,	
elgoridom,	এলগোরিগ,	এলগরিদম,	
segulo,	সেগুলো,	সেগুলো,	
faaj,	ফাযাজ,	ফাজ,	
swairacharibirodhi,	স্বৈবারবিরোধী,	স্বৈরাচারীবিরোধী,	
oitijjo,	ঐতিজ্য,	ঐতিহ্য,	
faltu,	ফালতা,	ফালতু,	
manobikotao,	মানবিকতাও,	মানবিকতাও,	
gamdan,	গামদান,	গামদান,	
maila,	মাইলা,	মাইল,	
lishenshe,	লিশেনশে,	লাইসেন্স,	
somabeshti,	সমাবেশ্টি,	সমাবেশটি,	
shrabostee,	শ্রবস্তি,	শ্রাবস্তী,	
biswashi,	বিশ্বাশী,	বিশ্বাসী,	
juboksoho,	যুবকসহ,	যুবকসহ,	
seo,	সেওও,	সেও,	
prokalpagulo,	প্রকালপগুলো,	প্রকল্পগুলো,	
apad,	আপাড,	আপদ,	
shuperheiro,	শুপেরহেরও,	সুপারহিরো,	
deh,	দেহ,	দেহ্,	
chinto,	চিন্তো,	চিনতো,	
mailkhanek,	মাইলখানেক,	মাইলখানেক,	
brojomohun,	ব্রমহহুন,	ব্রোজোমোহন,	
rifleksa,	রিফলেক্সা,	রিফ্লেক্স,	
madhumati,	মধুমাটি,	মধুমতী,	
kayech,	কেয়েচ,	কায়েছ,	
qaferderkey,	কাফেরদেকে,	কাফেরদেরকে,	
nanilalke,	নানিলালকে,	ননীলালকে,	
sithilota,	সিথিলোতা,	শিথিলতা,	
langhaner,	লাঙঘানের,	লংঘনের,	
dimbacriti,	ডিমব্রাকিটি,	ডিম্বাকৃতি,	
quartar,	কুওরাটার,	কোয়ার্টার,	
koreempoor,	করিমপপর,	করিমপুর,	
baire,	বাইরে,	বাইরে,	
sikkharrtheerao,	সিক্ষার্থাও,	শিক্ষার্থীরাও,	
kyathlik,	ক্যাথলিক,	ক্যাথলিক,	
rezidence,	রেজিডেন্স,	রেসিডেন্স,	
bojhao,	বোঝাও,	বোঝাও,	
keuoi,	কেও,	কেউই,	
diibug,	দিবুগ,	ডিবাগ,	
rajnoitik,	রাজনৈটিক,	রাজনৈতীক,	
hood,	হাড,	হুড,	
pettern,	পেটরার্ন,	প্যাটার্ন,	
nagorikkey,	নাগরিকে,	নাগরিককে,	
ateetkale,	অতিকটালে,	অতীতকালে,	
baaik,	বাইক,	বাইক,	
priseflex,	প্রিসেফ্লেক্স,	প্রাইজফ্লেক্স,	
bodhirota,	বধিরতা,	বধিরতা,	
naraphoka,	নারাফাকা,	নরফোক,	
kormokarke,	কর্মকরাকে,	কর্মকারকে,	
ala,	আলা,	আলা,	
oboshore,	অবশরে,	অবসরে,	
tecno,	টেকনো,	টেকনো,	
soommita,	সুম্মিতা,	সুমিতা,	
byaboharkarir,	ব্যবহরকারীর,	ব্যবহারকারীর,	
kokeyin,	কোকেয়িন,	কোকেইন,	
manushgulor,	মাুশগুলোর,	মানুষগুলোর,	
bastubad,	বাস্তুবাদ,	বস্তুবাদ,	
lekhaksattwar,	লেখক্ষত্ববর,	লেখকসত্ত্বার,	
kabutorer,	কাবুতের,	কবুতরের,	
dibet,	ডিবেট,	ডিবেট,	
palkee,	পালকি,	পাল্কি,	
kyatgarite,	ক্যাতগারিতে,	ক্যাটগারিতে,	
sarbhare,	সর্ভারে,	সার্ভারে,	
minister,	মিনিস্টের,	মিনিস্টার,	
songkulan,	সংকুলান,	সংকুলান,	
elaakate,	এলাকাতে,	এলাকাতে,	
kumbhalnar,	কুম্ভল্লার,	কুম্ভালনার,	
dalnata,	দলনাতা,	ডালনাটা,	
saptahokal,	সপ্তাখোল,	সপ্তাহকাল,	
protijogiider,	প্রতিযোগ্িদের,	প্রতিযোগীদের,	
bisnoo,	বিসনুও,	বিষ্ণু,	
registrikrito,	রেজিস্ৃকৃত,	রেজিস্ট্রীকৃত,	
onurbar,	অনুরবার,	অনুর্বর,	
charukala,	চরুকালা,	চারুকলা,	
projanankal,	প্রজানকাল,	প্রজননকাল,	
sooya,	সুয়া,	সোয়া,	
dharabahikvabe,	ধারাবাবিকাবে,	ধারাবাহিকভাবে,	
kinenni,	কিনেন্নি,	কিনেননি,	
booroon,	বুরুন,	বোরন,	
tukrowti,	তুক্রোটি,	টুকরোটি,	
raia,	রায়া,	রায়,	
khude,	খ্যুড়ে,	ক্ষুদে,	
garora,	গারোরা,	গারোরা,	
veenish,	ভিনিশ,	ভেনিস,	
parka,	পারকা,	পার্ক,	
karmosansthan,	কর্মসস্থান,	কর্মসংস্থান,	
sommotite,	সম্মতিতে,	সম্মতিতে,	
mujuru,	মুজুরু,	মুজুরু,	
tookror,	ত্কৌর,	টুকরোর,	
sambhabonao,	সম্ভাবনাও,	সম্ভবনাও,	
dajhyo,	দাঝ্য,	দাহ্য,	
meshintao,	মেশিন্তাও,	মেশিনটাও,	
tophaat,	তোফায়াট,	তফাৎ,	
bisshonath,	বিশ্থনথথ,	বিশ্বনাথ,	
phakay,	ফাকা,	ফাকে,	
direqtareta,	ডিরেক্তারটা,	ডিরেক্টরেট,	
societytey,	সোকিইটে,	সোসাইটিতে,	
bibader,	বিবাদের,	বিবাদের,	
gondogol,	গণ্ডগল,	গন্ডগোল,	
hijrite,	হিজরিতে,	হিজরীতে,	
bbiswashke,	ব্বিশবাশকে,	বিশ্বাসকে,	
mandape,	মান্ডাপে,	মন্ডপে,	
feroza,	ফেরোজা,	ফিরোজা,	
protishtan,	প্রতিষ্টান,	প্রতিষ্টান,	
dharabahikotitey,	ধারাবাহিতিতে,	ধারাবাহিকটিতে,	
shtona,	শ্তোনা,	স্টোন,	
sangaskritipreme,	সংস্কৃত্তিসে,	সংস্কৃতিপ্রেমে,	
dharabahikbhabe,	ধারাবাবীকে,	ধারাবাহিকভাবে,	
toching,	তোচিং,	টোচিং,	
haris,	হারিস,	হ্যারিস,	
chotogolper,	চটগল্লের,	ছোটগল্পের,	
shukraanoo,	শুকরানো,	শুক্রানু,	
ameettrakkhor,	অমিত্রক্ষার,	অমিত্রাক্ষর,	
dokaangoolote,	ডোকানগুলোতে,	দোকানগুলোতে,	
machgulo,	মাছগুলো,	মাছগুলো,	
qaferder,	কাফেরদের,	কাফেরদের,	
soori,	সুরি,	সুরি,	
boudher,	বৌধের,	বৌদ্ধের,	
bisheshya,	বিশেশ্য,	বিশেষ্য,	
ivil,	আইভিল,	ইভিল,	
deil,	ডেল,	ডেইল,	
kaathhmaandute,	কাঠমান্দুতে,	কাঠমান্ডুতে,	
protectionism,	প্রোটেক্টিনিস,	প্রোটেকশনিজম,	
shitei,	শিতেই,	শীতেই,	
niketon,	নিকেতন,	নিকেতন,	
doorotaumo,	দূরতামো,	দূরতম,	
amarika,	আমরিকা,	আমেরিকা,	
koyekbare,	কোয়েক্বরে,	কয়েকবারে,	
artore,	আর্তরে,	আর্টরে,	
godamjato,	গোদামগাতো,	গুদামজাত,	
societykey,	সকিস্টেক,	সোসাইটিকে,	
saseza,	সাজেজা,	সসেজ,	
shorifer,	শরিফের,	শরিফের,	
redcrosser,	রেক্রোস্সের,	রেডক্রসের,	
karaponner,	কারাপন্নের,	কারাপণ্যের,	
neerbahi,	নীরবাহী,	নির্বাহি,	
brittakar,	বৃত্যাকার,	বৃত্তাকার,	
vool,	ভুল,	উল,	
tantubayer,	তন্তুবায়ের,	তন্তুবায়ের,	
haripur,	হরিপুর,	হরিপুর,	
jaadrel,	যাড্রেল,	জাঁদরেল,	
edseler,	এডসেলের,	এডসেলের,	
paroner,	পারোনের,	পারণের,	
karore,	কারের,	কারোর,	
landey,	ল্যান্ডে,	ল্যান্ডে,	
ratishilatai,	রতিশিলতাই,	রতিশীলতায়,	
fansi,	ফানসি,	ফাঁসী,	
teunar,	টেউনার,	টিউনার,	
esoosiyetasa,	এসোসিয়েশা,	এসোসিয়েটস,	
kaansaat,	কানসাট,	কানসাট,	
madhabi,	মধাবী,	মাধবী,	
alraji,	আলরাজি,	আলরাজী,	
heart,	হার্ট,	হার্ট,	
shikkharrthirao,	শিক্ষার্থারীও,	শিক্ষার্থীরাও,	
mutar,	মুতার,	মুতার,	
eeksapreeshana,	ইকশ্প্রীন,	এক্সপ্রেশন,	
arthonitite,	আর্থনিতিতে,	অর্থনীতিতে,	
udor,	উদর,	উদর,	
drabyatah,	দ্রব্যত,	দ্রব্যতঃ,	
bangulzai,	বাঙ্গল্লাই,	বঙ্গুলিজাই,	
chhutee,	ছুটি,	ছুটি,	
mulyabriddhikale,	মূল্যবৃধিলীধ্যকলে,	মূল্যবৃদ্ধিকালে,	
gore,	গোরে,	গোর,	
antercticker,	অ্যান্টার্সিকের,	অ্যান্টার্কটিকের,	
habshi,	হাবশী,	হাবশী,	
chalochchitreer,	চালচ্ছ্রিত্রীর,	চলচ্চিত্রের,	
shatan,	শতন,	শয়তান,	
cholochchitrake,	চলচচ্তিত্রাকে,	চলচ্চিত্রকে,	
matorom,	মাতোরোম,	মাতরম,	
gobeshakgon,	গবেশকংগণ,	গবেষকগণ,	
bhangchur,	ভাঁচুর,	ভাংচুর,	
mooney,	মুনে,	মুনে,	
daaktikite,	দাকতিকিতে,	ডাকটিকিটে,	
greenald,	গ্রিণ্ড,	গ্রিনল্ড,	
valobase,	ভালোবাসে,	ভালোবাসে,	
bhuushito,	ভূশিত,	ভূষিত,	
jeshtha,	জেষ্ঠা,	জ্যেষ্ঠা,	
pulivendla,	পুলিভেন্ড্,	পুলিভেন্ডলা,	
deares,	ডেরাস,	ডিআরএস,	
alaul,	আলৌল,	আলাওল,	
bajite,	বাজিতে,	বাজিতে,	
ekoirokom,	একিরকম,	একইরকম,	
oncholgulir,	অঁচচলগুলির,	অঞ্চলগুলির,	
dii,	ডিআই,	দিই,	
gejeted,	জেজেটেড,	গেজেটেড,	
gabinius,	গাবিনাইস,	গাবিনিআস,	
firalem,	ফিরালেম,	ফিরালেম,	
bosano,	বসানো,	বসানো,	
hamburgey,	হামবারগেই,	হামবুর্গে,	
himchi,	হিমচি,	হিমচি,	
moshahidur,	মোশাহিদুর,	মোশাহিদুর,	
ajibooner,	আজিবনের,	আজীবনের,	
hosne,	হোসনে,	হোসনে,	
buddhitii,	বুদ্ধিতিই,	বুদ্ধিটিই,	
prottokkhovabe,	প্রত্যক্ষভাবে,	প্রত্যক্ষভাবে,	
rajashri,	রাজাশ্রী,	রাজশ্রী,	
kiandi,	কিয়ন্ডি,	ক্যান্ডি,	
jaruri,	জারুরি,	জরূরী,	
mosjidsoho,	মসজিজসহ,	মসজিদসহ,	
jiland,	জিলান্ড,	জিল্যান্ড,	
dorun,	দরুন,	দরুণ,	
pratisthanik,	প্রতিস্থানিক,	প্রাতিষ্ঠানিক,	
cxt,	সিকিএসসিএট,	সিএক্সটি,	
mosjidtir,	মসজিদ্তির,	মসজিদটির,	
mukhmondole,	মুখমন্ডলে,	মুখমণ্ডলে,	
abhidhaaneeck,	অভিধায়েন্ক,	অভিধানিক,	
hattey,	হ্যাটটে,	হাঁটতে,	
poroborti,	পরবর্তি,	পরর্বতী,	
chiroharit,	চিরোহারিট,	চিরহরিৎ,	
swatantrata,	স্বতন্ত্রততা,	স্বতন্ত্রতা,	
deefinition,	ডিফিনিশন,	ডেফিনেশন,	
boshoborty,	বশবর্ত,	বশবর্তী,	
lendol,	লেন্ডল,	লেন্ডল,	
crucer,	ক্রুসার,	ক্রুশের,	
pragreesa,	প্রগৃরাসা,	প্রগ্রেস,	
ekok,	একোক,	একক,	
laagche,	লাগছে,	লাগছে,	
hank,	হ্যাংক,	হাঙ্ক,	
chaalkee,	চালকি,	চালকে,	
bollov,	বল্লভ,	বল্লভ,	
chhadura,	ছাদুরা,	ছাদুরা,	
thailandshoho,	থাইলান্দস,	থাইল্যান্ডসহ,	
uddharkarmirai,	উদ্ধরকর্মীরাই,	উদ্ধারকর্মীরাই,	
taposgoner,	তাপসগনের,	তাপসগণের,	
bidhirnityang,	বিধির্থিন্ত,	বিধির্নিত্যং,	
abti,	আব্তি,	আবতি,	
amontronkarider,	আমন্ত্রকারীদের,	আমন্ত্রণকারীদের,	
shilpikuler,	শিল্পিকুলের,	শিল্পীকুলের,	
jotota,	জততা,	যতোটা,	
zakharovar,	যখারোভার,	জাখারোভার,	
wictor,	উইক্টর,	ভিক্টর,	
rajendracholer,	রাজেন্দ্রাগলের,	রাজেন্দ্রচোলের,	
debete,	দেবেতে,	ডিবেট,	
chapal,	চাপাল,	চপল,	
miley,	মিলি,	মিলে,	
shringa,	শ্রিংগা,	শৃঙ্গ,	
flexta,	ফ্লেসেকটা,	ফ্লেক্সটা,	
durgotsab,	দুর্গোতসাব,	দুর্গোৎসব,	
proshikkhane,	প্রশিক্ষাণে,	প্রশিক্ষণে,	
tokeo,	তোকেও,	টোকেও,	
grambaaseeder,	গ্রামবাসিদের,	গ্রামবাসীদের,	
gaziipur,	গজিপুর,	গাজীপুর,	
byan,	ব্যান,	ব্যাং,	
protibedokrao,	প্রতিবেদ্রকাও,	প্রতিবেদকরাও,	
prokolpoti,	প্রকল্তটি,	প্রকল্পটি,	
elaakaati,	এলাকাটি,	এলাকাটি,	
pisach,	পিসাচ,	পিশাচ,	
kod,	কোড,	কোড,	
morodeho,	মোরোদেহ,	মরদেহ,	
cholchhe,	চলচে,	চলছে,	
ansarir,	আনসারীর,	আনসারীর,	
laiseensim,	লেইসিনস,	লাইসেন্সিং,	
ceramiksh,	সেরামিক্স,	সিরামিকস,	
teamothy,	তেমোথি,	টিমোথি,	
upbasher,	উপ্বাশের,	উপবাসের,	
hool,	হুল,	হুল,	
jetam,	জেটাম,	যেতাম,	
seguloi,	সেগুলোই,	সেগুলোই,	
sharifpur,	শরিপপুর,	শরিফপুর,	
chikitsanirbhar,	চিকিতাসরিবরহ,	চিকিৎসানির্ভর,	
trabuco,	ট্রাবুকো,	ট্র্যাবুকো,	
kade,	কাদে,	কোড,	
beauby,	বিযবি,	বিউবি,	
show,	শোও,	শো,	
bibadey,	বিবাদে,	বিবাদে,	
subade,	সুবাদে,	সুবাদে,	
jonoshongjog,	জনশং্যোগ,	জনসংযোগ,	
rijoor,	রিজুর,	রিজুর,	
ekirokom,	একিকরম,	একইরকম,	
idyi,	আইডিআই,	আইডিই,	
samaveshke,	সমাভেশকে,	সমাবেশকে,	
jonomukhi,	জনমুখী,	জনমুখী,	
ispredsheet,	ইসপ্রেডশট,	স্প্রেডশীট,	
lirikti,	লিরিকটি,	লিরিকটি,	
muradkey,	মুরাদকে,	মুরাদকে,	
informetion,	ইনফর্রেশন,	ইনফরমেশন,	
kichudinpar,	কিচুদিনপুর,	কিছুদিনপর,	
ardasho,	আর্দাশ,	আর্দশ,	
setikey,	সেতিকে,	সেটিকে,	
musalmani,	মুসলমানি,	মুসলমানই,	
shaater,	শাতের,	শ্যুটার,	
brekthrough,	ব্রেক্রঘাউগ,	ব্রেকথ্রু,	
soommo,	সুমমো,	সুমো,	
drissogulo,	দৃস্বগুলো,	দৃশ্যগুলো,	
laaishenshh,	লাইশেন্,	লাইসেন্স,	
akhandota,	আখান্ডতা,	অখণ্ডতা,	
deeares,	ডীরেস,	ডিআরএস,	
prasadhoni,	প্রসাধনি,	প্রসাধনী,	
plainey,	প্লেমাই,	প্লেনে,	
mulvitti,	মুলভিত্তি,	মূলভিত্তি,	
corsin,	কর্সিন,	করসিন,	
popaike,	পোপাইকে,	পপাইকে,	
sethai,	সেথাই,	সেথাই,	
uindos,	উইন্ডস,	উইন্ডোস,	
digree,	ডিগ্রি,	ডিগ্রি,	
codeti,	কোডেটি,	কোডটি,	
paab,	পাব,	পাব,	
headquartus,	হেডকার্টাস,	হেডকোয়ার্টাস,	
sohokari,	সহকারী,	সহকারী,	
omeettrakkhor,	ওমিত্রাক্ষর,	অমিত্রাক্ষর,	
canservatian,	ক্যানসেহারভিটন,	কনসারভেশন,	
dara,	দারা,	দারা,	
serology,	সেরোলজি,	সেরোলজি,	
jaaygata,	জায়গতা,	জায়গাটা,	
kei,	কেই,	কেই,	
korle,	কোর্লে,	করলে,	
shef,	শেফ,	শেফ,	
longhan,	লোংঘান,	লংঘন,	
uthhaane,	উঠানে,	উঠানে,	
cheekitsar,	চিকিৎসার,	চিকিত্সার,	
abheedhaneek,	অভিধানক,	অভিধানিক,	
sambatsarkal,	সম্বাত্তককল,	সম্বৎসরকাল,	
sahojatprobritti,	সহজাতাপ্রব্ত্তি,	সহজাতপ্রবৃত্তি,	
bim,	বিম,	বিম,	
aamor,	আমোর,	আমর,	
hoonayin,	হুনয়ানী,	হুনাইন,	
serup,	সেরুপ,	সেরূপ,	
ghetu,	ঘেটু,	ঘেটু,	
roopdan,	রূপদান,	রুপদান,	
panda,	পান্ড,	পান্ডে,	
kraanti,	ক্রান্টি,	ক্রান্তি,	
doorger,	ডুরগের,	দুর্গের,	
antarctica,	অ্যান্টার্টিকা,	অ্যান্টার্কটিকা,	
rakshanbhag,	রক্ষণগাভ,	রক্ষণভাগ,	
ghumacchilo,	ঘুমাচিছিল,	ঘুমাচ্ছিল,	
kortona,	কর্তনা,	করতনা,	
armeenian,	আর্মিনিয়ান,	আর্মেনিয়ান,	
jatata,	জাতাতা,	যতোটা,	
prarthitao,	প্রার্থিতাও,	প্রার্থীতাও,	
masjidke,	মাসিজিকে,	মসজিদকে,	
monzushree,	মঞ্জুশ্রী,	মঞ্জুশ্রী,	
mekong,	মেকং,	মেকং,	
hitaishi,	হিতাইশী,	হিতৈষী,	
ghumachchila,	ঘুমাচ্ছিলা,	ঘুমাচ্ছিল,	
chitlar,	চিতলার,	চিতলার,	
carlosh,	কার্লোস,	কার্লোস,	
modhumotii,	মধুমতিই,	মধুমতী,	
tintikey,	তিনটিকে,	তিনটিকে,	
gonesher,	গণেশের,	গণেশের,	
adbhanced,	অ্যাডভাঞ্ভ,	অ্যাডভান্সড,	
pet,	পেট,	পেত,	
ghumachche,	ঘুমাচ্ছে,	ঘুমাচ্ছে,	
baipash,	বৈইপাশ,	বাইপাস,	
omanisa,	ওমানিসা,	অমানিশা,	
soomita,	সৌমিতা,	সুমিতা,	
conservetion,	কনসেরভেশন,	কনসারভেশন,	
kormyi,	কর্মি,	কর্মই,	
shikkhadikkhay,	শিক্ষাদিক্ষায়,	শিক্ষাদিক্ষায়,	
jotharthovabey,	যথারভাবায়ে,	যথার্থভাবে,	
yanqee,	যানকি,	ইয়াংকি,	
nichols,	নিচোল,	নিকলস,	
nosihote,	নসীহতে,	নসিহতে,	
bhaisaho,	ভৈসহ,	ভাইসহ,	
orbeet,	অরবিত,	অরবিট,	
aosafur,	আওসাফুর,	আওশাফুর,	
jaunotar,	যৌনতার,	যৌনতার,	
khali,	খালি,	খালি,	
anyarup,	অন্রাূপ,	অন্যরূপ,	
plasse,	প্লাসে,	প্লাসে,	
bohudeen,	বহুদিন,	বহুদিন,	
fanse,	ফ্যানসে,	ফাঁসে,	
neck,	নেক্,	নেক,	
osthishondhi,	অষ্থিশন্ধী,	অস্থিসন্ধি,	
bhaangchur,	ভাংচুর,	ভাংচুর,	
superheroo,	সুপেরাহেরও,	সুপারহিরো,	
giitikobitar,	গীতিকবিতার,	গীতিকবিতার,	
musolmanera,	মুসোলামেরা,	মুসলমানেরা,	
brahmanera,	ব্রহহমেনারা,	ব্রাহ্মণেরা,	
sanghitar,	সংহিতার,	সংহিতার,	
ancholsomuho,	আঞ্চলসমূহ,	অঞ্চলসমূহ,	
korush,	কোরুশ,	ক্রুশ,	
bandi,	বান্দি,	বন্দী,	
asif,	আসিফ,	আসিফ,	
rajtontre,	রাজতন্ত্রে,	রাজতন্ত্রে,	
pancbaar,	পাঁচবার,	পাঁচবার,	
sompadon,	সম্পাদন,	সম্পাদন,	
mathews,	মাথেস,	ম্যাথিউস,	
maktum,	মাকতুম,	মাকতুম,	
feemalee,	ফিমালি,	ফিমেল,	
ghatla,	ঘাতলা,	ঘটল,	
batom,	বাতম,	বাটম,	
rastagulikeo,	রাস্তাগুলিকেও,	রাস্তাগুলিকেও,	
bangobandhu,	বাঙ্গবাধধুন,	বঙ্গবন্ধু,	
adhunikkale,	আধুনিকালে,	আধুনিককালে,	
scorey,	স্কোরে,	স্কোরে,	
utpatti,	উৎপাটটি,	উতপত্তি,	
baju,	বাজু,	বাজু,	
konar,	কোনার,	কণার,	
jothon,	যথন,	যথন,	
seekkhokbrindo,	শিক্ষবকৃণ্দ্,	শিক্ষকবৃন্দ,	
akkheperi,	অক্ষেপীরে,	আক্ষেপেরই,	
mohit,	মহিত,	মুহিত,	
hondooras,	হন্ড্রাস,	হন্ডুরাস,	
madhobeer,	মাধবীর,	মাধবীর,	
taholo,	তাহোলো,	তাহলো,	
qaro,	কারো,	কারো,	
swartho,	স্বার্থ,	স্বার্থ,	
ansareer,	আনসারীর,	আনসারীর,	
taxikeo,	ট্যাক্সিকেও,	ট্যাক্সিকেও,	
baipass,	বাইপাস,	বাইপাস,	
sombhobonao,	সম্ভবনাও,	সম্ভবনাও,	
musalmanderke,	মুসল্নার্ডেককে,	মুসলমানদেরকে,	
mukhomondoler,	মুখমন্দললের,	মুখমণ্ডলের,	
abosare,	অবসারে,	অবসরে,	
remacry,	রেমার্ি,	রেমাক্রী,	
kloud,	ক্লুড,	ক্লাউড,	
dhos,	ধোস,	ধস,	
magrey,	ম্যাগ্রে,	ম্যাগ্রে,	
folleni,	ফললেনি,	ফলেনি,	
japanostho,	যাপানস্থ,	জাপানস্থ,	
suiza,	সুইজা,	সুইজা,	
dologuloo,	দলগুলোও,	দলগুলোও,	
monir,	মনির,	মনির,	
sanaktakaran,	সনক্তকাণ,	সনাক্তকরণ,	
choshon,	চোশন,	চোষণ,	
tyapa,	ত্যাপা,	ট্যাপ,	
banglota,	বাংলতা,	বাংলোটা,	
kaale,	কালে,	কালে,	
sudrishya,	সুদ্রীশ্য,	সুদৃশ্য,	
nothiboddho,	নথিবদ্ধ,	নথিবদ্ধ,	
maritimer,	মারিটিমের,	মেরিটাইমের,	
dharavahikbhabe,	ধরভাবিভাবে,	ধারাবাহিকভাবে,	
bhramapraban,	ভ্রমাপ্রবাণ,	ভ্রমপ্রবণ,	
musallati,	মুসল্তি,	মুসল্লাটি,	
jamjamat,	জম্জামাত,	জমজমাট,	
postac,	পোস্টাক,	পোস্টকে,	
gloria,	গ্লোরিয়া,	গ্লোরিয়া,	
rubala,	রুবালা,	রুবল,	
narsinghomgulor,	নারসিহগুলোর,	নার্সিংহোমগুলোর,	
motabolombira,	মোটাবলবিরা,	মতাবলম্বীরা,	
harasta,	হারস্তা,	হারাস্তা,	
deliver,	ডেলিভের,	ডেলিভার,	
himsrot,	হিমস্রোট,	হিমস্রোত,	
kormoi,	কর্মই,	কর্মই,	
neermol,	নিরমল,	নির্মল,	
prodiiper,	প্রদিপের,	প্রদীপের,	
ishahak,	ইশাহাক,	ইসাহাক,	
dharavahik,	ধররাবিহ,	ধারাবাহিক,	
chalachchitra,	চলচাচত্ত,	চলচ্চিত্র,	
manbe,	মানবে,	মানবে,	
bikargrasta,	বিকারগ্রস্ত,	বিকারগ্রস্ত,	
mozlis,	মজলিস,	মজলিশ,	
eura,	ইউরা,	ইউরো,	
masto,	মাস্টো,	মাস্ত,	
suchonakal,	সুচনাকাল,	সূচনাকাল,	
fasir,	ফাসির,	ফাসীর,	
abhijitda,	অভিযিত্া,	অভিজিতদা,	
anandamahale,	আনন্দমহলে,	আনন্দমহলে,	
chaka,	চাকা,	চাকা,	
sorting,	সর্টিং,	সর্টিং,	
nirbachokder,	নির্বাচকের,	নির্বাচকদের,	
kormokarer,	কর্মকারের,	কর্মকারের,	
asbab,	আস্বাব,	আসবাব,	
shresthoshcho,	শ্রেষ্ঠশ্চ,	শ্রেষ্ঠশ্চ,	
hepatetisa,	হেপাতেসিটা,	হেপাটাইটিস,	
engrezder,	এঙ্গারদের,	ইংরেজদের,	
murad,	মুরাদ,	মুরাদ,	
ghaghat,	ঘাঘাত,	ঘাঘট,	
welaqama,	ওেলাকামা,	ওয়েলকাম,	
sectore,	সিক্টরে,	সেক্টরে,	
meloonborrone,	মেলোবর্পনে,	মেলবোর্নে,	
baharamporer,	বহরমর্পের,	বহরমপুরের,	
awatar,	আবতার,	অবতার,	
elakaai,	এলাকাই,	এলাকাই,	
shotodha,	শতধা,	শতধা,	
drissogoolote,	দৃস্সগুলোতে,	দৃশ্যগুলোতে,	
tep,	টেপ,	ট্যাপ,	
dharavahiker,	ধরভাহীকের,	ধারাবাহিকের,	
karmoi,	কারমোই,	কর্মই,	
spreadshiit,	স্প্রেশিডিট,	স্প্রেডশীট,	
poripaker,	পরিপাকের,	পরিপাকের,	
chakti,	চক্তি,	চাকতি,	
pleta,	প্লেটা,	প্লেটো,	
hafej,	হাফেজ,	হাফেয,	
porizoner,	পরিজনের,	পরিজনের,	
rojapalaner,	রোজাপালানের,	রোজাপালনের,	
neerbachoker,	নিরবাচকের,	নির্বাচকের,	
goonoman,	গৌনমান,	গুণমান,	
kekru,	কেকরু,	কেকরু,	
siropa,	সিরোপা,	শিরোপা,	
dantahin,	দন্তাহীন,	দন্তহীন,	
ostad,	অস্তা,	ওস্তাদ,	
proshadhoner,	প্রশাধনের,	প্রসাধনের,	
arthurer,	আরথুরের,	আর্থারের,	
balabhadra,	বলভভদ্র,	বলভদ্র,	
shhow,	শোউ,	শো,	
bbiswasho,	ব্বিশ্বাশ,	বিশ্বাসও,	
phutbolarder,	ফাটবলালদের,	ফুটবলারদের,	
nazranar,	নজরানার,	নাজরানার,	
ajibon,	আজিবন,	আজীবন,	
dito,	দিতো,	দিতো,	
fake,	ফাকে,	ফাকে,	
karu,	কারু,	কারু,	
mukhamandoler,	মুখমান্ডলের,	মুখমণ্ডলের,	
nothibhukto,	নথিভুক্ত,	নথিভুক্ত,	
kaalengaa,	কালেঙ্গা,	কালেঙ্গা,	
hetimganje,	হেতিমাঞ্জে,	হেতিমগঞ্জে,	
inphormeshon,	ইনফারসমন,	ইনফরমেশন,	
irish,	ইরিশ,	আইরিস,	
asaktibandhan,	অসক্তিনব্ধন,	আসক্তিবন্ধন,	
gabeshonar,	গাবেশনার,	গবেষনার,	
dombhoke,	দমভোকে,	দম্ভকে,	
chikitshar,	চিকিৎশার,	চিকিত্সার,	
tintir,	তিন্তির,	তিনটির,	
rena,	রেনা,	রেনো,	
maner,	মানের,	মানে,	
rohosyo,	রহস্য,	রহস্য,	
minishtarer,	মিনিশ্টারের,	মিনিস্টারের,	
maladabha,	মালাদাভা,	মলদোভা,	
karir,	কারির,	কারীর,	
mumtajer,	মুম্তাজের,	মুমতাজের,	
nek,	নেক,	নেক,	
krus,	ক্রুস,	ক্রুশ,	
shithilata,	শিথিলতা,	শিথিলতা,	
borkhastokritora,	বরখকস্তৃকিরা,	বরখাস্তকৃতরা,	
shten,	শ্টেন,	স্টেন,	
futonta,	ফুতোন্টা,	ফুটন্ত,	
monroe,	মন্রো,	মনেরোর,	
showtey,	শুট,	শোতে,	
niroja,	নিরোজা,	নিরোজা,	
cholechi,	চলেছি,	চলেছি,	
boshoborti,	বশবর্তি,	বশবর্তী,	
carzar,	চারজার,	চার্জার,	
oblivion,	অবিভিভন,	অবলিভিয়ন,	
chaudhurio,	চৌধুরিও,	চৌধুরীও,	
uparjon,	উপারজন,	উপার্জন,	
nagorikderkey,	নাগরিকদেকে,	নাগরিকদেরকে,	
scholarship,	স্কলর্শরপ,	স্কলারশিপ,	
bonshi,	বন্ি,	বংশী,	
chokhwala,	চোখবালা,	চোখওয়ালা,	
shajano,	শাজানো,	সাজানো,	
gej,	জেজ,	গেজ,	
atorkitey,	আতরকিতেই,	অতর্কিতে,	
kisti,	কিস্তি,	কিস্তি,	
ateetkaale,	অতিকটালে,	অতীতকালে,	
terlarang,	টেরলারং,	তেরলারং,	
chalochchitraeei,	চালচ্ছ্রত্রী,	চলচ্চিত্রেই,	
shudhir,	শুধির,	শুধীর,	
fongli,	ফংলি,	ফংলি,	
salsa,	সালসা,	সালসা,	
orunima,	অরুনিমা,	অরুণিমা,	
agomonke,	আগমনকে,	আগমনকে,	
horidbar,	হোরিদবার,	হরিদ্বার,	
somraat,	সোমরট,	সম্রাট,	
parking,	পারকিং,	পার্কিং,	
madhoori,	মাধরি,	মাধুরী,	
shoori,	শুরি,	সুরি,	
manushera,	মনুশেরা,	মানুষেরা,	
durgotsabe,	দুর্গতসাবে,	দুর্গোৎসবে,	
oncholtee,	অঁচোলটি,	অঞ্চলটি,	
amorendro,	আমরেন্দ্র,	অমরেন্দ্র,	
tookrote,	ত্কৌরোতে,	টুকরোতে,	
bbosonto,	ব্বসন্ত,	বসন্ত,	
teenej,	তিইনেজ,	টিনেজ,	
doltyagi,	দল্তাগ্ঞি,	দলত্যাগী,	
lobbytey,	লববিট,	লবিতে,	
bikretaara,	বিক্রেটারা,	বিক্রেতারা,	
aalkaatra,	আলকাত্রা,	আলকাতরা,	
stoic,	স্টোইক,	স্টোয়িক,	
kanasarabhesana,	কানাসারেবানা,	কনসারভেশন,	
dip,	ডিপ,	দীপ,	
eokee,	এইকি,	এওকি,	
kaamij,	কামিজ,	কামিজ,	
bhromoner,	ভ্রমেণের,	ভ্রমণের,	
yukeliptash,	যুকেলিল্তিপ,	ইউক্যালিপ্টাস,	
bhabanir,	ভবনীর,	ভবানীর,	
jhalkanite,	ঝালকানিতে,	ঝলকানীতে,	
abheedhaaneeck,	অভেধাযান্স,	অভিধানিক,	
ekoghore,	একঘঘে,	একঘরে,	
pratijogira,	প্রতিযোগিরা,	প্রতিযোগীরা,	
vaibon,	ভাইবন,	ভাইবোন,	
emarjenshi,	এমারজঞ্জে,	এমার্জেন্সি,	
sikkhakromer,	সিক্ষাকর্মের,	শিক্ষাক্রমের,	
nartana,	নর্তনা,	নর্টন,	
panchadadu,	পঞ্চাদু,	পঞ্চাদাদু,	
hypar,	হাইপার,	হাইপার,	
chhutochhuti,	ছুটচুটি,	ছুটোছুটি,	
jahangirbad,	জহাঙ্গীরবাগ,	জাহাঙ্গীরবাদ,	
bondiira,	বন্ডিরা,	বন্দীরা,	
vince,	ভিন্সে,	ভিন্স,	
impaction,	ইমপ্পেশন,	ইমপ্যাকশন,	
gratha,	গ্রাথা,	গ্রোথ,	
shoriph,	শরিফ,	শরিফ,	
crashlands,	ক্রারলান্ড,	ক্র্যাশল্যান্ডস,	
jaatti,	যাত্তি,	জাতটি,	
manushe,	মানুশে,	মানুষে,	
senabahinio,	সেনাবাহীনীও,	সেনাবাহিনীও,	
srk,	স্র্ক,	শাহরুখ,	
dada,	দাদা,	দাদা,	
cbi,	সিবিআই,	সিবিআই,	
bhimsen,	ভিমসেন,	ভীমসেন,	
naabyota,	নব্যতা,	নাব্যতা,	
tetela,	টেটেলা,	টাইটেল,	
soteciety,	সটেসিটি,	সোসাইটিতে,	
sollallhu,	সোললালুলু,	সল্লাল্লাহু,	
rabo,	রাব,	রব,	
kharar,	খারার,	খরার,	
bohorompurer,	বহরমূপের,	বহরমপুরের,	
chargar,	চারগার,	চার্জার,	
bokul,	বকুল,	বকুল,	
kusumeshu,	কুশুমেশু,	কুসুমেষু,	
dupleks,	ডুপলেক্স,	ডুপ্লে,	
steen,	স্টেন,	স্টেন,	
lyaandeeng,	ল্যাযাডিং,	ল্যান্ডিং,	
parq,	পার্ক,	পার্ক,	
sima,	সিমা,	সীমা,	
granthatyke,	গ্রান্থাটটিকে,	গ্রন্থটিকে,	
nadnadeer,	নদ্দাদির,	নদনদীর,	
dijijer,	দিজিজের,	ডিজিজের,	
residensa,	রেসিডেন্সা,	রেসিডেন্স,	
machkabar,	মাচকাবার,	মাচকাবার,	
vedanta,	ভেদান্তা,	বেদান্ত,	
parther,	পার্থের,	পার্থের,	
varma,	ভারমা,	ভার্মা,	
drishyogulote,	দৃশ্যগুলোতে,	দৃশ্যগুলোতে,	
saazano,	সাজানো,	সাজানো,	
anchalo,	অঞ্চালো,	অঞ্চলও,	
notti,	নত্তি,	নোটটি,	
shikhbe,	শিখবে,	শিখবে,	
drishyer,	দৃষ্যের,	দৃশ্যের,	
neutrinoo,	নেউতৃতন,	নিউট্রিনো,	
seeramiks,	সিরামিক্স,	সিরামিকস,	
snehban,	স্নেহবান,	স্নেহবান,	
romnar,	রোমনার,	রমনার,	
brookoleen,	ব্রুকোলিন,	ব্রুকলিন,	
gajiipur,	গজিপুর,	গাজীপুর,	
tongaa,	তোঙ্গা,	টোঙ্গা,	
gonjona,	গঞ্জনা,	গঞ্জনা,	
nirmankarmisaha,	নির্মাক্ষণকরসম,	নির্মাণকর্মীসহ,	
cloring,	ক্লোরিং,	ক্লোরিং,	
suporichita,	সুপরিচিতা,	সুপরিচিত,	
venkates,	ভেঙ্কেটেট,	ভেঙ্কটেশ,	
anchalgoolir,	আঁচালগুলির,	অঞ্চলগুলির,	
talaa,	তালা,	তালা,	
dakope,	ডাকপে,	দাকোপ,	
ishter,	ইশ্টার,	ইস্টের,	
bapokotor,	বাপকতর,	ব্যাপকতর,	
torkareer,	তরকারীর,	তরকারীর,	
jolrong,	জলরং,	জলরঙ,	
pratisthasaho,	প্রতিষ্ঠসহ,	প্রতিষ্ঠাসহ,	
bondhuvabaponyo,	বন্ধুবাবাপন্য,	বন্ধুভাবাপন্ন,	
soundarja,	সৌন্দর্য,	সৌর্ন্দয্য,	
mekon,	মেকন,	মেকং,	
bonorajite,	বনরাজিতে,	বনরাজিতে,	
niurolaji,	নিরোলাজী,	নিউরোলজি,	
billaho,	বিল্লাহ,	বিল্লাহ,	
concerter,	কনসার্টের,	কানসাটের,	
souripurang,	সৌরিপুর্ং,	সৌরিপুরং,	
shasheja,	শাশেজা,	সসেজ,	
hansasya,	হানসাস্য,	হংসস্য,	
monzeele,	মঞ্জিলে,	মঞ্জিলে,	
hugeke,	হুগেকে,	হিউজকে,	
niropekshtar,	নিরপকেষ্টার,	নিরপেক্ষতার,	
nibobondhonkrito,	নিববন্ধৃত্রত,	নিববন্ধনকৃত,	
parabortee,	পারাবর্তি,	পরর্বতী,	
dweepgoolotey,	দ্বিপগুলিতে,	দ্বীপগুলোতে,	
skolastik,	স্কোলস্টিক,	স্কলাস্টিক,	
starker,	স্টার্কের,	স্টার্কের,	
ashanka,	আশানকা,	আশংকা,	
jocqey,	জোকে,	জকি,	
habathu,	হাবাথু,	হাবাথু,	
sucre,	সাকরে,	সাকার,	
asabhya,	অশাভ্য,	অসভ্য,	
shrabosty,	শ্রাবস্টি,	শ্রাবস্তী,	
eduardo,	এদুরুর্ডো,	এডুয়ার্দো,	
reshmirekha,	রেশখেরাখা,	রেশমীরেখা,	
agomone,	আগমনে,	আগমনে,	
antorvukta,	অন্তরভুক্ত,	অন্তর্ভুক্ত,	
ekla,	একলা,	একলা,	
confliqt,	কনফিল্টিক,	কনফ্লিক্ট,	
sector,	সেক্টর,	সেক্টর,	
karmokarke,	কার্মোরকে,	কর্মকারকে,	
hock,	হক্,	হুক,	
zubokder,	যুবকদের,	যুবকদের,	
gandhiio,	গানধিও,	গান্ধীও,	
dai,	২ইএ,	দিই,	
farid,	ফারিদ,	ফরিদ,	
gingbhalobasen,	গিংভলভাবেশেন,	গিংভালোবাসেন,	
farna,	ফার্না,	ফার্ন,	
shapad,	শাপাদ,	শ্বাপদ,	
chhootochhuti,	ছৌথোটি,	ছুটোছুটি,	
hajeerhatt,	হাজিরহাট,	হাজিরহাট,	
ongkush,	অংকুশ,	অংকুশ,	
jhumjhumita,	ঝুমঝুমিতা,	ঝুমঝুমিটা,	
larson,	লারসন,	লারসন,	
reejideencee,	রিজিডেন্স,	রেসিডেন্স,	
michhilti,	মিছিলটি,	মিছিলটি,	
siddhanto,	সিদ্ধান্ত,	সিদ্ধান্তও,	
aniyantrita,	অনিয়ত্রতন,	অনিয়ন্ত্রিত,	
niharkantibabu,	নিহর্কানবিতাবাবু,	নিহারকান্তিবাবু,	
abarte,	আবররেতে,	আবর্তে,	
peshto,	পেষ্ট,	পেষ্ট,	
conflict,	কনফল্লিক্ট,	কনফ্লিক্ট,	
sumi,	সুমি,	সুমি,	
chalochchitrogulor,	চালচ্ছগ্রুতুলোর,	চলচ্চিত্রগুলোর,	
sarbhaarti,	সর্ভর্তি,	সার্ভারটি,	
uporitale,	উপরিতলে,	উপরিতলে,	
dhanak,	ধানাক,	ধানক,	
kathla,	কাথলা,	কাঠলা,	
ekghore,	একঘরে,	একঘরে,	
basab,	বাসাব,	বাসাব,	
devolapar,	দেবোলার,	ডেভলপার,	
baarbadoj,	বারবাদোজ,	বার্বাডোজ,	
utsahi,	উৎসাহী,	উৎসাহী,	
elakatay,	এলাকাটাই,	এলাকাতে,	
elakatite,	এলাকাতিতে,	এলাকাটিকে,	
aqram,	আক্রাম,	আকরাম,	
madraser,	ম্যার্াসের,	মাদ্রাজের,	
uponeesoder,	উপনিসদের,	উপনিষদের,	
teestar,	তেস্তার,	তিস্তার,	
zerusaleme,	জেরুসালেমে,	জেরুসালেমে,	
qraima,	ক্রাইমা,	ক্রাইম,	
khiladirao,	খিলাদিরাও,	খিলাড়িরাও,	
tukroti,	তুকরোটি,	টুকরোটি,	
choudry,	চৌড্রি,	চৌধুরী,	
semai,	সেমাই,	সেমাই,	
kathmandu,	কাঠমুন্দু,	কাঠমান্ডু,	
simaa,	সিমা,	সীমা,	
bunot,	বুনোত,	বুনট,	
daqop,	ডাকোপ,	দাকোপ,	
shiqara,	শিকারা,	শিকার,	
parqa,	পারকা,	পার্ক,	
eoki,	এইকি,	এওকি,	
shakankti,	শাকান্তি,	শকাঙ্কটি,	
bhabarlaler,	ভাবলরলের,	ভবরলালের,	
kaatbey,	কাতবে,	কাটবে,	
alumni,	আলুমনি,	অ্যালমনি,	
gaddaphii,	গদ্ফাফি,	গাদ্দাফী,	
ganoporibahoner,	গণপরহবাহীণের,	গণপরিবহনের,	
ghoomachhilo,	ঘুমাছিল,	ঘুমাচ্ছিল,	
chandrimaa,	চন্দ্রমিয়া,	চন্দ্রিমা,	
jonosomaj,	জনসোজাম,	জনসমাজ,	
huk,	হুক,	হুক,	
artilary,	আর্টিলারি,	আর্টিলারি,	
atwabishvashi,	আত্যাবিবাশী,	আত্মবিশ্বাসী,	
rajnaiteek,	রাজনাইতিক,	রাজনৈতীক,	
sthapanar,	স্থাপানার,	স্থাপনার,	
patrol,	পাত্রল,	পেট্রোল,	
deejeejer,	জিজেজের,	ডিজিজের,	
bufer,	বুফের,	বাফার,	
ingrejra,	ইঙ্গ্রেরা,	ইংরেজরা,	
prothar,	প্রথার,	প্রথার,	
definition,	ডিফিনেশন,	ডেফিনেশন,	
gaphiloti,	গািলতি,	গাফিলতি,	
orthanitike,	অর্থানিতিকে,	অর্থনীতিকে,	
siddhanter,	সিদ্ধান্তের,	সিদ্ধান্তের,	
khaaneker,	খাঁেকের,	খানেকের,	
karmojog,	কার্মোগ,	কর্মযোগ,	
sadeena,	সাদেনা,	সাডেন,	
bapio,	বাপিও,	বাপিও,	
oedipus,	ওইডিপিস,	ইডিপাস,	
armshtronj,	আর্মশ্রসমন,	আর্মস্ট্রং,	
drissoteer,	দৃস্সটির,	দৃশ্যটির,	
dajjha,	দাঝঝা,	দাহ্য,	
probhur,	প্রভুর,	প্রভুর,	
songkolonti,	সংকলন্তি,	সংকলনটি,	
choson,	চোসন,	চোষণ,	
oswasteekor,	অস্সাস্তকর,	অস্বস্তিকর,	
prime,	প্রিমে,	প্রাইম,	
purple,	পারপপল,	পার্পেল,	
popke,	পপকে,	পোপকে,	
baman,	বামান,	বামন,	
philo,	ফিলো,	ফিলো,	
holding,	হলিডিং,	হোল্ডিং,	
dristiheen,	দৃষ্টিহীন,	দৃষ্টিহীন,	
pohnpeic,	পোহ্নপেক,	ফোনপেইক,	
harbare,	হারবার,	হারবারে,	
nirikho,	নিরিখো,	নিরিখ,	
chalochchitraeer,	চলচচ্তিত্র,	চলচ্চিত্রের,	
tookrokey,	তক্রকে,	টুকরোকে,	
prajanankal,	প্রজনকাল,	প্রজননকাল,	
mehsus,	মেহসুস,	মেহসুস,	
assexe,	এসেস্স,	অ্যাসেক্সে,	
pranibigyani,	প্রাণীবিজ্ঞানী,	প্রাণীবিজ্ঞানী,	
sikara,	সিকারা,	শিকার,	
deelibhara,	দীলিভারা,	ডেলিভার,	
raunanganey,	রাউন্গেনগে,	রণাঙ্গনে,	
mookhomaundoler,	মৌখমান্ধলের,	মুখমণ্ডলের,	
gaje,	গাজে,	গেজ,	
detik,	ডেটিক,	দেতিক,	
cantan,	ক্যান্টান,	ক্যান্টন,	
laaishheshh,	লাইশেশ,	লাইসেন্স,	
paste,	পাস্তে,	পেষ্ট,	
prakar,	প্রকার,	প্রকার,	
hyaloyin,	হ্যালোনিন,	হ্যালোইন,	
shtonehenge,	শ্তনেহেঙ্গে,	স্টোনহেঞ্জ,	
haitasha,	হাইসা,	হাইটস,	
hingsar,	হিংসার,	হিংসার,	
chalachchitroi,	চলচাচ্ত্রিও,	চলচ্চিত্রই,	
plak,	প্লাক,	প্ল্যাক,	
evereste,	এভেরেস্টে,	এভারেস্টে,	
baarnish,	বার্িস,	বার্নিশ,	
grauth,	গ্রাউথ,	গ্রোথ,	
binakar,	বিনাকার,	বিনাকার,	
nothibhukta,	নথিভুক্ত,	নথিভুক্ত,	
khamotagulor,	কামতাগুলোর,	ক্ষমতাগুলোর,	
phiqsa,	ফিকসা,	ফিক্স,	
boiragirhat,	বৈরাগরহাত,	বৈরাগিরহাট,	
pooshti,	পুষ্টি,	পুষ্টি,	
annimated,	অ্যান্নিমাট,	এনিমেটেড,	
hughes,	হুগেস,	হিউজেস,	
nepchooner,	নেপশনের,	নেপচুনের,	
vabaponno,	ভাবাপন্ন,	ভাবাপন্ন,	
kholdhular,	খোলধুলার,	খোলধূলার,	
rubidium,	রুবিউডিম,	রুবিডিয়াম,	
deqe,	ডেকে,	ডেকে,	
bijepi,	বিজেপি,	বিজেপি,	
koruna,	করুনা,	করুণা,	
zoojyota,	যুজ্যতা,	যোজ্যতা,	
patishapta,	পাতিশ্প্ত,	পাটিসাপটা,	
asovyo,	অসভ্য,	অসভ্য,	
sarajibonbyapi,	সরাজনবিস্যাপী,	সারাজীবনব্যাপী,	
phiksa,	ফিকসা,	ফিক্স,	
marodeho,	মারোদেহ,	মরদেহ,	
zozyota,	জজ্যতাা,	যোজ্যতা,	
darjiling,	দার্জিলিং,	দার্জিলিং,	
ajeeboner,	আজেবনের,	আজীবনের,	
balakarak,	বালাকারা,	বলকারক,	
gemske,	গেমসেকে,	জেমসকে,	
aholyar,	আহল্যার,	অহল্যার,	
gasthii,	গাস্থই,	গোষ্ঠীই,	
eevil,	ইইভিল,	ইভিল,	
mukhomandaley,	মুখমান্ধলেয়ে,	মুখমণ্ডলে,	
sangkoolan,	সংকোলান,	সংকুলান,	
krechi,	ক্রেচি,	করেছি,	
giitikobita,	গীতিকোবিতা,	গীতিকবিতা,	
madaspushto,	মাদাপস্ত,	মদদপুষ্ট,	
dormetori,	ডর্মতরি,	ডরমিটরি,	
sten,	স্টেন,	স্টেন,	
chirkut,	চিরকুত,	চিরকুট,	
gaujano,	গৌজানও,	গজানো,	
comoros,	কমোরস,	কোমোরোস,	
esprito,	এসপৃত,	এস্পিরিটো,	
guha,	গুহা,	গোহ,	
torunderke,	তরুন্দেরকে,	তরুণদেরকে,	
promothesh,	প্রমথেশ,	প্রমথেশ,	
khalidke,	খালিদকে,	খালিদকে,	
gavaskar,	গাভাস্কার,	গাভাস্কার,	
ganaporibahaner,	গণাপরীবাহাণের,	গণপরিবহনের,	
choukato,	চৌকাতো,	চৌকাত,	
ooporoshtho,	ঔপর্ষষ্ট,	উপরস্থ,	
paripakey,	পরিপাকে,	পরিপাকে,	
bolatkar,	বোলাতকার,	বলাৎকার,	
cheento,	চিন্তো,	চিনতো,	
nagarikera,	নাগারিকেরা,	নাগরিকেরা,	
ummool,	উমমুল,	উম্মুল,	
lubitz,	লুবিত,	লুবিৎজ,	
dhaleshwari,	ধলেশ্বর্বী,	ধলেশ্বরী,	
utshahomulok,	উৎশাহূলক,	উৎসাহমূলক,	
modelkey,	মোডেলকে,	মডেলকে,	
ekjoge,	একগোগে,	একযোগে,	
melbourner,	মেলববর্ণের,	মেলবোর্নের,	
chheher,	ছেহের,	ছেহের,	
saramukhe,	সরামুখে,	সারামুখে,	
avinetar,	অভিনেতার,	অভিনেতার,	
udbodhani,	উদ্বোধনানী,	উদ্বোধনী,	
bishesyo,	বিশেষ্য,	বিশেষ্য,	
bondhukey,	বন্ধুকে,	বন্ধুকে,	
rohasyer,	রোহাস্যের,	রহস্যের,	
lyaanding,	ল্যাযান্ডিং,	ল্যান্ডিং,	
fokskon,	ফকসনক,	ফক্সকন,	
toler,	তোলের,	তালের,	
proboleme,	প্রবলেমে,	প্রবলেমে,	
varote,	ভারেতে,	ভারতে,	
sallallahu,	সলললালু,	সল্লাল্লাহু,	
vugoley,	ভুগোলি,	ভূগোলে,	
sthapanagulor,	স্থাপানগুলোর,	স্থাপনাগুলোর,	
rahi,	রাহি,	রাহী,	
zeland,	জেলান্ড,	জিল্যান্ড,	
philipiner,	ফিলিপিনের,	ফিলিপাইনের,	
turisht,	তুরিশ্ট,	টুরিস্ট,	
manjushri,	মঞ্জুষ্রী,	মঞ্জুশ্রী,	
dhonni,	ধন্নী,	ধন্যি,	
lokhindorer,	লখিন্দরের,	লখিন্দরের,	
khonjena,	খোঁজেনা,	খোঁজেনা,	
jund,	জুন্ড,	জুন্দ,	
meshmeshya,	মেশেশময়,	মেশহমেশহিইয়া,	
taunship,	তৌঁশীপ,	টাউনশিপ,	
deraa,	দেরা,	ডেরা,	
podotyagsongkranto,	পদত্যাসংক্রান্ত,	পদত্যাগসংক্রান্ত,	
dhormokorme,	ধর্মকর্মে,	ধর্মকর্মে,	
antorbhuktimulak,	অন্তর্ভুলিভলক,	অন্তর্ভুক্তিমূলক,	
bondira,	বন্দিরা,	বন্দীরা,	
teman,	তেমান,	তেমন,	
birishiritey,	বিরিশিরীতে,	বিরিশিরিতে,	
shektor,	শেকতোর,	সেক্টর,	
charpanch,	চরপাঁচ,	চারপাঁচ,	
anubhutimalar,	অনুভুতিলাম,	অনুভূতিমালার,	
kale,	কালে,	কালে,	
shikkhartheerao,	শিক্ষার্থারও,	শিক্ষার্থীরাও,	
purbancoler,	পূর্বাক্নললের,	পূর্বাঞ্চলের,	
dooburir,	দুবুরীর,	ডুবুরির,	
sausage,	সৌসাগে,	সসেজ,	
bhagnekeo,	ভাগনেও,	ভাগ্নেকেও,	
gananatyo,	গণনত্য,	গণনাট্য,	
huka,	হুকা,	হুক,	
volivoler,	ভলিভোলের,	ভলিভলের,	
fatkabazare,	ফাটকবাাজেরে,	ফাটকাবাজারে,	
huqa,	হুকা,	হুক,	
shroddhabihin,	শ্রদ্ধবিহীন,	শ্রদ্ধাবিহীন,	
bisshasyi,	বিশ্শায়,	বিশ্বাসই,	
tanshree,	তানশ্রী,	তানশ্রী,	
jeher,	জেহের,	জেহের,	
peeth,	পিথ,	পীঠ,	
marri,	মারিরি,	ম্যারি,	
geographics,	গেগ্রাফিক্স,	জিওগ্রাফিকস,	
chetanagato,	চেতানাগতা,	চেতনাগত,	
arke,	আরকে,	আরকে,	
byaboharkari,	ব্যবহারকারী,	ব্যবহারকারী,	
sikkhokder,	সিক্ষকেের,	শিক্ষকদের,	
supplenza,	সুপেলপল্জা,	সাপলেঞ্জা,	
ramachandranke,	রমাচচন্দ্রকে,	রামাচন্দ্রনকে,	
poste,	পোস্টে,	পোস্টে,	
torkarite,	তরকারিতে,	তরকারিতে,	
tunaita,	তুউনাইটা,	টুনাইট,	
breqathru,	ব্রেকাচুরু,	ব্রেকথ্রু,	
postay,	পোস্টা,	পোস্টে,	
beshirbhaagei,	বেশির্ভাগেই,	বেশিরভাগেই,	
habsi,	হাবসি,	হাবশী,	
kanshat,	কানশাত,	কানসাট,	
bishhnu,	বিষ্ণু,	বিষ্ণু,	
bishasey,	বিশাসেই,	বিশ্বাসে,	
rekhapat,	রেখাপাট,	রেখাপাত,	
aasar,	আসার,	আসর,	
srivatsalakshanang,	শ্রীবাংকংলং,	শ্রীবৎসলক্ষণং,	
ekatitto,	একাতিত্ত,	একাতিত্ব,	
hijritey,	হিজরিতে,	হিজরীতে,	
borlen,	বরলেন,	বরলেন,	
maradeha,	মারাদেহা,	মরদেহ,	
birmuktijoddhagan,	বীর্মুক্তিদ্ধাগন,	বীরমুক্তিযোদ্ধাগণ,	
kada,	কাদা,	কোডা,	
gasthi,	গাস্থী,	গোষ্ঠী,	
artherer,	আর্থারের,	আর্থারের,	
rilayensha,	রিলায়েন্া,	রিলায়েন্স,	
fishing,	ফিশিং,	ফিসিং,	
jyaqasana,	জ্যাকসন,	জ্যাকসন,	
jeten,	জেটেন,	জেতেন,	
ghoorchen,	ঘুরচেন,	ঘুরেছেন,	
edaningkale,	এডানিংকালে,	ইদানীংকালে,	
indro,	ইন্দ্র,	ইন্দ্র,	
aaziz,	আজিজ,	আজিজ,	
agaldar,	আগালদার,	আগলদার,	
pitiler,	পিটিলের,	পিটিলের,	
maryir,	মাররি,	ম্যারির,	
kandy,	কান্ডি,	ক্যান্ডি,	
ekghare,	একঘারে,	একঘরে,	
horas,	হোরাস,	হোরাস,	
kortam,	কর্তাম,	করতাম,	
eporzonto,	এপরজন্ত,	এপর্যন্ত,	
sausagee,	সৌসাগী,	সসেজ,	
cheentaikaree,	চিন্তাকারী,	ছিনতাইকারী,	
drishi,	দৃশি,	দৃশ্যই,	
ase,	আসে,	আসে,	
obosorer,	অবসরের,	অবসরের,	
deilee,	দেইলি,	ডেইলি,	
hakone,	হাকেনো,	হাকোনে,	
nyata,	ন্যাটা,	ম্যাট,	
enjineers,	এনজিনার্স,	ইঞ্জিনিয়ার্স,	
hossne,	হসসে,	হোসনে,	
bosoben,	বসবেন,	বসবেন,	
soceitytey,	সকেইস্টেই,	সোসাইটিতে,	
bibecchyo,	বিবেচ্য,	বিবেচ্য,	
khoakshir,	খোয়করীর,	খোয়াক্ষীর,	
rohinibabu,	রোহিনিবাবু,	রোহিনীবাবু,	
pacchi,	পাচ্ছি,	পাচ্ছি,	
bongshokey,	বংশককেই,	বংশকে,	
munsi,	মুনসি,	মুন্সী,	
orbi,	অরবি,	ওরবি,	
jesh,	জেশ,	জেস,	
dalip,	দালিপ,	দালিপ,	
dadapur,	দাদাপুর,	দাদাপুর,	
chikittsar,	চিকিতসার,	চিকিত্সার,	
monohputo,	মনোপপুত,	মনঃপুত,	
jomjamat,	জোম্জামাট,	জমজমাট,	
louhojato,	লৌহজাতো,	লৌহজাত,	
nischitobhabe,	নিশ্চিভভাবে,	নিশ্চিতভাবে,	
dhrubaker,	ধ্রুবাকের,	ধ্রুবকের,	
gandhiir,	গানধীর,	গান্ধীর,	
fastara,	ফাস্তারা,	ফস্টার,	
probeshkari,	প্রবেশকারী,	প্রবেশকারী,	
neshadrabyer,	নেশাদ্ব্যের,	নেশাদ্রব্যের,	
prosadhoner,	প্রসাধনের,	প্রসাধনের,	
benojir,	বেনোজীর,	বেনজীর,	
rajbandi,	রাজবান্দি,	রাজবন্দী,	
baffer,	বাফের,	বাফার,	
karaa,	কারা,	কারো,	
korimpur,	করিমপুর,	করিমপুর,	
sohinsotar,	সোহিনসতার,	সহিংসতার,	
bodhir,	বোধীর,	বধির,	
taunsheep,	তৌউন্িপ,	টাউনশিপ,	
somratra,	সোমত্রা,	সম্রাটরা,	
suisharke,	সুশারকে,	সুইশারকে,	
ghamtaa,	ঘামতা,	ঘোমটা,	
horiddare,	হরিদ্রারে,	হরিদ্বারে,	
nachar,	নাচার,	নাচার,	
toufik,	তৌফিক,	তৌফিক,	
residence,	রিসিডেনকে,	রেসিডেন্স,	
satan,	সাতান,	শয়তান,	
pakhtunistan,	পাখতুনিষ্টান,	পাখতুনিস্তান,	
koordider,	কুরদিদের,	কুর্দিদের,	
shabkam,	শ্বাবমাম,	শবকাম,	
puding,	পুডিং,	পুডিং,	
debdebie,	দেবদেবী,	দেবদেবী,	
zaire,	জাইরে,	জাইরে,	
sangkulaan,	সংকুলান,	সংকুলান,	
bikromei,	বিক্রমেই,	বিক্রমেই,	
bisshas,	বিশ্বাস,	বিশ্বাস,	
falak,	ফালাক,	ফলক,	
mulbhitti,	মুলভিত্তি,	মূলভিত্তি,	
samajikotar,	সমাজিকতার,	সামাজিকতার,	
pinogbagke,	পিনোগ্বাগে,	পিনগবাগকে,	
tiunara,	তিউননা,	টিউনার,	
hindutirtha,	হিন্দুত্রিথ,	হিন্দুতীর্থ,	
chhotogolper,	ছোটগল্লের,	ছোটগল্পের,	
oojbekistan,	আজবেক্সিতন,	উজবেকিস্তান,	
porbotmala,	পর্বততলা,	পর্বতমালা,	
shubhag,	শুভাগ,	শুভাগ,	
torkarir,	তররকরীর,	তরকারীর,	
lambi,	লামবি,	লম্বি,	
balaruma,	বালারামা,	বলরুম,	
avidur,	অভিদুর,	আভিদুর,	
dakticket,	ড্যাক্টিকেট,	ডাকটিকিট,	
tata,	তাতা,	তাতা,	
seconder,	সেকোন্ডের,	সেকেন্ডের,	
dong,	ডংগ,	ডং,	
kanader,	কানাদের,	কণাদের,	
beila,	বেইলা,	বেইলা,	
shangkalonti,	শংকলন্তি,	সংকলনটি,	
miitar,	মিতাতার,	মিত্র,	
cs,	সিএসএস,	সিএস,	
premoronge,	প্রেমরঙ্গে,	প্রেমরঙে,	
prakalpatike,	প্রক্তাপকিকে,	প্রকল্পটিকে,	
jibanto,	জীবান্ত,	জীবন্ত,	
valobasen,	ভালোবেসেন,	ভালোবাসেন,	
marketing,	মার্কেটিং,	মার্কেটিং,	
protisthan,	প্রতিষ্ঠান,	প্রতিষ্টান,	
milton,	মিলতন,	মিলটন,	
shahabike,	শহাবিকে,	সাহাবীকে,	
mesenjjar,	মেসেন্জার,	মেসেঞ্জার,	
somsher,	সোমশের,	সমশের,	
queri,	কুয়েরি,	কোয়েরি,	
treend,	ট্রিন্ড,	ট্রেন্ড,	
elaakaate,	এলাকাতে,	এলাকাতে,	
neerbahe,	নীর্বহে,	নির্বাহে,	
eekbalke,	ইকবালকে,	ইকবালকে,	
sompadonkaree,	সম্পাদকর্াই,	সম্পাদনকারী,	
wrighter,	রিঘের,	রাইটের,	
baugey,	বাগে,	বাগে,	
bisshasi,	বিশশাসী,	বিশ্বাসী,	
euqalyptus,	ইউকাল্টিপাস,	ইউক্যালিপ্টাস,	
daqten,	ডাক্েন,	ডাকতেন,	
saifai,	সাইফাই,	সাইফাই,	
plaiin,	প্লিইন,	প্লেন,	
korkotkraantee,	করকোত্রান্ত্ত,	কর্কটক্রান্তি,	
komanera,	কোমানেরা,	কমানেরা,	
bidyadanke,	বিদ্যান্যাকে,	বিদ্যাদানকে,	
sushposhtolikhito,	সুষ্পষ্ষলিত,	সুষ্পষ্টলিখিত,	
nibirbhabe,	নিবীরভাবে,	নিবিরভাবে,	
akkhunno,	অক্ষুণ্ন,	অক্ষুণ্ণ,	
elakai,	এলাকাই,	এলাকাই,	
thyachar,	থ্যাচার,	থ্যাচার,	
probeshan,	প্রবেশন,	প্রবেশন,	
kailashrao,	কাইলশরাও,	কৈলাশরাও,	
musabbirul,	মুসাবিরিল,	মুসাব্বিরুল,	
gandhariir,	গানধার,	গান্ধারীর,	
vvimsenn,	ভিমসিন্,	ভীমসেন,	
setike,	সেতিকে,	সেটিকে,	
mukhyo,	মুখ্য,	মুখ্য,	
ashor,	আশর,	আসর,	
kk,	ক্কি,	কেকে,	
bupher,	বুফের,	বাফার,	
batsmanei,	বাৎসমানেই,	ব্যাটসম্যানই,	
hunine,	হুনিনে,	হুনাইন,	
graambaaseeder,	গ্রামবাসিইডের,	গ্রামবাসীদের,	
blasterke,	ব্লাস্টারকে,	ব্লাস্টারকে,	
vange,	ভাঙ্গে,	ভাঙ্গে,	
aansareer,	আনসারীর,	আনসারীর,	
mexicoteo,	মেকিস্টকেতেও,	মেক্সিকোতেও,	
surke,	সুরকে,	সুরকে,	
qyantana,	ক্যান্টনা,	ক্যান্টন,	
ganakantha,	গণকান্থ,	গণকণ্ঠ,	
aairees,	আইরিস,	আইরিস,	
playtey,	প্লেযাটে,	প্লেটে,	
asaciates,	অ্যাসাকিয়াটেস,	এসোসিয়েটস,	
agamane,	আগামানে,	আগমনে,	
graambashee,	গ্রামবাশী,	গ্রামবাসী,	
dai,	২ইএ,	ডে,	
platform,	প্লামফর্ট,	প্লাটফর্ম,	
corymb,	কর্মিব,	করিম,	
mahbunur,	মাহবুনুর,	মাহবুনুর,	
durlabhatwang,	দূর্লভংভাং,	দুর্লভত্বং,	
hariken,	হারিকেন,	হ্যারিকেন,	
hafsa,	হাফসা,	হাফসা,	
sqalarashipa,	স্কালারিশাপা,	স্কলারশিপ,	
gudamjat,	গুদাম্ত,	গুদামজাত,	
lagche,	লাগছে,	লাগছে,	
rajbandir,	রাজবান্দির,	রাজবন্দীর,	
sikkharthirao,	সিক্ষার্থিরাও,	শিক্ষার্থীরাও,	
shrichaitanyadev,	শ্রীচাত্যবেদেব,	শ্রীচৈতন্যদেব,	
vejjanno,	ভেজজান্ন,	ভেজানো,	
fooloo,	ফুলোও,	পোলো,	
uporoshtho,	উপরপষ্থ,	উপরস্থ,	
ganaparibahan,	গণপপরীবহীন,	গণপরিবহন,	
kram,	ক্রাম,	ক্রম,	
ul,	উউএল,	উল,	
heepatitis,	হিপাটিটিস,	হেপাটাইটিস,	
ajeejer,	আজেজের,	আজিজের,	
aaeerese,	আইয়েরেস,	আইরেসে,	
jansa,	জানসা,	জন্স,	
alsaar,	আলসার,	আলসার,	
karecho,	কারেছো,	করেছো,	
pyetarna,	প্য়ত্রা,	প্যাটার্ন,	
keui,	কেউ,	কেউই,	
venush,	ভেনুশ,	ভেনাস,	
votarer,	ভোতারের,	ভোটারের,	
bornolikhon,	বর্ণলিখন,	বর্ণলিখন,	
ponchasjon,	পঞ্চাসঞন,	পঞ্চাশজন,	
taufik,	তৌফিক,	তৌফিক,	
capshule,	ক্যাশশুলে,	ক্যাপসুল,	
shansthagulo,	শানস্থাগগুলো,	সংস্থাগুলো,	
pader,	পাদের,	প্যাডের,	
dwibidho,	দ্বিবিধ,	দ্বিবিধ,	
deputi,	দেপুটি,	ডেপুটি,	
madhuri,	মাধুরী,	মাধুরী,	
shahidputra,	শহিদপুত্র,	শহীদপুত্র,	
akar,	আকার,	একার,	
niknayman,	নিক্নম্যন,	নিকনেইমান,	
sofie,	সোফি,	সোফি,	
nirmalata,	নির্মলতা,	নির্মলতা,	
byabaharkariderke,	ব্যবহারকেরকে,	ব্যবহারকারীদেরকে,	
sheets,	শিটস,	শীটস,	
riphleksa,	রিফলেক্স,	রিফ্লেক্স,	
maley,	মালে,	মালে,	
peengna,	পিংগা,	পিংনা,	
shhashtra,	শাস্ত্র,	শাস্ত্র,	
mukherjee,	মুখেরজি,	মুখার্জী,	
sweety,	স্বি,	সুইটি,	
phutonta,	ফুতন্ত,	ফুটন্ত,	
injiniyarim,	ইনজিনারিযাম,	ইঞ্জিনিয়ারিং,	
dhaanche,	ধাঁচে,	ধাঁচে,	
orthonitir,	অর্থনীতির,	অর্থনীতির,	
asamonjasyopurno,	অসামান্যপূর্ণ,	অসামঞ্জস্যপূর্ণ,	
laicenshe,	লেইকেন্সে,	লাইসেন্স,	
graambaaseeo,	গ্রামবাসিও,	গ্রামবাসীও,	
bitlaser,	বিত্লাসের,	বিটলসের,	
ghotleo,	ঘটললেও,	ঘটলেও,	
pinglateo,	পিংলেটেও,	পিংলাতেও,	
bujhechhila,	বুঝেছিলা,	বুঝেছিল,	
joones,	জুনস,	জোন্স,	
protijogii,	প্রতিযোগীও,	প্রতিযোগী,	
vabnakey,	ভাবনাকে,	ভাবনাকে,	
emiratas,	এমিরাটাস,	এমিরেটাস,	
bhadaka,	ভাদাকা,	ভদকা,	
ikbaaler,	ইকবালের,	ইকবালের,	
meghacchonno,	মেঘাচঞ্চন,	মেঘাচ্ছন্ন,	
jontrototto,	যন্ত্রত্ত,	যন্ত্রতত্ত্ব,	
eshtoniya,	এষ্টনিয়,	এস্তোনিয়া,	
milayatane,	মিলায়ানে,	মিলায়তনে,	
eukalyptus,	ইউকাল্টিপাস,	ইউক্যালিপ্টাস,	
chatrorai,	চাত্ররায়,	ছাত্ররাই,	
gara,	গারা,	গোর,	
bhugol,	ভুগল,	ভূগোল,	
kanasharabheshhana,	কনশরববেষণ,	কনসারভেশন,	
raagee,	রাগি,	রাগী,	
battery,	ব্যাট্রাই,	ব্যাটারী,	
transform,	ট্রানস্ফর্,	ট্রান্সফর্ম,	
teennis,	টিন্নিস,	টেনিস,	
olympik,	অলিমপিক,	অলিম্পিক,	
groth,	গ্রোথ,	গ্রোথ,	
oindrila,	ঐয়্দ্রীলা,	ঐন্দ্রিলা,	
vromonkaley,	ভ্রোমোকালেই,	ভ্রমণকালে,	
ujbekistaner,	উজবেকিস্তানের,	উজবেকিস্তানের,	
firth,	ফির্থ,	ফার্থ,	
mashtarsha,	মাষ্টার্ষা,	মাস্টার্স,	
bachai,	বাছাই,	বাছাই,	
bahubar,	বহুবার,	বহুবার,	
nimitte,	নিমিত্তে,	নিমিত্তে,	
doneta,	দোনেটা,	ডোনাট,	
tiger,	তিজের,	টাইগার,	
armshtrong,	আর্সরগ্রং,	আর্মস্ট্রং,	
thechar,	থেছার,	থ্যাচার,	
uposhthit,	উপশ্থিত,	উপস্থিত,	
samanyai,	সমন্যায়,	সামান্যই,	
inapharameshana,	ইনাফরাসেমা,	ইনফরমেশন,	
moushum,	মৌশুম,	মৌসুম,	
ministara,	মিনিস্তারা,	মিনিস্টার,	
rudiger,	রুডিগের,	রুদিগের,	
shift,	শিফ,	শিফট,	
naajii,	নাজিই,	নাত্সি,	
masjidti,	মাসজিদ্তি,	মসজিদটি,	
bagdadii,	বাগদাদি,	বাগদাদী,	
distibutor,	দিস্তিবুতর,	ডিস্টিবিউটারের,	
munim,	মুনিম,	মুনিম,	
raiialati,	রেয়ালাটি,	রয়্যালটি,	
chittronatyokar,	চিত্রনাতাক্যার,	চিত্রনাট্যকার,	
byatikrami,	ব্যতিক্রমী,	ব্যতিক্রমী,	
karim,	কারিম,	করিম,	
jeebanjapon,	জীবন্যাজন,	জীবনযাপন,	
daybhager,	দাবভাগের,	দায়ভাগের,	
capsule,	ক্যাপসুলে,	ক্যাপ্সুল,	
ispredseet,	ইসপ্রেডটিট,	স্প্রেডশীট,	
melborrone,	মেলবর্নে,	মেলবোর্নে,	
qredita,	ক্রেডিটা,	ক্রেডিট,	
upobaasee,	উপবাসা,	উপবাসী,	
sheshardhe,	শেশারধে,	শেষার্ধে,	
jens,	জেন্স,	জিন্স,	
chalachchitrer,	চলচচ্ছিত্রের,	চলচ্চিত্রের,	
shiulijhra,	শিলিজরা,	শিউলিঝরা,	
mangoleek,	মাঙ্গোলিক,	মাঙ্গলিক,	
nagorikke,	নাগরিক্কে,	নাগরিককে,	
bostubad,	বস্তুবাদ,	বস্তুবাদ,	
tukroke,	তুকরোকে,	টুকরোকে,	
gronthoti,	গ্রন্থটি,	গ্রন্থটি,	
notey,	নোটে,	নোটে,	
utotoro,	উতততর,	উততর,	
abheedhanic,	অভিভাচিক,	অভিধানিক,	
uponishad,	উপনিশা,	উপনিষদ,	
dakter,	ড্যাক্তার,	ডাকতের,	
oncholshomuher,	অঞ্চলসূমহের,	অঞ্চলসমূহের,	
kraim,	ক্রাইম,	ক্রাইম,	
noteti,	নতেটি,	নোটটি,	
kaferder,	কাফেরদের,	কাফেরদের,	
biplabee,	বিপলাবি,	বিপ্লবী,	
casper,	ক্যাসপার,	ক্যাসপার,	
ahmed,	আহমেড,	আহামদ,	
dufresne,	ডুফ্রেস্ন,	ডুফরেস্ন,	
adorsho,	আদর্শ,	আর্দশ,	
directarate,	ডিরেক্টারাটে,	ডিরেক্টরেট,	
jolrang,	জোলরাং,	জলরঙ,	
prijon,	প্রিজন,	প্রিজন,	
atmobonchito,	আত্মবন্চিত,	আত্মবঞ্চিত,	
vogno,	ভগ্ন,	ভগ্ন,	
brail,	ব্রাল,	ব্রেইল,	
mukhya,	মুখ্যা,	মুখ্য,	
pratiyogita,	প্রতিয়গত,	প্রতিযোগীতা,	
kosambir,	কোসাম্বির,	কোসাম্বীর,	
toxoid,	টোক্সইড,	টক্সয়েড,	
jontropatigulite,	যন্ত্রপ্তগুলিতে,	যন্ত্রপাতিগুলিতে,	
diiptii,	দিপিতই,	ডেপুটি,	
victor,	ভিক্টোর,	ভিক্টর,	
nirgomon,	নির্মগন,	নির্গমন,	
jotsna,	জোটসনা,	জ্যোৎস্না,	
jalarong,	জালারং,	জলরঙ,	
dhhaabi,	ঢাবি,	ঢাবি,	
moresbai,	মোরেসবাই,	মোরেসবাই,	
shikkharthirao,	শিক্ষার্থারও,	শিক্ষার্থীরাও,	
audiotike,	অডিওটিকে,	অডিওটিকে,	
addabaj,	আদ্দাবাজ,	আড্ডাবাজ,	
daaktikit,	ডাকতিক,	ডাকটিকিট,	
dhaleshorii,	ধলেশরী,	ধলেশ্বরী,	
themeke,	থেমেক,	থিমকে,	
byabaharkaree,	ব্যবহারকারী,	ব্যবহারকারী,	
ghurte,	ঘুরতে,	ঘুরতে,	
laaisheesh,	লাইশিস,	লাইসেন্স,	
siddhante,	সিদ্ধান্তে,	সিদ্ধান্তে,	
parjotaker,	পার্যটাকের,	পর্যটকের,	
katateo,	কাতাতেও,	কাটাতেও,	
laat,	লাট,	লাট,	
ddebet,	দেবেট,	ডিবেট,	
seekkharthirao,	শিক্ষার্থারীও,	শিক্ষার্থীরাও,	
gorjon,	গর্জন,	গর্জন,	
churger,	চারগের,	চার্জের,	
cholochchitro,	চলচচিত্র,	চলচ্চিত্র,	
byathapather,	ব্থাথপাঠের,	ব্যথাপথের,	
addhattikotar,	আদ্ধাতিকতার,	আধ্যাত্মিকতার,	
stoonahenja,	স্তোনাহ্য,	স্টোনহেঞ্জ,	
graambaasheeo,	গ্রামবাশীও,	গ্রামবাসীও,	
site,	সিতে,	সিটে,	
poketchorder,	পোকেটচর্কের,	পকেটচরদের,	
azimpur,	আজিমপুর,	আজিমপুর,	
sahajlabhbhotar,	সহাজলতার,	সহজলভ্যতার,	
ovinetar,	অভিনেতার,	অভিনেতার,	
holuder,	হলুদের,	হলুদের,	
deciliter,	ডিকিলেটিটের,	ডেসিলিটার,	
moonshi,	মুনশি,	মুন্সি,	
ganoparibahaner,	গণপারীবহানের,	গণপরিবহনের,	
fastag,	ফ্স্টাট,	ফ্যাসট্যাগ,	
gunje,	গুঞ্জে,	গুঁজে,	
hurricane,	হুরিকানে,	হ্যারিকেন,	
lotharan,	লোথারা,	লুথেরান,	
magical,	ম্যাগিকাল,	ম্যাজিকাল,	
graambasider,	গ্রাম্সাসীদের,	গ্রামবাসীদের,	
korimkey,	করিমকেই,	করিমকে,	
perry,	পের্,	পেরি,	
humira,	হুমিরা,	হুমিরা,	
peri,	পেরি,	পেরি,	
sohojlovyotar,	সহজজ্লবতার,	সহজলভ্যতার,	
sutir,	সুতির,	সুতির,	
toptoshele,	তপ্টশেলে,	তপ্তশেলে,	
cn,	সিএনএন,	সিএন,	
tooku,	তুকু,	টুকু,	
aashtikotaa,	অশ্টিকোটা,	আস্তিকতা,	
municipal,	মুনিকিপল,	মিউনিসিপ্যাল,	
chokrantosoho,	চক্রান্তঃ,	চক্রান্তসহ,	
laatimer,	লাতিমের,	লাটিমের,	
shchalastik,	স্লাস্টিক,	স্কলাস্টিক,	
graambasio,	গ্রাম্বাসিও,	গ্রামবাসীও,	
kazianis,	কাজিয়ানিস,	কাজানিস,	
dibate,	দিবাতে,	ডিবেট,	
siit,	সিত,	শীত,	
chandrima,	চন্দ্রিমা,	চন্দ্রিমা,	
shoreefpur,	শরিপপুর,	শরিফপুর,	
phartha,	ফার্থা,	ফার্থ,	
chhadite,	ছাডিতে,	ছড়িতে,	
mile,	মিলে,	মিলে,	
duhsthanostho,	দুঃস্থান্থ,	দুঃস্থানস্থ,	
saifullahil,	সাইফুল্লাল,	সাইফুল্লাহিল,	
dorneca,	ডর্নেকা,	ডরনেকা,	
dienes,	ডিয়েন্স,	ডিএনএস,	
domone,	দোমনে,	দমনে,	
tokee,	তোকি,	তকি,	
panchasjan,	পঞঁচশঞ্জান,	পঞ্চাশজন,	
deaubande,	দেউবান্ডে,	দেওবন্দে,	
purborekorde,	পুর্বরেকদে,	পূর্বরেকর্ডে,	
capsul,	ক্যাপসুল,	ক্যাপসুল,	
licensin,	লিইসেন্স,	লাইসেন্সিং,	
osamarik,	ওসামারিক,	অসামরিক,	
telakucha,	তেলাকাচা,	তেলাকুচা,	
probhritike,	প্রভৃতিকে,	প্রভৃতিকে,	
pabo,	পাবো,	পাব,	
dipgulote,	দিপগুলোতে,	দ্বীপগুলোতে,	
joumana,	জৌমানা,	জুমানা,	
nikela,	নিকেলা,	নিকেল,	
fitarsaho,	ফিতারসহ,	ফিতরসহ,	
dhyanastha,	ধ্যানস্থ,	ধ্যানস্থ,	
vezano,	ভেজানো,	ভেজানো,	
riazuddin,	রিজযুদ্দিন,	রিয়াজউদ্দীন,	
oncholsomuho,	অন্চলসমূহ,	অঞ্চলসমূহ,	
nirgamon,	নির্গামন,	নির্গমন,	
prashikkhane,	প্রশিক্ষণে,	প্রশিক্ষণে,	
jumlalancer,	জুমলাল্যান্সের,	জুমলাল্যান্সার,	
bossonte,	বসসন্তে,	বসন্তে,	
rajtantra,	রাজতন্ত্র,	রাজতন্ত্র,	
dubureer,	দুবুরীর,	ডুবুরির,	
chhaikalo,	ছাইকালো,	ছাইকালো,	
romantik,	রোমান্তিক,	রোমান্টিক,	
sobchey,	সবচে,	সবচে,	
dumaa,	দুমা,	দুমা,	
pretti,	প্রেটটি,	প্রিটি,	
shho,	শোয়,	শো,	
zonsa,	জনসা,	জোন্স,	
vittimul,	ভিত্তিমূল,	ভিত্তিমূল,	
miraclee,	মিরাক্লি,	মিরাকেল,	
average,	আভেরাগে,	এভারেজ,	
farhetin,	ফারহহেন্টিন,	ফারহেতিন,	
senabahineeow,	সেনাবহীননেও,	সেনাবাহিনীও,	
sqirt,	স্ক্রিট,	স্কার্ট,	
safin,	সাফিন,	সাফিন,	
siramikasa,	সিরামিকাসা,	সিরামিকস,	
gronther,	গ্রনথার,	গ্রন্থের,	
michir,	মিচির,	মিচির,	
chalochchitrei,	চালচচ্ত্রেই,	চলচ্চিত্রেই,	
laishenshim,	লেইশেন্সিম,	লাইসেন্সিং,	
milekhanek,	মিলেখানেক,	মাইলখানেক,	
bonnopran,	বন্নপ্রাণ,	বন্যপ্রাণ,	
akkelpure,	আক্কেলপুরে,	আক্কেলপুরে,	
koomarir,	কুমারির,	কুমারীর,	
vushi,	ভুশি,	ভুষি,	
suparichiti,	সুপারিচিতি,	সুপরিচিতি,	
jaanachhe,	জাঁচাছে,	জানাচ্ছে,	
senabahineekey,	সেনাবাহানীনে,	সেনাবাহিনীকে,	
saoum,	সাওম,	সাওম,	
jewellery,	জেওয়ালে,	জুয়েলারির,	
prakalpoguli,	প্রকল্োগুলি,	প্রকল্পগুলি,	
shahjapur,	শাহপাজুর,	শাহজাপুর,	
alexanderke,	আলেক্সান্ডার্ডকে,	আলেকজান্ডারকে,	
akpaase,	আকপাসে,	একপাশে,	
qanasarabheshana,	কানাসারেবা,	কনসারভেশন,	
sangbadmadhyame,	সংসব্যবাধ্যে,	সংবাদমাধ্যমে,	
eesosiyeetasa,	ইসোসিয়াসা,	এসোসিয়েটস,	
xpose,	ক্ক্সপেসে,	এক্সপোজ,	
audioguloke,	অডিওগুলোকে,	অডিওগুলোকে,	
lettere,	লেট্টারে,	লেটারে,	
santoshpore,	সান্তসপর্ে,	সন্তোষপুর,	
karima,	কারিমা,	করিম,	
bheenisa,	ভিনিসা,	ভেনিস,	
mentither,	মেন্টিথের,	মেনটিথের,	
nirbaho,	নির্বাহ,	নির্বাহ,	
rudrasagar,	রুদ্রসগর,	রুদ্রসাগরের,	
sobrakamer,	সোবরাকামের,	সবরকমের,	
sampadon,	সম্পাদন,	সম্পাদন,	
erythrian,	এর্রিয়ান,	এরিথ্রিয়ান,	
sqolastiq,	স্কোলস্টিক,	স্কলাস্টিক,	
bonvumitey,	বনভুমিটেই,	বনভূমিতে,	
vault,	ভাউল্ট,	ভল্ট,	
noitikota,	নৈতিকতা,	নৈতিকতা,	
amiretus,	অমিরারাস,	এমিরেটাস,	
licencedhari,	লিকেন্ধারীরা,	লাইসেন্সধারী,	
sheshdinti,	শেশদিনটি,	শেষদিনটি,	
everage,	এভেরাগে,	এভারেজ,	
adhyatmik,	আধ্যাত্মিক,	আধ্যাত্মিক,	
titarer,	তিতারের,	তিতারের,	
srabosty,	স্রাবস্ত্তি,	শ্রাবস্তী,	
meridiane,	মেরিডিয়ান,	মেরিডিয়ানে,	
blogarra,	ব্লোগারা,	ব্লগাররা,	
jandrel,	জান্ড্রেল,	জাঁদরেল,	
kheylechen,	খেলেছেন,	খেলেছেন,	
swadesh,	স্বােশ,	স্বদেশ,	
kichutei,	কিছুতেই,	কিছুতেই,	
masjidsaho,	মাসিজসহ,	মসজিদসহ,	
chuti,	চুটি,	ছুটি,	
muhurtati,	মুহুর্তাটি,	মুহুর্তটি,	
phokser,	ফকসের,	ফক্সের,	
asommoti,	আসম্তি,	অসম্মতি,	
bandhubhaabaapanna,	বান্ধুবূন্া,	বন্ধুভাবাপন্ন,	
saatzoner,	সায়োজনের,	সাতজনের,	
baieq,	বাই়ক,	বাইক,	
grambaasi,	গ্রামবাসি,	গ্রামবাসী,	
erokomer,	এরোকেমের,	এরকমের,	
mulor,	মুলোর,	মুলোর,	
iub,	ইউউব,	আইইউবি,	
qonfliqt,	কনফিক্ট,	কনফ্লিক্ট,	
chakrapani,	চকররাপানি,	চক্রপানী,	
cuti,	কুটি,	কিউটি,	
samany,	সামান্নি,	সামান্য,	
chhooti,	ছৌটি,	ছুটি,	
dobhara,	দোভারা,	ডোভার,	
dorgaaho,	দরগাহ,	দরগাহ,	
chinito,	চিনিতো,	চিনতো,	
mele,	মেলে,	মাইল,	
mast,	মাস্ট,	মাস্ত,	
laishensha,	লাইশেন্সা,	লাইসেন্স,	
rayyalati,	রায়লতলি,	রয়্যালটি,	
shainyader,	শৈন্যয়দের,	সৈন্যদের,	
koro,	কোরো,	করো,	
nilfamarir,	নিলফামারীর,	নীলফামারীর,	
existing,	এক্সিসিং,	এক্সিসটিং,	
peeri,	পিরি,	পেরি,	
qarqa,	কারকা,	কার্ক,	
masjidtir,	মাসজিদ্তির,	মসজিদটির,	
aakik,	আকিক,	আকিক,	
osommotite,	অসম্তমে,	অসম্মতি,	
adhyattikota,	অধ্যত্্যকিত,	আধ্যাত্মিকতা,	
foxcon,	ফক্সকন,	ফক্সকন,	
sumoo,	সুমো,	সুমো,	
niphelheim,	নিফালেম,	নিফেলহেইম,	
swajan,	স্বজন,	স্বজন,	
shkalarashhipa,	শ্কালারিধাপা,	স্কলারশিপ,	
bhupal,	ভূপাল,	ভূপাল,	
jerusalema,	জেরুসালেমা,	জেরুসালেম,	
shoreefer,	শরিফের,	শরিফের,	
jaanar,	জানার,	জানার,	
dera,	দেরা,	ডেরা,	
bhenasha,	ভেনাশা,	ভেনাস,	
fatakesto,	ফাযাটাকস্ট,	ফাটাকেষ্ট,	
harishankar,	হরিশনকার,	হরিশংকর,	
sharoker,	শারোকের,	স্মারকের,	
siqh,	সিখ,	শিখ,	
daaradaa,	দারাদা,	দারদা,	
aamoode,	আমোদোডে,	আমুদে,	
pillai,	পিল্লাই,	পিল্লাই,	
taronee,	তারোন,	তরণী,	
nanir,	নানির,	নানীর,	
pleeta,	প্লিটা,	প্লেট,	
sthitiko,	স্থিতিকো,	স্থিতিকো,	
sthaponagulor,	স্থাপানগুলোর,	স্থাপনাগুলোর,	
turkamena,	তুর্কামেনা,	তুর্কমেন,	
ishtone,	ইশ্টনে,	স্টোন,	
sangosrobomukto,	সংস্রবস্ক্ত্ত,	সংস্রবমুক্ত,	
beem,	বিম,	বিম,	
krimlin,	ক্রিম্লিন,	ক্রিমলিন,	
joki,	জোকি,	জকি,	
dorgah,	দোরগাহ,	দরগাহ,	
bulano,	বুলানো,	বুলান,	
chorchita,	চর্চিতা,	চর্চিত,	
janmat,	জানমাত,	জন্মাত,	
sithilotar,	সিথিলোতার,	শিথিলতার,	
akkaas,	আক্কাস,	আককাস,	
meshenjar,	মেশেনজজার,	মেসেঞ্জার,	
sures,	সুরেস,	সুরেশ,	
mukhomandaler,	মুখমান্ধলের,	মুখমণ্ডলের,	
ghotaibe,	ঘটাইবে,	ঘটাইবে,	
bisshaskey,	বিশশেশেই,	বিশ্বাসকে,	
kolkarkhana,	কলকরকখানা,	কলকারখানা,	
makhno,	মাখনো,	মাখনো,	
sharif,	শরিফ,	শরিফ,	
nothibhukteer,	নথিভুক্তির,	নথিভুক্তির,	
chire,	চিরে,	চিরে,	
shishu,	শিশু,	শিশু,	
prosadhani,	প্রসাধানী,	প্রসাধনী,	
sikkhagata,	সিক্ষাগতা,	শিক্ষাগত,	
digreeke,	ডিগ্রিকে,	ডিগ্রিকে,	
nottee,	নটি,	নোটটি,	
suraaropito,	সুরারোরিপিত,	সুরারোপিত,	
shomser,	শমসের,	সমশের,	
moorali,	মোরালালি,	মুরলী,	
champa,	চামপা,	চাঁপা,	
korijachilen,	করিজাছিলেন,	করিযাছিলেন,	
dhanijomite,	ধানিজমিতে,	ধানিজমিতে,	
kiuti,	কিটিটি,	কিউটি,	
foreks,	ফরেক্স,	ফরেক্স,	
jones,	জনেস,	জোন্স,	
gaandaas,	গণ্ডাস,	জ্ঞানদাস,	
arg,	আর্গ,	আর্গ,	
prachando,	প্রচান্ড,	প্রচণ্ড,	
blacq,	ব্ল্যাক্,	ব্ল্যাক,	
chhatrodiger,	ছাত্রদিগের,	ছাত্রদিগের,	
futote,	ফুটোটে,	ফুটোতে,	
madhukori,	মধুকরী,	মাধুকরী,	
gabhaaskar,	গাভাসকার,	গাভাস্কার,	
engrejer,	এঙ্গেরের,	ইংরেজের,	
jamanataswarup,	জমনাত্বর্প,	জামানতস্বরূপ,	
bokahoke,	বকাহকে,	বকাহকে,	
nirikhe,	নিরিখে,	নিরিখ,	
antarvuktimulak,	অন্তর্ভুলিতলক,	অন্তর্ভুক্তিমূলক,	
obhaarbhiu,	ওভারবূহী,	ওভারভিউ,	
choddo,	চদ্দ,	চোদ্দো,	
firozaa,	ফিরোজাও,	ফিরোজা,	
meghachchanno,	মেঘাচাচ্ন,	মেঘাচ্ছন্ন,	
safiin,	সাফিইন,	সাফিন,	
gajetted,	গ্জেজেট,	গেজেটেড,	
mail,	মাইল,	মাইল,	
armashtram,	আর্মস্ত্রস্,	আর্মস্ট্রং,	
norfolk,	নরফলক,	নরফোক,	
ramnathbabur,	রামনাথবুবুর,	রামনাথবাবুর,	
byabosthar,	ব্যবস্থার,	ব্যবস্থার,	
temonbhabe,	তেমোভাবে,	তেমনভাবে,	
tolemyr,	টলেমির,	টলেমির,	
batistambhatike,	বাতিস্তভামিতেকে,	বাতিস্তম্ভটিকে,	
toki,	তোকি,	তকি,	
purohitra,	পুরহিত্র,	পুরোহিতরা,	
basaake,	বাসাকে,	বাসাকে,	
kaathhaamaandu,	কাঠামন্দুদু,	কাঠমান্ডু,	
bamon,	বামন,	বামন,	
abhidhaner,	অভিধানের,	অভিধানের,	
atmira,	আত্মিরা,	আত্মীরা,	
forma,	ফোর্মা,	ফর্মা,	
siddhantoo,	সিদ্ধান্ত,	সিদ্ধান্তও,	
kinsa,	কিনসা,	কিংস,	
bidghootey,	বিদঘুটে,	বিদঘুটে,	
lagchhe,	লাগচে,	লাগছে,	
paner,	পানের,	পানের,	
sontoshpur,	সন্তশপুর,	সন্তোষপুর,	
monjooshree,	মঞ্জশূর্ি,	মঞ্জুশ্রী,	
ashociatesh,	অশোকিশেশ,	এসোসিয়েটস,	
pracharanamulak,	প্রচরণণামূলক,	প্রচারণামূলক,	
distance,	ডিস্টেন্স,	ডিসট্যান্স,	
drissotir,	দৃস্তটির,	দৃশ্যটির,	
bisheshshyer,	বিশেশ্যের,	বিশেষ্যের,	
breel,	ব্রিল,	ব্রিল,	
uporitaley,	উপরিটেলে,	উপরিতলে,	
moomtaj,	মুমতাজ,	মুমতাজ,	
karam,	কারাম,	কেরাম,	
protisthar,	প্রতিষ্ঠার,	প্রতিষ্ঠার,	
middleton,	মিডডলেন,	মিডলটন,	
yathaarthabhaabe,	যাথর্থাাবে,	যথার্থভাবে,	
naneer,	নানীর,	নানীর,	
naazee,	নাজি,	নাত্সি,	
duple,	ডুপল,	ডুপ্লে,	
zommu,	জম্ু,	জম্মু,	
talaal,	তালাল,	তালাল,	
bitertrate,	বিতের্রাতে,	বাইটারট্রেট,	
robot,	রোবত,	রোবোট,	
amarjito,	আমর্জিত,	অমার্জিত,	
provur,	প্রভুর,	প্রভুর,	
khudhartara,	খ্ষুধারতারা,	ক্ষুধার্তরা,	
manatmulak,	মননতুলমলক,	মানতমূলক,	
keyboarder,	কেওয়বর্ডের,	কীবোর্ডের,	
guzon,	গুজন,	গুজব,	
utkhaat,	উৎখাট,	উত্খাত,	
stona,	স্তোনা,	স্টোন,	
akatwa,	আকত্বা,	একাত্ব,	
vobani,	ভবানী,	ভবানী,	
prothakey,	প্রথাকেই,	প্রথাকে,	
mandope,	মান্ডপে,	মন্ডপে,	
bhittiti,	ভিত্তি,	ভিত্তিটি,	
kramp,	ক্রাম্প,	ক্র্যাম্প,	
niutrino,	নিউটৃনিও,	নিউট্রিনো,	
kharavel,	খারাভেল,	খারবেল,	
suparharo,	সুপারাহারও,	সুপারহিরো,	
vesselli,	ভেসেললি,	ভেসেলি,	
direectoratee,	ডিরেকটরিটিটা,	ডিরেক্টরেট,	
hosney,	হোসে,	হোসনে,	
cheess,	চিস,	চেস,	
bishshasho,	বিশ্বাসো,	বিশ্বাসও,	
ajij,	আজিজ,	আজিজ,	
heteler,	হেটেলের,	হেটেলের,	
navaratri,	নভরত্রী,	নবরাত্রি,	
directorete,	ডিরেকটরিতে,	ডিরেক্টরেট,	
nirgoon,	নিরগুন,	নির্গুণ,	
poddhotiteyi,	পদ্ধতিতেই,	পদ্ধতিতেই,	
rinobodh,	ঋণবোধ,	ঋণবোধ,	
kormoke,	কর্মকে,	কর্মকে,	
dojo,	দোজো,	ডোজো,	
danata,	দানাতা,	ডোনাট,	
kalirkhal,	কালিরখাল,	কালিরখাল,	
susamo,	সুসামো,	সুসম,	
spredsheet,	স্প্রেডশিট,	স্প্রেডশীট,	
houzgulite,	হুজগুলিতে,	হাউজগুলিতে,	
ruby,	রুবি,	রুবী,	
byabostho,	ব্যবস্থ,	ব্যাবস্থা,	
maudelgulo,	মৌডেলগুলো,	মডেলগুলো,	
spredshiit,	স্প্রেডশিট,	স্প্রেডশীট,	
creshcent,	ক্রেশেন্ট,	ক্রিসেন্ট,	
hevy,	হেভ,	হেভি,	
wagadada,	ওয়াডাা,	বাগদাদ,	
dhanche,	ধাঁচে,	ধাঁচে,	
proteemar,	প্রতিমার,	প্রতিমার,	
vaider,	ভাই়ের,	ভাইদের,	
mirina,	মিরিনা,	মিরিনা,	
bsnleu,	বিএনইসইই,	বিএসএনএলইইউ,	
makong,	মাকং,	মেকং,	
ronangane,	রোনাঙ্গানে,	রণাঙ্গনে,	
ganjana,	গঞ্জনা,	গঞ্জনা,	
shangsthaner,	শংস্থান্তের,	সংস্থানের,	
iling,	ইলিং,	ইলিং,	
towraat,	তোরাত,	তওরাত,	
ajijer,	আজিজের,	আজিজের,	
qara,	কারা,	কর,	
obhijojan,	অভিজোজান,	অভিযোজন,	
janoganonar,	জানোগননার,	জনগণনার,	
jounotar,	যৌনতার,	যৌনতার,	
lajik,	লাজিক,	লজিক,	
mardud,	মারদুদ,	মরদুদ,	
parikha,	পারিখা,	পরিখার,	
bairey,	বাইরে,	বাইরে,	
nimnosakkharkari,	নিম্নকাস্খারী,	নিম্নস্বাক্ষরকারী,	
shudhui,	শুধুই,	শুধুই,	
ap,	আপি,	আপ,	
sanstha,	সাস্থা,	সংস্থা,	
ganokantha,	গণকান্থ,	গণকণ্ঠ,	
dadar,	দাদার,	দাদার,	
landing,	ল্যান্ডিং,	ল্যান্ডিং,	
yuroo,	যুরোও,	ইউরো,	
dolphiny,	দলফিন্নি,	ডলফিনি,	
bhalobaas,	ভালোবাস,	ভালোবাসা,	
ghatleo,	ঘাটলও,	ঘটলেও,	
madhuree,	মাধুরি,	মাধুরী,	
difinishian,	ডিফিনিশন,	ডেফিনেশন,	
taims,	তাইমস,	টাইমস্,	
rakhtokkharone,	রক্তকর্ষণেও,	রক্তক্ষরণে,	
otyacharito,	অত্যাচারিত,	অত্যাচারিত,	
duuma,	দুউমা,	দুমা,	
sarsa,	সারসা,	সোর্স,	
rakhete,	রাখেতে,	রাখেতে,	
bosantake,	বোসানকে,	বসন্তকে,	
sombhobonaao,	সম্ভবনাও,	সম্ভবনাও,	
samratra,	সম্রত্র,	সম্রাটরা,	
rudroke,	রুদ্রকে,	রুদ্রকে,	
batikromee,	বাতিক্রম,	ব্যতিক্রমী,	
oichchheek,	ঐচচিক,	ঐচ্ছিক,	
megacaldera,	মেগাকাল্ডরা,	মেগাক্যাল্ডেরা,	
marpit,	মারপিট,	মারপিট,	
songbadmadhyame,	সংবাদ্ধামে,	সংবাদমাধ্যমে,	
refleks,	রিফলেক্স,	রিফ্লেক্স,	
sumeeta,	সুমিতা,	সুমিতা,	
tiuning,	টিউনিং,	টিউনিং,	
chirontan,	চিরোটান,	চিরন্তন,	
nehle,	নেহলে,	নেহলে,	
katbe,	কাতবে,	কাটবে,	
sokkhomotabriddhi,	সক্ষমমবিধিদ্রধী,	সক্ষমতাবৃদ্ধি,	
hoteltee,	হোটেলটি,	হোটেলটি,	
gondhe,	গোন্ধে,	গন্ধে,	
kayed,	কায়েড,	কায়েদ,	
konroop,	কনরোপ,	কোনরূপ,	
saurce,	সার্স,	সোর্স,	
croak,	ক্রোক,	ক্রোক,	
udbhaboney,	উদ্ভাবনে,	উদ্ভাবনে,	
chakradhare,	চকরাধারে,	চক্রধরে,	
carloos,	কার্লাস,	কার্লোস,	
hupile,	হুপিলে,	হুপিলে,	
adarsho,	আদারশো,	আর্দশ,	
ultrasonography,	উল্টরাস্গ্রাফি,	আলট্রাসনোগ্রাফিও,	
bardhitansh,	বার্ধিতান্,	বর্ধিতাংশ,	
poschimey,	পশিচিমে,	পশ্চিমে,	
bhotomulyoke,	ভোটমূল্যে,	ভোটমূল্যকে,	
jhamala,	ঝামালা,	ঝামালা,	
bossoben,	বসসবেন,	বসবেন,	
fostar,	ফোস্টার,	ফস্টার,	
deefinision,	ডিফিনেশন,	ডেফিনেশন,	
durotamo,	দূরতামো,	দূরতম,	
sulfatee,	সুলফাটি,	সালফেট,	
rajdhani,	রাজধানী,	রাজধানি,	
soheensotar,	সোহিসন্তার,	সহিংসতার,	
sobaiderke,	সোবাইদেরকে,	সবাইদেরকে,	
jibonnogor,	জীবনগ্র,	জীবননগর,	
jonoikaa,	জনৈকা,	জনৈকা,	
dipke,	দিপকে,	দ্বীপকে,	
jalbe,	জলবে,	জ্বলবে,	
proshtotto,	প্রশ্টত্ত,	প্রস্ত্তত,	
poddhotitei,	পদ্ধতিতেই,	পদ্ধতিতেই,	
rajan,	রাজান,	রাজন,	
eshiyetika,	এশিতেকিকা,	এশিয়াটিক,	
nomo,	নোমো,	নমো,	
angkita,	অংকিতা,	অঙ্কিতা,	
hisaber,	হিসাবের,	হিসাবের,	
porjotoker,	পর্যকতের,	পর্যটকের,	
aalaa,	আলা,	আলা,	
purushika,	পুরুষকিকা,	পুরুষিকা,	
satarkakari,	সতরকররী,	সতর্ককারী,	
hooq,	হুক,	হুক,	
militarir,	মিলিতারীর,	মিলিটারির,	
pushtee,	পুষ্টি,	পুষ্টি,	
antarctica,	অ্যান্টার্টিকা,	অ্যান্টার্কটিকার,	
hosbaleke,	হোসবালে,	হোসবালেকে,	
brittakarey,	বৃত্তকারে,	বৃত্তাকারে,	
sealvi,	সিয়ালভি,	সিলভি,	
salphat,	সালফাট,	সালফেট,	
sayatana,	সায়ানাতা,	শয়তান,	
shaddhi,	শাদ্ধী,	সাধ্বী,	
masjidsaha,	মাসিজসহ,	মসজিদসহ,	
omkar,	ওমকার,	ওঙ্কার,	
kinto,	কিন্তো,	কিনত,	
sqalastiqa,	স্কালাস্টিকা,	স্কলাস্টিক,	
ponjikar,	পঞ্জিকার,	পঞ্জিকার,	
shhikara,	শিকারা,	শিকার,	
uthaney,	উঠানে,	উঠানে,	
prarthonakokkher,	প্রার্থনকাখের,	প্রার্থনাকক্ষের,	
brixfield,	ব্রিকফল্ডি,	ব্রিক্সফিল্ড,	
aborto,	অবর্ত,	আবর্ত,	
khuliechilam,	খুলিইছিলাম,	খুলিয়েছিলাম,	
hozot,	হজজ,	হজত,	
licenshe,	লিকেন্সে,	লাইসেন্স,	
nathivookteer,	নাথিভক্তির,	নথিভুক্তির,	
choudhursoho,	চৌধুরসহ,	চৌধুরসহ,	
manush,	মানুশ,	মানুষ,	
mokhmoley,	মখমোলে,	মখমলে,	
ciima,	সিমা,	সীমা,	
armstronz,	আর্মস্ট্রজন,	আর্মস্ট্রং,	
leaders,	লিডার্স,	লিডার্স,	
nick,	নিক্,	নিক্,	
shem,	শেম,	সেম,	
panchbar,	পাঁচবার,	পাঁচবার,	
lopjonito,	লপপনিত,	লোপজনিত,	
vitti,	ভিত্তি,	ভিত্তিই,	
calabe,	কালাবে,	চালাবে,	
orthoneeti,	অর্থনিতি,	অর্থনীতির,	
sheekar,	শিকার,	শিকার,	
phonekari,	ফোনেকারী,	ফোনকারী,	
shniper,	শ্নিনের,	স্নাইপার,	
manab,	মানাব,	মানব,	
abdi,	আব্ি,	অব্দি,	
yatharthabhabe,	যাথর্তাবে,	যথার্থভাবে,	
hajirhat,	হাজিরহাট,	হাজিরহাট,	
jwar,	জ্রার,	জ্বর,	
alaol,	আলাওল,	আলাওল,	
dhamshrenite,	ধামশেন্ত্রীতে,	ধামশ্রেণীতে,	
bosante,	বসান্তে,	বসন্তে,	
kobulennechha,	কবুলেন্ছে,	কবুলেন্নেছা,	
urey,	উরে,	ইউরি,	
roopmatro,	রূপমত্র,	রূপমাত্র,	
digri,	ডিগরি,	ডিগ্রি,	
kani,	কানি,	কানি,	
turkyder,	টার্ক্ডির,	তুর্কিদের,	
bihar,	বিহার,	বিহার,	
mithener,	মিথেনের,	মিথেনের,	
beshyasdone,	বেশ্যাস্দনে,	বেশ্যাসদনে,	
mette,	মেটে,	ম্যাট,	
bakhyateet,	বাখ্যাত,	ব্যাখ্যাতীত,	
juktorastrer,	যুক্তসার্তের,	যুক্তরাষ্ট্রের,	
onshogrohoner,	অনশগ্রহণের,	অংশগ্রহনের,	
jaandrel,	যাঁডের,	জাঁদরেল,	
sylvi,	সিলভি,	সিলভি,	
diznee,	দিজনি,	ডিজনী,	
taffsherer,	তাফশারের,	তাফসীরের,	
lakkhero,	লাক্ষেরও,	লক্ষেরও,	
songasthatir,	সো্ন্সাতিির,	সংস্থাটির,	
thaanobhi,	থানোভী,	থানভী,	
kkomandar,	ক্মোনার্ডর,	কমাণ্ডার,	
poderthobid,	পদের্থবিবোধ,	পদার্থবিদ,	
baibosthar,	বৈবস্থার,	ব্যবস্থার,	
thakeni,	থাকেনি,	থাকেনি,	
spashtotai,	স্পাষ্টোটাই,	স্পষ্টতই,	
shringgo,	শ্রিং্গো,	শৃঙ্গ,	
dharmadasbabu,	ধর্মাদবাবু,	ধর্মদাসবাবু,	
schilling,	স্কিলং,	শিলিং,	
shiropar,	শিরোপার,	শিরোপার,	
grambasheeo,	গ্রামবাশী,	গ্রামবাসীও,	
goodamjato,	গুদাদমতা,	গুদামজাত,	
basakey,	বাসাকে,	বাসাকে,	
chalake,	চালাকে,	চালকে,	
khalidkay,	খালিদকায়,	খালিদকে,	
shudden,	শাদ্দেন,	সাডেন,	
abhidhaanic,	অভিধাইনিক,	অভিধানিক,	
hoteltite,	হোটেলটিতে,	হোটেলটিতে,	
saras,	সারাস,	সরস,	
salmaner,	সালমানের,	সালমানের,	
lutharan,	লুথারা,	লুথেরান,	
palashir,	পালাশীর,	পলাশীর,	
ovidhaner,	অভিধানের,	অভিধানের,	
zibonnogor,	জীবনন্গর,	জীবননগর,	
medilek,	মেডিলেক,	মেডিলেক,	
kalakushalir,	কলকলশললীর,	কলাকুশলীর,	
fising,	ফিসিং,	ফিসিং,	
karadando,	কারাদন্ড,	কারাদণ্ড,	
sahojlovyotar,	সহজজ্লবততার,	সহজলভ্যতার,	
avetar,	আভেটার,	অবতার,	
tirmijii,	তির্মীজি,	তিরমিজি,	
ghoomato,	ঘুমাতো,	ঘুমাতো,	
aatto,	এত্ট,	আত্ম,	
bipti,	বিপিতি,	বিপ্তি,	
bipajjanak,	বিপাজানক,	বিপজ্জনক,	
kadam,	কাদাম,	কদম,	
samajik,	সমাজিক,	সামাজিক,	
nagorikra,	নাগরিকরা,	নাগরিকেরা,	
nabatarange,	নবতরঙ্গে,	নবতরঙ্গে,	
poscime,	পোস্িমে,	পশ্চিমে,	
kuthibarike,	কুথিবারীকে,	কুঠিবাড়ীকে,	
gobeshokgon,	গবেশকগণ,	গবেষকগণ,	
jotinkey,	জোটিনকে,	যতীনকে,	
spreedashita,	স্পিরিদশিত,	স্প্রেডশীট,	
disposes,	ডিসপোস,	ডিসপোজেস,	
soketgulor,	সকেটগুলোর,	সকেটগুলোর,	
sahittekder,	সাহিত্দেকের,	সাহিত্যেকদের,	
asthishondhi,	অশ্থিসন্ধ,	অস্থিসন্ধি,	
teliha,	তেলিহা,	তেলিহা,	
ashamarthita,	অশামর্থীত,	অসমর্থিত,	
moshzidtike,	মোশজিদ্তিকে,	মসজিদটিকে,	
motke,	মোটকে,	মতকে,	
opohoron,	অপহরণ,	অপহরন,	
choopi,	চৌপি,	চুপি,	
francine,	ফ্রানসিনিন,	ফ্রান্সিন,	
elakaatite,	এলাকেতি,	এলাকাটিকে,	
saalsa,	সালসা,	সালসা,	
chhooteer,	ছুটির,	ছুটির,	
talgach,	তালগাছ,	তালগাছ,	
qlauda,	ক্লুড়া,	ক্লাউড,	
bhromonkaale,	ভ্রমণকালে,	ভ্রমণকালে,	
kadapaker,	কাড়াকাপের,	কড়াপাকের,	
mumtaz,	মুমতাজ,	মুমতাজ,	
perri,	পের্ি,	পেরি,	
pleto,	প্লেটো,	প্লেটো,	
onker,	অঙ্কের,	ওঙ্কার,	
youth,	যৌথ,	ইয়ুথ,	
brittakare,	বৃত্যাকের,	বৃত্তাকারে,	
mastarsa,	মাস্তার্সা,	মাস্টার্স,	
thandabhabe,	থান্দাবাবে,	ঠাণ্ডাভাবে,	
rushod,	রুশদ,	রুশদ,	
harees,	হারিস,	হ্যারিস,	
breq,	ব্রেক,	ব্রেক,	
fand,	ফ্যান্ড,	ফান্ড,	
nirvaha,	নির্ভা,	নির্বাহ,	
gobeshana,	গোবেশানা,	গবেষনা,	
bagicha,	বাগিছা,	বাগিচা,	
ancholgoolote,	আ্যানকোলগে,	অঞ্চলগুলোতে,	
shumo,	শুমো,	সুমো,	
konruup,	কোনরুপ,	কোনরূপ,	
addata,	আদ্দতা,	আড্ডাটা,	
pingna,	পিং্না,	পিংনা,	
landin,	ল্যান্ডিন,	ল্যান্ডিং,	
hilser,	হিলসের,	হিলসের,	
laga,	লাগা,	লগ,	
chapchap,	চাচপাপ,	চাপচাপ,	
arashie,	আরাশি,	আরসিএ,	
coons,	কুনস,	কুনস,	
ganoporibahon,	গণপরাবীবহণ,	গণপরিবহন,	
mitroder,	মিত্রদের,	মিত্রদের,	
pakistanira,	পাকিস্তারিরা,	পাকিস্তানীরা,	
nutunotto,	নুতুনতত্ত,	নতুনত্ব,	
arshie,	আর্ি,	আরসিএ,	
khitkar,	ক্ষিটার,	ক্ষিতকর,	
laesens,	লেয়েস,	লাইসেন্স,	
ashok,	আশোক,	আশোক,	
pujit,	পুজিত,	পুজিত,	
akheli,	আখেলি,	আখেলী,	
cinematographar,	সিনেমট্যগ্রাফ,	সিনেমাটোগ্রাফার,	
sobrakomer,	সব্রাকমের,	সবরকমের,	
jathartho,	যথার্থ,	যথার্থ,	
sangkalanti,	সংকলান্তি,	সংকলনটি,	
ayumi,	আয়ুমী,	আয়ুমি,	
chalochchitraeeo,	চালচ্চিত্রীও,	চলচ্চিত্রেও,	
provritike,	প্রভ্রিতিকে,	প্রভৃতিকে,	
ekhate,	এখাতে,	একহাতে,	
pachak,	পাচাক,	পাচক,	
sthapanagulo,	স্থাপাপানগুলো,	স্থাপনাগুলো,	
indrakanan,	ইন্দ্রকান,	ইন্দ্রকানন,	
kuhelika,	কুহেলিকা,	কুহেলিকা,	
mochlekha,	মোলকেলা,	মোছলেখা,	
bamni,	বামনি,	বামনী,	
shite,	শিতে,	শীতে,	
bejiye,	বেজিয়ে,	বেজিয়ে,	
jipiusamriddha,	জিপিউসমধ্ধ,	জিপিউসমৃদ্ধ,	
laesensh,	লেশেনশ,	লাইসেন্স,	
uddhritir,	উদ্ধৃতির,	উদ্ধৃতির,	
nagorikra,	নাগরিকরা,	নাগরিকরা,	
quata,	কুয়াতা,	কোটা,	
bagdad,	বাগদড,	বাগদাদে,	
madhoboir,	মাধববর,	মাধবীর,	
dormitory,	ডরিমরিটির,	ডরমিটরি,	
bosben,	বসবেন,	বসবেন,	
dagmukta,	দাগকুক্ত,	দাগমুক্ত,	
bouddher,	বৌদ্ধের,	বৌদ্ধের,	
sakshatkarer,	সাকশাকতের,	সাক্ষাৎকারের,	
install,	ইনস্টাল,	ইন্সটল,	
juktorashtreo,	যুক্তশার্তেরও,	যুক্তরাষ্ট্রেও,	
dighol,	দিঘল,	দীঘল,	
pichte,	পিচে,	পিছতে,	
khappar,	খাপপার,	খপ্পর,	
geejeeteeda,	জিজেতিদা,	গেজেটেড,	
aasirbaad,	আসিরবাদ,	আশির্বাদ,	
institutione,	ইনস্টিশেনে,	ইনস্টিটিউশনে,	
mataram,	মাতারাম,	মাতরম,	
vobobibhuti,	ভববিভূতি,	ভববিভূতি,	
vortuki,	ভর্টুকি,	ভর্তুকি,	
barrageke,	বাররাগেকে,	ব্যারেজকে,	
debdebier,	দেবদেবীর,	দেবদেবীর,	
samajikatar,	সমাজিকাতার,	সামাজিকতার,	
chalachchitro,	চলচচ্তির,	চলচ্চিত্র,	
tasminer,	তাসমিনের,	তাসমিনের,	
ghomtaa,	ঘোম্টা,	ঘোমটা,	
iraner,	ইরারের,	ইরানের,	
foloshrutite,	ফলশুরটিতে,	ফলশ্রুতিতে,	
iksaprishana,	ইক্সপ্রীণা,	এক্সপ্রেশন,	
nirbahey,	নির্বাহে,	নির্বাহে,	
tigmanshu,	তিগমানসু,	তিগ্মাংশু,	
kanasarabheeshana,	কানাসারিবাষণা,	কনসারভেশন,	
parshwer,	পার্বের,	পার্শ্বের,	
bikretara,	বিক্রেটারা,	বিক্রেতারা,	
nodiiteyi,	নদীইতেই,	নদীতেই,	
taroni,	তারোনি,	তরণী,	
abhidhanick,	অভিধাধিনিক,	অভিধানিক,	
shoodhooi,	শৌধোই,	শুধুই,	
aakaabaar,	আকাবার,	আকাবার,	
milea,	মিলিয়া,	মাইলে,	
byomkes,	ব্যমকেস,	ব্যোমকেশ,	
nilkuthir,	নীলকুঠির,	নীলকুঠির,	
townshhip,	তব্বিপীপ,	টাউনশিপ,	
panthar,	পাঁঠার,	পন্থার,	
shasyadi,	শাস্যাদী,	শস্যাদি,	
times,	টিমেস,	টাইমস্,	
orthobochorke,	অর্থববর্চকে,	অর্থবছরকে,	
jerusaleme,	জেরুসালেমে,	জেরুসালেমে,	
kaalaam,	কালাম,	কালাম,	
poriskoron,	পরিস্করণ,	পরিষ্করণ,	
bisnukey,	বিসনুকেই,	বিষ্ণুকে,	
purbanchaler,	পূর্বচানকালের,	পূর্বাঞ্চলের,	
muktilav,	মুক্তিলাভ,	মুক্তিলাভ,	
bishaashke,	বিশাশকে,	বিশ্বাসকে,	
rohasyati,	রোহাস্যাতি,	রহস্যটি,	
songrahak,	সোংরাখা,	সংগ্রাহক,	
bajpa,	বাজপা,	বাজপা,	
nothivukto,	নথিভুক্ত,	নথিভুক্ত,	
vishnuu,	ভিশ্নৌ,	বিষ্ণু,	
muktijuddhojato,	মুক্তিযুদ্ধাত,	মুক্তিযুদ্ধজাত,	
tarkale,	তার্কলে,	তারকালে,	
songkoloney,	সংকলনে,	সংকলনে,	
gotirodh,	গতিরোধ,	গতিরোধ,	
balatkar,	বালাতকার,	বলাৎকার,	
sarboporee,	সর্বপরী,	সর্বোপরী,	
hari,	হারি,	হরি,	
probondhobhittik,	প্রবন্ধভিত্তিক,	প্রবন্ধভিত্তিক,	
agomoney,	আগোমেনি,	আগমনে,	
samyuktha,	সম্যুক্থ,	সামিউক্তা,	
oncholshomuh,	অন্চলমূষ,	অঞ্চলসমূহ,	
nathivookto,	নাথিভূক্ত,	নথিভুক্ত,	
bhenise,	ভেনিসে,	ভেনিসে,	
uponeeshod,	উপনিদোশ,	উপনিষদ,	
toroonraa,	তোরোনারা,	তরুণরা,	
pharn,	ফার্ন,	ফার্ন,	
cholocchitrer,	চলচচ্ছিত্রের,	চলচ্চিত্রের,	
dakshinangsho,	দাকশনিংশ,	দক্ষিণাংশ,	
roy,	রোয়,	রায়,	
ghumachhe,	ঘুমাছে,	ঘুমাচ্ছে,	
drishyogulotey,	দৃষ্যগুলোতে,	দৃশ্যগুলোতে,	
protishta,	প্রতিষ্টা,	প্রতিষ্টা,	
akai,	আকাই,	একাই,	
black,	ব্ল্যাক,	ব্ল্যাক,	
modhyekar,	মধ্যেকার,	মধ্যেকার,	
nabyata,	নব্যতা,	নাব্যতা,	
jorury,	জরুর্ি,	জরূরী,	
attacharito,	অত্তাচারিত,	অত্যাচারিত,	
debate,	দেবাতে,	ডিবেট,	
dormroome,	ডর্রমূ,	ডর্মরুমে,	
naitikatavodh,	নৈইতিকাতোধ,	নৈতিকতাবোধ,	
daayitto,	দায়িতত,	দায়িত্ব,	
ooipokar,	ওওপকার,	উইপোকার,	
kushakhali,	কুশাখালী,	কুশাখালি,	
kalenga,	কালেঙ্গা,	কালেঙ্গা,	
seshardhe,	সেশারধে,	শেষার্ধে,	
santaa,	সান্তা,	সান্তা,	
kanuner,	কানুনের,	কানুনের,	
bhenicer,	ভেনিসের,	ভেনিসের,	
boudhher,	বৌধের,	বৌদ্ধের,	
horipur,	হরিপুর,	হরিপুর,	
dharmee,	ধারমম,	ধর্মী,	
daakten,	ডাকতেন,	ডাকতেন,	
dakkhinkare,	দক্ষিণকারে,	দক্ষিণকরে,	
aansaareer,	আনসারির,	আনসারীর,	
mahafezkhanar,	মহাফেজনকার,	মহাফেজখানার,	
aholya,	আহোল্য,	অহল্যা,	
pnouchute,	প্যুচুতে,	পৌঁছুতে,	
gujab,	গুজাব,	গুজব,	
pacbar,	পাকবার,	পাঁচবার,	
fasi,	ফাসি,	ফাঁসী,	
horippur,	হরিপপুর,	হরিপুর,	
hijri,	হিজরি,	হিজরী,	
difinisian,	ডিফিনিসিয়ান,	ডেফিনেশন,	
manob,	মানব,	মানব,	
heawy,	হেয়ে,	হেভি,	
dobhaar,	দোভার,	ডোভার,	
tigmanshu,	তিগমানসু,	তিগমংশু,	
sahozlabhbhatar,	সহজ্জলতালভার,	সহজলভ্যতার,	
shikare,	শিকারে,	শিকারে,	
chhedon,	ছেদোন,	ছেদন,	
bbiswash,	বিশ্বাশ,	বিশ্বাস,	
recondishon,	রেকন্দশশন,	রিকন্ডিশন,	
parikhar,	পারিখার,	পরিখার,	
mulyayonsapekkhe,	মুল্যয়া্থেক্ষে,	মূল্যায়নসাপেক্ষে,	
anisa,	আনিসা,	আনিস,	
debeting,	ডেবেটিং,	ডিবেটিং,	
gajano,	গাজানো,	গজানো,	
madeling,	ম্যাডেলিং,	মডেলিং,	
sumita,	সুমিতা,	সুমিতা,	
krusher,	ক্রুশের,	ক্রুশের,	
byabosthar,	ব্যবস্থার,	ব্যাবস্থার,	
satarkabhabey,	সতরকাাবে,	সতর্কভাবে,	
srisri,	শ্রিসরি,	শ্রীশ্রী,	
beatleser,	বেটেলসের,	বিটলসের,	
keyu,	কেয়ু,	কেউ,	
bishshaasho,	বিশ্বাশো,	বিশ্বাসও,	
prosadhoni,	প্রসাধনি,	প্রসাধনী,	
jakso,	জাকসো,	যক্ষ,	
chaaktir,	চাক্টির,	চাকতির,	
furio,	ফুরিও,	ফুরিও,	
mah,	মাহ,	মাহে,	
monchosthol,	মন্চস্থল,	মঞ্চস্থল,	
dianes,	ডায়ানেস,	ডিএনএস,	
relance,	রেলান্স,	রিলায়েন্স,	
teentir,	টেন্টির,	তিনটির,	
chalaabi,	চালাবি,	চালাবে,	
bashoborty,	বাশবর্তি,	বশবর্তী,	
chalochchitreei,	চালচ্ছ্রিরি,	চলচ্চিত্রেই,	
mirakela,	মিরাকেলা,	মিরাকেল,	
porirshoder,	পরির্শদের,	পরির্ষদের,	
supreetira,	সুপ্রীতারী,	সুপ্রীতিরা,	
rca,	আরসিএ,	আরসিএ,	
lutheerana,	লুথিরানা,	লুথেরান,	
bhogiroth,	ভগিরোথ,	ভগীরথ,	
aarik,	আরিক,	আরিক,	
nirvachaker,	নির্ভাকের,	নির্বাচকের,	
footbalarer,	ফুটটলবালের,	ফুটবলারের,	
seoul,	সেওওল,	সোল,	
rohosyoti,	রহস্যতি,	রহস্যটি,	
maailey,	মাইলে,	মাইলে,	
edipass,	এডিডিপস,	ইডিপাস,	
homsher,	হোম্ের,	হোমসের,	
chetanagoto,	চেতানাগোত,	চেতনাগত,	
tuni,	তিউনি,	টুনি,	
dewaben,	দেওয়াবেন,	দেওয়াবেন,	
syfy,	সিফি,	সাইফাই,	
infarmatian,	ইনফার্টিমিয়ান,	ইনফরমেশন,	
chirkoot,	চিরকুট,	চিরকুট,	
jerushalema,	জেরুশলমে,	জেরুসালেম,	
modelgulo,	মোডেলগুলো,	মডেলগুলো,	
noitik,	নৈটিক,	নৈতিক,	
providere,	প্রভিদেরে,	প্রভাইডারে,	
mandondo,	মান্ডন্ড,	মানদণ্ড,	
bonsho,	বন্ষ,	বংশ,	
ixprission,	আক্সপ্রিশন,	এক্সপ্রেশন,	
horiddar,	হোরিদ্দার,	হরিদ্বার,	
postar,	পোস্টার,	পোস্টের,	
sarollo,	সারোল্লো,	সারল্য,	
kaande,	কান্ডে,	কাণ্ডে,	
fol,	ফোল,	ফল,	
kamla,	কামলা,	কামলা,	
umb,	উমএববি,	ইউএমবি,	
shamuker,	শামুকের,	শামুকের,	
shucharita,	শুচারিতা,	সুচরিতা,	
ssahocorze,	স্বাসকর্জে,	সাহচর্যে,	
ajuhath,	আজুথা,	অজুহাত,	
gatibege,	গাতিবেগে,	গতিবেগে,	
azijer,	আজিজের,	আজিজের,	
sahozlabhbhotar,	সহজজলোল্তার,	সহজলভ্যতার,	
cheerontan,	চিরোটান,	চিরন্তন,	
veniser,	ভেনিসের,	ভেনিসের,	
phiksim,	ফিকসিম,	ফিক্সিং,	
mmadhukkori,	ম্যামধুক্রী,	মাধুকরী,	
chongar,	চোঙগার,	চোঙ্গার,	
prokolpogulor,	প্রকলগোগুলোর,	প্রকল্পগুলোর,	
grambaashio,	গ্রামবাশীও,	গ্রামবাসীও,	
poripakey,	পরিপাকে,	পরিপাকে,	
sangasthagulo,	সংস্থাগুলো,	সংস্থাগুলো,	
rilayensa,	রিলাইয়ান্স,	রিলায়েন্স,	
bboponer,	ব্বপনের,	বপনের,	
mukharji,	মুখরাঝি,	মুখার্জী,	
goora,	গৌরা,	গোর,	
qirq,	কির্ক,	কার্ক,	
mugdal,	মুগদাল,	মুগডাল,	
dhauto,	ধৌতঃ,	ধৌত,	
simons,	সিমনস,	সিমন্স,	
annorup,	অ্যান্নপূপ,	অন্যরূপ,	
encidablu,	এন্সিডিবাল,	এনসিডাব্লু,	
vittiteo,	ভিত্তিতেও,	ভিত্তিতেও,	
pachattar,	পাচাত্র,	পাচাত্তার,	
jini,	জিনি,	যিনি,	
remacri,	রেমাক্রি,	রেমাক্রী,	
magar,	মাগার,	মাগার,	
argead,	আর্জেড,	আর্জিদ,	
sepha,	সেফা,	শেফ,	
akram,	আক্রাম,	আকরাম,	
foolkopi,	ফুলকপু,	ফুলকপি,	
antorvuktimulak,	অন্তর্ভুক্তলভূলক,	অন্তর্ভুক্তিমূলক,	
chorban,	চোরবান,	চর্বন,	
prasadhoner,	প্রাসাধনের,	প্রসাধনের,	
greep,	গ্রিপ,	গ্রিপ,	
bohoodin,	বহহিদিন,	বহুদিন,	
nationalser,	নাটিনালসের,	ন্যাশনালসের,	
brake,	ব্র্যে,	ব্রেক,	
rasunkunchi,	রসুনকুন্ছি,	রসুনকুঁচি,	
militaryr,	মিলিটার্,	মিলিটারির,	
elaakaa,	এলাকা,	এলাকা,	
upobasee,	উপবাসা,	উপবাসী,	
phund,	ফান্ড,	ফান্ড,	
baarnis,	বার্িস,	বার্নিশ,	
sanghatakder,	সংঘঠাাদের,	সংঘটকদের,	
mimgulor,	মিমগুলোর,	মিমগুলোর,	
chintakarma,	চিন্তাকর্ম,	চিন্তাকর্ম,	
kottar,	কোত্টার,	কট্টর,	
touraat,	তৌরাত,	তওরাত,	
skirt,	স্ক্রিট,	স্কার্ট,	
poorohitder,	পুরহহত্ের,	পুরোহিতদের,	
niemond,	নিইমন্ড,	নিমন্ড,	
uddhritto,	উদ্ধৃত্ত,	উদ্ধৃত,	
deputy,	ডিপিটি,	ডেপুটি,	
nariderke,	নারীদেরকে,	নারীদেরকে,	
bage,	বাগে,	বাগে,	
aviyojan,	অভিয়জজান,	অভিযোজন,	
digrir,	ডিগর,	ডিগ্রির,	
tenishe,	তেনিশে,	টেনিসে,	
slatgulor,	স্ল্যগুলোর,	স্ল্যাটগুলোর,	
bhaandar,	ভান্দার,	ভাণ্ডার,	
aalkatraa,	আলককত্র,	আলকাতরা,	
graambasi,	গ্রামবাসি,	গ্রামবাসী,	
grambaashi,	গ্রামবাশী,	গ্রামবাসী,	
krishibigyani,	কৃষিব্যজনী,	কৃষিবিজ্ঞানী,	
arasie,	আরাসি,	আরসিএ,	
with,	উইথ,	ভিত,	
ujobekeestaner,	উজবেকস্তানের,	উজবেকিস্তানের,	
kantajir,	কান্তাজির,	কান্তজির,	
naagaalyand,	নাগলায়ন্দ,	নাগাল্যান্ড,	
aajeej,	আজেজ,	আজিজ,	
everestey,	এভারেস্টে,	এভারেস্টে,	
homshke,	হোমশকে,	হোমসকে,	
jahara,	জহারা,	যাহরা,	
ipl,	আইপি,	আইপিএল,	
chopal,	চোপাল,	চপল,	
dolu,	দলু,	ডলু,	
auttacharer,	অট্টাচারের,	অত্যাচারের,	
logotype,	লগোটি,	লোগোটাইপ,	
fulkapi,	ফুলকাপী,	ফুলকপি,	
shikshakbrinda,	শিকশাবকৃন্দ্,	শিক্ষকবৃন্দ,	
tikto,	টিক্ত,	তিক্ত,	
lagto,	লাগতো,	লাগতো,	
kutubuddinke,	কুতুবুদ্দিনকে,	কুতুবুদ্দিনকে,	
jhijhi,	ঝিঝি,	ঝিঝি,	
ranangone,	রানাঙ্গো,	রণাঙ্গনে,	
yucalyptus,	যুকাল্িস,	ইউক্যালিপ্টাস,	
kayartara,	কায়ারটার,	কোয়ার্টার,	
mosharroph,	মোশাররোপ,	মশাররফ,	
tyap,	টাযাপ,	ট্যাপ,	
baganoto,	বাগানত,	বাগানত,	
jeelyaand,	জীল্য়ান্দ,	জিল্যান্ড,	
gotihin,	গতিহীন,	গতিহীন,	
alpo,	আলপো,	অল্প,	
bhabaaponno,	ভাবাপন্ন,	ভাবাপন্ন,	
prity,	প্রিতি,	প্রিটি,	
kkhur,	ক্রুর,	ক্ষুর,	
sarjur,	সার্জুর,	সরযূর,	
shringey,	শ্রিঙ্গে,	শৃঙ্গে,	
purohitder,	পুরহহিতদের,	পুরোহিতদের,	
bhumija,	ভূমিজা,	ভূমিজ,	
unchuporjayer,	উন্চুপ্রযের,	উঁচুপর্যায়ের,	
ruptan,	রূপ্তান,	রূপটান,	
quota,	কুওটা,	কোটা,	
rodney,	রোডে,	রেডনি,	
danakana,	দানাকানা,	ডানকান,	
bohudin,	বহুদিন,	বহুদিন,	
dhyana,	ধ্যানা,	ধ্যান,	
bhebechili,	ভেবেছিলি,	ভেবেছিলি,	
ohalyar,	ওহায়ার,	অহল্যার,	
delibhara,	দেলিভারা,	ডেলিভার,	
doobate,	দুবাতে,	ডুবাতে,	
bonbhumi,	বন্ভুমি,	বনভূমি,	
mohajote,	মহাজতে,	মহাজোট,	
monchostho,	মঞ্চস্থ,	মঞ্চস্থ,	
chyeta,	চ্যেটা,	চ্যাট,	
sadeep,	সাদিপ,	সদীপ,	
lendl,	লেন্ড,	লেন্ডল,	
siima,	সিমামা,	সীমা,	
bhittimul,	ভিত্তিমূল,	ভিত্তিমূল,	
protinito,	প্রতিনিত,	প্রতিনিত,	
lakshmir,	লক্ষর্মীর,	লক্ষ্মীর,	
upobaashee,	উপবাশা,	উপবাসী,	
soleel,	সলিল,	সলিল,	
sachetonvabe,	সাচেটনভাবে,	সচেতনভাবে,	
hames,	হামেস,	হোমস,	
enginiiring,	এন্গিন্রিং,	ইঞ্জিনিয়ারিং,	
besirbhaagi,	বেশিরভাগী,	বেশিরভাগই,	
meropenemer,	মেরোপেনেমের,	মেরোপেনেমের,	
grahoksebai,	গ্রহক্ষসাই,	গ্রাহকসেবায়,	
bishwasho,	বিশ্বাসো,	বিশ্বাসও,	
heavy,	হেভি,	হেভি,	
deool,	ডেওয়াল,	দেউল,	
somonnitobhabe,	সমন্তিভাবে,	সমন্বিতভাবে,	
chemjong,	চেমগং,	চেমজং,	
ghenshei,	ঘেনশেই,	ঘেঁষেই,	
plato,	প্লাট,	প্লেটো,	
kidambi,	কিদামবি,	কিদম্বি,	
bharatey,	ভারাতে,	ভারতে,	
chaanoo,	চানাও,	চানু,	
pyore,	প্যারে,	পিওর,	
saabyastha,	সব্যস্থ,	সাব্যস্থ,	
mach,	মাচ,	মাছ,	
vobanipur,	ভবনীপুর,	ভবানীপুর,	
satarkabhabe,	সতরকরভাবে,	সতর্কভাবে,	
inziniyarsa,	ইন্জিনার্স,	ইঞ্জিনিয়ার্স,	
bondi,	বন্ডি,	বন্দী,	
stonehenje,	স্তোনেন্জে,	স্টোনহেঞ্জ,	
badargaji,	বাদরগাজী,	বদরগাজী,	
durtomo,	দূর্তমো,	দূরতম,	
matt,	মায়ট,	ম্যাট,	
patigoniter,	পাতিগোগেতের,	পাটিগণিতের,	
kathghera,	কাঠঘেরা,	কাঠঘেরা,	
lat,	লাট,	লাট,	
raagei,	রাগেই,	রাগেই,	
jommu,	জম্ু,	জম্মু,	
ceramicsh,	সেরামিক্স,	সিরামিকস,	
dakteekiter,	দাক্তিকের,	ডাকটিকিটের,	
video,	ভিদেও,	ভিডিয়োও,	
bhowanipur,	ভোবানীপুর,	ভবানীপুর,	
ved,	ভেড,	বেদ,	
chowdhuryke,	চৌধির্কে,	চৌধুরীকে,	
amar,	আমার,	আমর,	
jonee,	জনি,	জনি,	
cena,	সেনা,	সিনা,	
bishnoo,	বিশ্নো,	বিষ্ণু,	
gyandaas,	জ্ঞান্ডস,	জ্ঞানদাস,	
karpeter,	কার্পেতের,	কার্পেটের,	
gafeeloti,	গাফিলতি,	গাফিলতি,	
toroonra,	তররণারা,	তরুণরা,	
groundta,	গ্রেন্ডটা,	গ্রাউন্ডটা,	
goolen,	গুলেন,	গুলেন,	
dibi,	দিবি,	দিবি,	
umedpoor,	উমেডপুপর,	উমেদপুর,	
kaia,	কায়া,	কায়া,	
tuleche,	তুলেছে,	তুলেছে,	
chalachchitrei,	চলচচ্তিতেই,	চলচ্চিত্রেই,	
chet,	চেট,	চ্যাট,	
breakthrough,	ব্রেক্রাঘ,	ব্রেকথ্রু,	
licensedhari,	লিইসেন্সারিধারী,	লাইসেন্সধারী,	
chalachchitrotike,	চালাচ্তিতিতে,	চলচ্চিত্রটিকে,	
lyaataa,	ল্যাটাটা,	ল্যাটা,	
pyatarne,	প্যাতারন্যে,	প্যাটার্নে,	
thabai,	থাবাই,	থাবাই,	
thailand,	থাইলাঁড,	থাইল্যান্ড,	
shanno,	শান্ন,	সান্নো,	
bonke,	বনকে,	বনকে,	
prothati,	প্রথাটি,	প্রথাটি,	
ukeliptash,	উকেলিপ্িশ,	ইউক্যালিপ্টাস,	
phormat,	ফোরমাট,	ফরম্যাট,	
ernad,	এর্নাড,	এরনাড,	
bujhtepari,	বুঝেেপারী,	বুঝতেপারি,	
bhabatarini,	ভবতারানি,	ভবতারিণী,	
khelaphate,	খেলাফাতে,	খেলাফতে,	
labonaaktotaar,	লাবনক্তার,	লবণাক্ততার,	
acrolect,	এক্রেক্লেট,	অ্যাক্রোলেক্ট,	
machsoho,	মাচসহ,	মাছসহ,	
palestine,	পালেস্টিনে,	প্যালেস্টাইনে,	
shandra,	শান্দ্রা,	শান্দ্রার,	
suhasini,	সুহাসীনী,	সুহাসিনী,	
bike,	বিকে,	বাইক,	
elbamtite,	এলবামিতে,	এলবামটিতে,	
akten,	আক্তেন,	অকটেন,	
seniar,	সেনিয়ার,	সিনিয়র,	
transhapharma,	ট্রানশার্ম,	ট্রান্সফর্ম,	
bairer,	বাইরের,	বাইরের,	
abhirupbabuke,	অভিরপাবাবুকে,	অভিরূপবাবুকে,	
ghoshito,	ঘোষিত,	ঘোষিত,	
rahee,	রাহি,	রাহী,	
edaning,	এডানিং,	ইদানিং,	
rockibul,	রকিবুল,	রকিবুল,	
sift,	সিফট,	শিফট,	
torunosomriddho,	তরুণসম্দ্র,	তরুণসমৃদ্ধ,	
helloin,	হেলোলিন,	হ্যালোইন,	
taler,	তালের,	তালের,	
manober,	মানবের,	মানবের,	
sonaicha,	সোনাইছা,	সোনাইচা,	
asiatic,	অ্যাযিয়াটিক,	এশিয়াটিক,	
soource,	সার্ক,	সোর্স,	
whole,	ভলে,	হোল,	
ddheela,	ঢিলা,	ঢিলা,	
hugheke,	হুঘেকে,	হিউজকে,	
hadisti,	হাদিস্টি,	হাদিসটি,	
mythological,	মাইথোলিকালাল,	মাইথলজিকাল,	
prabhritite,	প্রাভ্রিতে,	প্রভৃতিতে,	
bhandar,	ভান্দার,	ভাণ্ডার,	
bolechile,	বলেছিলে,	বলেছিলে,	
venus,	ভেনুস,	ভেনাস,	
lendal,	লেন্ডল,	লেন্ডল,	
esasiyetasa,	এসেশেয়াসা,	এসোসিয়েটস,	
laiseensee,	লেইসেনস,	লাইসেন্স,	
nazad,	নাজাদ,	নাজাদ,	
bhenkates,	ভেনকাটেস,	ভেঙ্কটেশ,	
basturoi,	বাসতুরো,	বস্তুরই,	
maailkhanek,	মাইলখানেক,	মাইলখানেক,	
ramantic,	র্যামাটিক,	রোমান্টিক,	
timoothi,	তিমোথি,	টিমোথি,	
sukumaree,	সুকুমারী,	সুকুমারী,	
wedanta,	ওয়ানান্ত,	বেদান্ত,	
teemothi,	তীমোথি,	টিমোথি,	
toranganj,	তোরঙ্গ,	তোরাবগঞ্জ,	
songbadmadhyomer,	সংসবাধ্বমদের,	সংবাদমাধ্যমের,	
taunasipa,	তৌনাসিপা,	টাউনশিপ,	
milekhaanek,	মিলেখানেক,	মাইলখানেক,	
ahalyar,	আহাল্যার,	অহল্যার,	
deenesh,	দিনেশ,	দীনেশ,	
govindarajan,	গোবিন্দরাজান,	গোবিন্দরাজন,	
badhamuktovabe,	বাধামকতভাবে,	বাধামুক্তভাবে,	
kindom,	কিন্ডম,	কিংডম,	
swarther,	স্বার্থের,	স্বার্থের,	
eupheike,	ইউফেকে,	ইউফেইকে,	
ganohotyake,	গণহত্যাকে,	গণহত্যাকে,	
bharotchilo,	ভারোচিলো,	ভারতছিল,	
vins,	ভিনস,	ভিন্স,	
shrimoti,	শ্রীমতি,	শ্রীমতি,	
zoubankal,	যৌবালকাল,	যৌবনকাল,	
daap,	দাপ,	ড্যাপ,	
homeser,	হোমেসের,	হোমসের,	
bhimsenkei,	ভিমসেনকেই,	ভীমসেনকেই,	
vaticaner,	ভ্যাটিকাযানের,	ভ্যাটিকানের,	
teoyana,	তেওয়ানা,	তাইওয়ান,	
reflex,	রিফলেস,	রিফ্লেক্স,	
prokolpow,	প্রকলপপু,	প্রকল্পও,	
kalkarkhana,	কালকর্খানা,	কলকারখানা,	
saqara,	সাকারা,	সকার,	
airish,	এইরিশ,	আইরিস,	
biplabeer,	বিপলাবীর,	বিপ্লবীর,	
vangley,	ভ্যাংলে,	ভাঙলে,	
bade,	বাদে,	বাদে,	
kagbeni,	কাগবেনি,	কাগবেনি,	
pyor,	পায়ার,	পিওর,	
internship,	ইন্টারশশিপ,	ইন্টার্নশিপ,	
kogake,	কোগাকে,	কোগাকে,	
kirke,	কিরকে,	কিরকে,	
konflict,	কনফিল্টিক,	কনফ্লিক্ট,	
upbrazillian,	উপব্রজিলান,	আপব্রাজিলিয়ান,	
batikromshalee,	বাতিক্রসমললা,	ব্যতিক্রমধর্মী,	
teksuser,	তেকসুসের,	টেক্সাসের,	
sikarer,	সিকারের,	শিকারের,	
deobonde,	দেওবন্ডে,	দেওবন্দে,	
spancer,	স্পেন্সার,	স্পেন্সার,	
mukhoshdharir,	মুখোশধার,	মুখোশধারীর,	
sarboshokteeman,	সর্বকতম্্তন,	সর্বশক্তিমান,	
kanshater,	কাঁশাতের,	কানসাটের,	
planey,	প্লানে,	প্লেনে,	
mumtaj,	মুমতাজ,	মুমতাজ,	
dinar,	দিনার,	ডিনার,	
chereche,	চেরেছে,	ছেড়েছে,	
said,	সাইড,	সাইদ,	
rakkhanvag,	রক্ষণ্গা,	রক্ষণভাগ,	
chopol,	চোপল,	চপল,	
indra,	ইন্দ্রা,	ইন্দ্র,	
kuresher,	কুরেশের,	কুরেশের,	
shomostigoto,	শমস্তগিত,	সমষ্টিগত,	
harris,	হারিস,	হ্যারিস,	
zerusalem,	জেরুসামেল,	জেরুজালেম,	
atarkitey,	আতারকিতে,	অতর্কিতে,	
gandhikey,	গণ্ধিকে,	গান্ধীকে,	
abdoone,	আব্দনে,	আবদুন,	
byaptikaler,	ব্যপতিকালের,	ব্যাপ্তিকালের,	
skolarsip,	স্কোল্রাইপ,	স্কলারশিপ,	
windows,	উইনডো,	উইন্ডোস,	
khanonkaj,	খানোঙ্কাজ,	খননকাজ,	
abikaul,	অবিকৌল,	অবিকল,	
dhormoprobortokder,	ধর্মপ্রবকদের,	ধর্মপ্রবর্তকদের,	
kachhakaachhi,	কাচাকাছি,	কাছাকাছি,	
dapadpi,	দাপাদ্পী,	দাপাদপি,	
abdan,	আবদান,	আব্দান,	
irana,	ইরানা,	ইরান,	
laps,	ল্যাপস,	ল্যাপস,	
torabganj,	তোরাবগঞ্জ,	তোরাবগঞ্জ,	
noditir,	নদিটির,	নদীটির,	
venisey,	ভেনিসে,	ভেনিসে,	
durgatsob,	দুর্গৎসব,	দুর্গোৎসব,	
tahalo,	তাহালো,	তাহলো,	
doula,	দৌলা,	দৌলা,	
satarkatar,	সতরকাতার,	সতর্কতার,	
tigre,	তিগ্রে,	টাইগার,	
ekspression,	একস্রেশন,	এক্সপ্রেশন,	
oncoleo,	অনকোলে,	অঞ্চলেও,	
mercial,	মার্সিয়াযাল,	মার্শিয়াল,	
edmiral,	এডিরালাল,	এডমিরাল,	
kurdider,	কুরদিদের,	কুর্দিদের,	
durarohini,	দুরারহীনী,	দুরারোহিণী,	
hazat,	হাজাত,	হজত,	
bouddho,	বৌদ্ধ,	বৌদ্ধ,	
aairish,	এইরিশ,	আইরিস,	
ghatiti,	ঘাতিটি,	ঘাঁটিটি,	
bayii,	বাইয়,	বাঈ,	
mathieu,	মাথিউ,	ম্যাথিউ,	
durbhagya,	দুর্ভাগ্য,	দূর্ভাগ্য,	
patengar,	পাতেঙ্গার,	পতেঙ্গার,	
kyatagorir,	ক্যাতাগোরীর,	ক্যাটাগরির,	
krisenta,	ক্রিসেন্টা,	ক্রিসেন্ট,	
moushumei,	মৌশুমেই,	মৌসুমেই,	
lidars,	লিডার্স,	লিডার্স,	
vandar,	ভান্দার,	ভাণ্ডার,	
totokson,	ততকসন,	ততক্ষন,	
macbeth,	ম্যাকবেথ,	ম্যাকবেথ,	
afzol,	আফজোল,	আফজল,	
ghotol,	ঘটল,	ঘটল,	
parisankhanvid,	পরিসাখানবিদ,	পরিসংখ্যানবিদ,	
licencer,	লিকেন্সের,	লাইসেন্সের,	
sommotitey,	সম্মতিতে,	সম্মতিতে,	
vaisoho,	ভাইসহ,	ভাইসহ,	
krush,	ক্রুশ,	ক্রুশ,	
kode,	কোডে,	কোড,	
tinhazar,	তিনহাজার,	তিনহাজার,	
biplobi,	বিপ্দবী,	বিপ্লবী,	
america,	আমেরিকা,	আমেরিকা,	
eenameela,	ইনামিলা,	এনামেল,	
title,	টিটলে,	টাইটেল,	
nischitobhave,	নিশ্চিতভাভে,	নিশ্চিতভাবে,	
naazi,	নাজি,	নাত্সি,	
romjaner,	রোমজানের,	রমযানের,	
itostatah,	ইতস্তাহ,	ইতস্ততঃ,	
salchak,	সালচাচ,	সালচাক,	
pathanirdeshona,	পাঠানীর্দেশা,	পথনির্দেশনা,	
chhooteete,	ছুটিতে,	ছুটিতে,	
gaj,	জাজ,	গেজ,	
prokolpotike,	প্রক্পতিকে,	প্রকল্পটিকে,	
siitei,	সিতেই,	শীতেই,	
babona,	বাবনা,	বাবনা,	
swastir,	স্বাস্টির,	স্বস্তির,	
plack,	প্লাক্,	প্ল্যাক,	
katui,	কাটুই,	কাতুই,	
deebug,	দীবুগ,	ডিবাগ,	
suparichito,	সুপারিচিত,	সুপরিচিত,	
husni,	হুসনি,	হুসনি,	
muhuriganj,	মুহুরিনগঞ্জ,	মুহুরীগঞ্জ,	
dhila,	ধীলা,	ঢিলা,	
lebina,	লেবিনা,	লেবিনা,	
rajbondir,	রাজবন্দীর,	রাজবন্দীর,	
argho,	আরঘো,	অর্ঘ্য,	
dinifitian,	ডিনিফিটিয়ান,	ডেফিনেশন,	
zarniz,	জার্নিজ,	জারনিজ,	
plator,	প্লাসাটোর,	প্লেটোর,	
sayanaida,	সায়ানীদা,	সায়ানাইড,	
nirapattamulok,	নিরাপত্তমূলক,	নিরাপত্তামূলক,	
bikargrosto,	বিকারগগ্রস্ত,	বিকারগ্রস্ত,	
yura,	যুরা,	ইউরো,	
bhyatikaner,	ভ্যাতিকানের,	ভ্যাটিকানের,	
jitpur,	জিতপুর,	জিতপুরের,	
grootha,	গ্রোথা,	গ্রোথ,	
gandagol,	গণ্ডগগল,	গন্ডগোল,	
dharmiyabhabei,	ধর্মিয়াবেই,	ধর্মীয়ভাবেই,	
beam,	বিম,	বিম,	
jokkher,	জোক্ষের,	যক্ষের,	
conflikt,	কনফলিক্ট,	কনফ্লিক্ট,	
accountdharira,	অ্যাক্উউন্টিরীরা,	একাউন্টধারীরা,	
nirikh,	নিরিখ,	নিরিখ,	
sainyader,	সৈন্যয়দের,	সৈন্যদের,	
pratisthanikvabe,	প্রতিষ্ঠানিভাবে,	প্রাতিষ্ঠানিকভাবে,	
jeshh,	জেশ,	জেস,	
rachonakal,	রচনাকল,	রচনাকাল,	
shamshernagar,	শামশেরগাগার,	শমশেরনগর,	
chai,	চাই,	ছাই,	
charban,	চরবান,	চর্বন,	
bojhe,	বোঝে,	বোঝে,	
sadadyarao,	সদদ্যদররও,	সদদ্যরাও,	
marketin,	মারকেনটিন,	মার্কেটিং,	
danaqana,	দানাকানা,	ডানকান,	
dokan,	ডোকান,	দোকান,	
nabatamo,	নবতামো,	নবতম,	
natshi,	নাটশী,	নাত্সি,	
nogore,	নগরে,	নগরে,	
adhunikkaley,	আধুনিক্ললে,	আধুনিককালে,	
fud,	ফুড,	ফুড,	
jhonkar,	ঝোঁকার,	ঝঙ্কার,	
girilal,	গিরিলাল,	গিরিলাল,	
ishton,	ইশ্তন,	স্টোন,	
borendroke,	বরেন্দ্রকে,	বরেন্দ্রকে,	
nothivookta,	নথিভুক্তা,	নথিভুক্ত,	
shommotite,	শম্মতিতে,	সম্মতিতে,	
land,	ল্যান্ড,	ল্যান্ড,	
samaptir,	সমাপ্তির,	সমাপ্তির,	
kourabe,	কৌরাবে,	কৌরবে,	
scholastik,	স্কোলস্তিক,	স্কলাস্টিক,	
uter,	উতের,	উটের,	
trutimatra,	ট্রুটিমাত্র,	ত্রুটিমাত্র,	
sumitrar,	সুমিত্র,	সুমিত্রার,	
shector,	শেক্টর,	সেক্টর,	
khoor,	খুর,	ক্ষুর,	
cholchhee,	চলচি,	চলছে,	
barbadoj,	বারববোজ,	বার্বাডোজ,	
protiakromonei,	প্রতিকামরণেই,	প্রতিআক্রমণেই,	
kaaferder,	কাফের্ডের,	কাফেরদের,	
manoharpur,	মনোহারপপুর,	মনোহরপুর,	
shahoshikatar,	শহসিহিকতার,	সাহসিকতার,	
paolasthi,	পাওলাস্থি,	পাওলাসথি,	
blacker,	ব্লাসকের,	ব্ল্যাকের,	
kalki,	কলকি,	কালকি,	
tapdei,	তাপদেই,	তাপড়েই,	
ghotleyo,	ঘটটলেও,	ঘটলেও,	
pack,	প্যাক্,	প্ল্যাক,	
vodqa,	ভোডকা,	ভদকা,	
monjurul,	মঞ্জুরুল,	মনজুরুল,	
rajtantro,	রাজতান্ত্র,	রাজতন্ত্র,	
lettar,	লেট্টার,	লেটার,	
sursur,	সুরসুর,	সুরসুর,	
attorkite,	আত্তকৃতে,	অতর্কিতে,	
pujito,	পুজিত,	পুজিত,	
yuro,	যুরো,	ইউরো,	
sabrakamer,	সব্রকামের,	সবরকমের,	
graambaashee,	গ্রামবাশ,	গ্রামবাসী,	
elakasoho,	এলাকাসহ,	এলাকাসহ,	
aakabar,	আকাবার,	আকাবার,	
manibhaijaner,	মানিভাজেনের,	মণিভাইজানের,	
bandhan,	বাঁধান,	বাঁধন,	
raiji,	রাইজি,	রাইজি,	
tarkareer,	তারকারীর,	তরকারীর,	
peerry,	পিররি,	পেরি,	
dephinishion,	দেফিনিশন,	ডেফিনেশন,	
rakhtokkharoner,	রক্ষত্যকরণের,	রক্তক্ষরণের,	
ghumunoi,	ঘুমুনোই,	ঘুমুনোই,	
abeganuvutir,	আবেগানুভিতির,	আবেগানুভূতির,	
ghoshanapatratio,	ঘোষাপন্ত্রীতাও,	ঘোষণাপত্রটিও,	
saraiki,	সারাইকি,	সরাইকি,	
dabarer,	দাবারের,	দাবারের,	
ganesh,	গানেশ,	গণেশ,	
sobche,	সোব,	সবচে,	
fiksing,	ফিকসং,	ফিক্সিং,	
dijmarescu,	দিজমার্সু,	দিজমার্সাকু,	
onchalti,	অঁচচলটি,	অঞ্চলটি,	
reliance,	রেলিয়ান্স,	রিলায়েন্স,	
udbhabaney,	উদ্ভাবানে,	উদ্ভাবনে,	
sportstar,	স্পোর্টস্টার,	স্পোর্টসস্টার,	
khalid,	খালিদ,	খালিদ,	
dosha,	দোশা,	দোসা,	
tukrote,	তুকরোতে,	টুকরোতে,	
ikboler,	ইকবলের,	ইকবলের,	
bibechyo,	বিবেচ্য,	বিবেচ্য,	
oporishodhito,	অপরিষিত,	অপরিশোধিত,	
protistha,	প্রতিস্থা,	প্রতিষ্টা,	
qor,	করর,	কর,	
rubidiyaam,	রুবিদিয়াম,	রুবিডিয়াম,	
murali,	মুরালি,	মুরলী,	
shikara,	শিকারা,	শিকার,	
elaaka,	এলাকা,	এলাকা,	
rotheen,	রোথিন,	রথীন,	
dheke,	ধেকে,	ঢেকে,	
logic,	লোগিক,	লজিক,	
shpredshiit,	স্প্রেশশিট,	স্প্রেডশীট,	
goshthiti,	গোষটি,	গোষ্ঠীটি,	
nakkal,	নককাল,	নক্কল,	
tecnokret,	টেক্নকেট,	টেকনোক্র্যাট,	
panchashjan,	পঞঞচশঞ্জান,	পঞ্চাশজন,	
kurdira,	কুরদিরা,	কুর্দিরা,	
panchashjon,	পঞঁচাসঞ্,	পঞ্চাশজন,	
eesa,	ইসএ,	আইএএস,	
ukeliptas,	উকেলিপ্যাপ্টাস,	ইউক্যালিপ্টাস,	
neemeette,	নীমেত্বে,	নিমিত্তে,	
matis,	মাতিস,	ম্যাটিস,	
paikgachha,	পাইগগাছা,	পাইকগাছা,	
echhti,	এছটি,	এছটি,	
bhikkharthe,	ভিক্ষার্তে,	ভিক্ষার্থে,	
caroline,	ক্যারোলিন,	ক্যরোলিন,	
sheetke,	শিতকে,	শীতকে,	
shasonamoleri,	শাসনামলেরই,	শাসনামলেরই,	
dokanei,	ডোকানেই,	দোকানেই,	
idipasha,	ইডিপাশা,	ইডিপাস,	
salapheeta,	সলাফিত,	সালফেট,	
dola,	দোলা,	দলা,	
gate,	গাতে,	গ্যেটে,	
ponero,	পনেরো,	পনের,	
siddhantoke,	সিদ্ধান্তকে,	সিদ্ধান্তকে,	
braqe,	ব্র্যাকে,	ব্রেক,	
grushko,	গ্রুষকো,	গ্রুশকো,	
female,	ফেমালে,	ফিমেল,	
associatis,	এসযাকিওটিটিস,	এসোসিয়েটস,	
sharthe,	শার্থে,	স্বার্থে,	
joubanbatee,	জৌবান্ত,	যৌবনবতী,	
shikhra,	শিখরা,	শিখরা,	
nirbachakder,	নির্বাক্চার,	নির্বাচকদের,	
obdee,	অবদ,	অব্দি,	
shhepha,	শেফা,	শেফ,	
olpo,	ওলপো,	অল্প,	
boiporiityen,	বৈপরিতেন,	বৈপরীত্যেন,	
armeeniyana,	আর্মিনিয়ানা,	আর্মেনিয়ান,	
ganosachetanata,	গণসচনন্চতা,	গণসচেতনতা,	
pravura,	প্রভূরা,	প্রভুরা,	
rajotta,	রাজতটা,	রাজত্ব,	
jamseder,	জামসেদের,	জামসেদের,	
probhura,	প্রভূরা,	প্রভুরা,	
sangbadmadhyome,	সংসবাব্ধ্যমে,	সংবাদমাধ্যমে,	
matthews,	ম্যাথেথাইস,	ম্যাথিউস,	
literacy,	লিটারেক্,	লিটারেসি,	
scholars,	স্কোলারস,	স্কলার্স,	
nyeta,	নিয়াতা,	ম্যাট,	
janagononar,	জানাগনার,	জনগণনার,	
palbongsher,	পালবংংসের,	পালবংশের,	
damodar,	দামোদার,	দামদর,	
liceensee,	লিকেন্সি,	লাইসেন্স,	
marry,	মারি,	ম্যারি,	
chaudhurider,	চৌধুদিরের,	চৌধুরীদের,	
browser,	ব্রাসসের,	ব্রাউজার,	
danab,	দানাব,	দানব,	
pachchi,	পাচছি,	পাচ্ছি,	
mane,	মানে,	মানে,	
falasrutite,	ফালাসুরিতে,	ফলশ্রুতিতে,	
premo,	প্রেমো,	প্রিমো,	
byepass,	ব্যাপাস,	বাইপাস,	
chhon,	ছন,	ছোঁ,	
akkharkey,	অক্ষকর্ষী,	অক্ষরকে,	
deep,	ডিপ,	দীপ,	
turbiner,	তুর্বিনের,	টারবাইনের,	
dokaangulotey,	দোকাঙ্গুলোতে,	দোকানগুলোতে,	
rayyaleti,	রেয়লেটি,	রয়্যালটি,	
jamkaalo,	জামকালো,	জমকালো,	
jacksonke,	জ্যাকসনককে,	জ্যাকসনকে,	
nothivukta,	নথিভুক্ত,	নথিভুক্ত,	
kaalki,	কালকি,	কালকি,	
patjata,	পাতজাতা,	পাটজাত,	
alkatra,	আলকাত্রা,	আলকাতরা,	
romancha,	রোমাচ্ছা,	রোমাঞ্চ,	
jomoker,	জমোকের,	জমকের,	
vabook,	ভাবক,	ভাবুক,	
chakundite,	চাকুন্দিতে,	চাকুন্দিতে,	
nobotom,	নবতম,	নবতম,	
ucchosito,	উচ্চিত,	উচ্ছসিত,	
seramiks,	সেরামিক্স,	সিরামিকস,	
bedantodhormo,	বেদান্ধর্ম্য,	বেদান্তধর্ম,	
nirmankaaj,	নির্মান্জা,	নির্মাণকাজ,	
doorotomo,	দূরতম,	দূরতম,	
osamanno,	ওসামন্ন,	অসামান্য,	
teoner,	টেওনের,	টিওনার,	
nodiitei,	নদীদেতেই,	নদীতেই,	
chilahatee,	চিলাহাট,	চিলাহাটি,	
siqhar,	সিখার,	শিকার,	
choudhurike,	চৌধুরিকে,	চৌধুরীকে,	
gazipur,	গজিপুর,	গাজিপুর,	
alexandar,	আলেক্সান্ডার,	আলেকজান্ডার,	
railliner,	রাইললের,	রেললাইনের,	
qulim,	কুলিম,	কুলিং,	
ayantarqatiqa,	আয়ন্তর্কতক,	অ্যান্টার্কটিকা,	
hastamathun,	হস্তমান,	হস্তমথুন,	
kormopontha,	কর্মপন্থ,	কর্মপন্থা,	
dabliudabliui,	দাবলেউদবাই,	ডাব্লিউডাব্লিউই,	
bisheshshyo,	বিশেশ্য,	বিশেষ্য,	
ruble,	রুবলে,	রুবল,	
maadla,	মাডলা,	মাদলা,	
oitijjha,	ঐতিজ্য,	ঐতিহ্য,	
safiha,	সাফিহা,	সাফিহা,	
muradpur,	মুরাদপুর,	মুরাদপুর,	
fevarite,	ফেভারিতে,	ফেভারিট,	
chalochchitro,	চালচচিত্র,	চলচ্চিত্র,	
chenza,	চেন্জা,	চেঞ্জ,	
shakara,	শাকারা,	সাকার,	
karmake,	কারমাকে,	কর্মকে,	
turkeyder,	তুর্কিদের,	তুর্কিদের,	
firoze,	ফিরোজে,	ফিরোজ,	
smarak,	স্মারাক,	স্মারক,	
uddhrita,	উদ্ধিতা,	উদ্ধৃত,	
neelkamal,	নীলকালাল,	নীলকমল,	
dipon,	দিপন,	দীপন,	
bane,	বানে,	বনে,	
ganonanatto,	গণনাতত্ত,	গণনাট্য,	
bone,	বোনে,	বনে,	
aaps,	এএপসএস,	এএপিএস,	
segular,	সেগুলার,	সেগুলোর,	
suraropito,	সুরারপিত,	সুরারোপিত,	
nariider,	নারীদের,	নারীদের,	
neemitte,	নীমিত্যে,	নিমিত্তে,	
shikh,	শিখ,	শিখ,	
engreziteo,	এঙ্গ্রেটিতেও,	ইংরেজিতেও,	
langhoner,	লাংঘণের,	লংঘনের,	
dibya,	দিব্য,	দিব্যা,	
prakalpagulor,	প্রকালগুলোর,	প্রকল্পগুলোর,	
vugorvey,	ভুগর্ভে,	ভূগর্ভে,	
shamshere,	শামশেরে,	শমসের,	
goteehin,	গতিহীন,	গতিহীন,	
ashamorthito,	অশামর্থিত,	অসমর্থিত,	
jor,	জর,	জ্বর,	
ganochien,	গ্যানোচিন,	গণচীন,	
lisense,	লিসেন্সে,	লাইসেন্স,	
osthisondhi,	অস্থিস্ধি,	অস্থিসন্ধি,	
songasthaner,	সংস্থাানের,	সংস্থানের,	
rajyabhogi,	রাজ্যাভোগী,	রাজ্যভোগী,	
sahittopritite,	সহিত্তপ্রীতে,	সাহিত্যপ্রীতিতে,	
bijito,	বিজিত,	বিজিত,	
gronthowo,	গ্রন্থৌ,	গ্রন্থও,	
mozdur,	মজ্দুর,	মজদুর,	
sthapanatir,	স্থাপানানির,	স্থাপনাটির,	
unchiyechilo,	উঁচিয়েছিলো,	উঁচিয়েছিল,	
johor,	জহর,	জহর,	
jatinkey,	জাতিনকে,	যতীনকে,	
shuchonakal,	শুচনাকাল,	সূচনাকাল,	
manir,	মানির,	মনির,	
soomitrar,	সূমিত্রার,	সুমিত্রার,	
tomader,	তোমাদের,	তোমাদের,	
lavta,	লাভতা,	লাভটা,	
backflipe,	ব্যাকপিলিপ,	ব্যাকফ্লিপে,	
graambaaseer,	গ্রাম্বাসীর,	গ্রামবাসীর,	
pratishthanik,	প্রতিষ্ঠিনক,	প্রাতিষ্ঠানিক,	
elakatir,	এলাকাটির,	এলাকাটির,	
shulfate,	শুলফাতে,	সালফেট,	
guzober,	গুজবের,	গুজবের,	
arthonitir,	আর্থনিতির,	অর্থনীতির,	
besirvagei,	বেসিরভাগেই,	বেশিরভাগেই,	
temonvabe,	টেমনভাবে,	তেমনভাবে,	
salafeta,	সলফেলাট,	সালফেট,	
hoondayi,	হুন্ডায়ি,	হুন্দাই,	
harysoner,	হারিসনের,	হ্যারিসনের,	
janghu,	জাংহু,	জঙ্ঘু,	
bisnuke,	বিসনুকে,	বিষ্ণুকে,	
odeb,	ওডেব,	ওদেব,	
flux,	ফ্লুকেস,	ফ্লাস্ক,	
drissoke,	দৃষ্সকে,	দৃশ্যকে,	
ramantika,	রামান্তিকা,	রোমান্টিক,	
ostheesandhi,	অস্থিসান্ধী,	অস্থিসন্ধি,	
pouchute,	পৌচুতে,	পৌঁছুতে,	
myathiou,	ম্যাথু,	ম্যাথিউ,	
deputee,	দেপিউট,	ডেপুটি,	
bangladesh,	বাংলাদেশ,	বঙ্গালাদেস,	
abheedhaaneek,	অভিধানাকে,	অভিধানিক,	
aakaabar,	আকাবার,	আকাবার,	
gazeetteed,	গ্যাজিত্ত,	গেজেটেড,	
bornanukrome,	বর্ণাকুর্মে,	বর্নানুক্রমে,	
gabhaskaar,	গাভাস্কার,	গাভাস্কার,	
restuarant,	রেস্টারান্ট,	রেষ্টুরেন্ট,	
mag,	মাগ,	এমএজি,	
gronthao,	গ্রনথাও,	গ্রন্থও,	
narishwar,	নরিশ্বর,	নারীশ্বরের,	
engrejra,	এঙ্গ্রেরা,	ইংরেজরা,	
saainyo,	সাইন্যো,	সৈন্য,	
jhimochchilo,	ঝিমোচ্ছিল,	ঝিমোচ্ছিলো,	
norpholk,	নরফফক,	নরফোক,	
station,	স্টেটিশন,	ষ্টেশন,	
serveray,	সার্ভারে,	সার্ভারে,	
freelancerra,	ফ্রিলানার্সার,	ফ্রিল্যান্সাররা,	
spredashiita,	স্প্রেডেপ্স্টা,	স্প্রেডশীট,	
palta,	পাল্তা,	পালটা,	
bhutbhut,	ভূতভূট,	ভুটভুট,	
gandogol,	গ্যানডোগল,	গন্ডগোল,	
sharansthal,	শরর্থস্তল,	শরণস্থল,	
ashonkai,	আশনকায়,	আশঙ্কাই,	
turbine,	তুরবিনে,	টারবাইন,	
gonona,	গণনা,	গননা,	
udyem,	উদ্যেম,	উদ্যেম,	
orbit,	অরবিত,	অরবিট,	
atwobishvashi,	আত্যবিবাশী,	আত্মবিশ্বাসী,	
ritesh,	রিটেশ,	রিতেশ,	
chhintayikari,	ছিন্তাইকারী,	ছিনতাইকারী,	
vorkendra,	ভরকেন্দ্র,	ভরকেন্দ্র,	
vagni,	ভাগনি,	ভগ্নী,	
bhabanipur,	ভবনীপুর,	ভবানীপুর,	
manushsoho,	মানুষসহ,	মানুষসহ,	
catholicder,	ক্যাথলিক্ডের,	ক্যাথলিকদের,	
inafarameshana,	ইনাফারামেশা,	ইনফরমেশন,	
armori,	আরমোরি,	আরমোরি,	
treebhuj,	ত্রিইভুজ,	ত্রিভূজ,	
jinsa,	জিনসা,	জিন্স,	
mononiitoder,	মননিনততের,	মনোনীতদের,	
byaboharkareer,	ব্যবহারকার,	ব্যবহারকারীর,	
rachanakal,	রচনাকাল,	রচনাকাল,	
shasonkarta,	শাসনকর্ত,	শাসনকর্তা,	
thanvi,	থাঁভি,	থানভী,	
dharabahiktite,	ধারাবাহিতে,	ধারাবাহিকটিতে,	
bosturoi,	বস্তুরোই,	বস্তুরই,	
markeetim,	মার্কিতিম,	মার্কেটিং,	
kushumba,	কুশুমবা,	কুশুম্বা,	
ghomta,	ঘোমতা,	ঘোমটা,	
oxfordey,	অক্সফর্ডে,	অক্সফোর্ডে,	
bhittow,	ভিত্তু,	ভিত্তিও,	
duryogamoyee,	দূর্যগাময়,	দুর্যোগময়ী,	
volapuk,	ভোলাপুক,	ভোলাপুক,	
poscater,	পোস্টাযার,	পশ্চাতের,	
nodimatrik,	নদিমত্রিক,	নদীমাতৃক,	
ancholsaha,	অঞ্চলস্চ,	অঞ্চলসহ,	
anusthane,	অনুষ্ঠানে,	অনুষ্ঠানে,	
protizogiita,	প্রতিযোগিতা,	প্রতিযোগীতা,	
bhiktara,	ভিক্তারা,	ভিক্টর,	
difinishion,	ডিফিনিশন,	ডেফিনেশন,	
chrystal,	চ্রিস্তাল,	ক্রাইস্টাল,	
dhadhiye,	ধাধিয়ে,	ধাধিয়ে,	
autopromotioner,	অটোপ্রোমিনের,	অটোপ্রমোশনের,	
ralf,	রালফ,	রালফ,	
lyandim,	ল্যান্ডিম,	ল্যান্ডিং,	
dembakreeti,	দেমবাকৃতি,	ডিম্বাকৃতি,	
otyacharer,	অত্যচারের,	অত্যাচারের,	
morathee,	মোরাথ,	মরাঠি,	
rashedul,	রাশেদুল,	রাশিদুল,	
yaq,	যাক,	ইয়াক,	
sedikei,	সেদিকেই,	সেদিকেই,	
carbus,	কারববাস,	কারবাস,	
taateo,	তাতেও,	তাতেও,	
hul,	হুল,	হুল,	
shekarmani,	শেকারমানী,	শেকরমানি,	
emarjensi,	এমারজেন্সী,	এমার্জেন্সি,	
prasadhani,	প্রসাধনী,	প্রসাধনী,	
hitokor,	হিতকর,	হিতকর,	
kamti,	কামতি,	কমতি,	
hepatitis,	হেপাটিস,	হেপাটাইটিস,	
judge,	যুডগে,	জাজ,	
jatinke,	জাতিনকে,	যতীনকে,	
progresh,	প্রগ্রেশ,	প্রগ্রেস,	
asociatis,	অ্যোসোিসিযাটিস,	এসোসিয়েটস,	
summer,	সুমমার,	সামার,	
juakhelar,	জুয়াখেলার,	জুয়াখেলার,	
ebham,	এভাম,	ইভিএম,	
parijaner,	পরিজানের,	পরিজনের,	
madhabike,	মধধাবিকে,	মাধবীকে,	
emargency,	এমারজেন্,	এমার্জেন্সি,	
chaloke,	চালোকে,	চালকে,	
karuna,	কারুনা,	করুণা,	
behrampurer,	বেহরমূপুরের,	বহরমপুরের,	
procharona,	প্রচারণা,	প্রচারণা,	
samashtike,	সমাশকিকে,	সমষ্টিকে,	
vetrillocuism,	ভেট্রিলিক্সিম,	ভেট্রিলোকুইজম,	
rajtantrey,	রাজতানেত্রে,	রাজতন্ত্রে,	
neemeetto,	নীমেতো,	নিমিত্ত,	
simantarkkhibahinir,	সীমান্ত্রবিখীনীর,	সীমান্তরক্ষীবাহিনীর,	
abhiyojan,	অভিজ্যান,	অভিযোজন,	
photanor,	ফটানোর,	ফোটানোর,	
transapharma,	ট্রানস্রর্ম,	ট্রান্সফর্ম,	
elaakati,	এলাকাটি,	এলাকাটি,	
palteche,	পাল্টেছে,	পাল্টেছে,	
cheenja,	চিন্জা,	চেঞ্জ,	
tawnship,	তাবশিপ,	টাউনশিপ,	
mitrer,	মিত্রের,	মিত্রের,	
turista,	তুরিস্তা,	টুরিস্ট,	
remakri,	রেমাক্রি,	রেমাক্রী,	
ekbakye,	একবাক্যে,	একবাক্যে,	
icelands,	আইকেল্যান্ডস,	আইসল্যান্ডসহ,	
angibhutovabe,	অঙ্গিভভভাবে,	অঙ্গীভূতভাবে,	
deefinishion,	দিফিনিশন,	ডেফিনেশন,	
arthanitike,	অর্থানিতিকে,	অর্থনীতিকে,	
hastantar,	হাস্তান্তার,	হস্তান্তর,	
bulichev,	বুলিভেব,	বুলিচেভ,	
munot,	মুনোট,	মুনোট,	
liseensee,	লিসিনস,	লাইসেন্স,	
mahakabi,	মহাকবাবী,	মহাকবি,	
nisader,	নিসাদের,	নিষাদের,	
podarthobidder,	পদারবববিদ্ধের,	পদার্থবিদদের,	
tinage,	তিনাগে,	টিনেজ,	
suparahiro,	সুপারাহীরও,	সুপারহিরো,	
bm,	বিএমএম,	বিএম,	
roktokhoron,	রক্তখন,	রক্তক্ষরণের,	
teemothy,	তেইমো,	টিমোথি,	
diniphition,	ডিনিফিশিন,	ডেফিনেশন,	
bojata,	বোজাতা,	বোজাটা,	
sikarder,	সিকারদের,	শিকারদের,	
shasankorta,	শাসাঙ্করটা,	শাসনকর্তা,	
rakim,	রাকিম,	রাকিম,	
abodamaner,	অবদামানের,	অবদমনের,	
bishwaashshoi,	বিশ্বাশ্ষই,	বিশ্বাসই,	
kartona,	কার্তনা,	করতনা,	
upobashii,	উপবাশীই,	উপবাসী,	
munshiji,	মুনশিজি,	মুনশীজি,	
ramolino,	র্যামোলিনো,	রামোলিনো,	
punorabortonte,	পুনরাবর্ণে,	পুনরাবর্তন্তে,	
graambasheeo,	গ্রামবাশীও,	গ্রামবাসীও,	
piulir,	পিউলির,	পিউলির,	
bii,	বিআই,	বি,	
byabaharkareer,	ব্যবহারকার,	ব্যবহারকারীর,	
pooshteer,	পুষ্টির,	পুষ্টির,	
pyaleshtainer,	প্যালেষ্টানের,	প্যালেস্টাইনের,	
uindoos,	উইন্ডস,	উইন্ডোস,	
silabhara,	সিলাভারা,	সিলভার,	
aflatoxin,	আফলোটোক্সিন,	আ্যফ্ল্যাটক্সিন,	
chakurijibirao,	চাকুরিজাবারও,	চাকুরীজীবীরাও,	
potka,	পটকা,	পটকা,	
aditisaha,	আদিতিসহ,	অদিতিসহ,	
ragee,	রাগি,	রাগী,	
siddharther,	সিদ্ধার্তের,	সিদ্ধার্থের,	
blyaka,	ব্ল্যাকা,	ব্ল্যাক,	
dacope,	ডাকপে,	দাকোপ,	
registaner,	রেজিস্তানের,	রেগিস্তানের,	
qarpeta,	কর্পেটা,	কার্পেট,	
shektore,	শেক্তরে,	সেক্টরে,	
asantosh,	অসন্তোশ,	অসন্তোষ,	
jani,	জানি,	জনি,	
antennal,	অ্যান্টেন্লাল,	অ্যান্টেনাল,	
kuronir,	কুরণীর,	কুরনীর,	
shalook,	শালুক,	শালুক,	
shlok,	শ্লো,	শ্লোক,	
bangalore,	বাঙ্গালরে,	ব্যাঙ্গালুরে,	
rananganey,	রণাঙ্গানেই,	রণাঙ্গনে,	
laishensh,	লাইশেন,	লাইসেন্স,	
hillse,	হিলসে,	হিলসে,	
sipa,	সিপা,	শিপ,	
jolaatonko,	জলাতনক্ক,	জলাতঙ্ক,	
ekroop,	একররপপ,	একরূপ,	
parkin,	পারকিন,	পার্কিং,	
akreetokarjo,	আক্রিতারক্য,	অকৃতকার্য,	
afrazuler,	আফরাজুলের,	আফরাজুলের,	
dokaanei,	ডোকানেই,	দোকানেই,	
bosonte,	বসন্তে,	বসন্তে,	
bodhirta,	বোধির্তা,	বধিরতা,	
bhageri,	ভাগেরি,	ভাগেরই,	
aieesha,	আইএএএসএ,	আইএএস,	
gardeen,	গার্দিন,	গার্ডেন,	
vaabnake,	ভাবনাকে,	ভাবনাকে,	
byabaharkarike,	ব্যবহরকারীকে,	ব্যবহারকারীকে,	
cholochchitrai,	চলচচ্ত্রী,	চলচ্চিত্রই,	
ekbakke,	একবাকে,	একবাক্যে,	
myari,	ম্রারিরি,	ম্যারি,	
foxer,	ফক্সার,	ফক্সের,	
mukhomandoler,	মুখমান্দলের,	মুখমণ্ডলের,	
dooburira,	দুবুরীরা,	ডুবুরিরা,	
kirti,	কিরতি,	কীর্তি,	
shringge,	শ্রিং,	শৃঙ্গে,	
dikpal,	ডিকপল,	দিকপাল,	
beshakbar,	বেশাকবার,	বেশকবার,	
taatey,	তাতে,	তাতে,	
bishwaashshke,	বিশ্বশককে,	বিশ্বাসকে,	
parqim,	পারকিম,	পার্কিং,	
dovaar,	দোভার,	ডোভার,	
saria,	সরিয়া,	সরিয়া,	
becha,	বেচা,	বেচা,	
amudey,	আমুদে,	আমুদে,	
shloker,	শ্লোকের,	শ্লোকের,	
gobeshonar,	গোবেশনার,	গবেষনার,	
seebiai,	সিবিয়াই,	সিবিআই,	
promodwara,	প্রমদ্বারা,	প্রমদ্বারা,	
daacktickete,	ডাযাক্টিকেট,	ডাকটিকিটে,	
nirbahi,	নির্বাহী,	নির্বাহি,	
wishnu,	উশ্নু,	বিষ্ণু,	
nathibhuktir,	নথিভুক্তির,	নথিভুক্তির,	
adhikartai,	আধিকার্তাই,	অধিকর্তাই,	
utsahamulak,	উৎসাহূলক,	উৎসাহমূলক,	
enamela,	এনামেলা,	এনামেল,	
daakticketer,	ড্যাক্টিকেটের,	ডাকটিকিটের,	
dharavassokar,	ধরভাসকার,	ধারাভাষ্যকার,	
ganochin,	গাঁচোছিন,	গণচীন,	
scuvi,	স্কুভভি,	স্কুভি,	
amiya,	আমিয়া,	অমিয়,	
cheerokoomari,	চিরোকারীরা,	চিরকুমারী,	
shardotsobei,	শার্দতসবেই,	শারদোৎসবেই,	
mumtazer,	মুমতাজের,	মুমতাজের,	
niketaner,	নিকেতানের,	নিকেতনের,	
asovya,	অসোভ্যা,	অসভ্য,	
plate,	প্লেটে,	প্লেট,	
jyesttha,	জ্যেস্থা,	জ্যেষ্ঠা,	
choritrotakeo,	চরিত্রকাতেও,	চরিত্রটাকেও,	
lungiti,	লুঙ্গিটি,	লুঙ্গিটি,	
booksar,	বুক্সার,	বুক্সার,	
konnoder,	কন্নদের,	কন্যদের,	
ceramicer,	সেরামিকের,	সিরামিকের,	
nirobota,	নিরবতা,	নিরবতা,	
byke,	বিকে,	বাইক,	
bharotiyotar,	ভারতিয়তার,	ভারতীয়তার,	
khanabale,	খানাবালে,	খানাবলে,	
nirbahe,	নির্বহে,	নির্বাহে,	
aporishodhito,	অপরিরিষিত,	অপরিশোধিত,	
ponchaashjon,	পঞ্চাঞ্শন,	পঞ্চাশজন,	
cloudbook,	ক্লাওবক,	ক্লাউডবুক,	
carlo,	কার্লো,	কার্লো,	
mousumeo,	মৌসুমেও,	মৌসুমেও,	
uzobekeestaan,	উজবেক্তাশন,	উজবেকিস্তান,	
khoka,	খোকা,	খোকা,	
phood,	ফুড,	ফুড,	
mozdoor,	মজদুর,	মজদুর,	
weelcomee,	উইলমোমি,	ওয়েলকাম,	
cholochchitratike,	চলচ্চতারিতাকে,	চলচ্চিত্রটিকে,	
hojurer,	হোুরের,	হজুরের,	
bojiye,	বোজিয়ে,	বজিয়ে,	
akmato,	আক্মাতো,	একমত,	
somoodrotote,	সমদ্রতে,	সমুদ্রতটে,	
pranidero,	প্রানিদেরও,	প্রানীদেরও,	
israelbahini,	ইস্রাবেনী,	ইস্রায়েলবাহিনী,	
gitikobita,	গিতিকিবতা,	গীতিকবিতা,	
uchchotara,	উচ্চতারা,	উচ্চতর,	
elakatikay,	এলাকাটিকায়,	এলাকাটিকে,	
onucheeder,	অনুচিদের,	অনুচ্ছেদের,	
subader,	সুবাদের,	সুবাদে,	
baibasthaar,	বৈবাস্তার,	ব্যবস্থার,	
unitgulo,	আনিতগুলো,	ইউনিটগুলো,	
majlishpur,	মজ্লিশপুর,	মজলিশপুর,	
ponchaasjon,	পঞ্চাঞ্শন,	পঞ্চাশজন,	
orhan,	ওরহান,	ওরহান,	
mawdeel,	মাউদিল,	মডেল,	
suhayeler,	সুহায়ালের,	সুহায়েলের,	
dwipke,	দিপিপে,	দ্বীপকে,	
juktarashtrasaha,	যুক্রাত্রস্ত,	যুক্তরাষ্ট্রসহ,	
mmehonoti,	ম্মেহোনটি,	মেহনতি,	
canflikt,	ক্যানফলিক্ট,	কনফ্লিক্ট,	
caramiks,	ক্যারামিক্স,	সিরামিকস,	
abhidhaaner,	অভিধানের,	অভিধানের,	
somraatder,	সোমরাতদদের,	সম্রাটদের,	
chhuti,	ছুটি,	ছুটি,	
gandhike,	গাণধিকে,	গান্ধীকে,	
poriikkhateo,	পরিক্ষেতাও,	পরীক্ষাতেও,	
sip,	সিপ,	শিপ,	
metropalitana,	মেত্রপোলিনানা,	মেট্রোপলিটন,	
jati,	জাতি,	যাতি,	
chikkingsasoho,	চিক্সংহাসহ,	চিকিংসাসহ,	
bipradas,	বিপ্রদাস,	বিপ্রদাস,	
ched,	চেড,	ছেদ,	
mausumeo,	মৌসুমেও,	মৌসুমেও,	
utpotti,	উৎপ্তটি,	উতপত্তি,	
shansthaner,	শানস্থানের,	সংস্থানের,	
pariyech,	পারিয়েছ,	পরিয়েছ,	
bisheshyo,	বিশেষ্য,	বিশেষ্য,	
dekaner,	ডেকানের,	দেকানের,	
angshogrohon,	অংশগ্রহণ,	অংশগ্রহন,	
shrabasti,	শ্রবাস্তি,	শ্রাবস্তী,	
chintamani,	চিন্তমানি,	চিন্তামনি,	
miraqela,	মিরাকেলা,	মিরাকেল,	
angsogrohone,	অ্যাংস্যগ্রনে,	অংশগ্রহনের,	
prapokkey,	প্রাপকে,	প্রাপককে,	
ekekrokom,	একেক্রম,	একেকরকম,	
olympic,	অলিমপিক,	অলিম্পিক,	
bhagno,	ভাগননও,	ভগ্ন,	
jakatke,	জাকাতকে,	যাকাতকে,	
prachirer,	প্রাচিরের,	প্রাচিরের,	
poribahokotto,	পরিবাহক্ত,	পরিবাহকত্ব,	
shatokeo,	শাতোকেও,	শতকেও,	
ponera,	পোনেরা,	পনের,	
nirbaahe,	নির্বাহে,	নির্বাহে,	
sorsa,	সোরসা,	সোর্স,	
boner,	বনের,	বনের,	
russad,	রুস্াদ,	রুশদ,	
teenisa,	তিনিসা,	টেনিস,	
ogovir,	ওগভির,	অগভীর,	
alpakichudin,	আল্পাচিপিদিন,	অল্পকিছুদিন,	
nopdnodir,	নপ্দোনির,	নদনদীর,	
karadandey,	করদান্দেই,	কারাদণ্ডে,	
bbiseshyer,	ব্শিশেযের,	বিশেষ্যের,	
saralya,	সরল্য,	সারল্য,	
khudrokar,	ক্ষুদ্রকার,	ক্ষুদ্রকার,	
baet,	বেইত,	বাইট,	
apolokbhabe,	অপললকাবে,	অপলকভাবে,	
anyorup,	অন্রুূপ,	অন্যরূপ,	
zesa,	জেসা,	জেস,	
horeepur,	হরিপুর,	হরিপুর,	
flirt,	ফ্লিস্টার,	ফ্লার্ট,	
anutpadanshil,	অনুত্দন্শীলী,	অনুৎপাদনশীল,	
siddhantei,	সিদ্ধান্তেই,	সিদ্ধান্তেই,	
besur,	বেসুর,	বেসুর,	
nabayug,	নবায়ুগ,	নবযুগ,	
bandhano,	বা্ধানও,	বাঁধানো,	
daaun,	দাউন,	ডাউন,	
ujobekeestan,	উজবেক্তান,	উজবেকিস্তান,	
mekapgulo,	মেকাপগুলো,	মেকআপগুলো,	
elakatike,	এলাকাটিকে,	এলাকাটিকে,	
roopdaan,	রূপডান,	রুপদান,	
samoshtigato,	সমস্তিগত,	সমষ্টিগত,	
daraider,	দারাইদের,	দরাইদের,	
nirmolota,	নির্মলতা,	নির্মলতা,	
chiraharit,	চিরহরিত,	চিরহরিৎ,	
swasthohinotay,	স্বাস্থ্িতিয়া,	স্বাস্থ্যহীনতায়,	
uporzon,	উপর্জন,	উপার্জন,	
satarkokari,	সতরকরকারী,	সতর্ককারী,	
prrajanankaal,	প্রজানকাল,	প্রজননকাল,	
janamukhi,	জানমুখু,	জনমুখী,	
chomski,	চম্সককি,	চমস্কি,	
omarader,	ওমারাদের,	ওমারাদের,	
myat,	ম্যাট,	ম্যাট,	
bhardwaj,	ভর্দবাজ,	ভরদ্বাজ,	
stagecraft,	স্টেক্যাফ্রাক্ট,	স্টেজক্রাফট,	
domonmulok,	দমনমূলক,	দমনমূলক,	
bhenom,	ভেনোম,	ভেনম,	
samley,	স্যালমে,	সামলে,	
baibosthaar,	বৈবস্থার,	ব্যবস্থার,	
byapoktor,	ব্যাপক্তর,	ব্যাপকতর,	
ekatto,	একাত্ত,	একাত্ব,	
rajshri,	রাজশ্রী,	রাজশ্রী,	
shashtra,	শাস্ত্র,	শাস্ত্র,	
chikitsar,	চিকিতসার,	চিকিত্সার,	
pradoshik,	প্রাদোশিক,	প্রাদশিক,	
turkii,	তুর্কী,	তুর্কি,	
chadake,	চাড়াকে,	চড়াকে,	
marathi,	মারাথি,	মরাঠি,	
shukrabab,	শুকরাবাব,	শুক্রবাব,	
banshite,	বা্শিতে,	বাঁশিতে,	
saranor,	সারানোর,	সরানোর,	
dala,	দালা,	দলা,	
geja,	জেজা,	গেজ,	
ovidhanik,	অভিধানিক,	অভিধানিক,	
ashirbadatri,	অশির্ব্রদাত্রী,	আশীর্বাদাত্রী,	
oiteejye,	ঐতিযে,	ঐতিহ্যে,	
sbajan,	স্বজান,	স্বজন,	
bulan,	বুলান,	বুলান,	
moddhyoshtho,	মধ্ধ্যস্থ,	মধ্যস্থ,	
arifin,	আরিফিন,	আরিফিন,	
taranee,	তারানি,	তরণী,	
collaborators,	কল্লাবোর্ট,	কলাবরেটরস,	
sahab,	সাহাব,	সাহাব,	
mukhomandal,	মুখমান্দল,	মুখমণ্ডল,	
deepan,	দীপান,	দীপন,	
camerapersoner,	ক্যামেরাপাসনের,	ক্যামেরাপার্সনের,	
augustine,	অগুস্টিনে,	অগাস্টিন,	
sahinsatar,	সহিনসতার,	সহিংসতার,	
epiela,	এপিয়ালা,	আইপিএল,	
bayshorkarikarone,	বাশকরকারণী,	বেসরকারিকরণ,	
bachhaikrito,	বাছাইকৃত,	বাছাইকৃত,	
machhti,	মাছতি,	মাছটি,	
konorup,	কোনোরূপ,	কোনরূপ,	
shikshakbrindo,	শিক্শাকৃৃন্দ্ত,	শিক্ষকবৃন্দ,	
eshtonia,	এস্টোনিয়া,	এস্তোনিয়া,	
durgotshob,	দুর্গতব,	দুর্গোৎসব,	
lesense,	লেসেনস,	লাইসেন্স,	
nichupattir,	নিচুপত্তির,	নিচুপট্টির,	
veemsen,	ভিমসেন,	ভীমসেন,	
jyesthaa,	জেষ্ঠা,	জ্যেষ্ঠা,	
bo,	বোআর,	বু,	
chhutir,	ছুটির,	ছুটির,	
paramartha,	পরমর্থা,	পরমার্থ,	
firozapure,	ফিরোজুপের,	ফিরোজাপুরে,	
cheef,	চিফ,	শেফ,	
shatoke,	শাতোকে,	শতকে,	
temone,	তেমোনে,	তেমনই,	
maunchostho,	মাঁচোষ্ঠ,	মঞ্চস্থ,	
osomorthito,	অসমর্থিত,	অসমর্থিত,	
somosto,	সমস্ত,	সমস্ত,	
pustir,	পুস্টির,	পুষ্টির,	
haridware,	হরিদ্বরে,	হরিদ্বারে,	
orrgho,	অর্ঘর,	অর্ঘ্য,	
disni,	দিসনি,	ডিজনী,	
udvaboney,	উদভাবনে,	উদ্ভাবনে,	
shattoki,	শাত্তকী,	সাত্যকি,	
commissionvogider,	কমিিসনিভোগের,	কমিশনভোগীদের,	
kul,	কুল,	কুল,	
templet,	টেম্পলেট,	টেম্পলেট,	
bojhey,	বোঝে,	বোঝে,	
nederlande,	নেডার্ডাল্ডে,	নেদারল্যান্ডে,	
nadike,	নাদিকে,	নদীকে,	
rahshahi,	রাশহাসী,	রাহশাহী,	
buth,	বুথ,	বুথ,	
bhoolapuka,	ভূলাপুকা,	ভোলাপুক,	
pothnirdeshona,	পোঠনির্ধনে,	পথনির্দেশনা,	
oswastikor,	অস্সাস্তিকর,	অস্বস্তিকর,	
elakaasoho,	এলাকাসহ,	এলাকাসহ,	
charger,	চার্গের,	চার্জার,	
padee,	পাদি,	পাড়ে,	
sachetanvabe,	সচেছানেবাবে,	সচেতনভাবে,	
bedanta,	বেদান্তা,	বেদান্ত,	
plusey,	প্লাসে,	প্লাসে,	
taigara,	তাইগারা,	টাইগার,	
tottorat,	তত্তরাট,	তওরাত,	
drissogulote,	দৃস্সগুলোতে,	দৃশ্যগুলোতে,	
bishnu,	বিশ্নু,	বিষ্ণু,	
kanthar,	কাঁথার,	কাঁথার,	
jaubankal,	জৌবানকাল,	যৌবনকাল,	
atak,	আটাক,	আটক,	
chaiten,	চাইটেন,	চাইতেন,	
kaash,	কাশ,	কাস,	
torunra,	তরুন্রা,	তরুণরা,	
zubokra,	যুবক্রা,	যুবকরা,	
sahapathike,	সহাপথথীকে,	সহপাঠীকে,	
shikshakrom,	শিকশাক্রম,	শিক্ষাক্রম,	
byaktigotovabeo,	ব্যাক্তিভোগেও,	ব্যাক্তিগতভাবেও,	
mercedes,	মার্সেড,	মার্সেডেস,	
jubokti,	যুবক্তি,	যুবকটি,	
jounatar,	যৌনাতার,	যৌনতার,	
peethey,	পিথে,	পীঠে,	
ispredsiit,	ইসপ্রেডপট,	স্প্রেডশীট,	
tennis,	টেন্িস,	টেনিস,	
pathanatak,	পাথানাক,	পথনাটক,	
shishupalgarh,	শিশুপল্রলঘ,	শিশুপালগড়ে,	
planeti,	প্লানেটি,	প্লেনটি,	
narbur,	নারবুর,	নরবুর,	
deenes,	ডিনেস,	দীনেশ,	
poorohitra,	পৌরহীত্র,	পুরোহিতরা,	
brindaboney,	ব্রিন্ডবেনে,	বৃন্দাবনে,	
jatotaa,	জাতোটা,	যতোটা,	
satyaky,	সত্যক্,	সাত্যকি,	
kakhnoba,	কাখনোবা,	কখনওবা,	
batikromi,	বাতিক্রমী,	ব্যতিক্রমী,	
anagarikra,	অনাগাকরী,	অনাগরিকরা,	
sangram,	সংগ্রাম,	সঙ্গ্রাম,	
arekdol,	আরেক্ডল,	আরেকদল,	
dhhaloor,	ঢালুর,	ঢালুর,	
aprasangikbhabei,	অপ্রসংকাবাবীকেই,	অপ্রাসঙ্গিকভাবেই,	
shekender,	শেকেন্দের,	সেকেন্ডের,	
koota,	কুটা,	কোটা,	
windo,	উইন্ডো,	উইন্ডো,	
vabuk,	ভাবুক,	ভাবুক,	
transformaarer,	ট্রানস্ফর্মের,	ট্রান্সফরমারের,	
badaghat,	বাদাঘাট,	বাদাঘাট,	
bhittitei,	ভিত্তিতেই,	ভিত্তিতেই,	
baait,	বাইত,	বাইট,	
oncholke,	অঁচলকে,	অঞ্চলকে,	
sanaktokaran,	সনক্তকরণ,	সনাক্তকরণ,	
ekshoti,	এক্ষটি,	একশোটি,	
courtcaser,	কার্টসেসের,	কোর্টকেসের,	
tateo,	তাতেও,	তাতেও,	
kanar,	কানার,	কণার,	
sampadoner,	সম্পাদনের,	সম্পাদনের,	
kadakhonchar,	কাদাখান্নর,	কাদাখোঁচার,	
madhnagar,	মধনাগর,	মাধনগরের,	
tolemy,	টোলেমি,	টলেমির,	
bharpur,	ভারপুর,	ভরপুর,	
query,	কুয়ে,	কোয়েরি,	
edmeeral,	এডিরাম,	এডমিরাল,	
obharbhiu,	অভরভাই,	ওভারভিউ,	
rahimed,	রাহিমেদ,	রহিমেদ,	
cholochchitraeeo,	চলচ্চত্রীও,	চলচ্চিত্রেও,	
protijogi,	প্রতিযোগী,	প্রতিযোগী,	
nowel,	নুয়েল,	নভেল,	
oncolsoho,	অনকোলসহ,	অঞ্চলসহ,	
obosan,	অবসান,	অবসান,	
klaud,	ক্লুদ,	ক্লাউড,	
neker,	নেকের,	নেকের,	
sangitanusthane,	সংগীতাসুথানে,	সঙ্গীতানুষ্ঠানে,	
qarlosa,	কারলোসা,	কার্লোস,	
jhanjra,	ঝাঁজ্রা,	ঝাঁজরা,	
booponer,	বৌপের,	বপনের,	
kingsh,	কিংশ,	কিংস,	
talgachh,	তালগাছ,	তালগাছ,	
gandharir,	গানধারীর,	গান্ধারীর,	
humner,	হামনের,	হামনার,	
kompeeto,	কম্পিত,	কম্পিত,	
themekey,	থেমেকে,	থিমকে,	
poschime,	পশিচে,	পশ্চিমে,	
biswashi,	বিশ্বাশী,	বিশ্বাসই,	
munjur,	মুন্জুর,	মুনজুর,	
prakare,	প্রাকারে,	প্রকারে,	
byaboharkariyi,	ব্যবহারকারী,	ব্যবহারকারীই,	
alankorana,	আলাকর্ণা,	অলঙ্করণ,	
pratiyogitar,	প্রতিযোগতির,	প্রতিযোগীতার,	
gorrer,	গোর্র,	গোরের,	
sahachke,	সহাচ্ছে,	সাহাচকে,	
tochhnochh,	তচ্ছচ,	তছনছ,	
darji,	দারজি,	দরজি,	
hisabagyan,	হিসবব্যাঞ্জন,	হিসাবজ্ঞান,	
maudelti,	মাডেলটি,	মডেলটি,	
atighataner,	অতিঘাতানের,	অতিঘটনের,	
nathivukteer,	নথিভুক্তির,	নথিভুক্তির,	
pare,	পাযারে,	পাড়ে,	
marmaraa,	মারমারা,	মারমারা,	
porobortii,	পরবর্তিরই,	পরর্বতী,	
shipley,	শিপল,	শিপলে,	
chhutochhooti,	ছুটোচিটি,	ছুটোছুটি,	
abhidhaanick,	অভিধান্িক,	অভিধানিক,	
chhuteer,	ছুটির,	ছুটির,	
suri,	সুরি,	সুরি,	
ship,	শিপ,	শিপ,	
probolshoktio,	প্রবল্শক্ষিত,	প্রবলশক্তিও,	
madrasa,	মাদরাস,	মাদ্রাসা,	
godabari,	গোবাবারী,	গোদাবরী,	
chirantan,	চিরান্ত,	চিরন্তন,	
duburir,	দুবুরীর,	ডুবুরির,	
cocaine,	কোকাইন,	কোকেইন,	
rinattak,	ঋণত্টক,	ঋনাত্মক,	
windos,	উইন্ডস,	উইন্ডোস,	
gonohotyakey,	গণহত্যাকেই,	গণহত্যাকে,	
fotanor,	ফটানোর,	ফোটানোর,	
atibiplabi,	আতিবিল্বিবি,	অতিবিপ্লবি,	
harza,	হারজা,	হার্জ,	
shilver,	শিলভার,	সিলভার,	
mankisundar,	মানকিসুন্দার,	মানকিসুন্দর,	
balithubar,	বালিথুবার,	বালিথুবার,	
uparzoner,	উপার্জনের,	উপার্জনের,	
sorano,	সোরানো,	সরানো,	
achintyabhedaved,	অচিন্ত্যবেদেব,	অচিন্ত্যভেদাভেদ,	
dhani,	ধানি,	ধানি,	
fanding,	ফান্ডিং,	ফান্ডিং,	
muhaiminer,	মুহাইমিনের,	মুহাইমিনের,	
gannaprakasham,	গণ্নপ্রক্ষম,	গন্নাপ্রকাশম,	
protyokkhovabey,	প্রত্যক্ষভাবেই,	প্রত্যক্ষভাবে,	
jemy,	জেম,	জেমি,	
agora,	আগোরা,	আগোরা,	
hydrological,	হাইড্রোরিকোগাল,	হাইড্রোলজিক্যাল,	
heerani,	হিরানি,	হিরানি,	
sathik,	সাথিক,	সঠিক,	
helly,	হেল,	হিলি,	
noiteekotar,	নৈতেকোটার,	নৈতিকতার,	
aamontrito,	আমন্ত্রিত,	আমন্ত্রিত,	
joubankal,	জৌবানকল,	যৌবনকাল,	
tricksguli,	ট্রিসকগুলি,	ট্রিকসগুলি,	
selim,	সেলিম,	সেলিম,	
mase,	মাসে,	মাসে,	
expreshshion,	এক্সপ্রেশিন,	এক্সপ্রেশন,	
sadbi,	সাদবী,	সাধ্বী,	
parishram,	পরিশ্রম,	পরিশ্রম,	
desiseyer,	ডেসিসের,	ডিজিজের,	
samajeek,	সামাইক,	সামাজিক,	
rushad,	রুশাদ,	রুশদ,	
bandra,	বান্দ্রা,	বন্দীরা,	
fibergulote,	ফিবেরগুলোতে,	ফাইবারগুলোতে,	
ceramiker,	সেরামিকের,	সিরামিকের,	
chhayi,	ছাই়ি,	ছাই,	
ganosochetonota,	গণসচননতা,	গণসচেতনতা,	
nanabornobishishto,	নানবরবৃশন্ত,	নানাবর্ণবিশিষ্ট,	
probhuder,	প্রভুদের,	প্রভুদের,	
dholeshwari,	ধলেশ্বরী,	ধলেশ্বরী,	
juboke,	যুবকে,	যুবকে,	
graambaashio,	গ্রামবাশীও,	গ্রামবাসীও,	
boikalyo,	বৈকাল্য,	বৈকল্য,	
lyataa,	ল্যাটা,	ল্যাটা,	
jonmobhumitir,	জন্মভূতির,	জন্মভূমিটির,	
gaddaafee,	গাদ্ডাফ,	গাদ্দাফী,	
laaisens,	লাইনেস,	লাইসেন্স,	
nobotomo,	নবতমম,	নবতম,	
iqbalke,	ইকবালকে,	ইকবালকে,	
modele,	মডেলে,	মডেলে,	
nutaner,	নুতানের,	নূতনের,	
liaodong,	লিয়ারোডং,	লিয়াওদং,	
upobasher,	উপবাশের,	উপবাসের,	
sazanor,	সাজানোর,	সাজানোর,	
eexpreession,	ইক্সপ্রেশন,	এক্সপ্রেশন,	
anchalei,	আঁচালেই,	অঞ্চলেই,	
overholing,	ওভারহলিং,	ওভারহোলিং,	
grontho,	গ্রন্থ,	গ্রন্থ,	
puroheetder,	পুরহহেটদের,	পুরোহিতদের,	
shchalastic,	স্যাল্সিক,	স্কলাস্টিক,	
chandil,	চান্দিল,	চান্ডিল,	
uddhrito,	উদ্ধৃত,	উদ্ধৃত,	
habol,	হাবল,	হাবোল,	
golghare,	গোলঘারে,	গোলঘরে,	
basaalt,	বাসালট,	ব্যাসল্ট,	
eigulor,	এইগুলোর,	এইগুলোর,	
kinsha,	কিনশা,	কিংস,	
jibnagore,	জীবনাগোরে,	জীবননগর,	
aireshe,	আইরেশে,	আইরেসে,	
binee,	বিনি,	বেনি,	
udbhaboni,	উদ্ভাবনি,	উদ্ভাবনী,	
remission,	রেমিসিওন,	রিমিশন,	
jins,	জিনস,	জিন্স,	
gujob,	গুজব,	গুজব,	
notikotar,	নতিকতার,	নৈতিকতার,	
phuda,	ফুডা,	ফুড,	
shrabastee,	শ্রবাস্তি,	শ্রাবস্তী,	
ranangane,	রণাঙ্গানে,	রণাঙ্গনে,	
pluck,	প্লাসক,	প্ল্যাক,	
konagoolo,	কোনাগুলো,	কণাগুলো,	
ingrezeeteo,	ইংরেজিতেও,	ইংরেজিতেও,	
sookumari,	সুকুমারী,	সুকুমারী,	
hitlere,	হিটলার,	হিটলারে,	
gosthike,	গোষ্ঠীকে,	গোষ্ঠীকে,	
manjushree,	মঞ্জুশ্য,	মঞ্জুশ্রী,	
mmadhuri,	ম্যামধুরি,	মাধুরী,	
karmasampadon,	কর্মসম্পপন,	কর্মসম্পাদন,	
vittio,	ভিত্তিও,	ভিত্তিও,	
achintopurer,	অচিন্তপুরের,	অচিন্তপুরের,	
barnis,	বার্নিস,	বার্নিশ,	
bee,	বিই,	বি,	
nibeditar,	নিবেদিতার,	নিবেদিতার,	
firoza,	ফিরোজা,	ফিরোজা,	
directorate,	ডিরেক্টোটারে,	ডিরেক্টরেট,	
mohajot,	মহাজত,	মহাজোট,	
loombinee,	লুম্বিনি,	লুম্বিনী,	
venice,	ভেনিসে,	ভেনিস,	
niropekkho,	নিরপেক্ষ,	নিরপেক্ষ,	
liedtke,	লিড্টকে,	লইডটক,	
ghoor,	ঘৌর,	ঘুর,	
chalachchitroke,	চালাচ্তিরীকে,	চলচ্চিত্রকে,	
bhogni,	ভোগনি,	ভগ্নী,	
heelser,	হিলসসের,	হিলসের,	
dibug,	দিবুগ,	ডিবাগ,	
chouhate,	চৌহাতে,	চৌহাটে,	
shangkulaan,	শংকুলান,	সংকুলান,	
proteemake,	প্রতিমাকে,	প্রতিমাকে,	
barack,	বারাক্,	বারাক,	
elakaate,	এলাকাতে,	এলাকাতে,	
bhabaponno,	ভাবাপন্ন,	ভাবাপন্ন,	
innahu,	ইন্নাহু,	ইন্নাহু,	
pratista,	প্রতিস্তা,	প্রতিষ্টা,	
samle,	সামলে,	সামলে,	
nischoy,	নিশ্য়,	নিশ্চয়,	
shaahaabiike,	শাহাইবিকে,	সাহাবীকে,	
somraatra,	সোমরাত্রা,	সম্রাটরা,	
chal,	চাল,	চাল,	
rajpur,	রাজপুর,	রাজপুর,	
shiter,	শিতের,	শীতের,	
erajyobasi,	এরাজায়াবি,	এরাজ্যবাসী,	
latsaheb,	লাতসেবে,	লাটসাহেব,	
andon,	আন্দন,	আন্দোন,	
ramchander,	রামচান্ডের,	রামচন্দরের,	
mukhbondho,	মুখবন্ধ,	মুখবন্ধ,	
mahibur,	মহিবুর,	মহিবুর,	
oitijhya,	ঐতিঝ্য,	ঐতিহ্য,	
chandanara,	চন্দনারা,	চন্দনারা,	
bhoutikeshu,	ভৌটিকেশু,	ভৌতিকেষু,	
chasee,	চাসি,	চেস,	
phaltu,	ফালতু,	ফালতু,	
baaiq,	বাইক,	বাইক,	
gaichhe,	গাইছে,	গাইছে,	
chahidapotrer,	চাহিদাপত্রের,	চাহিদাপত্রের,	
konoroop,	কনোরপপ,	কোনরূপ,	
pharmesigulote,	ফার্েসিমাগুলোতে,	ফার্মেসীগুলোতে,	
madrasi,	মাদরাসী,	মাদ্রাজি,	
shcholastic,	শ্লাক্সিক,	স্কলাস্টিক,	
rupert,	রুপার্ট,	রুপার্ট,	
sossar,	সোসসার,	সকার,	
ahong,	আহং,	অহং,	
vaphara,	ভাপারা,	বাফার,	
moshjidke,	মোশজিদকে,	মসজিদকে,	
bopoon,	বপোন,	বপন,	
ghuznavi,	ঘুজনাভি,	গজনভি,	
nojder,	নজদের,	নজদের,	
colgirl,	কলগির,	কলগার্ল,	
jegulur,	জেগুলুর,	যেগুলুর,	
vimsen,	ভিমসেন,	ভীমসেন,	
oyebjin,	ওয়েবজিন,	ওয়েবজিন,	
mandarbani,	মন্দরববানী,	মন্দারবাণী,	
modyer,	মোদ্যের,	মদ্যের,	
alonkaran,	আলোকরণ,	অলঙ্করণ,	
procharjontrogulo,	প্রচারযোগ্রগুলো,	প্রচারযন্ত্রগুলো,	
protijogiitamulok,	প্রতিজমিতগুলকক,	প্রতিযোগীতামূলক,	
prosadhaner,	প্রসাধানের,	প্রসাধনের,	
hukar,	হুকার,	হুকার,	
sheepha,	শীফা,	শেফ,	
raghubar,	রাঘুবার,	রঘুবীর,	
bahjya,	বাহজ্যা,	বাহ্য,	
byabaharkareederke,	ব্যবহারকাদে,	ব্যবহারকারীদেরকে,	
bhejaano,	ভেজাও,	ভেজানো,	
maaktoome,	মাকতামে,	মাকতুম,	
upacharjo,	উপাচার্য,	উপাচার্য,	
nagorikota,	নাগরিকতা,	নাগরিকতা,	
shakar,	শাকার,	সকার,	
foks,	ফোক্স,	ফক্স,	
bishashke,	বিশাশকে,	বিশ্বাসকে,	
faskari,	ফাক্কারী,	ফাঁসকারী,	
swostir,	স্বস্তির,	স্বস্তির,	
akhhunno,	আখুন্ন,	অক্ষুণ্ণ,	
hizriite,	হিজরিতেতে,	হিজরীতে,	
proo,	প্রোও,	প্রো,	
ekbai,	একবাই,	একবাই,	
sondhisthaponer,	সন্ধিস্থাপনের,	সন্ধিস্থাপনের,	
kobutorer,	কবুতরের,	কবুতরের,	
adwanced,	অ্যাডবাযান্ড,	অ্যাডভান্সড,	
parswer,	পার্সের,	পার্শ্বের,	
mugdha,	মুগধা,	মুগ্ধ,	
bodhukeo,	বধুকেও,	বধুকেও,	
alpa,	আলপা,	অল্প,	
mayily,	মায়িলি,	মাইলি,	
prangulo,	প্রাণগুলো,	প্রানগুলো,	
lahano,	লাহানো,	লাহানো,	
ahalya,	আহাল্য,	অহল্যা,	
marmader,	মার্মদের,	মারমাদের,	
chaudhuriyo,	চৌধুরীয়,	চৌধুরীও,	
bhujangta,	ভূজাঙ্তা,	ভুজঙ্গটা,	
muchlima,	মুচলিমা,	মুছলিমা,	
aarmstrong,	আ্যার্মস্টংর,	আর্মস্ট্রং,	
nuhas,	নুহাস,	নুহাশ,	
dhangsachchi,	ধাংস্চি,	ধ্বংসাচ্ছি,	
protul,	প্রতুল,	প্রতুল,	
koordira,	কুরদিরা,	কুর্দিরা,	
langhangulir,	লঙ্ঘানগুলির,	লঙ্ঘনগুলির,	
hertj,	হার্ট,	হার্জ,	
shuri,	শুরি,	সুরি,	
wilderske,	উইল্ডরসকে,	উইল্ডার্সকে,	
shootar,	শুতার,	শ্যুটার,	
jyaqa,	জ্যাকা,	জ্যাক,	
edic,	এডিক,	এডিক,	
qonflict,	কনফলিক্ট,	কনফ্লিক্ট,	
debdebyr,	ডেবেদবির,	দেবদেবীর,	
oxite,	অক্সিতে,	অক্সাইট,	
hundai,	হুন্দাই,	হুন্দাই,	
bolbo,	বলবব,	বলবো,	
bhushito,	ভূষিত,	ভূষিত,	
anhu,	আনহু,	আনহু,	
karecho,	কারেছো,	করেছ,	
nachiketa,	নাচিকেটা,	নচিকেতা,	
poste,	পোস্টে,	পোষ্টে,	
jamarate,	জামারাতে,	জামারাতে,	
khilaphat,	খিলাপাট,	খিলাফত,	
standards,	স্টান্ডার্ড,	স্টান্ডার্ডস,	
asamanyo,	আসামান্য,	অসামান্য,	
orthanitir,	অর্থানিতির,	অর্থনীতির,	
nirabota,	নিরাবতা,	নিরবতা,	
kampita,	কামপিতা,	কম্পিত,	
iuro,	ইউইও,	ইউরো,	
suraaropeeto,	সুরারোপতত,	সুরারোপিত,	
aatmobishwasi,	আত্মবিশ্বাসী,	আত্মবিশ্বাসী,	
chhuteete,	ছুটেতে,	ছুটিতে,	
phutanta,	ফুতান্তা,	ফুটন্ত,	
phox,	ফ্যাক্স,	ফক্স,	
lutherana,	লুথেরানা,	লুথেরান,	
babare,	বাবারে,	বাবারে,	
jerusalemer,	জেরুসামের,	জেরুজালেমের,	
soundorjotakei,	সৌন্দর্যতাকেই,	সৌন্দর্যটাকেই,	
jackey,	জ্যাকে,	জকি,	
ramzaner,	রামজানের,	রমযানের,	
bouddha,	বৌদ্ধ,	বৌদ্ধ,	
oitijhyotike,	ঐতিহ্যতিহীকে,	ঐতিহ্যটিকে,	
abanishankar,	অবনীশঙ্কর,	অবনিশংকর,	
change,	চ্যাঞ্গে,	চেঞ্জ,	
hena,	হেনা,	হেনা,	
gyandas,	গ্ঞানদাস,	জ্ঞানদাস,	
dakten,	ড্যাক্টেন,	ডাকতেন,	
hol,	হোল,	হোল,	
aranyani,	আরণ্যানী,	অরণ্যানী,	
rejidens,	রেজিডেনস,	রেসিডেন্স,	
aembed,	এমবেদ,	এম্বেড,	
bhenus,	ভেনুস,	ভেনাস,	
torikher,	তরিখের,	তরিখের,	
taderek,	তাদেরিক,	তাদেরেক,	
faase,	ফাযাসে,	ফাঁসে,	
ghurechen,	ঘুরেছেন,	ঘুরেছেন,	
atmabishvashi,	আত্মাবিশী,	আত্মবিশ্বাসী,	
pratijogitamulak,	প্রতিজমুতিতলক,	প্রতিযোগীতামূলক,	
kaferderke,	কাফেরদেরকে,	কাফেরদেরকে,	
elakayi,	এলাকায়,	এলাকাই,	
bizito,	বিজিতো,	বিজিত,	
yaak,	য়ক,	ইয়াক,	
rakkhandurga,	রক্ষণ্দগুর্গ,	রক্ষণদুর্গ,	
rata,	রাতা,	রত,	
brekethru,	ব্রেকুঠুরা,	ব্রেকথ্রু,	
ashiatic,	অশিয়াটিক,	এশিয়াটিক,	
koyeeri,	কোয়িরি,	কোয়েরি,	
rajotwo,	রাজত্ব,	রাজত্ব,	
holdim,	হোলদি,	হোল্ডিং,	
baasaate,	বাসাতে,	বাসাতে,	
mitro,	মিত্রো,	মিত্র,	
parisankhanbid,	পরিসাখবাদিখ,	পরিসংখ্যানবিদ,	
oncoltike,	অন্নটিলকে,	অঞ্চলটিকে,	
durgatsabe,	দুর্গাসবাবে,	দুর্গোৎসবে,	
teter,	টেটের,	টেটের,	
nishad,	নিশাদ,	নিষাদ,	
ghamta,	ঘামতা,	ঘোমটা,	
renoo,	রেনো,	রেনো,	
madrasake,	মাদ্রাসাকে,	মাদ্রাসাকে,	
kantojir,	কানতোজির,	কান্তজির,	
bhogno,	ভগ্ন,	ভগ্ন,	
highcomissione,	হাইকমিসনে,	হাইকমিশনে,	
jolbe,	জলবে,	জ্বলবে,	
nabbata,	নব্বতা,	নাব্যতা,	
sarder,	সারদের,	সরদার,	
labonaktatar,	লাবনকতার,	লবণাক্ততার,	
zerusalemer,	জেরুসালেমের,	জেরুজালেমের,	
akhando,	আখান্ডো,	অখন্ড,	
shikshagato,	শিক্ষাগত,	শিক্ষাগত,	
korimer,	করিমের,	করিমের,	
oikhan,	ঐখান,	ঐখান,	
aziboner,	আজিবনের,	আজীবনের,	
elahabade,	এলাহাবাদে,	এলাহাবাদে,	
dipankar,	দীপান্ার,	দিপঙ্কর,	
amburi,	আম্বুরি,	আম্বুরি,	
mookhomandoler,	মৌখমান্ডলের,	মুখমণ্ডলের,	
shnaipara,	স্নেইপারা,	স্নাইপার,	
nikote,	নিকোতে,	নিকটে,	
aakkas,	আক্কাস,	আককাস,	
shariba,	শরীবা,	শরিবা,	
stana,	স্তানা,	স্টোন,	
kormobuddhite,	কর্মবুদ্ধিতে,	কর্মবুদ্ধিতে,	
moreecha,	মরিছা,	মরিচা,	
ajuhat,	আজুহাত,	অজুহাত,	
soinyora,	সৈন্যরা,	সৈন্যরা,	
manabmaner,	মানবামেনের,	মানবমনের,	
ingreziteo,	ইঙ্গ্রিজিতেও,	ইংরেজিতেও,	
bodna,	বোদনা,	বদনা,	
oxforde,	অক্সফোর্ডে,	অক্সফোর্ডে,	
pronoti,	প্রনতি,	প্রণতি,	
atmiyasulabh,	আত্মিয়ালুলসা,	আত্মীয়সুলভ,	
azin,	আজিন,	আজিন,	
shatodha,	শাতোধা,	শতধা,	
pleena,	প্লিনা,	প্লেন,	
eporjonto,	এপর্ন্ত,	এপর্যন্ত,	
contemporary,	কন্টেমপরিপা,	কন্টেম্পোরারি,	
thailandsaho,	ঠাইলান্ডসহ,	থাইল্যান্ডসহ,	
beekaargrasta,	বিকার্গ্রস্ত,	বিকারগ্রস্ত,	
zohns,	জোন্স,	জন্স,	
gyada,	জ্যাড়া,	গ্যাদা,	
golimodhye,	গলিমধ্যে,	গলিমধ্যে,	
jansha,	জানশা,	জন্স,	
krema,	ক্রেমা,	ক্রাইম,	
taufiq,	তাউফিক,	তৌফিক,	
mandanda,	মন্দান্ডা,	মানদণ্ড,	
zeeland,	জীলান্দ,	জিল্যান্ড,	
karlei,	কারলেই,	করলেই,	
antarctika,	অ্যান্টার্টিকা,	অ্যান্টার্কটিকা,	
heena,	হিনা,	হেনা,	
ebhara,	এভারা,	এভার,	
nothivuktir,	নথিভুক্তির,	নথিভুক্তির,	
kathmandute,	কাঠমন্দুতে,	কাঠমান্ডুতে,	
nodnodeer,	নদ্দদীর,	নদনদীর,	
palbongser,	পালবংস্জের,	পালবংশের,	
militarite,	মিলিতারিতে,	মিলিটারিতে,	
daltyagi,	দল্ত্বগী,	দলত্যাগী,	
majdur,	মাজদুর,	মজদুর,	
keu,	কেউ,	কেউ,	
grooth,	গ্রথ,	গ্রোথ,	
khorsed,	খোরসে,	খোরশেদ,	
gejetade,	জেজেটাদে,	গেজেটেড,	
oshtader,	অষ্টাদের,	ওস্তাদের,	
nariderke,	নারীদেরকে,	নারিদেরকে,	
biprodas,	বিপ্রদাস,	বিপ্রদাস,	
janar,	জানার,	জানার,	
halding,	হালদিং,	হোল্ডিং,	
evaner,	এভানের,	ইভানের,	
ramonar,	রামোনার,	রমনার,	
neshnosh,	নেশশোস,	নেশনস,	
fimela,	ফিমেলা,	ফিমেল,	
steeit,	স্টিট,	স্টেইট,	
paira,	পাইরা,	পাইরা,	
crime,	ক্রিম,	ক্রাইম,	
cheekitshar,	চিকিৎশার,	চিকিত্সার,	
kareer,	কারির,	কারীর,	
taitela,	তৈইটেলা,	টাইটেল,	
matrirup,	মাত্রিরূপ,	মাতৃরূপ,	
scholarsip,	স্কোলারসিপ,	স্কলারশিপ,	
mausumer,	মৌসুমের,	মৌসুমের,	
scoore,	স্কালর,	স্কোর,	
firti,	ফিরটি,	ফিরতি,	
saarbhaarti,	সারভার্টী,	সার্ভারটি,	
prithibir,	পৃথিবির,	পৃথবীর,	
daktikit,	দাকটিকিত,	ডাকটিকিট,	
jontrangshogulor,	যন্ত্রাঙগগুলোর,	যন্ত্রাংশগুলোর,	
glanio,	গ্লাসিও,	গ্লানিও,	
neshnos,	নেশনস,	নেশনস,	
trenda,	ট্রেন্ডা,	ট্রেন্ড,	
shommotir,	শম্তটির,	সম্মতির,	
onupater,	অনুপাতের,	অনুপাতের,	
rakkhanbhag,	রক্ষণবাগ,	রক্ষণভাগ,	
hooldim,	হুল্ডিম,	হোল্ডিং,	
pothon,	পথন,	পঠন,	
hughkey,	হুঘকে,	হিউজকে,	
shourshe,	শৌরশে,	সোর্স,	
harbur,	হারবুর,	হারবার,	
chupani,	চুপানি,	চুপানি,	
daebug,	দাবুগ,	ডিবাগ,	
kalnir,	কালনির,	কালনীর,	
oitijje,	ঐতিজ্যে,	ঐতিহ্যে,	
neelfamarir,	নীলফামারীর,	নীলফামারীর,	
jonesh,	জনেশ,	জোন্স,	
chalchhe,	চালচে,	চলছে,	
kheshar,	খেশার,	খেশার,	
qyapasula,	ক্যপাপুলা,	ক্যাপসুল,	
grambaseer,	গ্রামবাসির,	গ্রামবাসীর,	
temanti,	তেমান্তি,	তেমনটি,	
teta,	তেটা,	টেটা,	
chowdhurir,	চৌধুরীর,	চৌধুরীর,	
naubom,	নৌবম,	নবম,	
barder,	বারদের,	বার্ডের,	
bondishalatei,	বন্দিশালাতেই,	বন্দিশালাতেই,	
satjaner,	সাতজানের,	সাতজনের,	
gaaddafee,	গাড্ডফি,	গাদ্দাফী,	
plate,	প্লেটে,	প্লেটে,	
nikate,	নিকাতে,	নিকটে,	
kiibord,	কিবর্দ,	কীবোর্ড,	
orthisoho,	অর্থিসহ,	অর্থিসহ,	
tonoo,	তনু,	তনু,	
kleentoner,	ক্লিনটনের,	ক্লিনটনের,	
shilbar,	শিলবার,	সিলভার,	
cinemapremider,	সিনেমপ্রেদের,	সিনেমাপ্রেমীদের,	
sinakey,	সিনাকেই,	সিনাকে,	
soorsa,	সুর্া,	সোর্স,	
freekeh,	ফ্রিকেহ,	ফ্রিকেহ,	
bonvumi,	বনভুমি,	বনভূমি,	
smarok,	স্মারক,	স্মারক,	
konisttha,	কনিস্ট্থ,	কনিষ্ঠ,	
toufiq,	তৌফিক,	তৌফিক,	
fatakasto,	ফাতাকাস্ত,	ফাটাকেষ্ট,	
ghoomachhe,	ঘুমাছে,	ঘুমাচ্ছে,	
tahorir,	তাহরির,	তাহরীর,	
obdi,	ওবদি,	অব্দি,	
ancholgoolir,	আ্যানকোলির,	অঞ্চলগুলির,	
bedey,	বেডে,	বেদে,	
generalissimo,	জেনেরালিসিম,	জেনারেলিসিমো,	
makame,	মাকামে,	মাকামে,	
rahee,	রাহি,	রাহি,	
dharmantor,	ধর্মান্তর,	ধর্মান্তর,	
wodka,	ওয়াডকা,	ভদকা,	
boikolyo,	বৈচললই,	বৈকল্য,	
shekarone,	শেকারণে,	সেকারণে,	
gopalrao,	গোপালরাও,	গোপালরাও,	
juddhahato,	যুদ্ধাত,	যুদ্ধাহত,	
as,	আসএএ,	অস,	
laaisensh,	লাইশেন্স,	লাইসেন্স,	
cholochchitra,	চলচচ্ত্রিরা,	চলচ্চিত্র,	
gostigulo,	গোষ্টিগুলো,	গোষ্ঠীগুলো,	
hights,	হাইটট,	হাইটস,	
manohputa,	মনঃপুতা,	মনঃপুত,	
granada,	গ্রাণাদা,	গ্র্যানাডা,	
pathkrom,	পাঁক্রম,	পাঠক্রম,	
gurmukh,	গুর্মুখ,	গুরমুখ,	
abadamoner,	আবাদামনের,	অবদমনের,	
alimpiqa,	আলিমপিক্া,	অলিম্পিক,	
footballerra,	ফুটলবলালেরা,	ফুটবলাররা,	
ancholtike,	আ্যানচোলটিকে,	অঞ্চলটিকে,	
fuss,	ফুস্,	ফাস,	
baikalyo,	বৈকাল্য,	বৈকল্য,	
highcommissionay,	হিইংসমিয়ানি,	হাইকমিশনে,	
samanwitovabe,	সমন্বিতভাবে,	সমন্বিতভাবে,	
maudelder,	মাউডলের,	মডেলদের,	
bbiswashi,	বিশ্বাশী,	বিশ্বাসই,	
ongshogrohoner,	অংশগ্রহণের,	অংশগ্রহনের,	
andra,	আন্দ্রা,	আন্ড্রা,	
kaloniir,	কালোলির,	কালনীর,	
sbaajan,	স্বজান,	স্বজন,	
assaciates,	এ্যাস্সেটেটা,	এসোসিয়েটস,	
si,	সিয়,	এসআই,	
horidwar,	হোরিদ্বর,	হরিদ্বার,	
andamana,	আন্দামানা,	আন্দামান,	
sangbadmadhyamgulote,	সংবব্ধামগুলোগেতে,	সংবাদমাধ্যমগুলোতে,	
welcome,	ওয়েলকে,	ওয়েলকাম,	
khabarsoho,	খাবারসহ,	খাবারসহ,	
byaboharkarike,	ব্যবহরার্যীকে,	ব্যবহারকারীকে,	
shikkhakram,	শিক্ষকর্ম,	শিক্ষাক্রম,	
grambaasheeo,	গ্রামবাশাও,	গ্রামবাসীও,	
harja,	হারজা,	হার্জ,	
noiteek,	নৈতিক,	নৈতিক,	
lutharen,	লুথারেন,	লুথেরান,	
khagen,	খাগেন,	খগেন,	
review,	রেভিউ,	রিভিউও,	
aashanka,	আশানকা,	আশংকা,	
waal,	ওয়াল,	উল,	
johny,	জোহনি,	জনি,	
akpashe,	আকপাশে,	একপাশে,	
chilahaati,	চিলাহাটি,	চিলাহাটি,	
suiti,	সুইটি,	সুইটি,	
anektai,	আনেকটাই,	অনেকটাই,	
porishongkhanbid,	পরিষণকংবিগ,	পরিসংখ্যানবিদ,	
ashankai,	আশাঙ্কাই,	আশঙ্কাই,	
shamijir,	শামিজির,	স্বামীজীর,	
aswasteekor,	অস্বাস্তকর,	অস্বস্তিকর,	
torutoler,	তরুতলের,	তরুতলের,	
saqara,	সাকারা,	সাকার,	
hizrite,	হিজরিতে,	হিজরীতে,	
peterke,	পেটেরকে,	পিটারকে,	
dhojovongo,	ধোযোভন্গ,	ধ্বজভঙ্গ,	
footbalarra,	ফুতবালারা,	ফুটবলাররা,	
manushti,	মানুষ্টি,	মানুষটি,	
swadhinotatukui,	স্বাধীনতাতুই,	স্বাধীনতাটুকুই,	
bonobhumi,	বনভূমী,	বনভূমি,	
dhalur,	ধালুর,	ঢালুর,	
tikta,	তিক্তা,	তিক্ত,	
polashir,	পোলাশীর,	পলাশীর,	
amanisa,	আমানিসা,	অমানিশা,	
vagini,	ভাগিনি,	ভগিনী,	
parinati,	পরিনাটি,	পরিণতি,	
shahanara,	শাহানারা,	শাহানারা,	
sahooseekotar,	সহৌসকতার,	সাহসিকতার,	
kash,	কাশ,	কাস,	
nazad,	নাজাদ,	নজদ,	
amor,	আমোর,	আমর,	
horash,	হোরাস,	হোরাস,	
catholicbad,	ক্যাথোলিকাব,	ক্যাথলিকবাদ,	
stanahenja,	স্তান্েযা,	স্টোনহেঞ্জ,	
gagee,	গাগী,	গেজ,	
brindabane,	বৃন্দবানে,	বৃন্দাবনে,	
rokibul,	রকিবুল,	রকিবুল,	
thare,	থারে,	থরে,	
avisongson,	অভিসংসন,	অভিশংসন,	
sangbadmadhyomgulote,	সংব্যাধমুগ্ললোতে,	সংবাদমাধ্যমগুলোতে,	
tanu,	তানু,	তনু,	
surakarder,	সুরকারদের,	সুরকারদের,	
chitronattakar,	চিত্রনাক্তার,	চিত্রনাট্যকার,	
onkush,	অঙ্কুষ,	অংকুশ,	
stander,	স্ট্যান্ডার,	স্ট্যাণ্ডের,	
dubaate,	দুবাতে,	ডুবাতে,	
seqtara,	সেকতারা,	সেক্টর,	
dhanyi,	ধান্য,	ধন্যি,	
chalai,	চালাই,	চালাবে,	
prokar,	প্রকার,	প্রকার,	
prokolpogulikei,	প্রকলপপগুলিকেই,	প্রকল্পগুলিকেই,	
ji,	জিয়া,	জি,	
survative,	সূর্ভাতিভে,	সারভেটিভ,	
madhobi,	মাধবি,	মাধবী,	
bosontokke,	বসন্তকে,	বসন্তকে,	
bhorkendra,	ভর্কেন্দ্রা,	ভরকেন্দ্র,	
tistar,	তিস্তার,	তিস্তার,	
kooshumba,	কুশুমবা,	কুশুম্বা,	
balatarin,	বালাতারিন,	বালাতারিয়ান,	
daktickete,	ডাক্তিকেতে,	ডাকটিকিটে,	
donat,	দোনাত,	ডোনাট,	
anusvara,	অনুস্বরা,	অনুস্বার,	
ragei,	রাগেই,	রাগেই,	
paadee,	পায়িড,	পাড়ে,	
jaistho,	যাইস্থ,	জ্যৈষ্ঠ,	
dankaan,	ডানকান,	ডানকান,	
azaan,	আজান,	আজান,	
khuizza,	খুইজ্জা,	খুইজ্জা,	
krom,	ক্রম,	ক্রম,	
arsie,	আরসি,	আরসিএ,	
poriharsoho,	পরিহর্সহ,	পরিহারসহ,	
bibhinno,	বিভিন্ন,	বিভন্ন,	
zeebonto,	জীবন্ত,	জীবন্ত,	
nirmolotaa,	নির্মলতা,	নির্মলতা,	
torabgonj,	তোরাবগঞ্জ,	তোরাবগঞ্জ,	
rajyotiro,	রাজ্যতরী,	রাজ্যটিরও,	
besooro,	বেসোরো,	বেসুর,	
nathivukta,	নথিভুক্ত,	নথিভুক্ত,	
daaoon,	দাওন,	ডাউন,	
bongsho,	বংশো,	বংশ,	
murader,	মুরাদের,	মুরাদের,	
sahocorje,	সহোকর্্যে,	সাহচর্যে,	
oisamoyer,	ঐসামমের,	ঐসময়ের,	
totokhon,	ততখন,	ততক্ষন,	
kajangale,	কাজাগালে,	কজঙ্গলে,	
abosan,	অবসান,	অবসান,	
rajnikant,	রাজনিকান্ত,	রাজনীকান্ত,	
sikkhakbrinda,	সিক্ষাবকৃৃন্দ্,	শিক্ষকবৃন্দ,	
kotibondhe,	কতিবন্ধে,	কটিবন্ধে,	
dhache,	ধাচে,	ধাঁচে,	
nirmol,	নির্মল,	নির্মল,	
spredashita,	স্প্রেডাশ্টি,	স্প্রেডশীট,	
mojdur,	মজ্দুর,	মজদুর,	
ovarview,	ওভারভিয়,	ওভারভিউ,	
doloo,	দলো,	ডলু,	
bhabotarini,	ভাবতারীনী,	ভবতারিণী,	
sookkho,	সুক্ষ,	সুক্ষ্ম,	
muchi,	মুচি,	মুচি,	
byomkesh,	ব্যমকেশ,	ব্যোমকেশ,	
soolke,	সুলকে,	শুল্কে,	
shingping,	শিংপিং,	শিংপিং,	
bojhaao,	বোঝাও,	বোঝাও,	
qrisenta,	ক্রিসেন্টা,	ক্রিসেন্ট,	
kaley,	কলে,	কালে,	
joisttho,	যৈষ্ঠ,	জ্যৈষ্ঠ,	
societyke,	সোকিইটিকে,	সোসাইটিকে,	
bhyaatikaner,	ভ্যাতিকাণের,	ভ্যাটিকানের,	
sangharshik,	সংশর্িক,	সাংঘর্ষিক,	
shilpajata,	শিল্পাজাতা,	শিল্পজাত,	
aachhis,	আছিস,	আছিস,	
minilosar,	মিনিলোসার,	মিনিলোসার,	
mohammadi,	মোহামদামী,	মুহাম্মদী,	
nili,	নিলি,	নিলি,	
pratijogider,	প্রতিযোগীদের,	প্রতিযোগীদের,	
udbodhaney,	উদ্বধানেয়ে,	উদ্বোধনে,	
tarunra,	তরুনরা,	তরুণরা,	
khelechen,	খেলেছেন,	খেলেছেন,	
debholopar,	দেবলাপার,	ডেভলপার,	
mitrota,	মিত্রতা,	মিত্রতা,	
bifol,	বিফল,	বিফল,	
spenser,	স্পেন্সের,	স্পেন্সার,	
metrikoleshana,	মেটিরোকেশানা,	মেট্রিকোলেশন,	
saom,	সাওম,	সাওম,	
nirbaaho,	নির্বাহ,	নির্বাহ,	
ooipoka,	ওইপোকা,	উইপোকা,	
dekhso,	দেখস,	দেখসো,	
protizogii,	প্রতিযোগিই,	প্রতিযোগী,	
aaireshe,	এইরেশে,	আইরেসে,	
uthe,	উঠে,	উঠে,	
eucalyptus,	ইউকাল্িপ,	ইউক্যালিপ্টাস,	
spredasita,	স্প্রেডেস্টিটা,	স্প্রেডশীট,	
romarder,	রোমারদের,	রোমারদের,	
patininda,	পাতিনিন্ডা,	পতিনিন্দ,	
mangolic,	ম্যাঙ্গোলিক,	মাঙ্গলিক,	
alaoler,	আলাওলের,	আলাওলের,	
bhandti,	ভান্দটি,	ভাণ্ডটি,	
samratder,	সমর্তদের,	সম্রাটদের,	
mahasava,	মহাসাবা,	মহাসভা,	
cooda,	কুডা,	কোডা,	
pretty,	প্রেটি,	প্রিটি,	
dipti,	দিপ্টি,	ডেপুটি,	
shurugulo,	শুরুগুলো,	শুরুগুলো,	
dishani,	দিশানী,	দিশানি,	
superheiroo,	সুপারেহেও,	সুপারহিরো,	
kommandar,	কোমমান্ডার,	কমাণ্ডার,	
supparak,	সুপপারক,	সুপ্পারক,	
kuttake,	কুটতাকে,	কুত্তাকে,	
chaalaabi,	চালাবি,	চালাবে,	
satarka,	সতরকরকা,	সতর্ক,	
aagera,	আগেরা,	আগোরা,	
monzooshree,	মঞ্জশূরই,	মঞ্জুশ্রী,	
naper,	নাপের,	ন্যাপের,	
hoil,	হইল,	হইল,	
udvabani,	উদভাবানী,	উদ্ভাবনী,	
nabotom,	নাবতম,	নবতম,	
bhangle,	ভাংলে,	ভাঙলে,	
nirdesika,	নির্দেসিকা,	নির্দেশিকা,	
motkey,	মোটকে,	মতকে,	
shahurgulor,	শাহুরগুলোর,	শহুরগুলোর,	
ghotolen,	ঘটলেন,	ঘটলেন,	
difinision,	ডিফিনেশন,	ডেফিনেশন,	
chamski,	চামসককি,	চমস্কি,	
dayitta,	দাইতিয়া,	দায়িত্ব,	
okritokarjo,	অকৃতকার্য,	অকৃতকার্য,	
quary,	কুয়ারি,	কোয়েরি,	
byboshthar,	বিবস্থার,	ব্যাবস্থার,	
gaichey,	গেইছে,	গাইছে,	
parkasa,	পারকাসা,	পার্কস,	
aziza,	আজিজা,	আজিজা,	
maarmaader,	মার্মাদের,	মারমাদের,	
taalaal,	তালাল,	তালাল,	
nodimaatrik,	নদিমত্রিকৃত,	নদীমাতৃক,	
path,	পাথ,	পাথ,	
noditei,	নদীতেই,	নদীতেই,	
emerjency,	এমারজেন্,	এমার্জেন্সি,	
hosto,	হস্ত,	হস্ত,	
shangsthatikey,	শংস্থতাতিকে,	সংস্থাটিকে,	
weenis,	উইনিস,	ভেনিস,	
laaz,	লাজ,	লাজ,	
daakteekite,	দাকটিকেতে,	ডাকটিকিটে,	
